2523568577,  Beppe_murg, 126, 61, 65, no
728188723075158016,  AleElle1, 30, 6, 24, no
2562814182,  franco_dimuro, 492, 220, 272, no
222411571,  furiadicheb1897, 45, 18, 27, no
1062583370,  UBrignone, 462, 52, 410, no
4432360889,  lindaeciao, 72, 27, 45, no
395908244,  _Orbis_, 16, 7, 9, no
1464788840,  lvoir, 260, 86, 174, no
2754543846,  vittoriodiri, 71, 29, 42, no
3094312457,  Tizianaviola46, 107, 19, 88, no
1229121186,  carlucci_cc, 322, 53, 269, no
1328664937,  AngeloVinardi, 31, 11, 20, no
3357308483,  demian_yexil, 704, 229, 475, no
702267737,  ACHILLEMARATI, 67, 24, 43, no
426719729,  MarGauFil, 34, 9, 25, no
732773769824047104,  NativiItaliani, 300, 121, 179, no
499128183,  niemiz1964, 1349, 540, 809, no
399589131,  francapapini, 13, 6, 7, no
3123285591,  RaimondoLazzano, 19, 8, 11, no
1160278561,  VanessaCorini, 85, 14, 71, no
792398721661149185,  maccaroneserena, 15, 7, 8, no
2746079253,  fulmine2006, 29, 11, 18, no
95482042,  gs5654, 60, 12, 48, no
744524292050788352,  antony220970, 112, 51, 61, no
3374386924,  fmugnani1, 24, 11, 13, no
705029912265097218,  MarrostafX, 109, 46, 63, no
966699302,  Leo_Frescura, 34, 12, 22, no
37434853,  RobRuggio, 17, 6, 11, no
421427868,  Shamaysan, 35, 16, 19, no
800750620818800640,  gensjulia1, 246, 64, 182, no
1021727540,  MarcoMorosini3, 24, 11, 13, no
372937945,  leonemaschio, 38, 17, 21, no
3038103838,  mafaldina61, 211, 72, 139, no
2921447206,  Ilenia1970, 261, 76, 185, no
1623140270,  LegaNordArcene, 407, 179, 228, no
716591970106417152,  claudiobonura, 222, 12, 210, no
985080900,  usaipiero, 19, 7, 12, no
1853857640,  ricrrooll, 60, 25, 35, no
4048087467,  crissscri871, 41, 13, 28, no
152673484,  AleKenobi, 101, 33, 68, no
721084485190688768,  besso_paolo, 33, 4, 29, no
1276339076,  ALEXIxoic, 8, 3, 5, no
318549168,  FerfraHemp, 119, 11, 108, no
3332448431,  benetti1961, 213, 44, 169, no
222157419,  guerrieriP, 16, 5, 11, no
443193400,  soleterramare, 80, 17, 63, no
186399539,  aculpo, 112, 3, 109, no
1316630180,  micheladania, 127, 6, 121, no
427372566,  Minerva_86, 10, 3, 7, no
97773643,  pallina60, 36, 8, 28, no
2267581078,  perozzzi, 20, 6, 14, no
2898075617,  MPenikas, 725, 100, 625, no
478663552,  DevidPorrello, 14, 4, 10, no
618138331,  Antony5S, 18, 8, 10, no
123235814,  silvestroso, 80, 6, 74, no
317680130,  rosa857, 32, 10, 22, no
405498561,  trottamirco, 124, 44, 80, no
2496989087,  DavideRibolini, 70, 7, 63, no
2979240557,  TS1078, 75, 26, 49, no
483258299,  TommasoMiele, 73, 22, 51, no
357074444,  OttaviDeborah, 58, 11, 47, no
1534486934,  m5ssuper, 66, 24, 42, no
3290984981,  BabbaiFabry, 150, 11, 139, no
2973459185,  Charlie7311, 44, 21, 23, no
1354935949,  M5S_Camera, 82, 6, 76, no
2838570387,  CiofiniGiulio, 42, 9, 33, no
170781140,  ald962, 63, 9, 54, no
1262939593,  occhiverdi57, 48, 10, 38, no
332885533,  Virus1979C, 292, 90, 202, no
410764821,  DiegoMaykail, 68, 14, 54, no
471347700,  kijuyu, 16, 3, 13, no
2527780688,  igorbrickil5S, 129, 9, 120, no
1412500075,  soniabetz1, 424, 162, 262, no
2390797348,  dindolone, 25, 7, 18, no
2386237696,  gioart79, 83, 36, 47, no
967124340,  pino_micali, 81, 4, 77, no
616372545,  GIORGIOBELLINO2, 14, 3, 11, no
154587914,  faetto, 11, 3, 8, no
57472352,  aledif3, 29, 4, 25, no
2350811871,  DavideDeVivo98, 23, 4, 19, no
1001303996,  decontentabile, 30, 13, 17, no
2804469977,  pittapittore, 8, 3, 5, no
2487298258,  RobertLonigro84, 17, 4, 13, no
3758739195,  VaniaCecconi, 90, 33, 57, no
2962772146,  GiulyFrac, 49, 18, 31, no
704779333307650048,  celestinoceles7, 165, 54, 111, no
943396292,  furiamp73, 9, 4, 5, no
4284959421,  cristianovilla9, 40, 15, 25, no
1103450372,  miconsentatwitt, 41, 15, 26, no
2422875421,  tonyooooo0, 42, 12, 30, no
2527788012,  robe_marc, 53, 16, 37, no
1334865294,  ClaudioRoasio, 406, 152, 254, no
1171065324,  ClaudioStecca, 11, 3, 8, no
1356675511,  andreagallo_it, 7, 3, 4, no
1017412344,  DanieleBibo, 40, 17, 23, no
633147468,  la_masseria, 10, 3, 7, no
99475834,  ilariomaiolo, 34, 13, 21, no
396218442,  lucaM1966, 249, 118, 131, no
352164101,  CorradoRabbia, 32, 10, 22, no
3431319455,  martinaital, 16, 7, 9, no
101573147,  giamma71, 133, 29, 104, no
2380592546,  silmauve775, 43, 12, 31, no
1114542462,  RobertoCoscelli, 10, 1, 9, no
865157341,  gaspare58, 11, 2, 9, no
390753281,  SaggioYogurt, 61, 25, 36, no
585968039,  Yi_Benevolence, 60, 28, 32, no
80200885,  Stefbazzi, 94, 33, 61, no
605749807,  zum_zug, 24, 5, 19, no
403652993,  franzfleck, 15, 3, 12, no
2714596672,  PaolaTacconi, 135, 56, 79, no
2902258413,  markmoreskins, 19, 9, 10, no
798743088206319616,  Melania11564076, 462, 124, 338, no
741592495155478528,  FioreVero123, 95, 28, 67, no
843757543,  assuntapaganucc, 54, 9, 45, no
499227001,  ANDREAZANETTIN, 235, 66, 169, no
2361360169,  SirioFerri, 702, 205, 497, no
3401876698,  marianomores61, 24, 11, 13, no
3385105642,  ElenaCerci, 513, 75, 438, no
1274899394,  cobraalveleno, 38, 15, 23, no
557827565,  luca_vidoni, 251, 40, 211, no
3377428947,  EntiLocaliFI, 27, 4, 23, no
4160203479,  LPincia, 143, 55, 88, no
2455541630,  66liuk, 103, 36, 67, no
26982622,  FaustoConti, 314, 71, 243, no
20430345,  renatobrunetta, 334, 132, 202, no
63126601,  danteferraris, 55, 15, 40, no
303139807,  Chiara5Stelle, 30, 14, 16, no
440716175,  TobrukBruno, 19, 9, 10, no
84874030,  mcapu100, 26, 12, 14, no
714739556747243520,  boettoisabella1, 16, 2, 14, no
1374652910,  simonavitelli60, 78, 36, 42, no
495466998,  zluca2, 31, 12, 19, no
1948013262,  1diaiaco, 9, 3, 6, no
474746645,  nabru11, 70, 14, 56, no
486400626,  ruggides, 5, 2, 3, no
443187387,  marpol55, 275, 115, 160, no
1372461787,  luisaloffredo28, 334, 111, 223, no
456894487,  pugganagga, 62, 29, 33, no
589286587,  JohnHard3, 118, 48, 70, no
395759988,  gabry_v, 14, 4, 10, no
530990399,  luchinux, 47, 11, 36, no
3871871513,  genovesi_mg, 65, 14, 51, no
1022123316,  biffino, 39, 14, 25, no
2940410703,  085a2db71d18453, 52, 13, 39, no
3369517217,  enricomaino, 19, 8, 11, no
3957645843,  Massimo27355129, 215, 50, 165, no
3243380165,  robbe1978, 9, 4, 5, no
1368152558,  TAL77SVAD, 227, 45, 182, no
265385204,  manilamatic, 48, 22, 26, no
1278202914,  A77362729, 23, 8, 15, no
1359735968,  zanzotteramauro, 25, 11, 14, no
436833006,  AfinetAlberto, 28, 11, 17, no
1261559155,  lucvit69, 84, 13, 71, no
1263818557,  CiceroM5S, 59, 20, 39, no
3124240699,  lucamedico, 53, 23, 30, no
702128508835860480,  LauraGio_75, 170, 68, 102, no
3028742807,  marcos_sup, 41, 15, 26, no
2431061097,  francescade54, 215, 70, 145, no
139188966,  Valnao, 73, 18, 55, no
753519234710376449,  pantanac, 88, 17, 71, no
2975094340,  ADTacitus, 55, 25, 30, no
2883830458,  renzoferrari61, 19, 9, 10, no
752897299186155520,  Alex46928800, 39, 16, 23, no
161450764,  aanddrreaa, 56, 24, 32, no
343239720,  catarvoyageur, 107, 27, 80, no
4372999402,  Sempre5S, 106, 36, 70, no
1176618985,  pigi02, 291, 84, 207, no
4142636141,  Sergio_torino, 9, 3, 6, no
737934742461526016,  charas2, 8, 2, 6, no
268749571,  lucadome76, 30, 12, 18, no
3024843525,  RealGottlieb, 114, 53, 61, no
730660405761191936,  Ant__RI, 23, 6, 17, no
451279327,  giorgio_trentin, 11, 4, 7, no
2359548435,  mikiden62, 31, 12, 19, no
2282469222,  francesco201423, 175, 67, 108, no
4911191667,  GianluSag, 124, 47, 77, no
778321813,  RattiEnrico, 232, 86, 146, no
192258181,  albinobistacco, 69, 24, 45, no
3067642931,  brusalucia, 15, 5, 10, no
1307016348,  poke_dem, 157, 68, 89, no
1088677627,  marisaLaDestra, 38, 13, 25, no
602903174,  Storace, 80, 31, 49, no
413217587,  gasparripdl, 292, 88, 204, no
1037692622,  frafra61_rossi, 137, 62, 75, no
3607235297,  ninalives81, 21, 10, 11, no
4098447160,  Elena07617349, 615, 209, 406, no
787009091373850625,  Salvato01143095, 337, 111, 226, no
413354451,  IlariaCalvani, 90, 34, 56, no
448998373,  PDibattista, 112, 36, 76, no
1478297786,  PravatoSilvano, 62, 10, 52, no
2436608759,  Uleprr, 343, 110, 233, no
194972957,  cinmir89, 174, 48, 126, no
1084193910,  kidstu, 99, 45, 54, no
4863618933,  CretellaRoberta, 183, 65, 118, no
118183154,  GianelliniR, 17, 6, 11, no
175783590,  shakerman1971, 10, 4, 6, no
742013658268598273,  Anna05600885, 33, 11, 22, no
115139827,  ardovig, 35, 10, 25, no
526552069,  gioritucci, 15, 7, 8, no
501225131,  AlexZan87, 30, 8, 22, no
416928501,  alfidom, 11, 4, 7, no
447990031,  andreagiacobin1, 15, 4, 11, no
257499288,  FrancoTrax, 71, 23, 48, no
475234937,  valy_s, 169, 84, 85, no
3058996408,  IFreeInfo, 13, 6, 7, no
488765562,  Monica_torino, 36, 15, 21, no
118053242,  _sofino, 23, 9, 14, no
2289164481,  petrucci_3, 9, 3, 6, no
836271002,  marino29b, 844, 177, 667, no
759428777793429505,  il_brigante07, 197, 66, 131, no
1967120184,  AntonyFederico, 15, 7, 8, no
2376140579,  NasoCarla, 19, 3, 16, no
2363684405,  AlessioFraumene, 75, 12, 63, no
2277559444,  andipa_di, 6, 2, 4, no
947879034,  Cosi49Cosimo, 70, 28, 42, no
1036788019,  nick__67, 21, 5, 16, no
2791075913,  GalloCostantino, 118, 58, 60, no
766601799155449857,  XMERIDIO78, 30, 12, 18, no
1891583048,  elisabetta7991, 31, 14, 17, no
381097192,  RaffaeleMerella, 7, 2, 5, no
237248877,  nottruv, 10, 4, 6, no
19441340,  grillocb, 15, 5, 10, no
788063079418499072,  maximocasale, 4, 1, 3, no
716911634871160832,  simosimona05, 177, 36, 141, no
369728921,  ruiciccio, 493, 199, 294, no
432010252,  aghi7723, 12, 2, 10, no
2906264861,  celeste_bazzoli, 71, 29, 42, no
70684476,  simonefagioli, 3, 1, 2, no
150254340,  VilmoModoni, 4, 1, 3, no
2170742693,  rosabta, 104, 28, 76, no
1667689482,  GonzDeGadda, 65, 28, 37, no
4845403365,  Andyesti, 53, 22, 31, no
3046529709,  giulietino11, 35, 11, 24, no
706086896275955712,  5risi1, 163, 68, 95, no
594802573,  carlomarroni, 4, 1, 3, no
734725512950603776,  TitiCasati, 64, 20, 44, no
481920011,  dani0470, 9, 4, 5, no
602182097,  SpaceCowboy21, 75, 34, 41, no
1257355178,  GianfrancoB3, 69, 29, 40, no
480757316,  marcobalsughi, 5, 1, 4, no
2906792414,  only_jimmy_it, 3, 1, 2, no
405170821,  Luka1961, 65, 15, 50, no
775636532,  garridino, 88, 37, 51, no
2980862283,  CateCollovati, 3, 1, 2, no
2397844595,  annalisapanello, 106, 46, 60, no
2427311741,  clabellocchi, 256, 106, 150, no
715925457774972929,  BrunoTulliani, 10, 4, 6, no
2176219136,  DeborahRaptus, 5, 2, 3, no
1012822723,  EmileFrancy, 40, 18, 22, no
153342663,  emato64, 29, 13, 16, no
2795593730,  11B_Mic, 27, 8, 19, no
3524610567,  Claudio85806751, 17, 1, 16, no
2876085995,  peppins2, 29, 13, 16, no
2813435920,  Salvo332Salvo, 21, 8, 13, no
1556491195,  pa_tere, 91, 41, 50, no
1471608194,  erpedrini, 171, 82, 89, no
1195176624,  YahFiorito, 51, 25, 26, no
545474882,  FabozziGennaro, 16, 3, 13, no
2977934441,  senantoniorazzi, 340, 21, 319, no
362550965,  ErosBonazzi, 61, 12, 49, no
536600780,  GianlucaBardell, 34, 16, 18, no
1009626624,  IsaaakCAErvello, 80, 38, 42, no
491969040,  CereIvan, 16, 7, 9, no
842378066,  bodyzen52, 26, 11, 15, no
278210313,  carmencasablanc, 61, 27, 34, no
2318610186,  futura09, 95, 29, 66, no
1106230255,  mzavarone, 46, 15, 31, no
75538541,  marcosimbula, 20, 9, 11, no
63060955,  RiprendRoma, 42, 7, 35, no
775039590784729088,  CalogeroVolpe21, 96, 23, 73, no
407685967,  Grand_Battery, 195, 57, 138, no
13727692,  fiordisale, 118, 51, 67, no
409089494,  avanti_xxx, 50, 14, 36, no
705813420973621248,  MAD13021966, 397, 108, 289, no
2322947462,  ValeMameli, 55, 21, 34, no
1384894520,  MauroBarin, 123, 59, 64, no
318434829,  GiuliaGenito, 22, 6, 16, no
1911991346,  social_5stars, 102, 13, 89, no
353575520,  emanuelapetrucc, 82, 40, 42, no
789786960470614017,  MaurizioGattus1, 29, 7, 22, no
773183546966048768,  FischerM55, 404, 26, 378, no
710498404531630080,  lidiapres08, 569, 24, 545, no
4016008995,  riccagilli, 46, 4, 42, no
3342531046,  iostoconmarino, 218, 11, 207, no
700817890497310720,  1vocexRoma, 214, 11, 203, no
708997585139318784,  annadivalerio, 213, 11, 202, no
4474043243,  ParteCivile, 375, 15, 360, no
4405643841,  lidiera1, 500, 22, 478, no
2282008813,  cla_cur, 1376, 605, 771, no
1059984817,  avvocatorinaldi, 24, 11, 13, no
1096235264,  LucianoBarraCar, 10, 2, 8, no
508645944,  BordignonAngelo, 23, 10, 13, no
702253149189439488,  LaVolage, 7, 2, 5, no
3217923085,  IlTweetDiDio, 24, 10, 14, no
1189981854,  meribia51, 18, 8, 10, no
3355338993,  voragano, 23, 4, 19, no
547050389,  LusiPatrizia, 285, 22, 263, no
1544336527,  elvise1657, 51, 21, 30, no
1339993381,  Ro78Fas, 31, 15, 16, no
2309237552,  Zedar73, 38, 9, 29, no
209891777,  Sorriento_tw, 29, 14, 15, no
1489965936,  argento62, 74, 2, 72, no
1371970536,  AquilabyClaKi, 9, 3, 6, no
701388779114930177,  micaleafacchini, 133, 56, 77, no
914050591,  VikSom71, 31, 15, 16, no
1037152033,  Sabina1956, 127, 61, 66, no
472905491,  gabelmanu, 29, 14, 15, no
3426670696,  enkai_pan, 170, 63, 107, no
4069173009,  Bacc_investor93, 128, 43, 85, no
213818443,  scudieromn, 19, 7, 12, no
465390684,  Ariachetira, 35, 12, 23, no
62951965,  Be_Strega, 25, 10, 15, no
4726174575,  forzafedele, 82, 24, 58, no
762326924,  al2395, 12, 5, 7, no
899385834,  arte_moses, 33, 13, 20, no
4104175103,  GiulianoPalotto, 6, 2, 4, no
394241598,  iltrenoromalido, 15, 5, 10, no
706596340306984961,  Frances33526378, 33, 9, 24, no
724573957781856256,  GiorgiRonchi, 19, 7, 12, no
562947998,  aef66116232, 5, 2, 3, no
1192672903,  CesareHandala, 7, 3, 4, no
620351637,  marcimarti17, 63, 30, 33, no
780095104132509696,  Malandra1957, 39, 17, 22, no
1306691233,  Renzoseccia, 72, 32, 40, no
69896457,  nan_nan_an, 28, 10, 18, no
4195440875,  spillatriceblu, 39, 13, 26, no
2995908064,  CutronaDomenico, 34, 6, 28, no
1860935300,  MaurizioIsola66, 9, 4, 5, no
1000188997,  ChessMassim, 44, 8, 36, no
375352671,  FabioPariante, 9, 3, 6, no
2521671494,  FrancoSuSarellu, 32, 12, 20, no
436629007,  MariannaBifulco, 17, 7, 10, no
899672546,  RiccardoUrbani3, 35, 16, 19, no
117026070,  vinmoccia, 9, 2, 7, no
276665800,  eliasalis, 29, 14, 15, no
303810430,  SALVATORECOSCIA, 28, 9, 19, no
3227318753,  marinapiva67, 120, 47, 73, no
121106879,  Fabio_Vita, 35, 16, 19, no
415437027,  i1ygq, 27, 12, 15, no
748139485335011328,  r_castiglia, 20, 9, 11, no
2422131402,  HeinrichTreviri, 24, 6, 18, no
758304360543707137,  laltravocenews, 29, 8, 21, no
361341817,  LilloFalsini, 48, 7, 41, no
2318991212,  antov2401, 16, 5, 11, no
501811802,  tomei_tomei, 13, 6, 7, no
22616757,  pellescura, 10, 4, 6, no
722718822134849539,  valensvale82, 3, 1, 2, no
440737015,  MicheleSolari70, 29, 14, 15, no
3306953649,  figliodelcaos, 5, 2, 3, no
720897887014645760,  gracemng4, 5, 1, 4, no
96327061,  luciano080, 22, 8, 14, no
423294786,  BeaGio62, 60, 29, 31, no
801764256299569152,  mattiapareddu, 17, 8, 9, no
2321258784,  salvo_pistaract, 8, 1, 7, no
22901191,  Blinky74, 19, 7, 12, no
719855009928716288,  paolopaolo2516, 109, 44, 65, no
84862444,  SimonePiloni, 6, 2, 4, no
424388863,  MarinoLizza, 20, 9, 11, no
1366648526,  GiusiSarcina, 10, 4, 6, no
1377558510,  nonhotutto, 3, 1, 2, no
1254440240,  74_pippo, 14, 5, 9, no
2267806358,  ottogattotto, 42, 12, 30, no
604628522,  abianchibg, 5, 2, 3, no
122014351,  Tommasolabate, 4, 1, 3, no
2993021697,  grandemax60, 80, 29, 51, no
319578825,  baronegiuseppe, 76, 36, 40, no
3613181357,  iovotono, 262, 102, 160, no
475248885,  donatogaetano, 232, 75, 157, no
599807864,  il_potatore, 25, 7, 18, no
2971568187,  PellegriniLuisa, 82, 29, 53, no
2982641339,  Zepp87, 69, 24, 45, no
477548046,  rosabevilacqua1, 20, 9, 11, no
426094795,  regis_andrea, 42, 14, 28, no
266066911,  Tucchia, 19, 5, 14, no
1640766590,  marcograsso581, 94, 27, 67, no
593582642,  m5sTess, 31, 13, 18, no
455266241,  Corrado_info, 122, 58, 64, no
3336714819,  morologiulio, 18, 6, 12, no
456674882,  evakent62, 62, 24, 38, no
8266162,  my_cinquestelle, 48, 21, 27, no
3987937325,  rebybor, 15, 7, 8, no
1332630272,  CoSksIMone, 55, 26, 29, no
371245774,  SynesthesiaRAC, 12, 4, 8, no
4885903612,  pantera2318, 87, 28, 59, no
2241274927,  Manuel_Ghezzi, 150, 31, 119, no
532222780,  LelloEsposito5, 198, 59, 139, no
142807042,  ricdil1, 56, 21, 35, no
270623814,  Surfiniae, 102, 25, 77, no
400902983,  ste_santini, 59, 26, 33, no
296528124,  JacopoVannucchi, 16, 7, 9, no
291328012,  1Poster1, 19, 7, 12, no
725759263025577985,  Dissenten2, 47, 22, 25, no
478505615,  rboni47, 7, 3, 4, no
3433378229,  GranelliPaolo, 134, 49, 85, no
17565436,  gaetano_rizza, 39, 14, 25, no
97532453,  matteosoraci, 5, 2, 3, no
131444859,  maxxfiore, 7, 3, 4, no
350469171,  giovanniaprea1, 16, 6, 10, no
3018290121,  versoilfuturo2, 64, 24, 40, no
1223079336,  Giuliano_Berta, 39, 12, 27, no
592546016,  Machelavoro, 37, 15, 22, no
576471812,  cominif, 20, 7, 13, no
987513386,  IvanGamberini, 6, 2, 4, no
3099708933,  RaiolaFeli, 10, 4, 6, no
83386342,  giulianabellino, 117, 50, 67, no
1055346697,  BartoloMercone, 26, 6, 20, no
513144334,  renatosouvarine, 145, 72, 73, no
475994227,  MauroIovino1, 14, 5, 9, no
717894055405961216,  Rosy87234986, 59, 28, 31, no
1143153842,  XerLItalia, 22, 7, 15, no
744819568909029377,  emeritoinsulso, 34, 13, 21, no
1926324451,  Pholey_vn, 63, 28, 35, no
788016239188860928,  Sabrinabarb4, 69, 16, 53, no
3364814494,  13d5e827fcb847d, 17, 2, 15, no
3022681938,  stefffi5, 30, 13, 17, no
989351852,  ComitatoIdoneiN, 79, 22, 57, no
1344701089,  angelotesta74, 62, 22, 40, no
2795115634,  lessini2, 55, 20, 35, no
447439107,  stagliacollo, 85, 27, 58, no
555551022,  Trappetta1, 14, 6, 8, no
2927551738,  vivistar81, 93, 23, 70, no
448631884,  orsolina71, 67, 15, 52, no
2927049323,  arch_fava, 67, 12, 55, no
3130552521,  ciroriccio74, 76, 11, 65, no
566434899,  Gi_Grimaldi, 20, 5, 15, no
1205274991,  AleKappaS, 30, 2, 28, no
498915523,  DKaleeva, 15, 3, 12, no
2203686361,  MaSpadavecchia, 76, 33, 43, no
2984502441,  nedopaglianti, 34, 9, 25, no
2331849409,  ManglaDan, 34, 8, 26, no
524493374,  nebookanizer, 35, 13, 22, no
58453980,  PiazzapulitaLA7, 48, 18, 30, no
270070566,  NOANNA2007, 45, 16, 29, no
870218785,  SergbarsSergio, 7, 1, 6, no
496233111,  AccusoEnzo, 9, 2, 7, no
331648841,  paola_di1, 8, 3, 5, no
3169965514,  VostraEminenza, 13, 6, 7, no
3110560259,  BrucatoGiusepp, 31, 14, 17, no
1962207937,  Gabrontolo_72, 7, 1, 6, no
43703232,  Torakjkj, 20, 6, 14, no
597137554,  Giusepp73199528, 3, 1, 2, no
394837520,  MatteoDonelli, 10, 4, 6, no
134206590,  arcanodavvero, 87, 21, 66, no
508555134,  guidamimmo, 19, 3, 16, no
735980645273489408,  PaolaSacchi3, 55, 23, 32, no
44160875,  AlexTheMod, 34, 12, 22, no
488895138,  sghi29, 112, 46, 66, no
415055892,  angelomontarsol, 5, 2, 3, no
57466155,  galeazzi66, 18, 5, 13, no
4853784417,  sergiovero855, 30, 9, 21, no
281477534,  EuPaleu, 23, 10, 13, no
2489764008,  cornizzolo, 16, 6, 10, no
3228099125,  GrappaTommaso, 20, 9, 11, no
714555676417265664,  Takezo85, 18, 6, 12, no
84130259,  zanzy82, 54, 24, 30, no
1268297346,  grullobeppe, 20, 4, 16, no
916522718,  ConteZero76, 127, 54, 73, no
1498786196,  polizia_locale_, 13, 5, 8, no
414385318,  protoromantica, 33, 13, 20, no
426640529,  alesweetshadow, 8, 3, 5, no
1037713867,  giancalex, 26, 10, 16, no
2416492224,  maxbax33, 42, 16, 26, no
1367363988,  SardellaBarbara, 26, 12, 14, no
2730482441,  annapapamiki071, 33, 15, 18, no
367390935,  Andrea_Beretta, 17, 8, 9, no
293608717,  iomaredinverno, 5, 2, 3, no
2616680851,  10261940, 51, 19, 32, no
2234448710,  Publio_Marone, 3, 1, 2, no
39022638,  giomaggiora, 74, 31, 43, no
409444860,  francabaratella, 56, 27, 29, no
962311958,  licia_la, 88, 43, 45, no
1278700207,  marangelo2005, 33, 16, 17, no
703875686218522624,  Bill30745412, 21, 10, 11, no
1598253523,  Lanzichenecco7, 17, 8, 9, no
533176044,  fedquattrocchi, 43, 21, 22, no
161740961,  Serfiss, 60, 27, 33, no
383052987,  sikeliota, 47, 0, 47, no
1857148146,  rodolfo80838139, 57, 27, 30, no
242351511,  araccontarlo, 33, 8, 25, no
745784576719589377,  AndriaClaucio, 18, 4, 14, no
3347934334,  francoxgreco, 246, 4, 242, no
455500859,  taxistalobbysta, 29, 13, 16, no
325760306,  Cor_Core_Acceso, 118, 53, 65, no
590188450,  s_fusco, 109, 17, 92, no
554179159,  Peleo59, 5, 2, 3, no
362516905,  crazybalzano, 3, 1, 2, no
1405465094,  lenuccia82, 100, 39, 61, no
2984790945,  RsSebastiano, 5, 2, 3, no
3313351684,  MetaSociale, 93, 6, 87, no
797773134669680640,  placidialex, 3, 1, 2, no
2462609518,  GrandukaC, 6, 2, 4, no
1921125602,  VianelloRita, 10, 2, 8, no
96364636,  anpolt, 9, 3, 6, no
1308112182,  MimmoBaeli, 19, 7, 12, no
1296801535,  _epoc24, 19, 7, 12, no
873734450,  amenoklean, 11, 5, 6, no
2760251254,  francescocorda9, 4, 1, 3, no
3025669096,  Democrazy_blog, 36, 14, 22, no
22604437,  attila47, 4, 1, 3, no
804014310066450432,  salvator_deli, 26, 10, 16, no
522292867,  giovann92391754, 60, 26, 34, no
498288910,  biondo2k, 7, 2, 5, no
988375248,  Solsbury93, 11, 4, 7, no
103056844,  AndreaSorb, 10, 2, 8, no
1894270790,  FalvoGianluca, 32, 4, 28, no
414978233,  amariMarisa, 25, 10, 15, no
805858804588023808,  PapiriAnna, 32, 14, 18, no
2184944111,  NaniPuffo, 21, 7, 14, no
4548508636,  SettimoFiorenzo, 49, 16, 33, no
379256309,  GiuliaDiVita, 27, 8, 19, no
3094278383,  novemberman3000, 166, 65, 101, no
1105814539,  andrea_pertici, 143, 32, 111, no
2260660337,  ciclista1231, 114, 56, 58, no
2817131786,  LoMangioSoloSeM, 24, 10, 14, no
805697989218013184,  tamburotamburo, 8, 3, 5, no
1275239096,  Beppesardinia, 45, 9, 36, no
213616021,  _kuball_, 128, 55, 73, no
1905601525,  Sandra_Savino, 28, 2, 26, no
2327342227,  Riccardi_FVG, 7, 2, 5, no
2858584827,  scuroscuroscuro, 149, 27, 122, no
1858061390,  Forza_ItaliaFVG, 51, 2, 49, no
796763568,  cinziamolizzi, 26, 5, 21, no
3471435689,  lullo64, 90, 12, 78, no
407746253,  ANTONIOMAUTAREL, 25, 3, 22, no
3387034282,  CantIdee, 23, 2, 21, no
2741727190,  Vituzzo_Zuccone, 90, 30, 60, no
1257881796,  MarcoMermarco, 27, 12, 15, no
2189430449,  magrini_sandra, 14, 6, 8, no
777025956078813184,  robgat51, 23, 11, 12, no
1477768746,  FredaRaffa, 5, 2, 3, no
3806382809,  StefanoSbardel2, 57, 5, 52, no
426026934,  PaoloVerri, 4, 1, 3, no
1433286055,  RaiTre, 28, 13, 15, no
1075099969,  Mordiglia, 3, 1, 2, no
135880913,  Dom_DeSantis, 6, 2, 4, no
4182142288,  cadoniantonella, 232, 78, 154, no
2313554308,  fredianoleu, 29, 14, 15, no
4811969481,  castigapolitici, 19, 8, 11, no
485012318,  Frankov74, 13, 2, 11, no
760872623538597889,  KdovejGrazie, 19, 8, 11, no
85136516,  sergimagugliani, 299, 65, 234, no
1225509780,  nessunoindietro, 96, 20, 76, no
248339544,  FuryBionda, 12, 3, 9, no
325473654,  RaffaCo54, 50, 21, 29, no
3135173073,  marioOrrico9, 26, 7, 19, no
3381325839,  Peritas65, 66, 18, 48, no
1488338479,  Orzo83, 91, 10, 81, no
2328923415,  MrLocci, 70, 8, 62, no
522329714,  AriCaldarella, 32, 8, 24, no
22743702,  alejorey, 12, 1, 11, no
2716739703,  cutolotto, 13, 3, 10, no
585674249,  cettymontemurro, 15, 3, 12, no
128998224,  johnnydsg, 14, 4, 10, no
402995375,  Lapid1, 23, 9, 14, no
331136187,  DanieleSpanu, 23, 11, 12, no
410852015,  dalbi62, 31, 3, 28, no
4187567045,  battaglia_persa, 90, 2, 88, no
478835343,  IoSonoColui, 9, 2, 7, no
861332947,  chiccoeri, 5, 1, 4, no
562805089,  Gattina721, 17, 2, 15, no
718185423571390464,  Solo_A_Roma, 35, 4, 31, no
2294163321,  EmanueleApp, 7, 2, 5, no
2227239038,  barbamob, 58, 18, 40, no
2494181366,  Giginet8472, 26, 11, 15, no
204041863,  Deepakumara, 28, 13, 15, no
753896468113678336,  Veronic70902762, 15, 6, 9, no
531137922,  Savj1951, 10, 4, 6, no
1122157453,  dariabianco, 10, 4, 6, no
418546477,  dilloamaurizio, 6, 1, 5, no
745709113552867328,  BestiaaitseB, 6, 2, 4, no
1331529962,  astrambaci, 6, 0, 6, no
2532491303,  ToninoR118, 22, 6, 16, no
766066296618414081,  proudman811, 414, 70, 344, no
1369005530,  GiovanniCalcara, 94, 10, 84, no
2873782396,  xsoniadm, 30, 13, 17, no
1143922956,  schiavone2012, 23, 8, 15, no
2222783701,  sergioalesi, 52, 24, 28, no
3309946937,  To_Arise, 241, 73, 168, no
2821597763,  la_ciccia, 23, 9, 14, no
3995124705,  AdelaidaDVeen, 42, 19, 23, no
2941902833,  Elenasciakky, 9, 4, 5, no
2895077031,  shopenauerwho, 169, 83, 86, no
504329686,  ChrFani, 25, 12, 13, no
561473002,  ntonioGiordano, 262, 130, 132, no
51167606,  GlaucoLora, 14, 6, 8, no
2703675064,  fragola1957, 67, 32, 35, no
780806706066395136,  _Referendum_, 12, 3, 9, no
2979050746,  frelich1988, 8, 3, 5, no
69532732,  DavideBoni, 41, 16, 25, no
771387619360043008,  danielaebasta4, 37, 18, 19, no
2597695185,  RcCamera, 21, 10, 11, no
3124079014,  dolcenovembre12, 327, 155, 172, no
1100783203,  fabio70AR, 272, 115, 157, no
1603393657,  matteopredica, 10, 4, 6, no
2889852755,  thelondonboys11, 164, 40, 124, no
4446307913,  Annabel27034387, 106, 36, 70, no
746943549661450240,  CORINNA07595792, 23, 7, 16, no
2322290576,  Vigan_Lt, 19, 9, 10, no
2719761311,  giulio_angelis, 32, 15, 17, no
253714436,  robinit66, 66, 19, 47, no
1353602473,  SAlbarosa, 29, 11, 18, no
2460104746,  BonoraGabriella, 30, 13, 17, no
602574015,  kirumakataossi1, 71, 31, 40, no
2901728910,  ArchideVivaio, 81, 40, 41, no
3309510766,  debbigiancarlo, 38, 11, 27, no
267174899,  mariolavia, 15, 4, 11, no
1047455850,  MFerraglioni, 26, 12, 14, no
82068999,  woodoow, 20, 6, 14, no
3019629387,  BarrioLatino67, 89, 9, 80, no
2203488436,  GAlloero, 32, 15, 17, no
2332571271,  elisabettap38, 132, 16, 116, no
953895188,  carloazzarone47, 24, 10, 14, no
23301182,  arosasco, 21, 4, 17, no
3216441514,  volonellaluce, 23, 11, 12, no
726108618051997696,  HondaClaudio, 33, 11, 22, no
3152228475,  toscaross, 69, 28, 41, no
1009243501,  marinabrunelli1, 69, 33, 36, no
2440237919,  carmen_piscopo, 43, 14, 29, no
2414500381,  barbara17767819, 43, 18, 25, no
3302069128,  antcampan, 42, 18, 24, no
1829960281,  GiorgioMorresi, 528, 156, 372, no
198981234,  Poppians, 22, 10, 12, no
2279477919,  effemme1957, 25, 5, 20, no
51522357,  RaffyB_68, 89, 17, 72, no
2832335447,  dukana2, 35, 15, 20, no
3387594292,  jmrhockey93, 13, 4, 9, no
3303278242,  CasoliEnza, 11, 5, 6, no
327455219,  emanuelefiano, 13, 6, 7, no
467573735,  francetomm, 64, 21, 43, no
324262863,  demmy747, 356, 27, 329, no
481929883,  GiangioTheGlide, 134, 12, 122, no
2559910725,  AntoTavolieri, 30, 8, 22, no
735888541079732225,  BurimZairi, 24, 7, 17, no
762983877849800704,  GabriellaMargh2, 25, 4, 21, no
396756630,  gstelluti, 417, 75, 342, no
333498140,  Dottor_Strange, 29, 9, 20, no
2306414611,  ferne1908, 5, 2, 3, no
3664503135,  beppe14788251, 14, 6, 8, no
3254009057,  10_cosimo, 11, 5, 6, no
4186758514,  marcopietro49, 103, 42, 61, no
588543892,  CAPOLONGOPIETR1, 5, 2, 3, no
2165464137,  Przmra, 12, 4, 8, no
858517812,  ernesto_piro, 15, 7, 8, no
3217393599,  lorenacelano61, 54, 21, 33, no
2341083257,  battistabd, 147, 50, 97, no
3014521558,  GsSeidita, 19, 4, 15, no
4024081156,  ConDiprospero, 15, 5, 10, no
535318339,  EnrichettaNegri, 41, 10, 31, no
215735286,  ilconteamar, 66, 31, 35, no
460611317,  kickmyballs222, 78, 16, 62, no
716353562020855810,  Andrea_D74, 34, 16, 18, no
734083116919365632,  marioaf18, 15, 4, 11, no
788124436406923264,  bot_tav, 25, 5, 20, no
437635996,  gioporce, 31, 15, 16, no
714382420,  CarmelaEmma, 183, 78, 105, no
1355024335,  SampieriValdis, 8, 3, 5, no
1929877436,  BBertaberry, 45, 22, 23, no
499633425,  NonUnodiMeno, 16, 6, 10, no
570833587,  pancraziovaleri, 135, 44, 91, no
3524549843,  TizianaBolzoni, 21, 9, 12, no
516918398,  ARosanio, 29, 9, 20, no
340847319,  etchisei, 85, 41, 44, no
2447574735,  366daniele, 151, 50, 101, no
600136789,  GhitaIacono, 158, 22, 136, no
1843782967,  edocogoo, 56, 2, 54, no
414319027,  luiginotedesco, 14, 2, 12, no
3225190005,  EEnricoielasi, 139, 39, 100, no
4617627196,  giulianobernar7, 8, 3, 5, no
2772829228,  matteoc1951, 70, 28, 42, no
799219281451958272,  Serenel73, 133, 37, 96, no
885661050,  FrancescoCarr11, 48, 5, 43, no
2259459451,  effebore, 67, 16, 51, no
1699665619,  incoronatacap, 46, 19, 27, no
1100350039,  fabiomorelli75, 74, 13, 61, no
4133217027,  ilpellicano88, 208, 6, 202, no
309347048,  Valer10ASR83, 19, 8, 11, no
428184160,  TeresaSicoli, 5, 2, 3, no
2717902222,  fulvia_fv, 76, 32, 44, no
715525255972917249,  Incazz_ato, 17, 7, 10, no
736491984081281024,  azzurra2016, 10, 3, 7, no
3359722569,  Stefaniadambra1, 9, 3, 6, no
524745118,  Al_Be_to, 13, 2, 11, no
266700017,  SaP011, 179, 32, 147, no
2155070496,  MirkoMartinez91, 101, 8, 93, no
297903655,  delPecora, 16, 7, 9, no
4243675906,  marinellafly12, 115, 6, 109, no
1069605998,  katmanduk2000, 12, 4, 8, no
1306369771,  FaenzaStefano, 29, 11, 18, no
9808092,  sparkgap, 39, 16, 23, no
402803669,  Fra_Lancellotti, 17, 3, 14, no
3332411590,  ivanbazzucchi1, 124, 10, 114, no
4188671596,  Marco_Zum, 108, 42, 66, no
2271564014,  tueetterin, 15, 5, 10, no
1084360147,  dartagnampolo, 20, 6, 14, no
3326316339,  ecortomaltese, 36, 9, 27, no
2376999356,  FabrizioRira, 150, 22, 128, no
1433806334,  ben_aio, 82, 16, 66, no
442950090,  Norrsken87, 56, 13, 43, no
566540382,  CivaRoma, 108, 7, 101, no
422340734,  AnnaxNar, 81, 24, 57, no
486787100,  sorso73, 39, 8, 31, no
3458047347,  FrancMolica, 28, 7, 21, no
1314132968,  Renato47Rm, 56, 19, 37, no
4121288038,  violaaa1981, 5, 2, 3, no
3764059997,  GualcoGabriella, 30, 6, 24, no
452985926,  iLGae75, 60, 24, 36, no
345488835,  DanilaScurria, 66, 17, 49, no
1171486081,  moderf47, 44, 20, 24, no
67746303,  masuccio67, 30, 14, 16, no
700939605521145856,  liliana14229842, 35, 12, 23, no
4914915772,  SegnalazioniSS, 28, 11, 17, no
567278450,  oznerol4, 23, 7, 16, no
69325472,  FPetrelli, 26, 9, 17, no
2390043691,  fabiobrunoen, 21, 6, 15, no
1857528240,  Inmezzora_Rai3, 33, 3, 30, no
1372922408,  belfast2609, 3, 1, 2, no
1867361222,  BartNicolotti, 17, 6, 11, no
1111297184,  Newsinunclick, 61, 21, 40, no
2464828514,  lievemente, 111, 37, 74, no
2316301654,  Massimo9456, 16, 7, 9, no
298123237,  FabioClerici, 150, 50, 100, no
418778432,  incrollabile, 10, 3, 7, no
17649765,  Gcesare, 9, 3, 6, no
442005205,  LucianoDavite, 32, 8, 24, no
723203630917136384,  GraziaGio1, 211, 96, 115, no
325739333,  gasalmi, 40, 13, 27, no
2652696807,  AgnelliPom, 22, 5, 17, no
1555826826,  rcolucci58, 13, 6, 7, no
4773242133,  CisasCampania, 19, 4, 15, no
1493589848,  cettiqualunque, 19, 2, 17, no
250774432,  angeloally, 122, 59, 63, no
2594867485,  donnadeipegni, 73, 18, 55, no
2511962844,  Antonel87691591, 152, 24, 128, no
434752212,  Vandauga, 67, 19, 48, no
1158164456,  MG462gm, 311, 149, 162, no
20128307,  holyghostpro, 6, 2, 4, no
2540910636,  AndreaGnarluz, 7, 3, 4, no
448045395,  trecy369875412, 15, 6, 9, no
795555849892691968,  gianAnt48908531, 13, 5, 8, no
439389927,  Magicaci, 11, 5, 6, no
2453297123,  danielabongior3, 15, 5, 10, no
891432866,  d73_alex, 12, 3, 9, no
1080507391,  DeivFur, 40, 16, 24, no
701647912686764032,  1972dpi, 31, 10, 21, no
91843058,  manuelaintini, 14, 3, 11, no
3937406775,  VIOLAMARTELLA46, 158, 16, 142, no
1174274426,  darioesposito26, 71, 17, 54, no
970705082,  Ste_Bussolino, 82, 39, 43, no
2891879657,  coppini_jacopo, 5, 2, 3, no
711299618219364354,  Peressita, 484, 18, 466, no
203005397,  Jacob2187, 344, 29, 315, no
797136442774450176,  andros2102, 305, 29, 276, no
4204326923,  AnnaMar55954470, 328, 19, 309, no
2651374166,  ScifoGiuseppe, 104, 27, 77, no
354210769,  gciprotti, 4, 1, 3, no
786244023837155328,  enza_venturelli, 10, 4, 6, no
2648038336,  Pasquino70, 37, 10, 27, no
1401604591,  wolfbywolf, 8, 3, 5, no
713009769,  LucBumbolo, 3, 1, 2, no
457622220,  MichaelRooster, 22, 10, 12, no
1913892218,  VCattivo, 39, 9, 30, no
526765918,  BEE_atriX, 31, 8, 23, no
263037408,  dib309mar, 11, 3, 8, no
2273694722,  liberafla, 8, 3, 5, no
540147645,  giuseppevenez11, 6, 2, 4, no
199216783,  lblou, 19, 8, 11, no
4384279288,  parloamestessa, 47, 6, 41, no
1260171894,  ArchCmc, 131, 50, 81, no
991498111,  RiccardoCorio1, 17, 5, 12, no
2467497190,  domenicosansov1, 71, 35, 36, no
416018070,  DieWelt75, 6, 2, 4, no
2872332023,  Libercolo, 54, 15, 39, no
708429391,  slavina6, 208, 63, 145, no
1156611540,  MarcoF_Cirillo, 9, 2, 7, no
2147638752,  La_Siusy, 16, 6, 10, no
396564186,  andrea__braga, 241, 12, 229, no
310216032,  luigibruscianes, 3, 1, 2, no
3404776456,  elvipetretta, 56, 12, 44, no
1357812068,  Aquintoc, 40, 9, 31, no
216688489,  Carmniello, 3, 1, 2, no
447863789,  carmenmalmassar, 29, 8, 21, no
123903173,  abacaino, 24, 11, 13, no
1456556520,  Gigino51, 12, 3, 9, no
1562890188,  StefanoCar91, 12, 4, 8, no
2173027221,  gvalle77, 23, 10, 13, no
3405599800,  5StelleOvunque, 29, 10, 19, no
785533550393192448,  Orizzonte_Nuovo, 28, 13, 15, no
50607243,  mamola, 4, 1, 3, no
336442306,  OttoVola, 69, 33, 36, no
96325900,  enzissimo, 22, 8, 14, no
2785158801,  FedeTremarco, 13, 3, 10, no
2319258554,  NanniCatta, 34, 14, 20, no
489368395,  SilvioRossi3, 35, 13, 22, no
323889720,  PalazzoAntonio, 72, 31, 41, no
3356485570,  GCappellazz, 173, 55, 118, no
397276980,  Anninacio, 15, 6, 9, no
322070453,  NoleRulez7, 5, 2, 3, no
587521626,  Valeri0_Valeri0, 59, 12, 47, no
2355249940,  stazi74, 14, 5, 9, no
436809285,  GianPalc, 10, 2, 8, no
2836840346,  sepilli55, 14, 4, 10, no
64144248,  manuele_a, 72, 34, 38, no
752800121138581504,  izoon2, 106, 51, 55, no
1474124408,  robenven, 4, 1, 3, no
319060887,  Leleganjamel8, 19, 6, 13, no
568377117,  totonnotato, 55, 20, 35, no
2342517254,  pentotaldoll, 248, 87, 161, no
423308449,  gobbo_roma, 4, 1, 3, no
2279399816,  _Sentifrux, 47, 17, 30, no
2199804117,  shosholoza74, 7, 3, 4, no
528649172,  aliquofrancesco, 5, 2, 3, no
744828787137839104,  cambiotesta, 37, 14, 23, no
1119007478,  MJmkeynes, 6, 2, 4, no
77823743,  aureliomancuso, 19, 7, 12, no
9437162,  Alea88, 11, 5, 6, no
246976552,  CiroPanariello, 44, 15, 29, no
1331997265,  PMessali, 7, 1, 6, no
2986947023,  GabrySSLFCJ, 62, 25, 37, no
763025898736082944,  Cri_Concardi, 14, 6, 8, no
60672327,  scandaglieremo, 4, 1, 3, no
1254291416,  catzeri3235, 44, 18, 26, no
3553383737,  manfattone, 10, 4, 6, no
48981619,  tondkar, 19, 9, 10, no
405548207,  AGiambart, 5, 2, 3, no
432524169,  MauGandolfi, 5, 2, 3, no
17876465,  giovannidicaro, 13, 3, 10, no
3686608235,  antonio0312dem, 3, 1, 2, no
715543732217626624,  Vanto_italiano, 14, 3, 11, no
4459906041,  DMarcoberard, 24, 7, 17, no
428897370,  LucaMiniero, 72, 22, 50, no
405192597,  MBattistina, 32, 15, 17, no
532083239,  SergioMariella, 5, 2, 3, no
1367973715,  mixc7, 35, 6, 29, no
4122678207,  lpaoli02, 10, 3, 7, no
74485176,  Dandy_Dv, 5, 1, 4, no
617404862,  nicorst, 15, 5, 10, no
1534786369,  ChriNesta13, 15, 2, 13, no
318575239,  ErCandela, 15, 4, 11, no
393220583,  cplataniaIT, 3, 1, 2, no
1583259805,  maccarimiranda, 60, 3, 57, no
785560131954216960,  Fr4nc35color377, 4, 1, 3, no
714226829071151104,  Billy56267838, 30, 14, 16, no
2221083463,  GioDL1, 12, 4, 8, no
2310261690,  Massimonelli83, 18, 8, 10, no
384948871,  CalzettaPa, 16, 1, 15, no
3261467549,  Eagle7982, 10, 4, 6, no
475887245,  TheRealViruZ, 17, 7, 10, no
2650582614,  renewableact, 39, 19, 20, no
375517350,  crispinoenzo, 7, 1, 6, no
2331861340,  alecsandordp, 30, 13, 17, no
404919799,  M73Diego, 3, 1, 2, no
1271715740,  46Mister, 6, 1, 5, no
832767270,  IreneCurcio, 21, 5, 16, no
2995507655,  arivarriale, 140, 35, 105, no
485101194,  mirkobucci1, 16, 4, 12, no
262634878,  maurizio_fava, 3, 1, 2, no
2878408107,  emycast1968, 43, 20, 23, no
376145932,  leonardicarmen, 32, 14, 18, no
708587318786007040,  luigipanico66, 110, 43, 67, no
706067859550695426,  Mauro5514, 114, 30, 84, no
713449513088888833,  pm_lagiusy, 35, 7, 28, no
919502593,  Catebarbieri, 17, 4, 13, no
778693643976581120,  Viola_mg, 17, 7, 10, no
521715693,  nene1311961, 4, 1, 3, no
763353589347672064,  PaoloTroia7, 331, 148, 183, no
3054231435,  ronal_DieCi, 58, 16, 42, no
225105585,  GaeDeRoberto, 68, 6, 62, no
909935803,  robertobarale63, 32, 6, 26, no
2456837270,  pier30660198, 19, 8, 11, no
4866822466,  Carlo490317591, 49, 10, 39, no
1573078681,  chiccamonopolii, 48, 6, 42, no
247505099,  paolavalenti29, 11, 5, 6, no
4196122397,  Cybeo66, 27, 10, 17, no
497880739,  Fede_gir, 23, 10, 13, no
2940999287,  lumaca4377, 79, 24, 55, no
273113501,  Annalisa_Ape, 23, 10, 13, no
754060114886324224,  annagrapagano1, 19, 9, 10, no
1114146019,  vamesa84, 17, 7, 10, no
753884370944004096,  MEsposito1987, 27, 13, 14, no
704773966850867200,  valesq2, 28, 13, 15, no
753877865645674496,  CaterinaP10, 27, 11, 16, no
753921440194461696,  Veronic66389936, 13, 5, 8, no
753690812983238656,  Fiona110378, 23, 11, 12, no
4181089545,  Lilil984, 22, 10, 12, no
2535866450,  Gino_Autieri, 5, 2, 3, no
14490966,  danilla, 11, 5, 6, no
151109371,  franco_giovani, 6, 2, 4, no
2252673458,  cryrho, 11, 5, 6, no
477626282,  TommyPinazzi, 5, 2, 3, no
596702756,  BepKar, 43, 16, 27, no
522457817,  valentinocossu, 117, 4, 113, no
1011559662,  AriannaFesta1, 29, 5, 24, no
2243105962,  BPtobia, 29, 4, 25, no
728897876072534016,  elenab1939, 13, 6, 7, no
1076597023,  AIaculli, 34, 8, 26, no
337155946,  IlMattinoFoggia, 93, 13, 80, no
238990492,  Mattiamasini18, 36, 17, 19, no
147543162,  forza_italia, 379, 33, 346, no
2150969605,  IlMattinale, 326, 30, 296, no
413215193,  antonellaiovin7, 34, 5, 29, no
3342884483,  cangius1962, 32, 8, 24, no
2894775544,  picardi65, 13, 6, 7, no
1946489059,  jachedeleo, 28, 13, 15, no
785129133009494021,  thewaterflea, 38, 15, 23, no
400811586,  MassimoMisiti, 19, 8, 11, no
2206549446,  CapitanHarloc13, 48, 19, 29, no
142298246,  loverddhh, 5, 1, 4, no
413181725,  FESMontemaggi, 4, 1, 3, no
525706428,  casagranden, 3, 1, 2, no
1118851009,  Danstellina, 27, 10, 17, no
455777345,  rosalinobove, 38, 18, 20, no
2331847077,  guffanti_marco, 3, 1, 2, no
3697986022,  RosaliaUngaro, 5, 0, 5, no
556978533,  UgoVolli, 5, 1, 4, no
424989077,  italmud, 8, 0, 8, no
2508437306,  MrWhite3556, 25, 6, 19, no
3855759741,  moreno_zl78, 9, 1, 8, no
1256994919,  simonereppucci, 4, 1, 3, no
703037640191451136,  uncittqualsiasi, 9, 3, 6, no
2845018504,  romanoziroldo, 61, 23, 38, no
3331059982,  RicBattaglia, 72, 34, 38, no
2389687188,  LuigiGuazzoni, 15, 7, 8, no
986244024,  FraLaRosa, 5, 0, 5, no
443484477,  donato_salvator, 5, 1, 4, no
747123888,  parniquotidiani, 22, 6, 16, no
416157197,  CarloAmenta1, 3, 1, 2, no
440247035,  Zampaglion, 93, 20, 73, no
2743096235,  architettoerra1, 3, 1, 2, no
2160946687,  biagiodimatteo, 38, 15, 23, no
155300542,  87Sary, 11, 5, 6, no
87457267,  andpoli, 6, 1, 5, no
2935219756,  drp_anna, 3, 1, 2, no
2466589783,  gabrisorrenti, 43, 14, 29, no
382133673,  rofuba, 14, 6, 8, no
187124848,  PegasoNero, 6, 1, 5, no
899952481,  MariaAversano1, 123, 39, 84, no
473659309,  MarioMalangone, 9, 2, 7, no
3296752419,  bassotti_g, 5, 2, 3, no
280175586,  nunziapenelope, 22, 7, 15, no
746263383473799169,  cinziasams, 29, 12, 17, no
168796358,  LanoCorio, 28, 12, 16, no
417897223,  Stegosauro, 18, 8, 10, no
1397232085,  mcacciaglia64, 23, 2, 21, no
440129638,  SoloCristy, 37, 12, 25, no
4371150255,  aldoadn, 11, 4, 7, no
220603109,  fracasul, 7, 1, 6, no
717452216840429569,  gianstraz, 117, 46, 71, no
149183666,  gentilcristiano, 8, 1, 7, no
3422769471,  adrimux, 43, 9, 34, no
434473804,  castellialessio, 9, 4, 5, no
98327606,  mottoshop, 6, 2, 4, no
154967452,  Romarege, 59, 26, 33, no
2149812819,  panarelli91, 7, 2, 5, no
1028897996,  magnagati86, 44, 3, 41, no
1331514499,  loimsmloi, 23, 8, 15, no
493260423,  alexpinnisi, 34, 15, 19, no
4464016355,  creutmann, 40, 12, 28, no
47154019,  stebellentani, 11, 5, 6, no
22031608,  piplaar, 15, 2, 13, no
527270217,  Honus888, 7, 2, 5, no
2994679426,  antonello19692, 15, 4, 11, no
2606637891,  onda_di_mare, 17, 8, 9, no
133485233,  il_Conte78, 5, 2, 3, no
774571846989668352,  Milu0095, 232, 6, 226, no
704968903622008832,  Marzian2016, 252, 13, 239, no
14324681,  RoDante, 30, 9, 21, no
1065387764,  FrancescoVolpic, 126, 29, 97, no
787620843320905728,  GiuseppaMarsal2, 6, 1, 5, no
960087626,  ignazioraspant1, 116, 57, 59, no
3033262155,  BalsamoRoberto, 9, 3, 6, no
582622919,  chryduca, 175, 16, 159, no
442225392,  Vito_Cipolla, 5, 2, 3, no
2238011889,  LaMadreBadessa, 23, 4, 19, no
2596945387,  Giustizia47Vera, 56, 10, 46, no
255666406,  tuziorista, 54, 16, 38, no
283636579,  MichelePlatoni, 324, 17, 307, no
88650213,  levignette, 7, 1, 6, no
728695134,  jianlucka, 46, 9, 37, no
3387547060,  lobbyingitalia, 15, 4, 11, no
44395683,  mattjrphoto, 30, 14, 16, no
469845313,  antoferito1, 11, 4, 7, no
4864791995,  Frances50147410, 6, 2, 4, no
381953555,  giannicuzzani, 25, 6, 19, no
786872673037062144,  Massimo6168, 6, 0, 6, no
537133786,  77OnFilm, 3, 1, 2, no
3138188655,  01976Debora, 314, 148, 166, no
499571765,  FarignaFarina, 66, 32, 34, no
725983920,  bomberinho11, 5, 2, 3, no
383888615,  isabeaubless, 18, 5, 13, no
2329195526,  brutiozzo, 4, 1, 3, no
4480184295,  cardinali_v, 4, 1, 3, no
1260037848,  igvania65, 5, 2, 3, no
56874315,  SirRobertgable, 3, 1, 2, no
2377659242,  GIMUSHI, 8, 1, 7, no
2751847457,  TrapellaAngela, 34, 1, 33, no
421753973,  lucalofranco, 5, 1, 4, no
854600858,  roberto25552758, 16, 1, 15, no
1168651670,  gmpmari12, 6, 2, 4, no
770615305,  Kasper_carlo, 10, 4, 6, no
2386835695,  Giulialaura9, 88, 42, 46, no
132092980,  fifranzo, 24, 10, 14, no
369749865,  archi_sergio, 97, 8, 89, no
2463100707,  lentinivince, 132, 42, 90, no
128978964,  radioHAZE, 68, 31, 37, no
430743919,  marcuspascal1, 46, 20, 26, no
1664604020,  Paolo885, 48, 23, 25, no
431084648,  twMec, 127, 46, 81, no
514422812,  giacob_, 22, 7, 15, no
804080566949859328,  marchesaangely, 43, 19, 24, no
267219188,  sebastian579, 9, 4, 5, no
4818612196,  FartFromAmerika, 14, 4, 10, no
147654699,  napolaris_, 13, 3, 10, no
1606319989,  pesposito2, 3, 1, 2, no
2938313507,  sangazzurr, 65, 29, 36, no
801520165250887680,  MarianSem64, 28, 11, 17, no
2907520191,  sbaffato, 67, 15, 52, no
257709473,  turgido, 103, 23, 80, no
1352568188,  NadaAlfano, 10, 2, 8, no
147611968,  PaoloScarpelli, 7, 2, 5, no
1260487207,  fattivostri, 10, 2, 8, no
3300629145,  zanfagniz, 8, 2, 6, no
1394277882,  Ori254, 266, 108, 158, no
2301960876,  Carmensic, 35, 5, 30, no
303618346,  rinaldoleggi, 9, 4, 5, no
483384295,  LuigiDeTroia, 129, 23, 106, no
1179962942,  MarracinoD, 104, 22, 82, no
4845999597,  sarasarli, 93, 25, 68, no
1222699580,  mefaivola, 15, 3, 12, no
253540043,  raffybianchi, 5, 2, 3, no
2433235432,  fabiocrivel, 7, 3, 4, no
4702970784,  MovPopulistaIta, 108, 14, 94, no
2359448190,  ArioPuggioni, 83, 15, 68, no
734705980873789440,  MenelMaria, 9, 3, 6, no
100878763,  sotirias, 20, 6, 14, no
1327684639,  meribia90, 14, 6, 8, no
211090942,  conteivan, 11, 2, 9, no
447854508,  iasius_1, 17, 8, 9, no
850940348,  melrief, 3, 1, 2, no
2467357784,  enzo64363787, 28, 4, 24, no
388480192,  GVignoni, 22, 8, 14, no
2351775654,  AGCarta, 92, 25, 67, no
3435148533,  MarcoFinizio74, 11, 2, 9, no
748252291959037952,  umberto_ga, 71, 27, 44, no
2752353844,  flexability68, 17, 7, 10, no
999474469,  ceredaemanuele, 11, 2, 9, no
1424689315,  manduchino, 27, 4, 23, no
1444286834,  vasco97273, 264, 16, 248, no
2524404516,  mdmstesso, 14, 5, 9, no
242922585,  minuscx, 26, 9, 17, no
706522020016746496,  GildaLemon, 8, 3, 5, no
362432939,  cdolcino, 46, 15, 31, no
587948551,  Paolo_CSGL, 10, 2, 8, no
3119071163,  lucillalucio7, 171, 12, 159, no
1261316370,  ororo61, 27, 4, 23, no
433717645,  tiecolino, 21, 8, 13, no
717319878542245888,  rettile11, 59, 11, 48, no
1472290938,  AntonioDiBari85, 50, 3, 47, no
2850135335,  avantinoi, 49, 12, 37, no
2420586324,  ANTEO17, 52, 7, 45, no
3347525428,  SilvioTriulzi, 16, 7, 9, no
407891527,  checco710, 46, 17, 29, no
2540653035,  Darkmind4ever, 26, 3, 23, no
2904967810,  Libellula51, 174, 47, 127, no
365065358,  francescagorini, 74, 28, 46, no
526460648,  FEBODIANA, 4, 1, 3, no
763983425569034240,  oscar_rafone3, 25, 3, 22, no
1962674090,  Changement71, 75, 19, 56, no
637292613,  Strapierre, 77, 36, 41, no
4867831151,  Fabio10091946, 53, 22, 31, no
782126365315371008,  Gianni24514253, 54, 17, 37, no
1008395305,  Peppumerlo, 11, 5, 6, no
3044614575,  M5SER, 7, 3, 4, no
1083273792,  bianchiremo, 38, 2, 36, no
1037077783,  mbonante, 47, 16, 31, no
418709964,  pierluigidiaco, 14, 6, 8, no
572426495,  gen_napoli, 17, 8, 9, no
803300175955558400,  Onomatopecora, 31, 11, 20, no
1407173916,  Roberto70Yahoo, 13, 5, 8, no
711433591083941888,  MirkoBfc, 11, 2, 9, no
51997642,  GeMazeltovGaldo, 5, 1, 4, no
355122344,  scimm77, 76, 32, 44, no
2285114260,  dondino63, 34, 11, 23, no
2206083227,  rita_angelis, 9, 2, 7, no
340573242,  paolo_spano, 8, 2, 6, no
16627700,  petermeyeer, 7, 3, 4, no
1883696546,  s56597686, 10, 4, 6, no
399314100,  liviofiorillo, 10, 3, 7, no
3053055853,  LambiaseTiziana, 9, 2, 7, no
1075391245,  verri_laura, 62, 19, 43, no
1851226928,  Shinichi_Kd, 17, 4, 13, no
1262157433,  63_manu, 14, 5, 9, no
3003876496,  Giam_92, 5, 1, 4, no
1227493782,  ilfattizzo, 9, 4, 5, no
297097891,  JadiMarinai, 3, 1, 2, no
838223696,  angcapparelli, 31, 7, 24, no
1325348036,  FmMilloch, 58, 1, 57, no
1092670394,  spinax64, 68, 30, 38, no
2948374265,  Salvionardi, 35, 15, 20, no
22025138,  emilioftorsello, 21, 7, 14, no
1219056841,  LoredanaCefalo, 16, 4, 12, no
325165914,  ing_rogi, 400, 196, 204, no
109578008,  Alberella, 99, 48, 51, no
541178236,  marcellosantell, 114, 48, 66, no
597787450,  gcftisca, 25, 6, 19, no
2321483287,  Zdany24, 5, 2, 3, no
1121666197,  Inserandipity, 15, 7, 8, no
2359406918,  lellinara, 34, 13, 21, no
340996459,  emanuele175, 19, 8, 11, no
950642215,  DrUmbertoVitali, 57, 26, 31, no
2706476465,  nexoslaika, 32, 13, 19, no
393895340,  Efficance, 5, 2, 3, no
4204098099,  ct_1957, 6, 2, 4, no
2781970583,  VagoLoridfbs, 61, 30, 31, no
4212951118,  Giuseppek17, 25, 12, 13, no
1026219187,  persefone900, 24, 4, 20, no
736896977749839872,  Ganbol74, 14, 6, 8, no
2998053413,  tussa67, 19, 9, 10, no
2218143675,  Ebebeb912, 11, 4, 7, no
428880267,  renbalt, 9, 3, 6, no
532920941,  Icios007, 11, 5, 6, no
1071260784,  Gottardi95, 6, 1, 5, no
2808862264,  palmiraprt, 7, 2, 5, no
512506306,  1_basta, 41, 18, 23, no
978137395,  Dertizia, 37, 18, 19, no
32624061,  giuliocavalli, 30, 8, 22, no
263686293,  mas_gui, 63, 20, 43, no
576539396,  LorenzoSospiri, 18, 5, 13, no
730060281670447104,  DragoneSantina, 7, 1, 6, no
310195119,  lctr82, 94, 30, 64, no
2231463645,  AngelaAnpoche, 17, 5, 12, no
755126469827915776,  GiusyPorzio85, 9, 2, 7, no
477187357,  pasqualevallari, 43, 8, 35, no
2940769763,  SenzaProvince, 27, 10, 17, no
2976609286,  maltocortese78, 17, 7, 10, no
986629687,  Gianluca_19_75, 5, 2, 3, no
4807013549,  Realizzareinsie, 16, 7, 9, no
500236905,  Leccezionale, 11, 1, 10, no
515350705,  fazio_nicola, 17, 7, 10, no
3356670165,  LuigiGelli, 51, 7, 44, no
2999879276,  nicolin_o, 50, 23, 27, no
982401096,  robertsoana, 66, 24, 42, no
523432889,  MGiangualano, 12, 4, 8, no
306058431,  marioddo, 31, 9, 22, no
1278345985,  ChilErminia, 4, 1, 3, no
2466390186,  DonatellaDAgati, 3, 1, 2, no
1057930387,  gfdileo, 107, 43, 64, no
426152264,  solounastella, 39, 13, 26, no
1125109992,  piras_zia, 31, 12, 19, no
435791610,  DaniloCason, 18, 8, 10, no
4892218558,  nino_pitrone, 22, 6, 16, no
53773490,  Straccia2, 29, 5, 24, no
2945491781,  AugustoSabatel1, 71, 15, 56, no
2311916317,  ivanoravasio, 17, 4, 13, no
787954994171506689,  Giuseppe140310, 51, 3, 48, no
748764531455762432,  IseNaeEsterni, 17, 8, 9, no
2424020059,  ObservingVotoNO, 81, 2, 79, no
732317340092780545,  sadape54, 79, 18, 61, no
765631835086917633,  giuseppe_monta, 52, 12, 40, no
4878708910,  amoilsud, 9, 2, 7, no
2574560504,  M_P_8, 30, 9, 21, no
2520868692,  silvano73068906, 21, 7, 14, no
4920828160,  daruni04, 34, 3, 31, no
2560173527,  DelluomoVanda, 3, 1, 2, no
2911535435,  VolleyFranco, 7, 2, 5, no
3481946428,  zozzumm, 45, 8, 37, no
728295648,  GianluigiDotti, 56, 15, 41, no
561204740,  AntonioMattiol1, 3, 1, 2, no
326226399,  000120o, 257, 68, 189, no
490733693,  FRANCESCOCARDE3, 58, 15, 43, no
428915501,  PaoloBrandi, 61, 18, 43, no
3629322863,  JesterA380, 17, 5, 12, no
4405181775,  claudio09103870, 41, 3, 38, no
350256698,  Caffe_Graziella, 23, 11, 12, no
202256562,  AARomita, 27, 9, 18, no
296475664,  MatzeuAle, 24, 10, 14, no
2981706863,  ToscanaProvUni, 22, 9, 13, no
229587251,  Paolasimpatia, 5, 2, 3, no
3010138109,  marc_corti, 22, 8, 14, no
419021368,  annaattajanese, 9, 4, 5, no
3032909475,  bumerangselli, 12, 1, 11, no
2914562626,  freschi_paola, 23, 8, 15, no
1474822591,  LucaZizo, 9, 1, 8, no
323676734,  CMdiFirenze, 20, 7, 13, no
448761968,  giovi_bi, 14, 4, 10, no
16162692,  Elisheba, 12, 2, 10, no
602216944,  gurulku, 15, 5, 10, no
2360803296,  succodilimone1, 3, 1, 2, no
980910583,  Gigidifr, 6, 1, 5, no
4705505042,  AzzurroLibero, 108, 21, 87, no
4714030515,  Madeflo_Ce, 146, 29, 117, no
4174063036,  GiancontieriGi1, 61, 24, 37, no
86209782,  DanielaPF75, 38, 12, 26, no
173789578,  devism76, 4, 1, 3, no
109652224,  Caronte1979, 11, 3, 8, no
603612465,  agotwitts, 45, 19, 26, no
263619418,  ricettedifulvio, 15, 7, 8, no
2663921790,  vittoria281073, 6, 0, 6, no
813055092,  manuela417, 32, 13, 19, no
2158966523,  Olivieri1Nicola, 41, 12, 29, no
308905321,  Luca4nrgs, 36, 13, 23, no
192165373,  nonnomischa, 20, 3, 17, no
128216246,  antonaz1, 8, 0, 8, no
475127858,  sonoiolore, 31, 11, 20, no
25499078,  pitbum, 12, 2, 10, no
458268610,  luigi_pelerin, 7, 1, 6, no
82578103,  Ominonero, 7, 2, 5, no
422665114,  didon76, 6, 0, 6, no
1130420497,  cocchi2a, 137, 44, 93, no
765647763442896896,  Vasco35481906, 83, 11, 72, no
1064422592,  FrMarenco, 11, 3, 8, no
2910801435,  MickySalomone, 4, 1, 3, no
24528997,  fabcelestini, 60, 23, 37, no
2155767706,  CapitanBuggy, 19, 3, 16, no
244053999,  alesixties, 20, 4, 16, no
141529750,  LauraCarrese, 460, 208, 252, no
1546218236,  JessyRelly, 12, 5, 7, no
58016005,  martamacbeal, 46, 21, 25, no
2437403432,  rickyriga11, 46, 16, 30, no
346518147,  Coccynella500, 34, 10, 24, no
332921113,  bastaCasta, 59, 25, 34, no
1447003466,  StefducFi, 28, 4, 24, no
1088806153,  misspassinella1, 47, 3, 44, no
630961397,  RobertoGranai, 15, 7, 8, no
390754622,  robertosterza, 8, 1, 7, no
829507466,  danieleonori1, 22, 3, 19, no
2256453579,  pelli54, 38, 18, 20, no
2163227033,  DottBellavia, 202, 29, 173, no
576946442,  RomualdoLuca, 10, 4, 6, no
310944185,  parsifalcinque, 3, 1, 2, no
805119209588006912,  difendolacasta, 43, 16, 27, no
1003031718,  MapiRocco, 5, 1, 4, no
3904145790,  Ereda_V, 51, 18, 33, no
1080249439,  pasqualemilly, 8, 3, 5, no
2358632181,  rafhp71, 11, 4, 7, no
252192394,  magrondo, 7, 3, 4, no
83631984,  mauri1709, 5, 1, 4, no
4818228771,  ErnePusceddu, 5, 1, 4, no
519596424,  annaluiseII, 10, 4, 6, no
163899788,  andreacatalano, 28, 10, 18, no
2315538860,  loriana34406751, 43, 6, 37, no
3131027463,  fpruneri0, 7, 2, 5, no
86342681,  loguerto, 13, 3, 10, no
471859605,  egos23, 17, 6, 11, no
4358642595,  LiaColombo1, 27, 7, 20, no
1870961815,  aristogitone1, 49, 12, 37, no
2607072282,  NinniRaffy, 9, 4, 5, no
744518687617593344,  franceccoy, 27, 11, 16, no
41544005,  fabiovalenza, 11, 4, 7, no
119067790,  ArgoTone, 54, 22, 32, no
750847152,  539th, 6, 2, 4, no
74157617,  stefanozacutti, 6, 1, 5, no
391531110,  sabsacc, 5, 1, 4, no
3305976862,  vaglica61, 27, 12, 15, no
331105395,  Massimo_Lokard, 7, 2, 5, no
36176128,  Mariunsen, 6, 1, 5, no
804008103222054912,  salvino_mattei, 58, 20, 38, no
1037749440,  002luigif, 3, 1, 2, no
619258906,  riccardosozio, 4, 1, 3, no
182745707,  Green1059, 6, 2, 4, no
51792460,  giorgiomeletti, 11, 4, 7, no
306384715,  DavidOLestrangE, 4, 1, 3, no
171857278,  24enrico, 9, 2, 7, no
1692004472,  CremascoV, 13, 4, 9, no
229082336,  massimonigi, 16, 5, 11, no
2948863234,  paolacorrenti, 14, 6, 8, no
102200819,  enrisav, 34, 15, 19, no
2637537674,  schierhangl, 6, 2, 4, no
2480352662,  ErPirofila, 42, 18, 24, no
606549225,  MartinoFiorenzo, 3, 1, 2, no
1444734901,  Massimi92120067, 31, 10, 21, no
136205033,  antonioscacc, 11, 4, 7, no
700412768730619905,  valerianom1948, 14, 3, 11, no
993159811,  MarcoMgp89, 4, 1, 3, no
2751078489,  cygnet601, 5, 2, 3, no
2597549564,  jimmyuforta, 15, 6, 9, no
706570552031444992,  Anti_Globalist_, 9, 4, 5, no
8032202,  umanesimo, 118, 54, 64, no
99702635,  scarpettavenere, 31, 13, 18, no
2343390020,  ChiatanteEnrico, 19, 8, 11, no
1918247922,  1511maxi, 67, 4, 63, no
371751749,  ferrante_franc, 3, 1, 2, no
1050697136,  arnj40, 23, 11, 12, no
534135497,  AleLodi81, 24, 7, 17, no
892707241,  TaiBure, 17, 4, 13, no
280653259,  EugenioNicotra, 4, 1, 3, no
332299735,  Robecho1, 4, 1, 3, no
629781012,  d_aledegidio, 5, 2, 3, no
401644924,  GabrieleTeodosi, 4, 1, 3, no
804396764925140996,  MassimoilG, 18, 1, 17, no
995189316,  AUlacco, 28, 4, 24, no
1116398478,  FTedeschini, 15, 2, 13, no
4891433775,  ProvFigAQ, 19, 2, 17, no
22129679,  emanuelecarioti, 30, 11, 19, no
696658225157029888,  Fig_AQ, 18, 3, 15, no
460275730,  Fra0283, 165, 6, 159, no
2518805059,  Effegilo, 54, 22, 32, no
331496903,  Mene015, 14, 4, 10, no
448270129,  MariaIovine, 3, 1, 2, no
107517248,  BarillariM5S, 23, 6, 17, no
58868395,  mywave76, 61, 22, 39, no
464675744,  semisconosciuto, 22, 4, 18, no
481359440,  RomanOsservator, 13, 5, 8, no
405792460,  1ettoreb, 73, 35, 38, no
229089974,  SilvanaDenicolo, 25, 10, 15, no
65872385,  MariaConversano, 7, 2, 5, no
2635714649,  a_ermetico, 93, 4, 89, no
272940016,  D_Etrusca, 28, 10, 18, no
2943808887,  dececcoenrico, 12, 2, 10, no
290669539,  Piero_Gallina, 11, 2, 9, no
87467449,  grotondi, 87, 8, 79, no
3297456253,  erikaleciancio, 51, 1, 50, no
4242565703,  laurapingitore2, 16, 0, 16, no
1565366160,  FedericaRanise, 12, 0, 12, no
3385872369,  massimoluigico2, 12, 0, 12, no
2192271144,  FI_Online_, 390, 29, 361, no
1344131071,  GruppoFICamera, 375, 27, 348, no
2494320428,  Nightmaresud, 19, 3, 16, no
804232112555651072,  kionz62, 11, 5, 6, no
745339531566661632,  raffaellamucci1, 122, 33, 89, no
16377508,  gala81, 7, 2, 5, no
438476133,  trepazia, 45, 18, 27, no
922711819,  binottofranco, 78, 27, 51, no
315970979,  nicola_liguori, 4, 1, 3, no
1373138137,  Daniele_Branca, 20, 3, 17, no
784101368646819840,  Jpolemica666, 3, 1, 2, no
565354789,  Chiara_Pax, 29, 13, 16, no
580789807,  Paolaaa81, 3, 1, 2, no
718791150325403649,  mariella2giugno, 15, 3, 12, no
2178536571,  IsabellaLell, 10, 3, 7, no
1171395356,  Leggilenuvole, 34, 16, 18, no
481409710,  Bart1705, 14, 4, 10, no
510439689,  Ciavarda, 3, 1, 2, no
798570804086763524,  sjcarjo1, 83, 13, 70, no
3104344534,  marcotrocu, 27, 12, 15, no
2201613873,  GPerioli, 26, 5, 21, no
151246430,  pakywood, 10, 4, 6, no
47438785,  chamberlainn, 6, 1, 5, no
2163514121,  nappi43, 26, 11, 15, no
3034643483,  DettoGinoPanino, 82, 33, 49, no
2224962167,  DiniMillo986, 98, 10, 88, no
702432335078285312,  NewsComunaliRM, 27, 13, 14, no
795963213724663808,  marcobal99, 7, 3, 4, no
475134082,  GerryPickford, 72, 2, 70, no
193008820,  mariellademarco, 3, 1, 2, no
370690455,  InfoAtac, 10, 2, 8, no
1082473454,  Official_zanzi, 3, 1, 2, no
1025054731,  pattyperr, 30, 12, 18, no
62940685,  MorbiduZz, 17, 0, 17, no
1068702612,  Fuxino89, 51, 4, 47, no
715121732110172160,  M_A_imperator, 12, 1, 11, no
3238853314,  Heidibrucia, 11, 3, 8, no
703927942192173056,  AlexSv85, 471, 233, 238, no
3043540575,  syusy1, 31, 14, 17, no
1181544271,  MMoocher, 18, 5, 13, no
1360582447,  ANNABASSI6, 54, 22, 32, no
550410227,  marsandr01, 7, 3, 4, no
2785334697,  AlessiaMarck, 57, 28, 29, no
4923500123,  EdoardoSatuto, 38, 11, 27, no
3034434386,  alegoliato, 29, 2, 27, no
536225770,  ValeNaldi89, 8, 3, 5, no
1655253469,  DrAntoniaPagani, 3, 1, 2, no
242339687,  arteletteratura, 68, 18, 50, no
1114019642,  BresciaFacile, 20, 6, 14, no
1051389715,  MariucciaMarras, 48, 7, 41, no
314059678,  gianfranco_fini, 46, 6, 40, no
528855195,  RobertoReimondi, 6, 1, 5, no
527710207,  AlbertRugy, 5, 1, 4, no
762274877806084096,  GiulianaBozzol1, 15, 2, 13, no
793166155112386560,  cioenelsenso, 43, 14, 29, no
1272047413,  CasolinoAntonio, 3, 1, 2, no
112454772,  ernestdematteis, 9, 4, 5, no
337333658,  SemGio, 5, 2, 3, no
247222140,  robertomenia, 10, 1, 9, no
431157210,  GiuseppeCascon3, 26, 4, 22, no
470359977,  StefanoFugazzi, 39, 19, 20, no
138868693,  carlopaolicelli, 20, 6, 14, no
774874962700238848,  Bannata2, 17, 3, 14, no
20940320,  pierpa2, 21, 10, 11, no
407051453,  saurokursk, 9, 4, 5, no
2767316247,  linda_mancino, 9, 1, 8, no
903551454,  oniizip10, 5, 1, 4, no
1274855814,  braveheartmmt, 11, 5, 6, no
146738509,  Noninfluente, 5, 2, 3, no
532163319,  Nessuno2012, 13, 6, 7, no
2363670784,  ernluccar, 42, 19, 23, no
2862461084,  Alcofibras77, 26, 10, 16, no
514280693,  raffaelespedic1, 19, 6, 13, no
557632715,  PKlavzar, 7, 3, 4, no
581185063,  maurizio1249, 8, 3, 5, no
390161953,  errepinna, 45, 5, 40, no
791365228839723008,  DanielaAVivoli, 7, 3, 4, no
519506055,  ACavFilmaker, 9, 4, 5, no
374941410,  franic_twi, 26, 10, 16, no
1372944860,  laremi_guido, 29, 10, 19, no
930776294,  CioppaLeonardo, 22, 8, 14, no
441149399,  GinoScardina, 12, 4, 8, no
790269417603162118,  asterwill, 35, 14, 21, no
1434279086,  salvagnoivan, 5, 2, 3, no
937279710,  CLAUDIO6210, 25, 10, 15, no
81837035,  giopge, 52, 14, 38, no
1166877775,  dstVoid, 69, 27, 42, no
15532171,  cernaia, 11, 4, 7, no
717334646405611525,  pigherino, 109, 12, 97, no
2319777925,  SalvoDiBetta, 24, 2, 22, no
4344819670,  erikarando11, 3, 1, 2, no
1145972966,  rossella123456, 26, 12, 14, no
465082146,  perniciaropietr, 6, 2, 4, no
2644998883,  MaleficoRojo, 110, 12, 98, no
2250169853,  GincosMm, 7, 1, 6, no
1006906356,  alfredo_zivvo, 7, 2, 5, no
395327805,  Nicknock82, 13, 2, 11, no
200657994,  griffi007, 10, 2, 8, no
214551930,  luchimaz, 18, 4, 14, no
923195227,  D__Abbate, 9, 4, 5, no
103294424,  alexmanj, 4, 1, 3, no
1055931559,  AntoninoMi, 70, 8, 62, no
385252844,  czroma54, 18, 7, 11, no
3317586231,  vonhoeneim, 20, 0, 20, no
2897960823,  GhellaOnTheRoad, 15, 0, 15, no
2363886035,  DaniloAloe, 63, 19, 44, no
1879889592,  Rosifregnan, 19, 9, 10, no
912833226,  osannacremonesi, 52, 4, 48, no
970760323,  Danielcuba72, 16, 6, 10, no
694638444807610368,  jesusdore97, 131, 30, 101, no
1010820098,  LupoMail, 52, 10, 42, no
418221631,  doloresebasta, 119, 21, 98, no
541527026,  lucialeone70, 78, 14, 64, no
788474975422443520,  nadiasannino, 9, 2, 7, no
2438650607,  BortesiBortesi, 48, 19, 29, no
210820445,  Macalla231059, 16, 7, 9, no
875178422,  actarus1070, 26, 4, 22, no
3291044750,  scrittricedony, 6, 2, 4, no
772848384961044483,  MarottaMarilisa, 25, 12, 13, no
2197080899,  lcnloris, 55, 24, 31, no
1218862927,  SAPAFER, 3, 1, 2, no
2544388753,  FisascatTaranto, 3, 1, 2, no
1891604736,  boccuzzibeppe, 3, 1, 2, no
3237012287,  spatresano, 87, 42, 45, no
2874742024,  GerardoOropallo, 7, 3, 4, no
771413293068128256,  minacercino, 17, 6, 11, no
16823683,  aluas, 18, 5, 13, no
503303414,  MIMIGIO, 115, 22, 93, no
888908046,  lauraconegian, 3, 1, 2, no
780430313218596864,  rossab66, 3, 1, 2, no
486713414,  VirnaBottarelli, 3, 1, 2, no
771404187074699264,  melaniabosso87, 11, 5, 6, no
780760650079285248,  SimonaCarpinie1, 23, 9, 14, no
701513839989358592,  alfonsomontana5, 17, 8, 9, no
342681065,  ceg62, 86, 22, 64, no
4872050638,  carenzagiuseppe, 50, 3, 47, no
2735797127,  ZamperiniGianni, 20, 7, 13, no
623602877,  tania1278, 48, 5, 43, no
2948698869,  CiuottoVs, 34, 2, 32, no
773136946696708096,  LuciaSaler, 9, 4, 5, no
754754187104292864,  fabyfa86, 11, 5, 6, no
419474598,  gribbio, 11, 5, 6, no
1860383658,  FrancescoMurat8, 4, 1, 3, no
432918462,  stomigrando, 39, 10, 29, no
526838409,  elenaruggeri2, 47, 11, 36, no
2543754356,  DanFumarola, 4, 1, 3, no
944269080,  DavideMazza10, 31, 11, 20, no
2376747126,  LazzaroPapi, 19, 4, 15, no
976243140,  FrancescoBasani, 36, 13, 23, no
771388686319677440,  rosagreca, 17, 8, 9, no
753983674652196864,  linacascella, 17, 7, 10, no
761229724685307904,  maritaexe, 11, 5, 6, no
771404383263289344,  a__lisa, 11, 5, 6, no
753880591205040128,  DelPreteEnza1, 15, 5, 10, no
754014552308801536,  StabileAnna8, 29, 14, 15, no
394293884,  marcymarcy17, 11, 3, 8, no
772078777295855620,  Imma__Esposito, 5, 2, 3, no
754269868896219136,  HanaAmemiya, 7, 2, 5, no
799330041117245440,  lalea_85, 5, 2, 3, no
711833597980835840,  MurMichela, 20, 7, 13, no
1619917472,  NicoViscomi, 17, 7, 10, no
740922692774301701,  leoguer74045306, 10, 4, 6, no
1346574637,  screzia, 40, 15, 25, no
55187309,  MicheleRusso, 9, 2, 7, no
748240006867730432,  Piera99486051, 21, 3, 18, no
967843051,  MBPellegrini, 9, 3, 6, no
4909543941,  GianlucaVnt, 72, 4, 68, no
3823074077,  PinoCostanzo, 89, 9, 80, no
2761183186,  teorema57m, 8, 2, 6, no
372273460,  myrtamerlino, 9, 2, 7, no
801747385949028354,  Gaetano38397120, 19, 9, 10, no
499028570,  Ziograna, 3, 1, 2, no
1213759908,  GIUSEPPEBALDASC, 12, 5, 7, no
2323802093,  lauracasali23, 3, 1, 2, no
2345773460,  ninafadda, 24, 9, 15, no
2731905976,  matita20145, 38, 11, 27, no
2523347460,  iosonoBea, 16, 6, 10, no
419544191,  SIMONEMESCHISI, 10, 3, 7, no
434993776,  MANUELROTUNDO1, 5, 2, 3, no
2845221227,  MazzacuratiFI, 39, 5, 34, no
1632825432,  tuccaplozio, 55, 7, 48, no
558651454,  danoris2110, 30, 3, 27, no
233546601,  gdt62, 29, 0, 29, no
1168160534,  pelton2013, 78, 2, 76, no
2809762856,  boccajaw, 24, 3, 21, no
3299490593,  Pimpinella1928, 51, 15, 36, no
206330375,  EloisaCovelli, 3, 1, 2, no
588587293,  VincinoWeb, 5, 2, 3, no
1492549380,  El_Flagelo, 9, 3, 6, no
1364215868,  ercazzaronero, 5, 1, 4, no
1672302936,  antoninobill, 60, 29, 31, no
4879045263,  aa_barbi, 12, 5, 7, no
715083557581033472,  PaoloRigoni5, 62, 19, 43, no
510652108,  ceccasud, 26, 7, 19, no
2517301839,  AlessandroGasb1, 126, 28, 98, no
785763689345363968,  GiuseppeDelll, 32, 14, 18, no
1059881101,  MauroBeltramo, 59, 26, 33, no
252161195,  spindavid, 13, 6, 7, no
1004482429,  CapitoloLuciana, 13, 5, 8, no
469267629,  AntonellaColoru, 77, 38, 39, no
342118728,  Denianto70, 11, 4, 7, no
411073767,  pinogag, 5, 2, 3, no
2674680536,  fabioblotta, 17, 5, 12, no
337171830,  AngeloTofalo, 13, 2, 11, no
116517401,  AlanPoll, 33, 8, 25, no
1223037354,  esisley, 196, 29, 167, no
766471224,  IsFrago, 80, 23, 57, no
2360744315,  tessirkuler, 13, 4, 9, no
14561296,  batmar, 12, 5, 7, no
307026014,  lupoalberto1960, 10, 4, 6, no
590833841,  massimogiorgi5, 51, 25, 26, no
2728402871,  umbydux, 66, 24, 42, no
3395014151,  GioChiAmoRe, 19, 6, 13, no
946620907,  FrancescoPrest7, 33, 8, 25, no
467389922,  NDecristofaro, 120, 29, 91, no
250085208,  incaxxatonero, 21, 7, 14, no
852595651,  rossanafra, 19, 3, 16, no
19036104,  nicolabonci, 9, 2, 7, no
3555782356,  FlavioPicolli, 41, 13, 28, no
139765259,  giuseppelacara, 32, 15, 17, no
2706574363,  valhoell, 27, 3, 24, no
110654085,  luigibagnato, 22, 9, 13, no
469354495,  vistullo, 12, 4, 8, no
3151825048,  benq_antonio, 63, 31, 32, no
2978007322,  CarneseMaria, 21, 10, 11, no
796821388023754753,  chiara_ciaba, 13, 6, 7, no
446371601,  guidig11, 12, 5, 7, no
378489654,  RobertoScolla, 16, 7, 9, no
855271164,  FiammaFrancesca, 7, 2, 5, no
317879495,  Varco001, 7, 3, 4, no
1092846918,  andreamusashi69, 47, 5, 42, no
780100421536849920,  Stucazzo1, 76, 35, 41, no
1069206085,  PaoloBaldo3, 31, 12, 19, no
1079226488,  warsteiner_SF, 61, 21, 40, no
281422377,  Valfabb, 8, 2, 6, no
1460451570,  punto_effe, 29, 4, 25, no
49060410,  dottomore, 3, 1, 2, no
2375736855,  cristina_ilardo, 14, 6, 8, no
493239048,  tony6tony8, 46, 5, 41, no
4824031401,  Mario22426580, 113, 16, 97, no
1249365224,  G_ianluc_a, 48, 8, 40, no
1339546009,  EnricoCardillo_, 10, 4, 6, no
2230228079,  Gimcstgv, 16, 4, 12, no
2999932538,  intoccabile_l, 63, 11, 52, no
186221116,  Master2001_3, 46, 18, 28, no
400798557,  StefanoFirenze2, 57, 23, 34, no
463192964,  socialmiliac, 3, 1, 2, no
728733122695725057,  GProietti76, 35, 6, 29, no
760806683564240896,  DelioScognamig1, 94, 15, 79, no
310845038,  LisiFrancesco, 21, 5, 16, no
939484063,  BettainChin, 43, 21, 22, no
292417838,  GASPARECARLINI, 18, 4, 14, no
4069758477,  Ivancir68, 55, 5, 50, no
3192457810,  roberto_rroby1, 3, 1, 2, no
2328166991,  gigicoz, 59, 5, 54, no
1219977643,  giudy51, 72, 17, 55, no
408437002,  clapr71, 14, 6, 8, no
1359299438,  AnnaLVenegoni, 20, 6, 14, no
1414076593,  collecorte, 22, 8, 14, no
389500881,  rufy4623, 26, 6, 20, no
1067982564,  alvarofiucci1, 31, 8, 23, no
353640576,  mauriziodalpra, 58, 17, 41, no
714553962599464960,  pirro_n, 66, 13, 53, no
2509301951,  Rota5Rota, 78, 18, 60, no
132811097,  camar07, 15, 1, 14, no
632742781,  pa__rm, 40, 13, 27, no
2230782069,  CEroscincidda, 33, 5, 28, no
2953019709,  SanzioPazzo, 13, 5, 8, no
2154746892,  ster67e, 99, 22, 77, no
3053723635,  BanfiTiziana, 77, 22, 55, no
1194951343,  IULGIO, 20, 9, 11, no
1101446990,  LelloConso, 91, 25, 66, no
883065655,  RPRESTIPINO, 76, 4, 72, no
953542285,  RussoMu, 26, 3, 23, no
1413220182,  piani_a, 79, 16, 63, no
3126770075,  GioTri71, 43, 13, 30, no
3776006296,  MSantariga, 30, 11, 19, no
574396225,  sguglielm0, 29, 14, 15, no
1337596044,  brichiel, 29, 8, 21, no
818183167,  CARONTEII, 55, 12, 43, no
1946899837,  MirkoZucca, 80, 23, 57, no
2656984642,  ribelle51, 95, 10, 85, no
1127618904,  ppfois, 25, 10, 15, no
1314367554,  salvamenick, 31, 9, 22, no
2975144398,  stefan1062, 56, 13, 43, no
1120206308,  andrea_gazza, 167, 19, 148, no
1919132101,  vilmaparenti, 195, 20, 175, no
2330768437,  AldoLecci, 5, 2, 3, no
105210939,  DarioTagliabue, 3, 1, 2, no
1372497578,  antonioguido58, 35, 9, 26, no
1418786191,  LilianaAmerise, 24, 6, 18, no
436671461,  adrigigli, 14, 2, 12, no
221707969,  Digicontact, 11, 5, 6, no
460226131,  gpellarin84, 54, 22, 32, no
2318283220,  JohnnyUtah_77, 64, 16, 48, no
194275021,  tomaurora1, 133, 12, 121, no
2472017715,  roxycafe123, 23, 2, 21, no
2191894196,  Rikjard76, 6, 2, 4, no
453287155,  Mauro_Boccia, 16, 6, 10, no
2374899158,  LuigiBertin, 8, 1, 7, no
369200086,  xbici, 99, 37, 62, no
2197175103,  grecale66, 42, 16, 26, no
448842961,  RolandCezanne, 7, 1, 6, no
74735060,  pasinaroberto, 3, 1, 2, no
964810638,  Pasquale_Mereu, 31, 11, 20, no
760240948488044544,  AntonioABarcaro, 15, 7, 8, no
558981012,  geoxgiuseppe, 23, 2, 21, no
208130207,  King___N, 13, 4, 9, no
4664853389,  teresa90175867, 54, 22, 32, no
2221404476,  SaraBencini, 209, 38, 171, no
4204183834,  Patty_Rose_LN, 75, 36, 39, no
776867281880178688,  SilviaSavigni, 33, 12, 21, no
731370864709636096,  saracanast, 3, 1, 2, no
96446959,  maxbunker, 5, 2, 3, no
463969453,  teovitamia, 171, 82, 89, no
3306842937,  NataleBeniamino, 13, 4, 9, no
2367849601,  dolcealbi, 10, 2, 8, no
747062212347461636,  susanette31, 10, 2, 8, no
2356806462,  BertRoug, 9, 4, 5, no
3251588698,  panibbi, 30, 14, 16, no
4602580341,  viky_chessa, 24, 7, 17, no
538341709,  mirinisupermiri, 8, 3, 5, no
1012961892,  francesco_colla, 5, 2, 3, no
1548872300,  MU231u231, 14, 6, 8, no
3430185532,  hemingway29956, 15, 6, 9, no
2484303523,  giusepp35269877, 20, 8, 12, no
4787048363,  alessan02272876, 11, 2, 9, no
1213170632,  sirtaura, 5, 2, 3, no
484914037,  Alberico10k, 25, 3, 22, no
796970107503251456,  SPIDERMARZIANUS, 277, 23, 254, no
3245319177,  Olivieri2Va, 4, 1, 3, no
464615450,  mottagiuseppe1, 23, 3, 20, no
1635529807,  Dibi_Dania, 43, 3, 40, no
1492509740,  OBonomi, 78, 8, 70, no
142731535,  alba90yt, 20, 4, 16, no
420538698,  StefaniaT1, 15, 3, 12, no
1926516720,  enricomontibell, 26, 6, 20, no
3368018859,  Bobbio65M, 453, 215, 238, no
1341261416,  NLongobardo, 3, 1, 2, no
420419717,  MarcoPic12, 15, 6, 9, no
229804443,  pieropalmo, 41, 18, 23, no
2833760769,  oldmanandsea1, 33, 14, 19, no
790948562,  VINCEVACIRCA, 30, 3, 27, no
723094218734862336,  ComitatoDelNO, 346, 34, 312, no
2883671135,  francescocasa9, 18, 2, 16, no
3036352179,  mameli54, 66, 24, 42, no
420533831,  P10paola, 22, 10, 12, no
2262991946,  vito22222, 24, 8, 16, no
1726668865,  tommasistefano2, 12, 5, 7, no
797374091959406592,  2piedi, 88, 41, 47, no
393342562,  KousNet, 36, 8, 28, no
51733848,  Davide33, 24, 10, 14, no
524545909,  silvia8542, 3, 1, 2, no
2204128029,  annietayler3, 35, 9, 26, no
607981040,  BCarazzolo, 29, 11, 18, no
785397318,  ValterRimini, 13, 5, 8, no
765195398587805696,  LaLestofante, 4, 1, 3, no
351555225,  laltraguanciama, 77, 29, 48, no
4155749909,  aldabelgrano, 10, 4, 6, no
250697308,  glfrancomano, 28, 12, 16, no
238501588,  ettorescafuro, 5, 2, 3, no
299780153,  Godsent072011, 17, 6, 11, no
3360251476,  5bc32772e3fb467, 33, 9, 24, no
63732939,  Highlander_Ro, 20, 7, 13, no
2312169774,  giorgiorosi1, 84, 20, 64, no
706097800040357889,  maryfagi, 57, 20, 37, no
2176575594,  LaTvNonDiceChe, 12, 5, 7, no
1314735973,  DegrandinGrandi, 19, 3, 16, no
2845737279,  baloi361, 62, 24, 38, no
4859931532,  UgoCutilliPhoto, 25, 8, 17, no
408681712,  PaoloRieux, 24, 8, 16, no
4188604709,  Virginia_Roma, 31, 14, 17, no
1339960975,  sgralady, 3, 1, 2, no
318988340,  BlackOutTotale, 17, 6, 11, no
1310209976,  Ecatetriformis, 13, 5, 8, no
214047668,  MatteoCorreani, 9, 4, 5, no
146215776,  Infinity_999, 20, 3, 17, no
17709747,  c_digiangiacomo, 14, 2, 12, no
406841197,  LorenzoPitzalis, 12, 2, 10, no
50233016,  CommentoRimosso, 48, 13, 35, no
29507504,  marcocanestrari, 3, 1, 2, no
404088514,  DimitriDeVita, 24, 2, 22, no
803051187704623104,  madre_deputa, 9, 3, 6, no
801218820086108160,  lady_retweet, 9, 3, 6, no
799574305935921153,  RtNon, 10, 4, 6, no
803012949157773313,  RtInferno, 9, 3, 6, no
802662799734427648,  ParadisertRt, 10, 3, 7, no
798129911240261632,  Musica_RT, 9, 3, 6, no
800508684254126080,  maniacretweet1, 9, 3, 6, no
2786870739,  PerainoDiego, 7, 3, 4, no
2938273510,  frasem6617, 8, 1, 7, no
70951142,  Ale_Mussolini_, 24, 9, 15, no
2601961486,  pinogalione, 16, 4, 12, no
762595238452006912,  GiovanniMorgan9, 3, 1, 2, no
1553447190,  70Ciabatti, 9, 4, 5, no
387345110,  AlbertodaSomma, 12, 5, 7, no
1729125788,  FabioVaio, 7, 3, 4, no
2369008892,  StefanoTeo73, 5, 2, 3, no
3309458867,  giovannicola73, 11, 4, 7, no
727770559107485696,  AlexRota65, 61, 26, 35, no
1467807296,  matematico65, 15, 4, 11, no
535447658,  jom5s, 74, 12, 62, no
704078981591646208,  LaSalisP, 23, 6, 17, no
34257738,  CyberRoby, 29, 2, 27, no
1679375545,  Ronin_ribelle, 51, 3, 48, no
433664513,  DiamanteGiallo, 20, 7, 13, no
2400560849,  PintonTiziana, 36, 8, 28, no
106724705,  Cuoredifango, 5, 2, 3, no
2225039966,  paola_chiarore, 7, 3, 4, no
189265027,  Veta76, 13, 5, 8, no
107488386,  FrancescaTibo, 24, 10, 14, no
711681123559014400,  antonio_cilento, 5, 2, 3, no
4076357194,  Mambolas, 46, 9, 37, no
497249239,  ale_barabino, 6, 2, 4, no
3243909749,  antonardelli, 37, 6, 31, no
2891116426,  Marco_B_86, 7, 3, 4, no
1020931404,  73rv, 14, 6, 8, no
435844281,  Patrizia_punto, 4, 1, 3, no
589418956,  giuslit, 33, 8, 25, no
1412675324,  luca_ottavi, 8, 1, 7, no
566361704,  merimascherpa, 56, 13, 43, no
396151080,  mocettast, 83, 20, 63, no
1310591124,  mariaDeNadie2, 15, 7, 8, no
784105196070854657,  oinot49, 167, 53, 114, no
775275218172510208,  Franca91632485, 12, 2, 10, no
1259041459,  leoberthi, 13, 3, 10, no
357768740,  giomur_62, 19, 3, 16, no
4318680568,  Antonio84496827, 29, 10, 19, no
2366082457,  maretegge, 21, 5, 16, no
567306134,  MASURISIBERIAN, 9, 4, 5, no
3173819499,  PatoOsko, 46, 17, 29, no
405426716,  sarracinus, 53, 16, 37, no
271654618,  AndreaH501, 7, 1, 6, no
721957168015126528,  Miziok67, 12, 2, 10, no
2160731013,  ecostantino73, 31, 12, 19, no
4342639457,  pierluigisabat1, 4, 1, 3, no
457442858,  FREDDYVERRENGIA, 20, 7, 13, no
451991982,  WalterRizzotti, 9, 2, 7, no
2170527625,  sampericoncetta, 19, 8, 11, no
4038240796,  thedrumsofmuzak, 11, 5, 6, no
204791100,  ergio78, 33, 15, 18, no
2191221171,  ALafronte, 7, 2, 5, no
3348796875,  fareprogressi, 3, 1, 2, no
158367488,  Biagio71To, 9, 3, 6, no
1357827044,  scastelas, 8, 3, 5, no
2695436575,  diMartedi, 20, 8, 12, no
1370769932,  antlan1, 8, 1, 7, no
789866400332611584,  Adesposto, 123, 8, 115, no
1264056133,  MassimoCannas1, 3, 1, 2, no
1101913508,  Barbara_Goi, 130, 25, 105, no
527221660,  guidocapitanio, 7, 2, 5, no
484570274,  pendolaria, 8, 2, 6, no
229441189,  GianniJJ, 4, 1, 3, no
1011151154,  Andrea84it, 23, 10, 13, no
6827962,  antoniopalmieri, 38, 11, 27, no
373277341,  NoTav_Rivalta, 22, 5, 17, no
798505651928465409,  salva594, 5, 2, 3, no
768979276804874240,  emaceste95, 3, 1, 2, no
3147597048,  m_scaglia, 5, 1, 4, no
2256723448,  SocciGianluca, 22, 10, 12, no
796321293452898304,  marepratokc264w, 15, 7, 8, no
989340356,  teoago72, 25, 7, 18, no
1361634884,  trendinaliaIT, 15, 4, 11, no
1913370296,  trendinalios, 8, 2, 6, no
2342856875,  simo2791, 53, 4, 49, no
232625504,  TWENTYREX, 3, 1, 2, no
298588711,  AlexGiack, 3, 1, 2, no
1128044090,  _fdm1, 26, 12, 14, no
744598818365255681,  lafaremopassare, 14, 6, 8, no
487564934,  Menna_Andrea, 9, 2, 7, no
1019758290,  LGSalvatore, 6, 1, 5, no
185274610,  pierandrea1965, 18, 8, 10, no
735374918892806145,  Redantw, 3, 1, 2, no
709468465531322370,  FrancescalGin, 62, 30, 32, no
2469186961,  Moneta_Sovrana_, 75, 26, 49, no
725664950,  LaTorreNormanna, 7, 3, 4, no
522195863,  MimmoBruni, 16, 2, 14, no
1855275732,  TaptaClip, 13, 5, 8, no
1283811182,  BracaliM, 56, 4, 52, no
391486485,  guastoman, 15, 4, 11, no
803115076672700418,  salvatore1666, 499, 140, 359, no
971840395,  monicacongiu2, 10, 0, 10, no
129135649,  michelekaraboue, 17, 8, 9, no
773428955214995456,  8607_329, 10, 4, 6, no
800613462741110786,  FI_Spagna, 11, 2, 9, no
702614277472034818,  rosydandrea1, 22, 6, 16, no
1090249998,  mrecchia70, 99, 44, 55, no
796334964342194178,  Italiabrucia, 140, 68, 72, no
3107458432,  Carla51C, 22, 5, 17, no
2842468841,  flyingfuck, 7, 3, 4, no
592688115,  gia161170, 27, 9, 18, no
799248233981759488,  MirkoPiccinini2, 22, 8, 14, no
2291700139,  Berlusconia9, 46, 15, 31, no
62300002,  Zio_Tom, 3, 1, 2, no
258562609,  orfeobossini, 14, 2, 12, no
1638143131,  CorrPetrocelli, 19, 2, 17, no
267335558,  gabpojer, 19, 8, 11, no
2410604455,  francesco_rand1, 6, 1, 5, no
3873606135,  MadeinJapan2015, 3, 1, 2, no
253728666,  grandesse, 5, 2, 3, no
214892045,  jamesluis87, 4, 1, 3, no
22674272,  Lippa64, 6, 2, 4, no
1028662526,  fillypollinzi, 219, 12, 207, no
68631041,  Raffael_Mandis, 3, 1, 2, no
408704922,  ValeriaColibri, 13, 6, 7, no
2589503250,  KamikazenRoma, 12, 1, 11, no
205276406,  21lettere, 10, 2, 8, no
202675420,  davideracconta, 8, 2, 6, no
551374959,  MartaEcca, 18, 7, 11, no
2373222249,  GiampaoloBaldi, 41, 8, 33, no
1280187702,  spree_prof, 3, 1, 2, no
970577154,  GennaroF74, 5, 1, 4, no
201654791,  JosephFranz, 10, 2, 8, no
569680694,  SimonaSelene, 50, 24, 26, no
1586159210,  SirWilliamBl, 28, 9, 19, no
621038509,  miloxandreax, 11, 5, 6, no
11080682,  madez, 14, 2, 12, no
4893192004,  SiAiVitalizi, 3, 1, 2, no
391237371,  demofiliaco, 14, 5, 9, no
972582380,  john_it_, 20, 7, 13, no
306433583,  andysalvatori, 3, 1, 2, no
946249914,  bianchi_ennio, 42, 18, 24, no
539942362,  fangiovanna, 19, 9, 10, no
2403957681,  Alce1954Z, 3, 1, 2, no
539157045,  stdara3, 45, 13, 32, no
738092501853216768,  danilosantini65, 32, 9, 23, no
2776509252,  ForzaCerea, 4, 0, 4, no
723843735482720256,  MarcoCattoni, 16, 0, 16, no
1114098782,  paolocristallo, 35, 6, 29, no
768899789136072704,  gianrobertomag, 3, 1, 2, no
761971314781487105,  Stocazz61709837, 30, 7, 23, no
586620795,  PIETROSCARTEZZI, 20, 7, 13, no
113981849,  guglielmoenrico, 5, 1, 4, no
1635242966,  PucaStefano, 8, 2, 6, no
719190663502426112,  RAFFAEL07976412, 9, 2, 7, no
2450147531,  BettoGigliola, 58, 27, 31, no
1053176233,  albertamanzoni, 15, 3, 12, no
430092847,  atominobipbip, 6, 1, 5, no
843223866,  ColombaLuigi, 5, 1, 4, no
554257940,  PeppeBrasa, 4, 1, 3, no
3319406075,  cappellodibarba, 3, 0, 3, no
392217780,  antoniosti, 5, 1, 4, no
1063955917,  Tshovel_, 73, 20, 53, no
493025647,  fabiorampelli, 15, 1, 14, no
380243566,  sabrinafantauzz, 18, 1, 17, no
1552494224,  FraBen80, 4, 0, 4, no
1014870637,  renatastortini, 83, 24, 59, no
455859309,  gorgosprizza, 9, 4, 5, no
1546005109,  29giugno77, 5, 1, 4, no
749757178530164737,  ElyMagicamagica, 10, 4, 6, no
2820455714,  Tiffany78Miss, 10, 2, 8, no
803617893464215556,  Anonimous_999, 184, 91, 93, no
589407736,  Fidel_partizan, 35, 15, 20, no
2501851306,  CaspaniStefania, 368, 183, 185, no
1231366670,  LucianoDAlessa6, 11, 5, 6, no
804031502229110794,  GasparriPerson, 42, 7, 35, no
738095532166553604,  ermellino1806, 37, 18, 19, no
4459087695,  Salvato18946554, 75, 32, 43, no
558053080,  ConzDenis, 90, 43, 47, no
3338622107,  irascema75, 314, 153, 161, no
756726681122004992,  Marinel84683170, 19, 9, 10, no
2679377412,  gPublic31, 144, 51, 93, no
164780237,  IsmaeleRognoni, 574, 286, 288, no
2716446892,  LGiambo, 298, 146, 152, no
791583592799404032,  VotaSalvini, 165, 82, 83, no
4060369233,  Diego56605415, 268, 133, 135, no
3448617916,  clau_perl, 417, 208, 209, no
51759517,  fdragoni, 10, 3, 7, no
473938490,  FraSchett, 20, 9, 11, no
863339647,  debmac1968, 17, 6, 11, no
1316131556,  russ_alexx, 5, 2, 3, no
592771212,  SoniaZeroli, 7, 3, 4, no
803336895820341249,  IOVotoNoM5S, 16, 3, 13, no
2378868702,  IovotoPicchi, 16, 3, 13, no
985140906,  iostoconPicchi, 17, 3, 14, no
2394225674,  PisaconPicchi, 84, 7, 77, no
2448071614,  griottisilvana, 12, 4, 8, no
40851070,  ARNALDIFERO, 8, 1, 7, no
89212874,  CSilvagni, 95, 6, 89, no
778950791361167360,  marcello_747, 3, 1, 2, no
211061112,  tenshi355, 12, 3, 9, no
1598750419,  Glover406P, 20, 5, 15, no
393289136,  MarcoGalligher, 25, 5, 20, no
2305446516,  pesapesp, 7, 3, 4, no
38398195,  gicvd, 20, 3, 17, no
1037543545,  Red19581966, 9, 3, 6, no
4881271245,  Sara42606433, 7, 3, 4, no
2355256140,  Alfonso0070, 10, 4, 6, no
768898726895185920,  Francesco260669, 28, 9, 19, no
2340110677,  acquodario, 44, 8, 36, no
4827636455,  Carolinamanfre6, 47, 21, 26, no
3102288245,  giors40, 12, 4, 8, no
3120793481,  GianniSartor, 3, 1, 2, no
789431766591340544,  Andrea652232211, 9, 2, 7, no
107064765,  Anaslele, 30, 13, 17, no
787748865197875201,  serenit16, 18, 8, 10, no
803252196695543808,  Wolter7300, 5, 1, 4, no
772520766885728260,  Torex1979, 36, 17, 19, no
779271293359325184,  enricosagulo, 12, 3, 9, no
731733318157373442,  laziamary23, 7, 3, 4, no
212661183,  BertinelliLuigi, 7, 2, 5, no
514506617,  alecobra1981, 8, 3, 5, no
1384855346,  cune_gonda, 40, 9, 31, no
3008542859,  corinnandreatta, 17, 7, 10, no
3297108689,  Sergio_M219, 16, 7, 9, no
452855803,  elena_zuccarini, 8, 3, 5, no
4812464489,  crotone_siulp, 25, 11, 14, no
1281118717,  AlbertoSalme, 15, 4, 11, no
800370508793417728,  designinterno, 17, 6, 11, no
2759396308,  alessio_tag1, 19, 4, 15, no
1190157246,  CittadinoResp, 6, 2, 4, no
419743304,  AlessioLale, 62, 28, 34, no
1021306837,  modamanager, 22, 7, 15, no
435419527,  fungo1983, 6, 1, 5, no
220806987,  TullioFlorio, 25, 12, 13, no
176541363,  Nicbono, 10, 3, 7, no
244705592,  sfloriana, 27, 10, 17, no
471117838,  EugenioBusin, 3, 1, 2, no
423738002,  PierpaoloManca, 3, 1, 2, no
554550990,  kanalibeach, 12, 4, 8, no
569054211,  GCTesoro, 10, 3, 7, no
4842381857,  TommasoLumare, 6, 2, 4, no
142088836,  Emacu73, 5, 2, 3, no
68111970,  lullabyg, 4, 1, 3, no
1480667646,  YaAdami, 3, 1, 2, no
51049489,  GiuseppeCarosi, 3, 1, 2, no
3428888823,  Mazzaufo, 10, 4, 6, no
3226537523,  Silvio_Did, 6, 2, 4, no
756061004556042244,  _mianing_, 7, 2, 5, no
2534379143,  micimpo, 3, 1, 2, no
2845626183,  scassatore1, 10, 4, 6, no
227605442,  giodel65, 3, 1, 2, no
1498219698,  FedericoZilia, 5, 2, 3, no
122644390,  fuser1975, 28, 4, 24, no
19392607,  micheleemiliano, 107, 13, 94, no
2408803254,  Castruccio64, 19, 8, 11, no
786541347750588419,  wholedani, 53, 14, 39, no
4197183543,  AminelliVr, 26, 12, 14, no
2654152260,  peppenordafrica, 29, 3, 26, no
1927387476,  MarioNapoletan3, 14, 5, 9, no
250316913,  brales41216, 50, 16, 34, no
896112570,  didomax71, 12, 1, 11, no
1671070807,  amshare_armando, 18, 3, 15, no
510952881,  ilariabbruzzesi, 11, 3, 8, no
2201962850,  carlo_masera, 11, 1, 10, no
495925655,  BALUBA74, 4, 1, 3, no
2369270534,  Monica_Cecchi, 3, 1, 2, no
196518637,  ArtemioAntinori, 3, 1, 2, no
319141378,  carnif, 2, 0, 2, no
117065803,  sdb251, 7, 2, 5, no
766056010406649856,  Pareti_Max, 5, 0, 5, no
794234183128322049,  MaialiSenza, 82, 10, 72, no
1387461,  betman, 4, 1, 3, no
1106715577,  ECARRATTA, 3, 1, 2, no
4822090449,  SiamoLuigino, 3, 1, 2, no
2516807525,  LegaNordRoma, 38, 14, 24, no
702514825214238720,  nadiagiacomazzi, 6, 2, 4, no
2665607653,  TheFansApps, 4, 1, 3, no
3011358083,  ItalExitTW, 6, 2, 4, no
3054346990,  MailaRatti, 3, 1, 2, no
3054312209,  GratiSandro, 6, 2, 4, no
3054364876,  DanieeFioretto, 6, 2, 4, no
730034081698877443,  TristanoQuaglia, 119, 30, 89, no
353766961,  cashpalla, 12, 5, 7, no
476144741,  JacopoMorrone, 3, 1, 2, no
428417530,  lisabrambilla, 22, 9, 13, no
271468279,  pasquimaenza, 59, 27, 32, no
1320360776,  LBoratto, 9, 2, 7, no
1124867449,  SaccaniSaccani, 40, 4, 36, no
1567906891,  LuciFrancesco, 9, 1, 8, no
493854798,  CorradinoMineo, 31, 4, 27, no
409352382,  michelestimola, 25, 7, 18, no
1062997310,  Francy1950, 29, 10, 19, no
1324221282,  alessandrogessa, 9, 4, 5, no
462343980,  antonyromanelli, 5, 1, 4, no
1105753646,  Giovanni2601, 23, 9, 14, no
2806242466,  MPellegrini1988, 10, 4, 6, no
234743222,  MarcoCav, 8, 1, 7, no
507652780,  simonefurlan1, 7, 2, 5, no
3349036179,  diarioditrieste, 3, 1, 2, no
1389335053,  gigig66, 18, 7, 11, no
3318421203,  PetteneAnna, 72, 20, 52, no
1620754188,  chilisummer, 14, 6, 8, no
2249221297,  1piede, 16, 7, 9, no
2950936654,  DrToninicesare, 50, 21, 29, no
3226558563,  pistoresir1, 50, 15, 35, no
1275456488,  claudioven90, 37, 18, 19, no
2878090661,  demichelibobby1, 3, 1, 2, no
2348140042,  nino_indelicato, 15, 2, 13, no
989192558,  AntonelloAng, 13, 6, 7, no
263158083,  capeppe, 7, 2, 5, no
2509485582,  paolacignap4021, 20, 8, 12, no
4256715496,  Ale_Manzo83, 43, 21, 22, no
421406745,  marcomiscio, 10, 3, 7, no
962210358,  freemin_d, 3, 1, 2, no
484106374,  godan9, 25, 2, 23, no
411706932,  EmanueleTesti, 8, 1, 7, no
271518898,  Ntina_bi, 3, 1, 2, no
427209531,  m_enomis, 20, 8, 12, no
205840088,  ienzottodue, 11, 5, 6, no
383730592,  MINOPOLIG, 3, 1, 2, no
39028896,  7m70, 32, 13, 19, no
411048509,  AscanioV, 18, 7, 11, no
1103812855,  lordbiron13, 20, 8, 12, no
164272724,  lucaverga, 17, 6, 11, no
293614669,  alberto_buson, 3, 1, 2, no
2628648221,  RMarabelli, 6, 1, 5, no
1365472506,  BladeRunner03, 10, 4, 6, no
1192260607,  ladycast_catia, 30, 10, 20, no
127435541,  sc_1969, 14, 3, 11, no
863020105,  mdanz72, 33, 14, 19, no
516432515,  marcogaius, 21, 7, 14, no
3382760081,  hfurms, 13, 3, 10, no
304598010,  marielSiviglia, 89, 28, 61, no
770348083343396865,  maurizio_guido, 3, 1, 2, no
2450265194,  MRHARLEY69, 16, 5, 11, no
2301664084,  giovanniemilia, 13, 6, 7, no
443775053,  giuseppepetroce, 13, 5, 8, no
246377592,  lupin1955, 7, 3, 4, no
1409736301,  ilcjanpete, 43, 12, 31, no
933010074,  turini_andrea, 3, 1, 2, no
500846038,  Filonide76, 3, 1, 2, no
2786881413,  newsalutamu, 3, 1, 2, no
497384675,  PetraccaMario, 40, 10, 30, no
2878223753,  lisi_24m, 15, 2, 13, no
53634013,  maxjuve, 16, 2, 14, no
990661279,  CaprioliSimone, 6, 2, 4, no
1683090120,  alessandrapln51, 10, 1, 9, no
3246166239,  valituttanto, 11, 2, 9, no
429144484,  gricc1947, 19, 9, 10, no
2375255690,  domenicoxLaura, 5, 2, 3, no
607112247,  claudiocostanzi, 55, 11, 44, no
2847895318,  bellomio95, 8, 2, 6, no
406469071,  giuliocampese, 52, 8, 44, no
2908032201,  S0ldiPubblici, 11, 3, 8, no
589053788,  ema_rigitano, 3, 1, 2, no
2214610401,  AmedeoDAlessan1, 4, 1, 3, no
2221874484,  abissi3, 20, 5, 15, no
944665938,  Romoletto72, 103, 41, 62, no
1044114469,  giampluzi, 18, 7, 11, no
92996440,  sauron72, 19, 3, 16, no
2281936099,  GAIDORic, 122, 5, 117, no
560046823,  pierocefaloni, 28, 1, 27, no
407661201,  DomenicoTripi, 3, 1, 2, no
1619769668,  GuidoAlberto6, 19, 9, 10, no
331223753,  arcocielo, 10, 2, 8, no
560401416,  Hazydavey34, 9, 4, 5, no
180112128,  sdallagata, 3, 1, 2, no
4783916222,  viliamdbr, 4, 1, 3, no
2935626166,  Beverari_M, 7, 2, 5, no
2886860662,  fabyo40, 5, 1, 4, no
265903575,  APEOnlus, 9, 4, 5, no
698226027756126210,  mmayr5, 71, 32, 39, no
717789567,  unsintagma, 7, 1, 6, no
2205598141,  marinacerioni, 23, 4, 19, no
1382206622,  FulvioGhio, 121, 2, 119, no
491318883,  francescopolica, 38, 14, 24, no
703708224168599552,  AlessiaPurrone, 55, 25, 30, no
2731197053,  chrcapuano, 76, 5, 71, no
922785494,  ferdisarno, 3, 1, 2, no
730858206830985216,  ficchinicchi, 7, 3, 4, no
4449871396,  andreaf31593441, 8, 3, 5, no
4120176819,  carmetrop, 7, 3, 4, no
50625691,  nicolafavrin, 15, 3, 12, no
188257090,  LucaGava, 3, 1, 2, no
854615178,  MissMartaOh, 3, 1, 2, no
397278990,  LorenzoAgresti, 9, 3, 6, no
28787275,  letissja_, 3, 1, 2, no
551084841,  ChiaraNews, 4, 1, 3, no
761047603,  SaraCintelli, 7, 2, 5, no
527830076,  AnfameFracico, 3, 1, 2, no
22621322,  placeinthesun, 3, 1, 2, no
2817088916,  signammancell, 21, 10, 11, no
1405748826,  _Forza_Italia_, 43, 5, 38, no
2327373751,  Fi_Pdl_Senato, 31, 3, 28, no
487751312,  _paolo_romani_, 4, 1, 3, no
24699941,  idonea2volte, 3, 0, 3, no
2967886673,  FoxyBiondi, 91, 6, 85, no
389131517,  Kuzzo74, 6, 2, 4, no
796980229768093696,  Caiobonus23, 23, 8, 15, no
3743344103,  mariocolombo65, 18, 8, 10, no
2948661737,  giannonefp, 15, 4, 11, no
2294481057,  Frances70338962, 3, 0, 3, no
2191938685,  mariaan99531581, 24, 5, 19, no
2150833213,  stefanopdci, 9, 4, 5, no
752726608272846849,  antonioproiet14, 11, 3, 8, no
428364426,  archguccione, 8, 3, 5, no
2420690215,  MauriceUtr92, 16, 7, 9, no
132525437,  Paolo_Puzzella, 4, 1, 3, no
319620609,  EdoardoSemmola, 6, 2, 4, no
305204306,  taddeovaio, 4, 1, 3, no
53747091,  pier_m, 3, 1, 2, no
219406236,  utique_eu, 46, 5, 41, no
771042114188742656,  giuliorossigno1, 26, 6, 20, no
1556086555,  theBsaint, 10, 4, 6, no
2181304610,  ITALOPTIMUM, 12, 4, 8, no
444398234,  digiancamillo, 4, 1, 3, no
784500022410969088,  MaurizioBilli17, 141, 52, 89, no
341097129,  maschera, 3, 1, 2, no
3654048027,  mo_sorte, 6, 1, 5, no
1015929313,  PalumboPatrizia, 8, 2, 6, no
2288794280,  Apocalisse23, 10, 1, 9, no
2831366043,  MarcAugliera, 54, 3, 51, no
630524940,  DedeVincenzo, 17, 4, 13, no
570045852,  MarchesiFranco, 22, 7, 15, no
797805269539520512,  Tina6893, 234, 25, 209, no
1125077892,  teresadelgiudi, 12, 3, 9, no
1100633432,  BilottaFranco, 8, 1, 7, no
989645683,  BibiBec, 23, 8, 15, no
83326299,  dk768, 17, 5, 12, no
467659856,  nickyangeli, 30, 13, 17, no
133366702,  nicola_bianchi, 8, 3, 5, no
1394952978,  alessio_54, 10, 4, 6, no
398611235,  chiara_201181, 21, 3, 18, no
468356881,  spotclod44, 14, 4, 10, no
118178579,  nazca27, 6, 1, 5, no
538946856,  AntonellaBerar4, 3, 1, 2, no
1729146290,  DomenicoVerago, 3, 1, 2, no
236333273,  lillyhami, 17, 3, 14, no
244477620,  Massa5Stelle, 10, 2, 8, no
1421381328,  HerrProof, 23, 5, 18, no
725557127872417792,  luciolucio1953, 42, 9, 33, no
851233315,  LuzPagoda, 24, 3, 21, no
2158195314,  F_Castellucci, 19, 5, 14, no
753901145366626304,  stefanoioele, 32, 10, 22, no
2215701370,  FiorellaBangraz, 33, 3, 30, no
845781758,  raffo1900, 66, 6, 60, no
1704854190,  GaProfgio, 57, 8, 49, no
870647947,  ANTIPOLLITICA, 64, 22, 42, no
427583657,  NikosMamoutis, 7, 3, 4, no
488339106,  ANNAMARIAPOMARE, 98, 21, 77, no
993135720,  AquilaRossa3, 6, 1, 5, no
1119430706,  LuigiTranquill, 30, 9, 21, no
770611373713854464,  Gabriel13111961, 8, 3, 5, no
3019669299,  e79f53507876409, 15, 6, 9, no
799340178854866944,  giusepp55986457, 20, 9, 11, no
1426319126,  Paolo_Calloxi, 6, 2, 4, no
1488327588,  Sam5stelle, 9, 3, 6, no
16615233,  armgra, 3, 1, 2, no
1264214780,  lrcasanova1, 15, 5, 10, no
712430076311314433,  RollyRenzi, 62, 10, 52, no
2350203541,  FioriMarcello, 25, 2, 23, no
3387135933,  AltraItaliaSB, 35, 14, 21, no
775301877512675328,  dario_dibordo, 154, 16, 138, no
1960868090,  ForzaItaliaRM, 308, 29, 279, no
775299421705732097,  PaolettaSabe, 158, 17, 141, no
2221318495,  SilvioSaleri, 119, 17, 102, no
2221331701,  Spagnolo_S, 200, 20, 180, no
2432208854,  CarolinaPetitti, 200, 16, 184, no
2221319742,  FraSoriano27, 173, 17, 156, no
756085177709916161,  ComitatoNoRoma, 234, 32, 202, no
2221331347,  FrancescoPotril, 125, 17, 108, no
1725558426,  _TV_Watch, 167, 24, 143, no
775632857993797633,  DiBattistaVale, 155, 16, 139, no
789012950585643008,  FreeNews_Online, 45, 13, 32, no
775294620259483648,  LuStuffo, 126, 18, 108, no
776003975921401862,  FanCluBrunetta, 141, 19, 122, no
4914230231,  AnnaCarrano5, 21, 6, 15, no
409448246,  SerpicoFra, 127, 5, 122, no
1521671185,  RidolfiSabrina, 58, 4, 54, no
2466256099,  CristianaQ69, 11, 1, 10, no
2922539446,  depaoli_tiziano, 9, 3, 6, no
1228485109,  AlbrigoAndrea, 12, 4, 8, no
2523336293,  marcelgiorda, 13, 6, 7, no
136225328,  Ponzietto, 20, 6, 14, no
1145835457,  marinaM5S, 10, 4, 6, no
4063380377,  Brasviz1, 52, 25, 27, no
2429027969,  AnnaAnnaritabo, 27, 7, 20, no
6322582,  a_monteleone, 3, 1, 2, no
785825867012444160,  Giovanna29908, 16, 4, 12, no
955561676,  Marcostoppa92, 3, 1, 2, no
112010082,  Hyodyo, 3, 1, 2, no
4160599461,  mariuskrossi1, 142, 53, 89, no
1418976222,  BocchiniLuca, 32, 4, 28, no
2300311050,  balduroberto, 87, 19, 68, no
1390614042,  AaaaaUrsula, 15, 4, 11, no
405620123,  Ida_____, 3, 1, 2, no
14900051,  drlectar, 29, 4, 25, no
3387294747,  luigia79p, 8, 2, 6, no
376310225,  gigitudine, 20, 5, 15, no
2414596461,  avellino53, 22, 8, 14, no
1386737474,  Angiolara, 5, 2, 3, no
1430162268,  sferriam, 32, 4, 28, no
291018700,  EliotWind, 4, 1, 3, no
771197191,  claryvic, 13, 4, 9, no
2182403667,  saraosalvatore, 35, 16, 19, no
1854556328,  PireddaMa, 36, 14, 22, no
2877035033,  maxxam66, 3, 1, 2, no
42603583,  wwwDARIOVEROcom, 5, 1, 4, no
2318486375,  EmanuelaOmal12, 13, 6, 7, no
427804855,  Giuseppe4g1, 32, 4, 28, no
706217983862054913,  marcoconti1973, 26, 9, 17, no
1169471665,  SilvioFrasca, 3, 1, 2, no
564360716,  Fabme0801, 51, 16, 35, no
496948669,  SilviaGiomi, 7, 3, 4, no
784909327387783170,  gciccar78, 9, 4, 5, no
453712873,  fab2563, 9, 2, 7, no
2224787402,  PaolaAterini, 6, 0, 6, no
797053138326945792,  PinoFummo, 46, 1, 45, no
738345206056128512,  Franksognatore, 4, 0, 4, no
1339529246,  ufogufo, 53, 6, 47, no
2175102489,  ferdan1970, 3, 0, 3, no
39239835,  ales_fama, 30, 1, 29, no
737351757819486208,  ceraroma2016, 7, 0, 7, no
1018416800,  gianninipiero, 4, 0, 4, no
2834036535,  labyrynthique, 4, 0, 4, no
585554400,  Plyrique, 5, 0, 5, no
1923814338,  luiginic73, 4, 1, 3, no
792019525,  michelevenezia2, 3, 0, 3, no
3434003098,  invisibile1959, 15, 6, 9, no
956969354,  corsaro47, 24, 6, 18, no
721143737770971136,  ApriGli_Occhi, 11, 4, 7, no
759601758,  HotmaMomi, 4, 0, 4, no
781846768661192704,  ManiniGiancarlo, 3, 0, 3, no
4890070021,  pane_nero, 7, 0, 7, no
1510536295,  merten_65, 5, 1, 4, no
1043011003,  ceciliavalent12, 29, 4, 25, no
553449880,  Hobgoblin3964, 3, 0, 3, no
1026539899,  irwinsmileaw, 3, 0, 3, no
1962856872,  le3scimmiette, 14, 2, 12, no
795177099392909312,  Enzopiz1, 5, 0, 5, no
3386077780,  foi_guido, 10, 3, 7, no
3345500597,  DiBaYsusHnos, 6, 0, 6, no
2721656760,  vorto752, 3, 0, 3, no
23724160,  yuuraku, 3, 0, 3, no
770010584033140736,  shokan1966, 4, 0, 4, no
1698522818,  M5STreviso, 9, 0, 9, no
3106260993,  STEFANIALOVE69, 5, 2, 3, no
738344440851468288,  ilbomba_, 27, 1, 26, no
2706185665,  Oscar4Marilyn, 11, 4, 7, no
761303645518499840,  DaniloBigonzi, 67, 3, 64, no
526894466,  willi752003, 8, 0, 8, no
765965375792148480,  BaffoJak, 72, 2, 70, no
2569703055,  deepakbaiocchi, 21, 5, 16, no
2400269172,  capotecnico, 8, 0, 8, no
708755071861964800,  PariniAlberto, 11, 0, 11, no
2302888393,  e_cozzolino, 13, 0, 13, no
169566296,  GianniVaretto, 4, 1, 3, no
584022845,  pdrmsmm, 57, 3, 54, no
2942183974,  CiniselloBM5S, 11, 1, 10, no
160011017,  Dix73, 62, 2, 60, no
517672213,  LorellaTotaro, 15, 1, 14, no
117402258,  cocorieo, 3, 0, 3, no
85167868,  danieleprato, 14, 3, 11, no
1045573032,  rosadep, 45, 2, 43, no
3914047581,  Italians4Trump, 17, 3, 14, no
711634646933618688,  gtagliente511, 7, 0, 7, no
177338309,  JorgeBlst, 4, 0, 4, no
142690511,  borrellidavid, 6, 0, 6, no
3300846436,  giulivi_luca, 3, 0, 3, no
3295966795,  nicodallara2, 12, 1, 11, no
1042807543,  supermario_75, 14, 4, 10, no
390721955,  franky_Cia, 6, 0, 6, no
799866654717054976,  MaurilioValeri, 5, 0, 5, no
786215749035720704,  Loredan60705692, 68, 1, 67, no
800464320484098048,  RSTopnews, 55, 4, 51, no
701169921053605888,  MARTEDEGANIP, 19, 3, 16, no
1444784371,  skleratha, 32, 1, 31, no
1521455803,  tuttigiuperterr, 30, 9, 21, no
299020216,  AnniPitea, 22, 1, 21, no
1702719008,  smarthicks76, 17, 5, 12, no
4814832225,  papagnap, 4, 0, 4, no
2506822612,  AntonellaIacob1, 39, 0, 39, no
2415685429,  stevvid, 19, 1, 18, no
538874342,  Paolo_HY, 3, 0, 3, no
1382241883,  roma_e_roma, 7, 0, 7, no
2207172466,  Claudiozanott, 132, 3, 129, no
728228470816395266,  orsoloco67, 3, 0, 3, no
2237096859,  SteccaAlessio, 55, 0, 55, no
585883841,  EdiMommi, 12, 2, 10, no
3261842987,  giagiangi, 9, 0, 9, no
2330689508,  luigi08020856, 16, 7, 9, no
706057101,  stefanocazzola1, 17, 4, 13, no
3345485428,  toninococ, 7, 0, 7, no
801092954454683650,  stefano19446629, 14, 1, 13, no
1301159155,  ESprovieri, 4, 0, 4, no
3085895092,  DoctorPanza, 11, 0, 11, no
4688664552,  ivanau87, 26, 0, 26, no
789137491190226944,  p81841108, 9, 0, 9, no
2904311573,  DarkMatterMario, 15, 5, 10, no
1151876744,  R__Rob, 27, 0, 27, no
576999728,  fabioazzaro, 3, 0, 3, no
3330461728,  Er_Cattivo, 44, 3, 41, no
96337794,  MarinoBruschini, 48, 8, 40, no
204249074,  francotuologo, 7, 0, 7, no
465763892,  cecegranata, 6, 0, 6, no
265399668,  DinoGambacorta, 6, 0, 6, no
3879470056,  KarimRahimi13, 10, 0, 10, no
427201823,  PietroVagli, 11, 1, 10, no
749617259849584640,  consoleantonio1, 22, 0, 22, no
302561494,  FBellusci, 18, 3, 15, no
1120118342,  Lamp__1, 42, 6, 36, no
498962103,  GionbatGiovanni, 3, 0, 3, no
736543941101817856,  enzoangeletti13, 4, 0, 4, no
745931678649061376,  gubitosagianni, 4, 0, 4, no
704431464524423168,  milena_vireca, 29, 2, 27, no
621771505,  FilippoFortuna, 18, 3, 15, no
570728506,  abertumella, 4, 0, 4, no
1089615589,  Gianfra58, 45, 8, 37, no
419768382,  antiglio, 16, 0, 16, no
516574301,  MassimoEsquilin, 6, 0, 6, no
1102216892,  NicoCusimano1, 33, 5, 28, no
395967162,  MIMMOLILLO, 3, 0, 3, no
937020181,  M5STerme, 4, 0, 4, no
227306075,  PatriziaErre, 10, 1, 9, no
1715119512,  micillom5s, 67, 0, 67, no
330574100,  emme_erre_ci, 8, 0, 8, no
1648199708,  filsco2004, 8, 0, 8, no
2913833871,  yujizainesilio, 43, 0, 43, no
340294381,  MELONEDAVIDE, 19, 4, 15, no
794473839526813696,  Armanfo7, 3, 0, 3, no
754009621724012544,  jacklamotta75, 16, 0, 16, no
261421785,  Benedict_Ux, 7, 2, 5, no
2999325983,  Silvano15018818, 12, 4, 8, no
2491958276,  zanderzermeno, 3, 0, 3, no
2508295280,  ilcieco07, 36, 3, 33, no
724560206152216583,  PacettiGiuliano, 7, 0, 7, no
3324608649,  INTEER999, 54, 1, 53, no
1908263497,  ma3dit, 42, 0, 42, no
464477564,  FlavioPatrizi, 13, 0, 13, no
589423738,  antoniavalenzis, 25, 0, 25, no
397481743,  enricome63, 5, 0, 5, no
751662668327583745,  MiminoOrlando1, 3, 0, 3, no
2427827258,  AleFiveStars, 30, 8, 22, no
369177021,  CarielFr, 14, 0, 14, no
1431247669,  stefanostaffa1, 39, 7, 32, no
2442517233,  Movimento_5s, 114, 5, 109, no
503276338,  GiuseppeConi1, 6, 0, 6, no
2173707058,  GinaNatuzzi, 9, 0, 9, no
4888582030,  lollomuay, 22, 0, 22, no
760548711701282816,  francescotozz11, 24, 0, 24, no
730380067637956610,  ciri2016, 28, 0, 28, no
1376730776,  mariaederaM5S, 19, 0, 19, no
533692413,  rdalzilio, 36, 0, 36, no
1472956555,  gianlucalibrale, 19, 1, 18, no
2751862871,  Zagaria22, 36, 0, 36, no
950313325,  umbagu, 20, 5, 15, no
1238622974,  Gunnyidol, 151, 6, 145, no
2371137846,  Nuccia58, 67, 1, 66, no
733743405751271424,  Blackwhite2840, 43, 3, 40, no
3291324425,  PaolettoDoro, 32, 0, 32, no
633645457,  maria_demurtas, 20, 2, 18, no
1142540912,  Canto_Quinto, 14, 1, 13, no
161428463,  aleottim, 35, 6, 29, no
704249890793193472,  Patriciaciribi3, 7, 0, 7, no
502039896,  utor34, 23, 0, 23, no
345535835,  libellula58, 56, 4, 52, no
2271552805,  saracinogino197, 4, 0, 4, no
2595566549,  midnightsilvia, 5, 0, 5, no
2499039877,  Vittori57825173, 3, 0, 3, no
725050316849336320,  marchio79, 10, 4, 6, no
771114116035543041,  AntoninoShop, 7, 0, 7, no
223549496,  bobo3340, 3, 0, 3, no
701059824520396800,  Marc0Manz0, 48, 2, 46, no
173430456,  xavierbellanca, 12, 0, 12, no
2951279819,  luce_lucialenzi, 303, 15, 288, no
473027302,  stefanoschwarz, 11, 2, 9, no
318923862,  Varese5Stelle, 9, 0, 9, no
2226747666,  pinodemi, 17, 0, 17, no
968433782,  emidioflamini, 18, 7, 11, no
481287765,  PaoloSartori4, 16, 7, 9, no
22678247,  ilmangia, 3, 0, 3, no
305051024,  eikouarucroatia, 3, 0, 3, no
111263349,  santy_07, 3, 0, 3, no
137275274,  prosperi_s, 4, 0, 4, no
500583344,  paolopietrodila, 7, 0, 7, no
1079126036,  claudioporcu73, 88, 1, 87, no
707643839343939584,  frances37000482, 7, 2, 5, no
1215628212,  Fandistelle, 36, 2, 34, no
721242552469479424,  Amedeo111960, 15, 1, 14, no
1036719990,  CiranGuccini, 48, 10, 38, no
1150394972,  EspeMarco, 11, 3, 8, no
914574283,  CIRAGGI, 56, 0, 56, no
773204075303276545,  Antonio_jz4, 4, 1, 3, no
2733334557,  vannigio3, 11, 2, 9, no
80871910,  Andrea_ONE, 3, 0, 3, no
2365532641,  PeppeGrillo_, 52, 16, 36, no
20968074,  Etrust12, 7, 0, 7, no
762573760037871616,  krefused, 3, 0, 3, no
350368337,  sinatratiziano, 6, 0, 6, no
3435243441,  antoninilidia, 3, 0, 3, no
326183542,  nicuzzo, 14, 0, 14, no
391620881,  pierodm, 76, 4, 72, no
581285865,  muttley_1974, 21, 2, 19, no
2521249817,  tile_small, 3, 0, 3, no
3862086448,  ada_bizialuna, 53, 4, 49, no
621679998,  araelmose, 6, 0, 6, no
802805449099776000,  ShNushin, 3, 0, 3, no
749173351999037441,  Salvo160, 7, 0, 7, no
507006278,  Mattia_Bracco, 14, 0, 14, no
802059051064561664,  OfficialRube, 24, 9, 15, no
802581982035247104,  pankadrillo17, 41, 13, 28, no
354896841,  dunky2588, 4, 0, 4, no
306180757,  LalloCocco, 99, 12, 87, no
711229634,  OcchiniSilvio, 6, 0, 6, no
160136129,  s_alati, 5, 0, 5, no
405443137,  alfredomartel65, 87, 1, 86, no
2153812941,  QuintoValter, 193, 6, 187, no
995341382,  campagnoli85, 27, 3, 24, no
3320655053,  ott_alba, 93, 3, 90, no
801062327810461696,  EnzaSorti, 90, 39, 51, no
475325454,  fausto_cag, 26, 12, 14, no
558010244,  susi1961, 6, 1, 5, no
420931672,  EmeiMarkus, 11, 0, 11, no
166161984,  titominardi, 12, 0, 12, no
538974240,  ernestopan, 6, 1, 5, no
218931858,  fedeRRik800, 70, 0, 70, no
34445466,  Astaschera, 6, 0, 6, no
609872484,  1DiMaio, 8, 2, 6, no
707218166250864640,  WalterAktarus, 30, 0, 30, no
75789796,  morettipaolo, 7, 2, 5, no
797171468002033664,  orl_dan, 19, 4, 15, no
2320901282,  DamendaoLibero, 3, 0, 3, no
800260812875055104,  CastlesJames2, 3, 0, 3, no
805772104461352960,  marekiaro19, 3, 0, 3, no
90859217,  okadascape, 11, 3, 8, no
710044495748927488,  IovotonoG, 67, 1, 66, no
353463744,  banawedata, 3, 0, 3, no
174210451,  largociospe, 16, 2, 14, no
1065974568,  Maximum70Mm, 3, 0, 3, no
199002258,  remomix, 3, 0, 3, no
875324551,  marco63307847, 15, 6, 9, no
3001188891,  erFabrillo, 12, 0, 12, no
471428838,  gizzi31, 222, 2, 220, no
3155684650,  AattAlessio, 3, 0, 3, no
1888044751,  silviachimienti, 7, 1, 6, no
474132230,  MasiaOssi95, 4, 0, 4, no
2397799935,  CanioA, 8, 0, 8, no
420543944,  o0desy0o, 21, 10, 11, no
733366019666944000,  claudiozano1961, 5, 0, 5, no
2351601439,  vic24g, 45, 1, 44, no
798899498152034305,  Penstellatotw, 9, 0, 9, no
3939431595,  LiberatiLinda, 32, 3, 29, no
369459091,  ivorobertocarbo, 5, 1, 4, no
58636171,  FabioILLogico, 67, 8, 59, no
197056224,  ANNAQuercia, 88, 1, 87, no
971780588,  marziazichella, 3, 0, 3, no
802931004700852228,  RobertoRossato4, 3, 0, 3, no
302967121,  gesa_2006, 13, 0, 13, no
368533605,  Leotennents, 6, 1, 5, no
762186331011375104,  piergio71, 96, 32, 64, no
51060893,  paolorivieccio, 3, 0, 3, no
1361432923,  mfantoni1977, 22, 1, 21, no
72848245,  lorenzoyzf, 4, 0, 4, no
802653586563928064,  NicolaMansi4, 5, 1, 4, no
2370908109,  VincenzoVickis1, 35, 2, 33, no
4872258489,  M72seventytwo, 8, 1, 7, no
4054730097,  ClaudioScarpino, 3, 0, 3, no
488587270,  LorellaBasso, 26, 2, 24, no
2532166333,  CarloFagnani, 4, 0, 4, no
19067940,  beppe_grillo, 106, 3, 103, no
697883940728782852,  Silviaa___, 3, 0, 3, no
289400495,  Mov5Stelle, 46, 0, 46, no
1530798872,  virginiaraggi, 8, 0, 8, no
2444235358,  shootingrome, 30, 6, 24, no
4827481564,  Gio_Angotti, 3, 0, 3, no
807579925,  cicciobronx77, 19, 9, 10, no
3406855018,  annamali458, 6, 0, 6, no
4603645649,  rossimatteol, 27, 6, 21, no
500923718,  vcioccolini, 3, 0, 3, no
4067152936,  SilvestriViola, 3, 0, 3, no
1540142966,  stefaboy3, 59, 4, 55, no
426706142,  cucciolo70, 9, 0, 9, no
702921914,  Titty973, 35, 6, 29, no
761582724176027649,  MassmilianoS, 136, 38, 98, no
247609737,  nataliemrizzo, 3, 0, 3, no
776488765183459328,  battini59, 19, 0, 19, no
1580176014,  italiaconGrillo, 22, 1, 21, no
2870220975,  GiacconeRosy, 69, 0, 69, no
1116671611,  gioatriz, 61, 9, 52, no
1114715887,  HomoItalicus, 11, 5, 6, no
1023807246,  Avv_Natalina, 8, 0, 8, no
2669111564,  Elpidio_Erc, 4, 0, 4, no
2901676730,  IEUREPORTER, 5, 0, 5, no
79036955,  serenasaetti, 21, 0, 21, no
413352483,  andreagonella77, 6, 0, 6, no
410117686,  claudiogalasio, 4, 0, 4, no
787664361036939264,  Claudio89801980, 3, 0, 3, no
1183652605,  PelusoRaffaele, 36, 1, 35, no
591884349,  ClaudiaTripoli, 10, 0, 10, no
2708501001,  piccolofux, 4, 0, 4, no
1283446118,  dangelo_luciana, 95, 6, 89, no
889099008,  luigiza2, 9, 0, 9, no
4210429707,  h3nkel, 5, 0, 5, no
3763150757,  NapolGiovanni, 12, 0, 12, no
4923691078,  Frances29571990, 3, 0, 3, no
281884852,  romano5stellebs, 134, 14, 120, no
711159303709847558,  eppursiride, 4, 0, 4, no
356923000,  1603ina, 40, 7, 33, no
997910394,  perronefulvio, 20, 2, 18, no
797922363270631424,  anetavilla94, 3, 0, 3, no
719601133019336706,  CristianaPazzi, 14, 1, 13, no
2849367177,  rinobattista2, 9, 3, 6, no
1110202813,  GmPoppi, 52, 4, 48, no
96340114,  PaoloX68, 22, 2, 20, no
582236593,  fabiopi1000, 23, 4, 19, no
299178306,  ninonovecento, 5, 1, 4, no
420852268,  indianmar1, 21, 3, 18, no
2178157155,  tonyasome, 10, 4, 6, no
516802751,  amvecchietti, 103, 25, 78, no
228249426,  selezione5stell, 18, 1, 17, no
2225431370,  AquilianoMolfa, 24, 2, 22, no
738086816226676736,  francyroll, 8, 1, 7, no
795564464829595648,  dam_malg92, 12, 4, 8, no
446937412,  LolloLollino, 20, 4, 16, no
2283780786,  PALMAMOLLO, 27, 4, 23, no
2970225064,  pmaremmi, 23, 2, 21, no
170747137,  pepcarp, 48, 3, 45, no
1908575102,  rosati22, 11, 4, 7, no
1737163674,  andy_message, 8, 3, 5, no
1524453986,  maxxxks, 21, 8, 13, no
37756411,  unaironeblu, 8, 1, 7, no
2593299788,  Akjnuk, 17, 1, 16, no
51361757,  idlavi, 24, 9, 15, no
389348747,  FrankieCS76, 15, 5, 10, no
4187885897,  crespil72, 16, 5, 11, no
756514855461453827,  maurizioceccar5, 31, 11, 20, no
734594705229545472,  marcocampus, 11, 1, 10, no
753651559003750400,  giuseppetat1, 4, 1, 3, no
247209095,  folfra, 21, 7, 14, no
158891854,  Pausini67, 15, 1, 14, no
622020182,  19marino74, 27, 9, 18, no
712643100590620676,  irbaf641, 3, 1, 2, no
438431990,  cny45tpa, 8, 2, 6, no
363542054,  claudiovr1, 63, 16, 47, no
411403085,  ottobrerosso11, 11, 4, 7, no
541670926,  GiorgioAntonel1, 43, 5, 38, no
546851983,  NahuelCespi, 3, 1, 2, no
564609095,  domenicocarrara, 14, 1, 13, no
1218936162,  augustabenedett, 21, 2, 19, no
978488840,  carlaruocco1, 11, 1, 10, no
435136836,  BrunelloEsu, 42, 2, 40, no
852549655,  Saveriogas, 4, 1, 3, no
560462597,  sipej, 9, 2, 7, no
2924683299,  LucheroniFabio, 3, 1, 2, no
574072662,  IvanGrippa, 9, 1, 8, no
782809034,  Kram11000, 8, 3, 5, no
313514631,  franknocode, 56, 5, 51, no
631465083,  rosanna_1990, 9, 2, 7, no
592174264,  Happy97164636, 12, 1, 11, no
216032839,  erTwitto, 5, 1, 4, no
2385799301,  annadelbello1, 15, 1, 14, no
2310308158,  plsgrd1965, 16, 5, 11, no
2597273655,  fabiocarusoCT, 21, 3, 18, no
2418170407,  allenatorebis, 42, 5, 37, no
400273310,  GabriellaSantor, 27, 1, 26, no
3380511171,  patripatty5, 16, 3, 13, no
253175429,  orsettinoit, 41, 1, 40, no
711187023,  PScotto1972, 37, 8, 29, no
398809701,  CoppolaLiliana, 23, 2, 21, no
1231417717,  RGrupelli, 19, 7, 12, no
3696089777,  athinaonassis1, 6, 1, 5, no
1070320147,  jobbe50, 15, 4, 11, no
438236543,  valente_adriano, 7, 2, 5, no
266841916,  TheRenry, 29, 4, 25, no
288339892,  gioderr, 8, 3, 5, no
97699315,  MauroLupo, 23, 9, 14, no
4394434523,  concettalombar8, 15, 2, 13, no
283080198,  Patrizia_Monica, 122, 7, 115, no
270518699,  OderzoGrillaM5S, 14, 1, 13, no
2179652340,  beppem54, 12, 4, 8, no
1318788918,  Fernet8, 14, 1, 13, no
313331114,  RiccardoBusi, 127, 44, 83, no
2786595941,  M5SCampaniaNews, 87, 7, 80, no
1277743430,  Ichnos1973, 19, 1, 18, no
2954613465,  salvatoresolop1, 13, 6, 7, no
1274289852,  Rokketto1, 10, 1, 9, no
4908787277,  Menocchio2, 5, 2, 3, no
2385290202,  FPuggini, 103, 6, 97, no
464145995,  GianniZarrillo, 6, 1, 5, no
1216273854,  jacoboome, 17, 6, 11, no
3416068515,  1974_sim74, 6, 2, 4, no
753620675970142208,  JohnMilnerCA, 3, 1, 2, no
721466546279817217,  robertocrieleni, 11, 1, 10, no
356975403,  Silviy5stars, 88, 2, 86, no
2437846648,  RettaroliS, 28, 4, 24, no
1052596340,  riccardo_fra, 4, 1, 3, no
2231318146,  LRoscetti, 19, 8, 11, no
986828390,  Elenaunica64, 62, 2, 60, no
621326231,  DiGiu2273, 5, 2, 3, no
11945512,  mirellaliuzzi, 7, 1, 6, no
134516956,  marcodifinizio, 9, 4, 5, no
2389396971,  6f94b7b2b0c4489, 3, 1, 2, no
1289227574,  Marco__Bellucci, 26, 3, 23, no
3410104307,  VienDalMare84, 15, 2, 13, no
250624869,  MarcoTalluto, 13, 1, 12, no
231010672,  carlino92, 3, 1, 2, no
1327241030,  scevro69, 58, 8, 50, no
22834067,  Roberto_Fico, 5, 1, 4, no
1068963974,  andreagaudio73, 7, 2, 5, no
1276570771,  CorinnnaT, 11, 2, 9, no
554581695,  GriecoV, 33, 10, 23, no
581801913,  loureiro1966, 105, 10, 95, no
865973760,  UldericoFilippe, 6, 1, 5, no
220750726,  paoloviri, 5, 2, 3, no
2942054782,  igor081976, 15, 1, 14, no
706363546,  stefano_muggio, 4, 1, 3, no
2831558388,  morlando46, 7, 3, 4, no
3049129313,  PaolaRomDiP1, 5, 1, 4, no
18114610,  glctesta, 14, 2, 12, no
2272916900,  delmonacofondie, 58, 22, 36, no
801258780,  tiziano_pasella, 15, 4, 11, no
585919562,  MauroCherubino, 17, 0, 17, no
557637492,  vellapaolo1, 9, 1, 8, no
2319599310,  leomartini_fi, 3, 1, 2, no
321375506,  FGaragnani, 21, 8, 13, no
101272144,  shady_el_mouine, 7, 2, 5, no
47781017,  cafifal, 10, 2, 8, no
172675414,  gabri_it, 3, 1, 2, no
238604711,  fulviagr, 17, 8, 9, no
782643007,  ttenti, 30, 1, 29, no
958322611,  PaoloDiGiovine, 30, 3, 27, no
962612156,  giulianavespa, 379, 3, 376, no
483671947,  Aaronn31, 14, 5, 9, no
3145265249,  peppemessina65, 75, 3, 72, no
785089989692493824,  LavoratoriPerNO, 297, 3, 294, no
932478324,  MasucciCarlo, 206, 3, 203, no
3368385652,  VaIentina_Iori, 168, 4, 164, no
2403776046,  deboramau, 97, 7, 90, no
15980018,  faberpiredda, 7, 3, 4, no
2515144546,  BMascalchi, 38, 17, 21, no
13728662,  marcomariaricci, 18, 2, 16, no
897054630,  patriziabottell, 16, 6, 10, no
4024983855,  MareBlu2015, 16, 0, 16, no
939337284,  GiuseppeMorrea3, 13, 4, 9, no
1192866157,  fgiro3, 13, 1, 12, no
2172522723,  met1927, 5, 1, 4, no
796684613452238848,  IoVotoNoInfo, 58, 25, 33, no
457889747,  melannas, 13, 6, 7, no
466565978,  Trottola62, 4, 1, 3, no
1578337921,  Silvia_amed, 28, 11, 17, no
557545233,  vsilvestrelli, 6, 2, 4, no
81637419,  lameduck1960, 5, 1, 4, no
794099287894396928,  Salvado52694110, 3, 1, 2, no
176712900,  picture61, 49, 16, 33, no
482306466,  Stele666, 5, 2, 3, no
541147498,  mab29a, 229, 63, 166, no
577936933,  graziamorisi, 44, 20, 24, no
1142502205,  roberto_marsura, 13, 6, 7, no
3129266409,  GiuseppeStalta1, 66, 28, 38, no
1953930264,  maxPatriots, 76, 30, 46, no
601368027,  LeonardoFontan7, 11, 5, 6, no
1048144170,  Iomarcomarzari, 16, 4, 12, no
1050781381,  cosimo1313, 24, 10, 14, no
2182969790,  SerafinoPietro, 16, 7, 9, no
265310236,  L4L5S1, 5, 2, 3, no
2442834988,  selena_sbadili, 32, 13, 19, no
713040261249687553,  eltankerjuve, 3, 1, 2, no
795317869131268096,  LiberoPensator5, 12, 5, 7, no
90593797,  profondo, 5, 1, 4, no
797820581584453632,  PrimulaBianca1, 58, 11, 47, no
1221995204,  nando_saviano, 74, 15, 59, no
398317849,  giamart1975, 7, 3, 4, no
488714232,  Fresh_chi, 6, 2, 4, no
2560083548,  chichoarena, 5, 1, 4, no
481267605,  EnzoLorenziBg, 12, 2, 10, no
3369259859,  Seby_5_, 5, 2, 3, no
2803289796,  3ZEiMhhVVpwECLe, 5, 1, 4, no
2464999802,  Zuzzurellone84, 5, 1, 4, no
343442484,  tuscolo, 54, 19, 35, no
2287024507,  TizianaDAmico1, 17, 4, 13, no
408118133,  ScottoLavina, 24, 5, 19, no
22009685,  ansim999, 10, 2, 8, no
1117558933,  hele_fr, 76, 36, 40, no
787562992728670209,  Royrb3, 6, 2, 4, no
3822891293,  russel1951, 3, 1, 2, no
2390747907,  CattoAngelo, 7, 2, 5, no
800339370129559552,  Giusepp62142292, 14, 4, 10, no
4136518337,  annamariaduca53, 3, 1, 2, no
2929270474,  AdrianoBagna, 16, 7, 9, no
890460000,  LetiziaBalestri, 4, 1, 3, no
616442617,  KikaKahshan, 9, 4, 5, no
424237536,  torrese99, 5, 2, 3, no
719612791087374337,  AlleanzaBz, 11, 2, 9, no
791301361128333313,  dioppo, 13, 6, 7, no
251309387,  govi47, 18, 6, 12, no
326176754,  salvo9284, 3, 1, 2, no
582265897,  AssuntaAccetto1, 31, 14, 17, no
2404494057,  michele_ugge, 54, 26, 28, no
933078536,  SussyEgo, 7, 3, 4, no
787432374237822977,  angyco888, 43, 21, 22, no
327411320,  bncntn71, 4, 1, 3, no
102119771,  andre_lanz, 8, 3, 5, no
739543389721485312,  Eraclito992, 12, 3, 9, no
1715498894,  marcofalconect, 11, 2, 9, no
3852977062,  paoloumberto191, 2, 0, 2, no
473209868,  PieraPadovani, 13, 5, 8, no
1952610200,  conteNitore, 3, 1, 2, no
13680802,  r_formigoni, 5, 1, 4, no
2350743580,  pino_maio, 8, 3, 5, no
4457987716,  milandenzaN2, 8, 3, 5, no
394814291,  ilmauri5, 2, 0, 2, no
2974517662,  JuveClubTweet, 5, 2, 3, no
251235949,  MaraRaqu, 13, 6, 7, no
975251790,  nicoterranova, 3, 1, 2, no
2359496138,  CloudsInClod, 21, 6, 15, no
858003427,  enzoben43, 20, 9, 11, no
55045274,  lucdilo, 7, 3, 4, no
396237618,  Davide_Magno, 11, 3, 8, no
1178411384,  emmenasi, 30, 10, 20, no
4576031421,  riri000197, 5, 2, 3, no
307278565,  Dome689, 197, 14, 183, no
1077269276,  CurrentiCalamo_, 3, 1, 2, no
3673796295,  LArcidiaco, 6, 2, 4, no
761237376601563136,  ComeunT, 55, 2, 53, no
1048802419,  tittina2013, 15, 5, 10, no
717647109114224640,  simone_macchia, 8, 3, 5, no
400209582,  arianoisidori, 10, 2, 8, no
419281902,  DenisGobbi, 3, 1, 2, no
3252061715,  mamia6570, 3, 1, 2, no
156316785,  M_Fedriga, 71, 32, 39, no
768783082736455680,  BeraldoAnnalisa, 421, 208, 213, no
756156933879525376,  LDream08, 25, 8, 17, no
1735223353,  SumAlessandro, 9, 3, 6, no
791407162790649856,  TizianaSandrin3, 7, 3, 4, no
728245393503424513,  lisa_libra_bram, 20, 8, 12, no
3291727493,  tullio_crespi, 11, 3, 8, no
4201687816,  _xabaras_, 5, 1, 4, no
275225571,  Simo_Storti, 13, 6, 7, no
2385918867,  ottobrina71, 16, 4, 12, no
3413676334,  colui71, 4, 1, 3, no
305623772,  anna_mitica, 5, 2, 3, no
495412522,  erreelleci, 14, 4, 10, no
371698564,  CrisGAMBARDELLA, 3, 1, 2, no
173925687,  Abocconetti, 130, 18, 112, no
749151808682164225,  Come___Marco, 3, 1, 2, no
29983104,  silviasemenzin, 9, 2, 7, no
370193812,  FraSottile, 28, 5, 23, no
416348802,  tweettatore, 18, 6, 12, no
18319776,  otyx, 3, 1, 2, no
17063476,  IlTagliando, 4, 1, 3, no
23116138,  ursulapala, 3, 1, 2, no
710385175,  LudovicoCordoni, 17, 5, 12, no
398635221,  Bossartiglio_, 5, 2, 3, no
1013634678,  SolomonClaudio, 3, 1, 2, no
1259291893,  lumirKu, 3, 1, 2, no
312250044,  mlauria93, 6, 2, 4, no
292376362,  AlexBrullo, 3, 1, 2, no
1270647104,  Fra_luch, 3, 1, 2, no
2627878649,  ica_feder, 3, 1, 2, no
4190295975,  RobertoPopeo, 5, 2, 3, no
4891704587,  ap_bcn, 3, 1, 2, no
397122109,  michelecarugi, 9, 4, 5, no
619316778,  francesco60221, 8, 0, 8, no
1200815466,  gattorosarosa, 5, 1, 4, no
4864664511,  eliorenzi1959, 68, 3, 65, no
4860559857,  Zaddl3, 22, 9, 13, no
2900897831,  sevise2, 26, 6, 20, no
320405620,  fabiosommo, 3, 0, 3, no
69743321,  ale_s84, 6, 0, 6, no
734074574275514368,  RedditCittadini, 232, 9, 223, no
383955971,  fabrifour3, 3, 0, 3, no
257223860,  bournetw, 15, 6, 9, no
2588246800,  CanciAbo, 205, 24, 181, no
2193790769,  DaianaColantuo, 4, 1, 3, no
2817371306,  selfie_gleba, 3, 0, 3, no
36493382,  gdiges, 19, 6, 13, no
1562493492,  Franzcolaleo, 11, 5, 6, no
433536879,  ale_quarta, 3, 0, 3, no
558051435,  camilla_O, 3, 0, 3, no
427564624,  LorenzoManfro, 6, 1, 5, no
437807413,  silviasprea, 5, 2, 3, no
815304163,  RiccardoDiofebi, 16, 6, 10, no
157994523,  rita_mameli, 3, 0, 3, no
354284014,  murba63, 29, 9, 20, no
515474269,  DarioViking, 14, 5, 9, no
458146177,  Alf_56reporter, 9, 1, 8, no
176085681,  Cost83, 3, 0, 3, no
805141954329800704,  Toto70451603, 174, 72, 102, no
3258090545,  cam_gioe, 6, 0, 6, no
625051527,  DJ491Official, 3, 0, 3, no
159459884,  ralex1976, 4, 0, 4, no
443708574,  V_Ani6, 21, 2, 19, no
328946204,  632101Viktormh, 11, 1, 10, no
2605945762,  CapuaFranco, 22, 9, 13, no
621761723,  grazianomatera1, 4, 0, 4, no
3352514566,  Simonebocs, 4, 0, 4, no
2809692579,  frt_valentina, 4, 1, 3, no
1974119078,  flowervigna, 9, 3, 6, no
3400668957,  lui_gi85, 3, 0, 3, no
2478580177,  salvatoremero12, 12, 0, 12, no
1317255619,  mirkokrea78, 17, 3, 14, no
2310230647,  henrydurante, 3, 0, 3, no
152671788,  Fexkiller, 4, 0, 4, no
143813004,  adriespo, 10, 1, 9, no
253542906,  gaboferraris, 4, 1, 3, no
2178758289,  galimberti61, 29, 11, 18, no
331525693,  ANDREACECCHINI1, 5, 0, 5, no
290597561,  ManuArrigons, 5, 0, 5, no
3048846859,  pasquino_spqr, 31, 2, 29, no
2654085878,  vince_cassano, 5, 0, 5, no
777565323344113664,  PdSudSanSevero, 30, 1, 29, no
3140978387,  esse_giovac, 3, 0, 3, no
3361200257,  Vitali_FV, 13, 0, 13, no
888296226,  RiccoLuciano, 20, 8, 12, no
722931043578310656,  vita_felicetto, 16, 4, 12, no
1331128747,  Sandra_AbbDR, 20, 8, 12, no
3386078415,  maurizio_lecci, 6, 1, 5, no
800698016768233472,  laura_marghe, 60, 22, 38, no
2652929369,  ciocco09, 8, 1, 7, no
799963787059167232,  Divina59297343, 9, 3, 6, no
801532114139250688,  anto_terr_1947, 42, 15, 27, no
188029214,  davjang, 24, 8, 16, no
385014976,  missNormaJane, 6, 1, 5, no
353160476,  RobertoRenga, 8, 3, 5, no
24252705,  aural85, 31, 8, 23, no
51271311,  RiflessoDiLuna, 19, 7, 12, no
2482396225,  nonnino37, 13, 2, 11, no
2153829339,  anna_mattarelli, 31, 7, 24, no
111933671,  cosimo73, 30, 13, 17, no
872443554,  giusedellosso, 6, 1, 5, no
417279241,  VasileAntonio, 17, 6, 11, no
41548247,  arcangelolamola, 8, 3, 5, no
411010417,  AGazaneo, 5, 1, 4, no
276697615,  supermariobrooo, 11, 4, 7, no
2270694999,  CarlaSicuro1, 3, 1, 2, no
133998087,  sdegnata, 11, 3, 8, no
2448108305,  martino311280, 4, 1, 3, no
1228391671,  pierpu6767, 69, 8, 61, no
543591886,  Matteo_LT, 3, 1, 2, no
819829657,  gisellaruccia, 20, 9, 11, no
600415712,  stefanofumarulo, 7, 1, 6, no
1012943576,  MazzoneSabino, 5, 1, 4, no
119001227,  RinaldoMelucci, 9, 4, 5, no
799185635999412224,  N8lino, 4, 1, 3, no
4273349056,  RitaMaio1, 16, 4, 12, no
47963163,  inchiostroverde, 10, 3, 7, no
2350131678,  marce4733007, 5, 1, 4, no
452831702,  laurettasivo, 11, 2, 9, no
2353082360,  MicBorrillo, 6, 2, 4, no
433192298,  GrecoGio, 7, 1, 6, no
2245661774,  mongi1965, 5, 2, 3, no
138799201,  onirepap, 5, 1, 4, no
1230010460,  ZPaolino, 3, 1, 2, no
1329985766,  adele_marinelli, 6, 2, 4, no
558591392,  QuagliarielloG, 14, 2, 12, no
3364660727,  gianturco4, 19, 6, 13, no
2995826032,  giocasmirri, 11, 2, 9, no
27833981,  giantrom, 6, 1, 5, no
28700620,  AlexilSecco, 3, 1, 2, no
2157630750,  stefelici, 5, 2, 3, no
2949242037,  Ludimar54Luigi, 7, 2, 5, no
3239016405,  claudio301065, 61, 23, 38, no
1557514573,  elio_vito, 10, 1, 9, no
85793150,  Paolo_Improta, 9, 4, 5, no
50584579,  beabri, 57, 3, 54, no
3294561682,  ferronibalbante, 3, 1, 2, no
514604251,  romani_m, 4, 1, 3, no
437533038,  francofontana43, 30, 6, 24, no
722086969094905864,  BenjaminW1892, 17, 1, 16, no
140358976,  francescobat, 8, 2, 6, no
380551414,  patrizietto75, 5, 1, 4, no
1331730614,  appnau, 9, 1, 8, no
2229049953,  eticasolitaria, 11, 1, 10, no
625000187,  schnitzlerrr, 33, 12, 21, no
77554140,  crialicata, 36, 14, 22, no
3049910135,  corallo_gianni, 5, 2, 3, no
68239562,  EdoardoMazzella, 9, 1, 8, no
1537342195,  valmatteucci, 5, 1, 4, no
85117452,  aniramiznat, 9, 3, 6, no
837804025,  emanuelevilla74, 29, 7, 22, no
2987520981,  berchieale, 7, 2, 5, no
3003254493,  carmen_distaso, 36, 16, 20, no
493524331,  clapaudice, 5, 1, 4, no
1361794033,  BiogalFa, 24, 9, 15, no
2404185052,  StruzzoSapiens, 6, 2, 4, no
2261701074,  Rizzolo1955, 23, 10, 13, no
2336448263,  avv_merighi, 3, 0, 3, no
471987010,  gpacenti, 17, 1, 16, no
706841262679310336,  BenitoMimmo, 5, 1, 4, no
519379680,  sandromerg, 21, 7, 14, no
383790840,  danielamazza2, 16, 6, 10, no
2233203519,  marrocco52, 23, 7, 16, no
726721856749842436,  gabrillasarti2, 41, 16, 25, no
803524673032114180,  MARCELL04259284, 3, 0, 3, no
345462468,  pierviparisi, 3, 0, 3, no
796428219301953546,  bobbore1960, 3, 0, 3, no
789025525322899456,  TrollHunterXL, 28, 1, 27, no
722572543610195968,  valentinachioc, 3, 1, 2, no
3127521489,  FantinoLuciana, 3, 0, 3, no
1733164921,  AgostinoDAndrea, 2, 0, 2, no
83071101,  gipiredo, 8, 1, 7, no
991727834,  giularegina, 32, 4, 28, no
209975198,  xPrenotare, 3, 1, 2, no
705303424951324672,  emiliobrizio, 4, 0, 4, no
760729745948565504,  TizianaDemma, 16, 0, 16, no
723538940502913024,  FdiAnUdine, 8, 3, 5, no
988229000,  MarcoGalbiati3, 4, 0, 4, no
392962936,  AngeloPrinci, 13, 0, 13, no
447893897,  BrigatiNicolas, 3, 1, 2, no
3317075583,  marcorigo82, 3, 1, 2, no
4452408435,  Valeriaflagiel1, 4, 1, 3, no
2319748337,  ForzaSilvioTW, 28, 2, 26, no
243216805,  FAltitonante, 2, 0, 2, no
1577808642,  GruppoFI_Lomb, 5, 0, 5, no
1183179234,  vincirinaldi, 139, 50, 89, no
784666406508003328,  raimondo8858, 10, 1, 9, no
418717321,  Marcodv76, 4, 1, 3, no
136566683,  rinodid, 3, 1, 2, no
2243630040,  StePeschiaroli, 33, 1, 32, no
55678400,  ReferendumExit, 11, 4, 7, no
889582477,  masi_marcri, 8, 1, 7, no
4318424669,  SorrentinoAnt10, 28, 10, 18, no
52011737,  fserneri, 11, 4, 7, no
1295447916,  Verkhojansk, 17, 3, 14, no
2452296161,  franzin53, 17, 5, 12, no
2891879969,  marcodilecce, 10, 4, 6, no
2394791163,  hawking1963, 3, 1, 2, no
594882199,  mauraelzi, 14, 6, 8, no
270951173,  vitaliadf, 36, 10, 26, no
2504756914,  listabiaso, 7, 2, 5, no
1037931534,  laur_bellezza, 3, 1, 2, no
433395124,  AntonioRubino6, 6, 2, 4, no
791345703679324160,  Silvano77208402, 4, 1, 3, no
2792329485,  PalaPala01, 3, 1, 2, no
1444752530,  lecorbuciccio, 11, 5, 6, no
1324304905,  GiovaPastor98, 9, 2, 7, no
3082802711,  francescasp89, 90, 5, 85, no
128311146,  piemarcy, 11, 4, 7, no
1360232480,  FmMosca, 11, 4, 7, no
754593317313216512,  radio_torino, 5, 1, 4, no
302720976,  LapoBeldonato, 21, 5, 16, no
1404322896,  rinaldi_rin, 11, 4, 7, no
61751856,  frenkilsolito, 83, 29, 54, no
2941026292,  mr725905, 6, 2, 4, no
2561421959,  stefatien, 13, 6, 7, no
2361146452,  Fiocchetto23, 12, 2, 10, no
803371786993893376,  LeoWolf1992, 47, 14, 33, no
986382066,  SelviStefano, 37, 14, 23, no
563773403,  itbread, 23, 8, 15, no
2361146452,  pollettofarf, 28, 4, 24, no
414719178,  albertosofia, 3, 1, 2, no
594106386,  AnielloNapolita, 3, 1, 2, no
615033595,  ConfortoC, 20, 1, 19, no
410910327,  zikiluna, 54, 2, 52, no
19643514,  paivetto, 35, 2, 33, no
911094367,  annamariabaldo1, 59, 0, 59, no
527516661,  GDezuani, 32, 8, 24, no
64522965,  SaffronHorizon, 11, 1, 10, no
1642789244,  CarmeloMontana2, 44, 9, 35, no
38042921,  SimoneRaul, 3, 1, 2, no
2329940551,  TizianaMaurizi, 11, 1, 10, no
3445916417,  Casear_Iulius, 16, 1, 15, no
431089246,  santilligia, 7, 2, 5, no
52149689,  TRotesi, 3, 1, 2, no
706841301,  ItAndreaScurti, 12, 2, 10, no
390641455,  Narutaru86, 16, 6, 10, no
3136144581,  Starwatcher00, 11, 3, 8, no
289839081,  lusami74, 5, 1, 4, no
214823847,  ienzus, 6, 1, 5, no
138418305,  poetam78, 8, 1, 7, no
252604372,  AngCappellina, 10, 2, 8, no
240753714,  ConteAgostino, 7, 1, 6, no
614540697,  GiuseppeFilieri, 7, 1, 6, no
145978802,  la_kinetica, 4, 1, 3, no
1086972710,  robyschen, 11, 2, 9, no
2560295545,  IRIC10, 6, 2, 4, no
783330667258142721,  Bellinieugenio1, 28, 11, 17, no
1890326197,  PicchixFirenze, 75, 15, 60, no
469502626,  ManzoniDavide, 7, 1, 6, no
2594466834,  damany81, 3, 1, 2, no
273051883,  Donburo, 9, 4, 5, no
1519870862,  AntPietrogrande, 3, 1, 2, no
71530179,  Achab94, 4, 1, 3, no
13631242,  balessa, 33, 6, 27, no
500191390,  SalGuttieri, 4, 1, 3, no
435760551,  GabrieleZahami, 6, 1, 5, no
426598982,  NicolaViti, 3, 1, 2, no
2691410693,  FdianF, 7, 1, 6, no
2301561164,  beppezini, 5, 1, 4, no
66997607,  mrjones1981, 6, 2, 4, no
1067868320,  68Cliffs, 3, 1, 2, no
82065633,  9cento, 14, 3, 11, no
2241594340,  mludodc, 9, 2, 7, no
3631947141,  luconeb81, 41, 17, 24, no
51539940,  guidobesana, 4, 1, 3, no
3147416317,  JukicEffe, 3, 1, 2, no
33228802,  BeatriceFeudale, 3, 1, 2, no
2425305955,  Skassankazzahia, 5, 2, 3, no
1183794373,  Kia_InSpace, 3, 1, 2, no
2227588349,  BaldCezar, 5, 1, 4, no
473220410,  Cri_Giordano, 5, 2, 3, no
421040395,  Naso29, 4, 1, 3, no
438660521,  valeria_e_ben, 3, 1, 2, no
143377146,  EugenioMadda, 6, 2, 4, no
945729890,  MarcoCerreto, 4, 1, 3, no
849582750,  FedericaTordi, 5, 2, 3, no
463834585,  MANUELALUZI1, 5, 2, 3, no
803242837,  Lollo_Vio, 3, 1, 2, no
89412025,  JovaGraziano, 8, 2, 6, no
2358475547,  _John80, 13, 3, 10, no
237608753,  rosso72, 15, 6, 9, no
122088248,  sannita90, 3, 1, 2, no
507792558,  natasu5stelle, 70, 4, 66, no
2927289074,  TrunfioDomenico, 7, 2, 5, no
778753237721706496,  giudiiiiiiiiii, 69, 10, 59, no
388299949,  bars_barbara, 15, 5, 10, no
2328471661,  weevil_forbix, 48, 9, 39, no
376871430,  Enzo_Pappalardo, 21, 7, 14, no
45140845,  enricovulpiani, 13, 6, 7, no
2347131464,  Iacobelli1987, 6, 1, 5, no
1474185410,  SupposteRette, 84, 5, 79, no
1201274174,  pieronederland7, 15, 5, 10, no
2369467775,  CarmeloPozzo, 8, 3, 5, no
315140856,  56carlo, 10, 3, 7, no
216630942,  leomauro73, 5, 2, 3, no
170296809,  Caymano1987, 5, 2, 3, no
4264651871,  Candid_S_Voce, 9, 4, 5, no
114695244,  Marcomixs, 5, 2, 3, no
317144718,  Ezioledo, 5, 2, 3, no
3300735423,  gnaafamos, 18, 8, 10, no
334337968,  MonicaCirinna, 15, 6, 9, no
1251089251,  salidaparallela, 14, 0, 14, no
804670047117574144,  clurbanpeople, 7, 3, 4, no
16112979,  AndreaDiMaio, 14, 1, 13, no
557057167,  sloquik, 8, 0, 8, no
2342009888,  mose_sorbo, 4, 0, 4, no
518366373,  la_miranet, 4, 0, 4, no
3298864072,  SSegnala, 15, 1, 14, no
710609693,  100Clacco, 15, 3, 12, no
883001814,  fidelioit, 9, 1, 8, no
434870760,  pitta1958, 7, 2, 5, no
901555177,  signorinigc, 14, 1, 13, no
424540306,  PSchirripa, 11, 0, 11, no
2164822594,  steanti19, 5, 0, 5, no
753856766639824896,  Vincetwittfos, 54, 16, 38, no
431500211,  angytnt, 12, 3, 9, no
871132850,  sanaricapaola, 5, 0, 5, no
1298737056,  SilviaDV73, 45, 0, 45, no
1219888831,  FedericoGer, 9, 3, 6, no
424997954,  MaryPetrillo1, 13, 4, 9, no
401947052,  PinoMartino03, 10, 4, 6, no
742397759991480320,  manu_etoile, 106, 51, 55, no
114179008,  Savo27, 15, 7, 8, no
3400696882,  Vero82G, 51, 24, 27, no
585988043,  rfigliola, 9, 3, 6, no
766589504694214664,  Simo10689923, 11, 2, 9, no
1021541239,  tommybonaveri, 66, 0, 66, no
989841337,  NICOLAfromROMA, 10, 0, 10, no
1051114320,  APeppinodit, 47, 2, 45, no
790567158489153536,  piras2017, 31, 0, 31, no
2822583095,  Hammurabhi, 38, 8, 30, no
590037686,  fanellis66, 21, 0, 21, no
2322734663,  gamin1978, 14, 5, 9, no
465960856,  CEustacchi, 9, 1, 8, no
2815530124,  lostupidiario, 11, 4, 7, no
4891656874,  PinoCostanzo1, 4, 0, 4, no
460322510,  bassi_riccardo, 2, 0, 2, no
1245505458,  SammyVarin, 27, 12, 15, no
1621071816,  ellamari53, 52, 22, 30, no
557943026,  cristina_gioia, 7, 2, 5, no
2354395787,  frau101_f, 45, 19, 26, no
4775882567,  lamentedmente, 72, 2, 70, no
101762540,  winetaste01, 3, 1, 2, no
280401262,  mimmo_rinaldi, 29, 6, 23, no
1344495229,  ildullo, 3, 1, 2, no
131800710,  MassFr, 4, 1, 3, no
425730108,  h2oroberto, 16, 7, 9, no
2382128702,  Daniela_Emme27, 33, 14, 19, no
4909156781,  pierguidob, 14, 3, 11, no
439258358,  Cipdimanu, 4, 0, 4, no
376610294,  IsabellaRauti, 6, 1, 5, no
1151076073,  ClaudioMonta64, 6, 2, 4, no
465471132,  danielabugatti, 49, 24, 25, no
2459996144,  M5S_Baroni, 12, 0, 12, no
4451671336,  skaytg24, 5, 1, 4, no
538138673,  DoctorMaurinho, 14, 3, 11, no
968509314,  V_Mazzotta, 5, 0, 5, no
349555564,  davidegastaldo, 9, 2, 7, no
1076537990,  sanvi_pao, 5, 0, 5, no
3026297093,  venanzi60, 12, 0, 12, no
265278924,  VigilJosef, 34, 1, 33, no
3478668807,  claudiavalli85, 3, 0, 3, no
708276706,  DadoneFabiana, 6, 0, 6, no
1327481593,  marcellamaglion, 21, 0, 21, no
428261286,  ChiaraGiacosa, 21, 0, 21, no
163879703,  Piemonte5stelle, 25, 0, 25, no
3306971873,  GallonSr, 9, 0, 9, no
120178254,  vitaste, 2, 0, 2, no
621269962,  AlbertoMacciani, 3, 1, 2, no
3329627571,  UglPenitenziari, 5, 1, 4, no
397402165,  AntonioSilves11, 6, 2, 4, no
932376896,  StefanoCetica, 125, 4, 121, no
1324201430,  uglaf, 55, 2, 53, no
1071492246,  Catone2013, 53, 3, 50, no
1327082838,  6ReTwitt, 22, 3, 19, no
2282354028,  WH_Beveridge, 35, 3, 32, no
2801772720,  Tanaquilla2, 15, 3, 12, no
113075421,  renatapolverini, 245, 4, 241, no
2160789500,  LIP_Rassegna, 43, 3, 40, no
1303711453,  1ConteOliver, 95, 4, 91, no
417342231,  fraba1, 3, 1, 2, no
1369768926,  celeste80686607, 9, 2, 7, no
454088602,  AmatrudaG, 28, 4, 24, no
185131593,  EzioFabiani, 8, 2, 6, no
2835121973,  Antincivili, 16, 1, 15, no
2433727925,  aidadafne, 20, 8, 12, no
2567298888,  lucamanetta1, 3, 1, 2, no
2397594482,  lucilla908, 17, 2, 15, no
1242301080,  francescoxconti, 3, 1, 2, no
2211479198,  elvcastellaneta, 8, 2, 6, no
272112410,  giovicon, 5, 2, 3, no
2778061603,  spinassunta, 37, 17, 20, no
462701585,  sydbarrett76, 11, 3, 8, no
1637660911,  thedreamer1707, 5, 2, 3, no
481321999,  MaurizioDiGiuse, 12, 5, 7, no
131262995,  dieguito82, 21, 10, 11, no
927916422,  lilasart, 25, 5, 20, no
334238732,  AngeloNicotra, 6, 1, 5, no
1050997706,  EspositoIvana, 10, 4, 6, no
488484539,  bicisnob, 6, 1, 5, no
1113395882,  Belen31192, 5, 2, 3, no
1337654743,  FrancoFalbo1, 6, 1, 5, no
33521233,  michelataxistro, 82, 2, 80, no
271879647,  MarcoCapoccetti, 9, 4, 5, no
3922344275,  mecca_salvatore, 25, 3, 22, no
9584192,  AlfonsoFuggetta, 19, 6, 13, no
744961229853167616,  gianpaolo72, 15, 7, 8, no
516453272,  Iaya68, 5, 1, 4, no
46635793,  bluvi0lin, 7, 3, 4, no
304681933,  notav_info, 7, 1, 6, no
298532531,  RANRoberto, 12, 4, 8, no
1473356281,  Dany_morritz, 6, 2, 4, no
1745966046,  luigidelucia218, 20, 2, 18, no
741293293930188800,  Alba02426651, 4, 1, 3, no
3054272141,  Aupo58, 3, 1, 2, no
1190111017,  RoccoFernandoSe, 7, 3, 4, no
389477469,  capitano1971, 15, 7, 8, no
2305058365,  laurapetrarca2, 4, 1, 3, no
2542889860,  marinocasoni, 5, 2, 3, no
519731238,  rizza_francesco, 10, 1, 9, no
35721171,  aldotorchiaro, 7, 3, 4, no
418790167,  Ricky_Rock81, 8, 3, 5, no
545051848,  RobertoZetti, 4, 1, 3, no
1288209314,  M5SpiuL, 20, 8, 12, no
947943943,  SamanthaBizzoni, 2, 0, 2, no
2851228124,  79b83962c72d42b, 13, 4, 9, no
604888657,  nicola_corrado, 2, 0, 2, no
790705219688693760,  Lab5Valenzano, 2, 0, 2, no
2216248313,  Statler_the_old, 4, 1, 3, no
696595370395172864,  PoliticaPerJedi, 6, 2, 4, no
593556512,  BertolliniR, 2, 0, 2, no
3189500505,  morelon9, 9, 2, 7, no
384225937,  carminebruno92, 4, 0, 4, no
125321939,  Bagos1984, 6, 1, 5, no
9334812,  notEricC, 2, 0, 2, no
374087921,  calpurniobestia, 5, 1, 4, no
967698096,  luiser133, 18, 1, 17, no
485039963,  demagistris_ant, 8, 0, 8, no
2919241120,  LDalfollo, 54, 1, 53, no
4893370455,  lupachiotto3, 49, 2, 47, no
440991666,  unodeibassi, 63, 2, 61, no
362093487,  ninotheworse, 24, 5, 19, no
292203548,  nopasaran846, 6, 1, 5, no
3985072012,  WMenicacci, 28, 11, 17, no
801710252827807745,  paolatirab64, 16, 1, 15, no
1066657957,  fortunatosommel, 11, 3, 8, no
753558289,  tonymeola, 5, 2, 3, no
796490271630434304,  mcDonaldTrump6, 8, 3, 5, no
1201970520,  grillonardo, 6, 2, 4, no
4189019849,  giogio_al_cubo, 11, 5, 6, no
2347311747,  BernardiniAr, 7, 3, 4, no
794903125,  MicheleSepe96, 10, 3, 7, no
1278185288,  GonniePolman, 8, 3, 5, no
2188803397,  laredazzi, 25, 2, 23, no
492319960,  StefanoMontuori, 11, 5, 6, no
371160962,  MauroGrandi78, 6, 2, 4, no
2754433686,  simplyUmberto, 6, 2, 4, no
1308491004,  Ciopfrem, 8, 3, 5, no
575833305,  LanfrancoPalazz, 10, 3, 7, no
769128592299134977,  NovaVetera, 30, 11, 19, no
3312303309,  frarorarf, 72, 2, 70, no
564148431,  camaleontimisti, 160, 4, 156, no
98212000,  jimimurani, 7, 3, 4, no
742259446764711936,  marandando77, 7, 2, 5, no
700690132769370112,  landrea92, 12, 2, 10, no
714775585088737280,  heredelilah, 10, 2, 8, no
2244030673,  frances_za, 6, 1, 5, no
2542387598,  DanesiSimonetta, 13, 3, 10, no
14108472,  civati, 101, 5, 96, no
1510231602,  delucaGen88, 2, 0, 2, no
360868017,  PaoloBersani, 68, 20, 48, no
409540134,  rossa008, 19, 8, 11, no
724633716396580864,  EmaMig67, 5, 1, 4, no
702904109070946304,  normalatosca, 3, 1, 2, no
1062548953,  bettegasewin, 7, 1, 6, no
168976687,  thequeenthree, 18, 8, 10, no
137997259,  mvdvdl, 3, 1, 2, no
2401418695,  francodg60, 52, 22, 30, no
797138085725278209,  realGiorgioBrux, 82, 33, 49, no
706570580,  OresteBortoluz, 33, 10, 23, no
2365653284,  giulia_molinaro, 15, 4, 11, no
529317309,  cipriani1945, 8, 2, 6, no
786865600115204096,  c_mauz, 21, 9, 12, no
1272915272,  GZanfanti, 4, 1, 3, no
236565724,  GiuliaGrilloM5S, 31, 0, 31, no
472185426,  RiccardoRogani, 30, 1, 29, no
949926276,  niforcheri, 2, 0, 2, no
919333159,  TimoRonk, 13, 2, 11, no
1330005582,  ArfioClandestin, 8, 2, 6, no
2891197923,  davidelgaudio, 61, 18, 43, no
697090269859213312,  Io__boh, 15, 4, 11, no
473274676,  mpace_pace, 3, 1, 2, no
1467171296,  Essere_Orietta, 3, 1, 2, no
786101538334932994,  SteRocca, 4, 1, 3, no
482938015,  artemisiagl, 4, 1, 3, no
614966455,  SimoneYue, 3, 1, 2, no
221853726,  GDMedici, 6, 2, 4, no
195063290,  OlivieriNicola, 11, 3, 8, no
53349887,  Ultrauseless, 4, 1, 3, no
3137217530,  LaGinuzza, 5, 2, 3, no
2719566132,  FlyingAndrew91, 10, 2, 8, no
178453735,  ohanastrana, 9, 3, 6, no
225484216,  DavideBerry, 3, 1, 2, no
2286669109,  GMeledandri, 10, 3, 7, no
1395477444,  JustinScandal, 5, 2, 3, no
500012385,  stefaniaaversa, 3, 1, 2, no
930476808,  SandorTence, 4, 1, 3, no
437044935,  francisforkekko, 5, 1, 4, no
3377204649,  valentinasheena, 3, 1, 2, no
259047162,  egoasavakit, 7, 3, 4, no
889062380,  Maria_Paulucci, 7, 2, 5, no
1068846679,  jkfgds, 13, 3, 10, no
4873807691,  tirasianicris, 32, 6, 26, no
2526923119,  ErneCremonesi, 5, 2, 3, no
298248825,  NatDeGregorio, 14, 3, 11, no
2800037465,  frances18310233, 5, 1, 4, no
36353564,  carlogubi, 30, 9, 21, no
781821141858091008,  BartoloGiusti, 19, 7, 12, no
757902800256917504,  AntoninoTolu, 3, 0, 3, no
3347451616,  consudsiriparte, 2, 0, 2, no
209007993,  PdSUD, 70, 2, 68, no
591663175,  leonanvehia, 7, 0, 7, no
478647183,  NataleCuccurese, 60, 0, 60, no
184015853,  schumyno, 41, 11, 30, no
82910300,  battiatino, 5, 2, 3, no
52362602,  lucastamati, 10, 2, 8, no
721338196639014912,  ALBERTOSEVERIN7, 219, 68, 151, no
1726027441,  AlexSoze, 8, 1, 7, no
798850577547464705,  FanoPossibile, 11, 1, 10, no
3390886840,  ViareggioPossi1, 18, 6, 12, no
23054148,  goldielocks75, 14, 4, 10, no
491142862,  laureali, 9, 4, 5, no
556270195,  sfnnicita, 4, 1, 3, no
776082811849695232,  ffortuzzi, 12, 5, 7, no
418662548,  CarloF0554ti, 50, 20, 30, no
714736755816185856,  AdelinaMatteo, 20, 3, 17, no
4893362397,  calzelunghe17, 11, 4, 7, no
1387006716,  emacurro, 58, 18, 40, no
712035142508945408,  Platone9402, 9, 2, 7, no
532132256,  apradi69, 9, 2, 7, no
1046168034,  MinutiV, 13, 3, 10, no
356997587,  swamilee, 3, 1, 2, no
20910977,  lucasofri, 5, 2, 3, no
47698840,  flaneurotic, 18, 7, 11, no
84887445,  daniale64, 6, 2, 4, no
434387464,  emiliofederico1, 25, 4, 21, no
223881169,  LEBBY4EVER, 81, 28, 53, no
4284146182,  nothingtoatone, 23, 6, 17, no
322540485,  JanfaJanf, 25, 1, 24, no
1291390106,  Canatecza, 3, 1, 2, no
15155803,  vpistorio, 13, 6, 7, no
240401072,  giovanpetr, 15, 2, 13, no
299535779,  paolaerra, 7, 2, 5, no
765416956921057280,  trivince49, 3, 1, 2, no
416386667,  __Behemoth, 5, 1, 4, no
1225148376,  AbbateCaterina, 3, 1, 2, no
2270460548,  Grosiglioni, 3, 1, 2, no
242071863,  saderjm, 217, 19, 198, no
4228521213,  Alorsondance89, 3, 1, 2, no
1732490672,  alfplata1, 10, 3, 7, no
713744729981263872,  RitaDarrisso, 6, 1, 5, no
297599017,  lomargef, 26, 8, 18, no
2330870210,  jazzmusic52, 5, 2, 3, no
1095383269,  ilaborletti, 16, 6, 10, no
944659129,  leolapus, 18, 8, 10, no
541142373,  LasTomino, 11, 1, 10, no
459446024,  MGBasolu, 58, 26, 32, no
72009402,  squeeze9, 3, 1, 2, no
1914930552,  mcdigiacco, 7, 0, 7, no
863518554,  GiancarloIannel, 5, 1, 4, no
777828215922581504,  scelgono, 7, 1, 6, no
134724104,  vic_purtusiello, 9, 3, 6, no
2359063466,  EnzoDiSalvatore, 8, 1, 7, no
763718509805305856,  FateOfLight, 11, 0, 11, no
2211388062,  CrassusDT, 26, 2, 24, no
3065958947,  sessa_mrossella, 28, 0, 28, no
3351913779,  nicola_picardi, 5, 2, 3, no
803174269744254976,  AtacInforma, 3, 1, 2, no
738311035,  Odisseo111, 12, 1, 11, no
430622753,  ANGELACHIDDEMI, 3, 1, 2, no
104841172,  vitolongo1979, 3, 1, 2, no
151572582,  ldentama, 14, 1, 13, no
442808538,  donpas52, 10, 4, 6, no
2770811619,  marasco_l, 3, 1, 2, no
796033040443129860,  goemilianogo, 94, 5, 89, no
494245231,  KiraGtx7, 10, 2, 8, no
3087139251,  19TIZIANO72, 12, 5, 7, no
1960098824,  a_ilacqua, 18, 4, 14, no
418511087,  RaffaeleRutigli, 3, 1, 2, no
2416323679,  VisionRivoluzio, 10, 1, 9, no
131494824,  patrikkka, 16, 7, 9, no
275805969,  GvRutigliano, 4, 1, 3, no
2909929737,  acqu_marina, 63, 8, 55, no
2229203829,  vincenzo_r, 5, 1, 4, no
1258895678,  PasqualeIzzo7, 4, 1, 3, no
427326829,  andtundo, 7, 2, 5, no
376173255,  RiccardoParzial, 5, 1, 4, no
476627549,  TommasoRicci1, 11, 4, 7, no
1269842413,  LauaraM5S, 9, 2, 7, no
2479381757,  suffragio1, 3, 1, 2, no
429496671,  Bero_perrone, 5, 1, 4, no
435279526,  MariaTeresaMor9, 5, 2, 3, no
4636768817,  candura_alice, 3, 1, 2, no
3977951957,  julesbeton, 18, 7, 11, no
1311732848,  HAchmueller, 68, 31, 37, no
59165953,  attila62, 15, 4, 11, no
964719079,  cardella42, 29, 13, 16, no
4039903701,  lucamilello, 25, 9, 16, no
513492134,  RiccoMichele, 9, 1, 8, no
796809654093410305,  Klara112233, 11, 5, 6, no
1058237736,  mariocan4, 12, 1, 11, no
533019074,  ManuPerra56, 15, 5, 10, no
528584272,  MisunNesun, 9, 3, 6, no
1269539851,  Massimi50942418, 27, 5, 22, no
2729953324,  giannamerola, 9, 4, 5, no
2662325954,  ludemilio, 3, 1, 2, no
2657542286,  MieiTweets, 10, 2, 8, no
1262703662,  SalvoLabate, 3, 1, 2, no
3339671398,  MargarethaZel23, 3, 1, 2, no
1499347417,  LaGentenon, 4, 1, 3, no
459219907,  tittidsimone, 31, 2, 29, no
1498709755,  AndreaSchin, 13, 4, 9, no
2478946331,  Walter4cs, 21, 4, 17, no
777543896519892992,  Daniel_S1979, 6, 1, 5, no
872297844,  GaetanoBruno3, 11, 0, 11, no
1456904898,  nonnamariola, 10, 2, 8, no
479450086,  MMitarotonda, 6, 1, 5, no
426206234,  robertinofuffol, 6, 2, 4, no
2540926930,  giovanisinistra, 9, 4, 5, no
946288772,  puorro1970, 16, 2, 14, no
366180331,  miciobigio, 10, 3, 7, no
328335015,  JacqTw, 7, 3, 4, no
2843887516,  zatta_mario, 15, 6, 9, no
77863297,  UL_Ui9__jiiiE, 11, 3, 8, no
801348354760474624,  MarcoPardini10, 16, 6, 10, no
2260822969,  sonnyscrivano, 19, 6, 13, no
781954997806370822,  lauratrema37, 63, 11, 52, no
801876745976770560,  Massimo07092269, 6, 0, 6, no
964093010,  CCantam, 4, 0, 4, no
462882815,  benedettidanilo, 11, 0, 11, no
1462583917,  giannisanna65, 8, 3, 5, no
420923031,  marfio47, 6, 0, 6, no
553445128,  massimodambros4, 8, 0, 8, no
786276460080209920,  DMALAGIGI2, 58, 11, 47, no
413935857,  kkxall, 13, 3, 10, no
772151913567625216,  GloriaMarulan11, 7, 3, 4, no
2942061736,  FrancoOmoore, 10, 3, 7, no
2984198033,  silviadimarco70, 266, 8, 258, no
537554676,  GiuManc, 17, 1, 16, no
1011327860,  GTriglione, 8, 2, 6, no
766644219930873860,  pistolesi_laura, 148, 47, 101, no
3395020235,  ignaziodeltrap1, 48, 9, 39, no
4143635368,  MirkoJerod, 10, 4, 6, no
48142731,  profumodimosto, 3, 1, 2, no
1213692008,  patrinavacchi, 29, 7, 22, no
3322620622,  scluzza, 216, 101, 115, no
436557042,  LiviaVentimigli, 7, 3, 4, no
740562673566396416,  MariaVenera4, 15, 1, 14, no
420464238,  alex752828, 18, 8, 10, no
4170027736,  fartaco, 8, 3, 5, no
188521082,  francescorussot, 27, 6, 21, no
432937614,  luigimariano66, 5, 2, 3, no
2817204236,  Valentina89x1, 24, 11, 13, no
3019867043,  antoniolosc, 5, 0, 5, no
2226249739,  riorosso2001, 3, 1, 2, no
164592843,  IvanAustraliano, 2, 0, 2, no
532157140,  Cede66De, 3, 0, 3, no
868595989,  reteCgil, 3, 0, 3, no
2288626020,  iLoveFiom, 2, 0, 2, no
2179948113,  Pierfanze208, 10, 2, 8, no
542094808,  WSchiavella, 4, 0, 4, no
1278347502,  pepdecr, 2, 0, 2, no
358677461,  XIIIr3d, 2, 0, 2, no
225453862,  v_pugliese, 3, 0, 3, no
331005596,  robersperanza, 5, 0, 5, no
804304134,  CGILModena, 9, 2, 7, no
490232626,  pattygrasso, 12, 1, 11, no
326152237,  mebufalino, 6, 2, 4, no
315102536,  StefanBernstein, 10, 4, 6, no
384437545,  Lapocao, 5, 2, 3, no
398570282,  Maax70, 19, 7, 12, no
702690830,  Beatrix_aka_BM, 17, 8, 9, no
376869096,  alelagattarossa, 7, 3, 4, no
2822217403,  ilsartino, 26, 2, 24, no
2888678625,  Diavoletto699, 24, 3, 21, no
1076707988,  Lucien_Mick, 11, 3, 8, no
381518652,  MarcellaCarlisi, 7, 1, 6, no
187196983,  _una_tragedia, 8, 1, 7, no
1008382820,  16blu, 24, 5, 19, no
97938993,  papariello, 5, 1, 4, no
2768667015,  PTinchi, 18, 4, 14, no
777222642961092609,  Patrizi81343276, 5, 1, 4, no
351541451,  gerardo_naddeo, 5, 2, 3, no
56336773,  iBaggino, 5, 2, 3, no
2774578942,  zorat67, 32, 5, 27, no
3296497990,  luidamato, 35, 11, 24, no
2494175436,  ALE70495242, 9, 2, 7, no
254242037,  cavadavi, 13, 4, 9, no
421723841,  GiulioGasparini, 36, 15, 21, no
272941891,  mastrociclista, 36, 15, 21, no
462414072,  Elisa_BV, 20, 1, 19, no
989695621,  nonvotorenzi, 15, 4, 11, no
1241565397,  niccneime, 18, 1, 17, no
768133193291722752,  Vallancufo, 14, 5, 9, no
465921722,  ZanellaRina, 19, 6, 13, no
707348966241865728,  pippoct1, 9, 3, 6, no
3310593215,  gerria63, 4, 1, 3, no
881165648,  aliotta_katia, 12, 5, 7, no
843573301,  giorgiopaoloni1, 12, 2, 10, no
3543518537,  ercivettone1, 22, 4, 18, no
3926735649,  SandroPop1, 17, 3, 14, no
49044510,  gdivona, 7, 3, 4, no
742634833541750784,  Mariagr36436003, 8, 1, 7, no
2342101993,  Apollo_MX5, 34, 16, 18, no
435825241,  geomiglio, 5, 1, 4, no
2376644398,  cozzoli_poli, 14, 3, 11, no
318379212,  tiziana_moro, 6, 1, 5, no
411530100,  armandoluongo10, 8, 3, 5, no
2347482439,  _tommyemme_, 9, 3, 6, no
634434387,  borlacch, 53, 2, 51, no
1429964996,  Lucky61mass, 5, 2, 3, no
504658270,  margheritamart4, 46, 12, 34, no
754738926083010560,  AnagniAtama, 24, 3, 21, no
1870641289,  robertocorti4, 26, 9, 17, no
2518901866,  gianni_azzali, 54, 15, 39, no
329734973,  sjpowa, 12, 4, 8, no
440152678,  elimuse, 14, 4, 10, no
792729282544013312,  DeputatiLega, 61, 24, 37, no
2629123617,  SimonettaAdami, 31, 1, 30, no
143415269,  CiccioRatti, 4, 1, 3, no
1072138536,  Vincenzo2483, 11, 5, 6, no
803737951683416064,  danielepais_, 9, 2, 7, no
96696594,  WIK1978, 22, 2, 20, no
465415975,  Tiz_Faniz, 34, 14, 20, no
461032513,  graziella_fiore, 17, 8, 9, no
1357198874,  giordanougl, 75, 4, 71, no
196560266,  pierdario, 36, 5, 31, no
224310474,  ciafella, 6, 2, 4, no
3386772711,  adriana_cirdei, 3, 1, 2, no
3234201647,  Andreacm1899, 5, 2, 3, no
264351373,  ferramari50, 8, 2, 6, no
761190317127327744,  Paul9milano, 5, 2, 3, no
1081132770,  federicogiuse, 4, 1, 3, no
1976450136,  buonfi71, 11, 5, 6, no
929249360,  xblunotte, 35, 12, 23, no
2947606421,  luciano_trop2, 6, 2, 4, no
633728787,  Keope, 14, 5, 9, no
803539173898653697,  Gabriel54258751, 67, 33, 34, no
469516428,  pierocalaciura, 11, 1, 10, no
756908583648976897,  soniacarboni_, 7, 2, 5, no
593623163,  Marsala5Stelle, 30, 4, 26, no
421810729,  Petecchio, 9, 4, 5, no
3640747095,  cicerbito1, 8, 2, 6, no
14867447,  Ildiserbante, 2, 0, 2, no
96851178,  LambertoRoberti, 3, 0, 3, no
1420443511,  anodo59, 39, 2, 37, no
416534525,  ASSOLIBERA, 21, 3, 18, no
2161187708,  MarioDerotti, 7, 3, 4, no
2843387003,  MassimoMegali, 9, 3, 6, no
517529981,  gilibertocapano, 5, 1, 4, no
916326246,  Albertozani4, 17, 2, 15, no
794072831906775040,  SocciF48, 8, 1, 7, no
1227483440,  AngeloFrisoni, 15, 6, 9, no
805854102039117824,  Loredanazucche5, 2, 0, 2, no
603531704,  ViolaRemedi, 15, 6, 9, no
3371026409,  Fra_nnic, 18, 5, 13, no
941290927,  lucio_massardo, 3, 1, 2, no
1904698302,  abramiagiuseppe, 3, 1, 2, no
3996258160,  RotellsA, 14, 4, 10, no
4074398955,  olitgiorgio, 3, 1, 2, no
2754433723,  oscarvalle1984, 41, 15, 26, no
3034313507,  GoldenLady886, 3, 1, 2, no
2427155309,  FRuighi, 8, 3, 5, no
96389952,  giulianobacca, 34, 7, 27, no
789477506646671360,  chiarasinc, 21, 9, 12, no
430033435,  GIGLIOLA11, 36, 9, 27, no
469369667,  PaoloMazzanti1, 4, 1, 3, no
1926741584,  paroleprecise, 20, 1, 19, no
1002172878,  EnricoBonotto, 4, 1, 3, no
752675748,  frapaper48, 9, 3, 6, no
839739973,  28febbraio, 5, 2, 3, no
795912820592410625,  utawind, 6, 1, 5, no
420575419,  fabiotelesca1, 3, 1, 2, no
4866444225,  veleniciociari, 3, 1, 2, no
34649922,  danielenossa, 5, 2, 3, no
596821309,  pizzi_cristina, 15, 7, 8, no
247289076,  FabrizioCrocini, 4, 1, 3, no
350216056,  FranckFixFire1, 6, 1, 5, no
1203189763,  LiberoAndreani, 7, 2, 5, no
2936119349,  Cri_Stark, 8, 2, 6, no
507212094,  gabbo1979, 10, 3, 7, no
439397412,  KKFabioKK, 9, 4, 5, no
3108090405,  AmedeoLionello, 7, 1, 6, no
423726677,  barbujani, 15, 3, 12, no
2995763703,  Greg_Wonder, 12, 4, 8, no
2598012474,  Stattefermo, 13, 6, 7, no
780714403217846272,  Vjloris1o, 12, 4, 8, no
4106012295,  lu_c01, 18, 4, 14, no
2939040203,  ugoilbrugo11, 3, 1, 2, no
958750693,  mannoiv, 28, 2, 26, no
407050794,  Mirko_Nano, 14, 4, 10, no
777879171993337856,  Siano5Stelle, 13, 1, 12, no
776479770502651904,  giovanni5439, 12, 3, 9, no
792094761637257217,  JoDreamer1960, 3, 1, 2, no
486443971,  tarzia5W, 8, 3, 5, no
2333790099,  DelleCaveGiovy, 3, 1, 2, no
1351237069,  GaudianoGiorgio, 24, 5, 19, no
2435959670,  mileneluzi, 16, 4, 12, no
2870641254,  GIUSEPPETRILLO, 5, 1, 4, no
1039546381,  alessandrazedd2, 7, 1, 6, no
1334549226,  francinizzeton, 7, 1, 6, no
436661637,  VincentVega46, 4, 1, 3, no
3359085957,  POSSIBILE5_0GE, 5, 1, 4, no
3978799463,  possibileLig, 15, 1, 14, no
1238864268,  calabraghe, 5, 1, 4, no
255417494,  damianobeltotto, 6, 2, 4, no
801152682702622720,  limar1964, 3, 1, 2, no
101060119,  waltermassa72, 3, 1, 2, no
595566285,  Giusep_Sciretta, 4, 0, 4, no
3293496178,  Magocla59, 7, 3, 4, no
454185506,  albertolapenna, 12, 1, 11, no
3037077532,  Ipercritic, 9, 4, 5, no
4915900165,  seanedwardlouis, 28, 10, 18, no
791392103876202496,  RomaReporting, 10, 4, 6, no
3906735870,  antonellatonon1, 28, 4, 24, no
57249412,  adriano1970, 15, 3, 12, no
2594797000,  fdamelio22, 6, 1, 5, no
1369658370,  maruscopetribis, 10, 3, 7, no
2877804497,  mammasi68, 81, 30, 51, no
407598164,  mmarilli38, 47, 22, 25, no
453288373,  acerba_follia, 3, 1, 2, no
791034319301140480,  vitodisweetgirl, 18, 6, 12, no
2375003982,  Dea5stars, 9, 3, 6, no
49397445,  evaigra, 11, 3, 8, no
628772007,  raffmancio1, 13, 3, 10, no
708425080645279745,  Benedettascagl5, 93, 37, 56, no
1013535530,  Romanista1976, 21, 7, 14, no
560546180,  cirofiorenzano, 5, 2, 3, no
2270541645,  itatwt, 6, 2, 4, no
3310422237,  jxgiuliano, 40, 8, 32, no
1037049997,  algirone, 3, 1, 2, no
1479828265,  theskindesigner, 7, 1, 6, no
3038785617,  FashionmailW, 38, 3, 35, no
801499650222129153,  deeplyfree3, 31, 8, 23, no
1655311418,  egoteabsolvo1, 13, 6, 7, no
4074792743,  vivaglianimali, 10, 4, 6, no
109034099,  BigBigio, 31, 1, 30, no
3373853703,  Sinapsii, 19, 9, 10, no
1311687600,  BerardiLina, 42, 16, 26, no
164223102,  quanitella, 13, 6, 7, no
220729165,  farmetti, 14, 3, 11, no
1043099688,  profluigimarino, 10, 4, 6, no
4787684421,  e0c430b78be949f, 5, 1, 4, no
116190223,  Geipeg, 33, 15, 18, no
436230438,  GiuseppeZane, 7, 3, 4, no
321264725,  It_Pol, 8, 3, 5, no
464755043,  BRaffaele77, 7, 2, 5, no
836055234,  MeloniVito, 14, 5, 9, no
265310795,  ilmontagnardo, 9, 3, 6, no
2625302733,  barbaralai84, 6, 2, 4, no
2888891609,  MirasoleCarlo, 7, 2, 5, no
861373158,  ManuelRizzi1, 12, 4, 8, no
85060556,  biancacle, 13, 3, 10, no
3418726954,  romifivestars, 17, 7, 10, no
406545803,  littlecow4, 9, 2, 7, no
332849354,  babus75, 5, 2, 3, no
461903387,  evymenna, 2, 0, 2, no
2997783909,  MainaMainafr, 4, 1, 3, no
2482345727,  clalurid74, 28, 3, 25, no
205203605,  nandosigona, 3, 1, 2, no
1879755822,  __MyPepsi__, 4, 1, 3, no
4889377726,  Marilen00160544, 12, 0, 12, no
527277129,  MichelaMirani, 8, 0, 8, no
62901570,  cpersiano, 8, 2, 6, no
3025368046,  ClaraMutsc, 48, 18, 30, no
588507242,  GiordanoSottosa, 14, 3, 11, no
1361815838,  magrotto68, 9, 4, 5, no
2822310640,  TizianoAdorni, 39, 4, 35, no
1209210108,  clabianchicla, 10, 4, 6, no
3001898993,  msolferino60, 6, 2, 4, no
779641199040798721,  JerryGa24411807, 11, 4, 7, no
865964642,  Paolina118, 5, 2, 3, no
391246325,  Brus_Uillis, 31, 11, 20, no
513444329,  MercPat, 10, 3, 7, no
749779490,  annaritaventuri, 17, 7, 10, no
407494932,  davide73_italy, 48, 15, 33, no
432009958,  danilamonteverd, 13, 4, 9, no
1009028191,  claudionucara, 30, 4, 26, no
742469305976098817,  Gfranco5Stelle, 24, 10, 14, no
1180597874,  lupus_in_tabula, 9, 4, 5, no
194632941,  francescorea, 7, 3, 4, no
792825362329788417,  MassimilianoEgo, 10, 4, 6, no
2587940700,  TwTunda, 8, 3, 5, no
2322849823,  mariandres2014, 31, 7, 24, no
2504129001,  KiverkD, 23, 6, 17, no
799352721254051844,  GiGiWolf119, 18, 5, 13, no
463118989,  OASIDEICELTI1, 7, 3, 4, no
799177228672237568,  trent175633512, 23, 9, 14, no
1960545097,  RiefoliSal, 6, 2, 4, no
780092964244783105,  pintirre, 40, 19, 21, no
717298250462662659,  Matteo31121962, 32, 13, 19, no
627383485,  emilianariccobo, 30, 3, 27, no
583920508,  fcamastra, 27, 13, 14, no
987136146,  annatorre7, 9, 3, 6, no
2940621262,  TwinStar755, 17, 8, 9, no
2715371230,  akumal2001, 4, 1, 3, no
433671269,  LucaPagliarini, 35, 17, 18, no
522567091,  FFTaurus, 45, 18, 27, no
452294805,  massimogrossi2, 23, 8, 15, no
794903071713325056,  jakena7, 17, 7, 10, no
2511415512,  antonio_ansp, 559, 275, 284, no
2544957299,  salvops17, 48, 23, 25, no
254092558,  Roberto_Ricci, 12, 4, 8, no
783740138660700160,  Antonio_Double, 370, 183, 187, no
2174691850,  mirellaladini, 89, 42, 47, no
733026190689210368,  daniele011960, 63, 28, 35, no
1052908075,  Anty82a, 7, 3, 4, no
2356966725,  DavideScotti433, 67, 30, 37, no
776366037566623745,  hellraiser13666, 20, 4, 16, no
4181504669,  NinnoCn, 5, 2, 3, no
97035161,  axl38, 20, 9, 11, no
1100740075,  epalermo79, 5, 1, 4, no
1608809730,  42yocom, 5, 2, 3, no
805387375270576128,  quantmint1, 21, 7, 14, no
2982639635,  rmedosi, 49, 22, 27, no
1369127191,  valerioaver, 3, 1, 2, no
2266409233,  GiovanniBagolin, 5, 2, 3, no
1260385676,  ale_mariano1986, 11, 5, 6, no
1077740636,  NiMartina, 23, 8, 15, no
137939617,  ren862, 9, 4, 5, no
1482397633,  filippoblu_, 32, 8, 24, no
1326880621,  cappellini_c, 32, 15, 17, no
207070244,  ItsFearless, 23, 11, 12, no
200888646,  Tony_Skid, 33, 13, 20, no
463201042,  V_campogomez, 4, 1, 3, no
382029804,  viviengonzales, 26, 7, 19, no
309784041,  dome_nico_73, 12, 4, 8, no
1446871488,  _cogico, 17, 7, 10, no
381958875,  CarmineTedeschi, 5, 1, 4, no
61011257,  rossijames, 41, 11, 30, no
1314231894,  gianni_mancino, 13, 2, 11, no
418508915,  GiuseppeCrisaf1, 15, 7, 8, no
225604191,  afgianas, 7, 3, 4, no
743898591597559808,  stemmis, 15, 7, 8, no
416398770,  filippomazzone, 13, 6, 7, no
4626223881,  giorgiomarinel4, 6, 1, 5, no
1382823301,  Sandrogallo4, 6, 2, 4, no
493497596,  sm_Adela, 6, 1, 5, no
96516447,  robertolotito, 40, 11, 29, no
1261872931,  cescomari, 26, 6, 20, no
3723192855,  HabbajFaouzi, 41, 18, 23, no
2167116718,  GherardoMarengh, 42, 20, 22, no
118348341,  dany118d, 6, 2, 4, no
144226252,  niccolo_avico, 7, 2, 5, no
1256727248,  TWs_Laura, 181, 88, 93, no
762774778767892484,  emizarre, 5, 2, 3, no
769434494789091328,  gegeelia, 19, 8, 11, no
802293571693019136,  hikky93, 29, 13, 16, no
739128484937801728,  njkkjn7, 11, 3, 8, no
797134962453581824,  ilBuonGustaio, 43, 16, 27, no
3155682418,  ChiodiDonatella, 21, 7, 14, no
298186616,  Rikku_75, 9, 4, 5, no
2234822984,  perlatiziana, 142, 70, 72, no
314540853,  Spazioalchimia, 10, 4, 6, no
380466302,  Matteo_Cecchin, 50, 24, 26, no
209249028,  SavioFicorella, 27, 10, 17, no
887496074,  acle1968, 14, 6, 8, no
1071579716,  43ribelle, 32, 5, 27, no
492688472,  augumedici, 148, 73, 75, no
287153306,  HakunaMatata_92, 17, 8, 9, no
189801758,  sliubi, 62, 29, 33, no
2249959502,  gpcep, 57, 28, 29, no
778470150336942081,  giuseppeevacuo, 11, 5, 6, no
2430563386,  taricco77, 4, 1, 3, no
766657539710783489,  BarbaraBet71, 9, 4, 5, no
2676171233,  HeldGabriela, 7, 2, 5, no
353134095,  edilscik, 3, 1, 2, no
598650191,  silviabl1975, 33, 10, 23, no
2843769504,  albegiorvalanga, 52, 14, 38, no
2962994278,  tter1518, 3, 1, 2, no
786616233584058368,  temozzico, 4, 1, 3, no
1316655810,  doranapolitano, 17, 4, 13, no
426712009,  valegboy, 23, 9, 14, no
3183670121,  ElisaSirica, 53, 26, 27, no
2494263560,  jomar680721, 9, 4, 5, no
3000604564,  CaesarVinces, 15, 7, 8, no
790164996667871233,  gio_figo, 15, 7, 8, no
435645089,  Amarenapx, 5, 2, 3, no
1357813057,  sascha_saghim, 32, 15, 17, no
393504284,  BenignoVincenzo, 3, 1, 2, no
2236761742,  sancono65, 22, 8, 14, no
437023656,  AnnaCavani, 4, 1, 3, no
3395459769,  ArelloPonch, 7, 3, 4, no
2226243518,  StefanoAglio, 8, 3, 5, no
4768064356,  Pasqual87159647, 6, 2, 4, no
1925940440,  halnovemila2, 5, 2, 3, no
2434465310,  idagarberi, 4, 1, 3, no
3073624366,  tommy_rimini, 6, 1, 5, no
467274250,  giulymuratori, 7, 3, 4, no
2197620432,  mbartolotta63, 20, 9, 11, no
2348760096,  MarcoCamillieri, 5, 2, 3, no
713429269490302976,  robertosimbolin, 8, 2, 6, no
326854012,  Edoenonsolo, 13, 6, 7, no
2387816981,  RossanaTrevisio, 9, 4, 5, no
1186603358,  GCloStli, 47, 20, 27, no
1034897761,  micos60, 34, 16, 18, no
377430097,  grancetto, 28, 12, 16, no
1272137623,  antospi1973, 15, 7, 8, no
3859630461,  livelifeVale, 18, 8, 10, no
416583838,  melinacugliari, 27, 13, 14, no
1079446351,  Eliseop53, 16, 7, 9, no
3238930005,  feb6bdff277d49e, 3, 1, 2, no
40131385,  IacobitaCristi1, 13, 1, 12, no
534375344,  STELOMBARDIFIM, 5, 2, 3, no
715130347852283905,  SalvatoreUsai3, 9, 4, 5, no
500602731,  mauriziobanimic, 8, 2, 6, no
2299766748,  cunilingus12, 39, 16, 23, no
1719985794,  coruccina, 11, 5, 6, no
2830900625,  fafailgrande, 15, 5, 10, no
3149053143,  telese3131, 9, 3, 6, no
2767295512,  FenjiHugMe_, 3, 1, 2, no
3029285000,  SenesiSergio, 5, 2, 3, no
779077333,  andreactrl, 30, 14, 16, no
367692964,  adrenaly1, 52, 21, 31, no
2921663680,  ellavandini, 5, 2, 3, no
439487431,  Be_ll_atrice, 12, 5, 7, no
797812715859406848,  molim_, 3, 1, 2, no
2335372808,  buch_1977, 65, 23, 42, no
783740711652978688,  Cangio44, 5, 2, 3, no
404987270,  antonio250755, 9, 4, 5, no
2523613014,  MIRICA1955, 5, 2, 3, no
216308253,  giovannitoma, 7, 1, 6, no
779645231285301248,  Anto_Casadei, 43, 18, 25, no
137954777,  markchierici, 3, 1, 2, no
419544789,  VioleMore, 3, 1, 2, no
4154714363,  NughesAdriana, 20, 9, 11, no
2920441331,  Ilfarnese, 3, 1, 2, no
1157534816,  EugeniaTimpano, 27, 12, 15, no
2574266145,  laura_petrulli, 144, 70, 74, no
499672556,  IlSilliDiPrato, 5, 2, 3, no
3047493292,  paneecicoria, 11, 5, 6, no
860350934,  jiff00, 9, 3, 6, no
996978686,  JL83X, 5, 2, 3, no
739209087427055617,  DarrenMorrisMGS, 5, 2, 3, no
3005907718,  SuaSignoria, 7, 3, 4, no
4743284837,  LisadeClugny, 3, 1, 2, no
594777484,  arusso414, 10, 4, 6, no
609075599,  massimostazi, 6, 2, 4, no
2218349510,  christian_trix, 7, 3, 4, no
200091336,  fnc40, 14, 6, 8, no
425254477,  vitocontesi, 14, 6, 8, no
4874754473,  ERazzani, 16, 4, 12, no
215593566,  Salvatore_1991, 5, 1, 4, no
354003815,  raoulrusso, 11, 4, 7, no
1336027495,  rastef58, 39, 17, 22, no
1114354382,  roccodileo3, 13, 5, 8, no
3025012821,  gianchialfred, 9, 4, 5, no
707978044179410944,  ContentaWalter, 10, 4, 6, no
746691972459597824,  VinciDibi, 57, 26, 31, no
3079246066,  NeroneroNerox, 11, 5, 6, no
2955148689,  Marine2017_Off, 28, 10, 18, no
775563174477238272,  stebikeMilano, 5, 1, 4, no
1048605840,  altamura63, 14, 4, 10, no
872497166,  Tonino775, 93, 42, 51, no
2737037620,  RaffyTrilli, 4, 1, 3, no
797871034535936004,  aurelio327, 27, 4, 23, no
190688480,  CervoVolante, 9, 3, 6, no
1930820899,  cds1056, 7, 2, 5, no
793115977634484225,  vitolillo5, 3, 1, 2, no
2549528592,  BobbiaOdille, 31, 12, 19, no
2800443747,  nicola99baldan, 22, 10, 12, no
582087196,  dalilello, 37, 8, 29, no
762637499428634625,  Matilde1270141, 4, 1, 3, no
773325167871287297,  kelerofonte, 21, 10, 11, no
1230871339,  lucas04106001, 17, 8, 9, no
2205011249,  GianpieraRasell, 9, 4, 5, no
4735423054,  elvialorena50, 20, 9, 11, no
2355147860,  AntonioDomenic, 27, 1, 26, no
1238596208,  azzurrantonella, 3, 1, 2, no
725817874602971136,  sghsihhf, 21, 7, 14, no
2634622329,  auroraman45, 6, 2, 4, no
187725799,  suchsteefat, 3, 1, 2, no
1646281124,  AValvecchia, 19, 9, 10, no
3568909456,  Avarello97, 4, 1, 3, no
3079488179,  itscyb, 5, 1, 4, no
4822490579,  tirittittina, 25, 12, 13, no
3053979329,  ElenaOrsi76, 20, 4, 16, no
782622314261196800,  ediononsono, 17, 5, 12, no
47368925,  SZ88, 17, 8, 9, no
259401999,  AlColasanti, 8, 3, 5, no
391279725,  reaman62, 17, 7, 10, no
2837876374,  trumpservative, 20, 8, 12, no
331047338,  fabriziohola, 13, 6, 7, no
3346047160,  AntonioFL97, 29, 14, 15, no
624359831,  tossina_libera, 23, 8, 15, no
800969617082552320,  Ketty57664851, 14, 3, 11, no
805387616921284608,  francotestoni5, 3, 1, 2, no
4439231793,  CanginilucaLuca, 19, 7, 12, no
2343993217,  GiorgioBuquik, 8, 2, 6, no
48687119,  andrealufino, 11, 5, 6, no
979960242,  mauri1brescia, 17, 6, 11, no
489546240,  saverioontwitt, 17, 7, 10, no
556328289,  serenatrinetta, 4, 1, 3, no
3394261233,  peppe_alagna, 35, 9, 26, no
109226009,  Banf85, 6, 1, 5, no
753932769147912193,  missmichela19, 3, 1, 2, no
329600452,  antonio4666, 9, 2, 7, no
800650112,  pzappatore, 3, 1, 2, no
1440369276,  gambuzzaannunzi, 3, 1, 2, no
576669912,  gianfrancocapo1, 5, 2, 3, no
2334034163,  santos35695291, 3, 1, 2, no
2359323311,  expomau, 11, 4, 7, no
1566803234,  FedericaFlajani, 29, 14, 15, no
709427870419062784,  Paolino_maioli, 42, 17, 25, no
3384511240,  ChryssIorio, 31, 14, 17, no
786909552906268672,  GIOBIS49, 5, 2, 3, no
791269727830237184,  Ambra76321544, 11, 3, 8, no
318601197,  EAlessandroni, 14, 4, 10, no
805743265454706688,  alessio_caale, 21, 8, 13, no
3046433745,  fastenseat, 5, 2, 3, no
1162661400,  luisamattina1, 10, 1, 9, no
805673295051980800,  UomoNellArena, 16, 7, 9, no
796770054511661057,  Claudio05021959, 3, 1, 2, no
414341453,  WaspSalander1, 5, 2, 3, no
1402688845,  miagmarsuren, 7, 3, 4, no
2172743300,  Snoopy16466, 23, 5, 18, no
347442566,  bestiucci, 14, 6, 8, no
805838348422156288,  MartinaGualtie4, 10, 3, 7, no
593533490,  ginkoramingo, 5, 1, 4, no
1048883828,  mirymiry6, 7, 2, 5, no
793101117844520968,  chicca2918, 13, 6, 7, no
2289645645,  LTrillni, 15, 7, 8, no
709840307249090560,  jeanlui007, 13, 6, 7, no
3995075176,  Imperoborbonico, 7, 3, 4, no
1667790625,  Giampaolo_R7, 5, 1, 4, no
492175524,  katesparu, 7, 3, 4, no
2316519053,  gaspero1953, 7, 3, 4, no
2417683973,  SanPaolo7, 12, 4, 8, no
3043617377,  gsoricaro, 16, 5, 11, no
1425755594,  gabmrocca, 3, 1, 2, no
970274028,  andreac841, 31, 15, 16, no
2910439048,  loredanapetric2, 8, 3, 5, no
860205385,  MARIELLA7172, 18, 7, 11, no
341389452,  ilparlamentare, 3, 1, 2, no
427671284,  Diabolikit, 10, 3, 7, no
1271977076,  mariodomenicoto, 7, 2, 5, no
1284301519,  dottbellue, 6, 1, 5, no
4834714805,  guido110170, 10, 3, 7, no
950500700,  OberdanBenanchi, 9, 3, 6, no
105277763,  lucianoserrone, 9, 4, 5, no
2252032623,  PaoloTiscornia, 4, 1, 3, no
249685018,  ilsuonatoredi, 25, 12, 13, no
221812643,  maxdercole, 3, 1, 2, no
1511087611,  grizzli2006, 3, 1, 2, no
3958002443,  MerloolreM, 5, 2, 3, no
58762054,  agipa, 5, 1, 4, no
3044636879,  vatu54, 3, 1, 2, no
3263800121,  pattyantonelli1, 15, 7, 8, no
836428490,  123stoka, 10, 4, 6, no
4483480636,  oui2oui3, 37, 18, 19, no
385890505,  GioGalgano, 15, 3, 12, no
1418554027,  vietvinc, 3, 1, 2, no
805810964142718976,  187_338, 3, 1, 2, no
1082718704,  leo_tomarchio, 75, 29, 46, no
2396639005,  Rita49865673, 18, 8, 10, no
801445435407798272,  lovingbricks, 21, 10, 11, no
3037744342,  Va_Bore, 7, 3, 4, no
3347613405,  oltreimuri, 7, 2, 5, no
501669408,  enricoxp, 18, 7, 11, no
1534670706,  MicheleDiGiusto, 3, 1, 2, no
4329256703,  Ginetto1959, 12, 5, 7, no
45859888,  Aladdinsane60, 9, 4, 5, no
2875156827,  Sorrybyme, 5, 1, 4, no
1068405199,  okmacy, 87, 34, 53, no
2418774046,  michi73477154, 58, 27, 31, no
375625467,  _ritasi, 6, 2, 4, no
2487798168,  coscorb, 14, 6, 8, no
417227921,  giuppi78, 15, 3, 12, no
34607171,  magnino, 12, 4, 8, no
459977317,  mariagrazia1vol, 13, 5, 8, no
2223407550,  eniobertolini, 34, 3, 31, no
2870870995,  danyace2014, 7, 3, 4, no
392169271,  EmilioBrambilla, 20, 8, 12, no
4713725061,  rengia_benito, 3, 1, 2, no
2318216051,  RipleyEmy, 14, 6, 8, no
1039675664,  enricoorsetti, 7, 3, 4, no
2565953471,  talebano1968, 7, 2, 5, no
3305696997,  alemarag, 13, 6, 7, no
4863603099,  pindacamp, 5, 1, 4, no
805710328625590272,  Piombo_Morbido, 15, 5, 10, no
1044887318,  paolo6555, 16, 7, 9, no
1555488049,  PutzoluSandra, 43, 3, 40, no
777436258767368192,  polemicotweet, 3, 1, 2, no
3298746532,  SanSanokkio, 7, 1, 6, no
605653016,  BlancStefan, 26, 7, 19, no
716422928,  davilla58, 85, 41, 44, no
2561992290,  yronladi, 9, 4, 5, no
801934415526002688,  Alessan41583443, 59, 29, 30, no
1257582146,  fabiovecchi24, 3, 1, 2, no
797905198811381760,  robertosterlicc, 7, 3, 4, no
1272524299,  ANGELONIOSI, 5, 2, 3, no
2784502136,  valman54, 16, 5, 11, no
416758608,  kilojhi, 3, 1, 2, no
748416033334132736,  Nain44955104, 15, 6, 9, no
597545163,  dyd74, 8, 3, 5, no
834267554,  omniamunda, 15, 5, 10, no
942010068,  perrellicoach, 54, 19, 35, no
3243937305,  Zambuzzz, 10, 2, 8, no
439073471,  LuigiCasc, 9, 3, 6, no
2964938091,  m_dazzi, 23, 7, 16, no
3063412516,  firedpt3, 4, 1, 3, no
767040529100079104,  Pinella1949, 29, 8, 21, no
4924743345,  antoarcu, 8, 2, 6, no
225178719,  mario19633, 11, 5, 6, no
755313289,  gongolo11, 13, 4, 9, no
2800242858,  mba_nico, 3, 1, 2, no
341335638,  nellomarrazzo, 16, 6, 10, no
802454590608330752,  LoStudenteSvevo, 7, 2, 5, no
388194972,  GaetanoScafa, 5, 2, 3, no
229112968,  AGNotizie, 6, 2, 4, no
3059131623,  agatamicia, 31, 11, 20, no
858249276,  lilly0971, 6, 2, 4, no
289688493,  Spartaco_8, 3, 1, 2, no
3130622027,  19justice69, 84, 41, 43, no
248734017,  dantechip, 19, 7, 12, no
788012181598113792,  criscarboni77, 5, 2, 3, no
793469352871858176,  kafyipel, 9, 4, 5, no
787512125610655744,  rocco22772495, 11, 3, 8, no
397251469,  sesy1947, 6, 2, 4, no
2969224684,  lubale271081, 10, 4, 6, no
426908100,  robertopoggi1, 5, 1, 4, no
349649017,  romanabarba, 15, 3, 12, no
954347947,  carcani_sn, 16, 3, 13, no
3375604709,  ailinon80, 16, 7, 9, no
431042658,  andrea_piras86, 8, 3, 5, no
204456385,  calderamat, 11, 4, 7, no
786491581503156225,  informationeu, 7, 3, 4, no
780318269995638784,  Blackred621, 7, 3, 4, no
801049687298113536,  sesto_empirico, 23, 2, 21, no
358847239,  nandoercole, 15, 4, 11, no
3834367960,  fabriziobizz1, 15, 4, 11, no
764056964821348353,  leonessa1967, 3, 1, 2, no
1106516964,  Susy_1968, 3, 1, 2, no
120713042,  savonarola51, 5, 2, 3, no
1314567997,  davide92_, 11, 3, 8, no
2979863884,  area_paolo, 9, 2, 7, no
24319564,  IeSslo, 5, 2, 3, no
3303871432,  scrivipicchi, 57, 3, 54, no
781315176,  veronicafili, 7, 3, 4, no
764071712950550528,  tonyeldoret, 6, 2, 4, no
607468987,  FerrantiXCIV, 5, 2, 3, no
425774798,  giovanni1039, 7, 3, 4, no
444551766,  Greekstudent12, 5, 2, 3, no
85793992,  bygip, 4, 1, 3, no
3025353091,  enzolarocca123, 3, 1, 2, no
47170794,  GiallucaD, 13, 3, 10, no
1044907412,  ACeschia, 11, 5, 6, no
364947294,  RinoRiezzo, 6, 2, 4, no
432268178,  andrea_ballario, 3, 1, 2, no
793787716727140353,  salvodepianof2, 6, 1, 5, no
72522293,  susymurzi, 23, 11, 12, no
1968968935,  SURESNESRBM, 13, 6, 7, no
1176004074,  RuslanaOpika, 3, 1, 2, no
318488169,  NCIngegneria, 8, 3, 5, no
790675660926808064,  frasilvestrona, 5, 2, 3, no
1451417796,  Palma304Paolo, 15, 7, 8, no
321252271,  fcolombo73, 12, 4, 8, no
2946017621,  giovip1948, 5, 2, 3, no
2985859289,  simonettarodol1, 12, 5, 7, no
483352788,  sonnen74, 14, 6, 8, no
3988102589,  FirstOnHisName, 8, 3, 5, no
1257848173,  Stefanoboh, 23, 7, 16, no
2412990951,  OpenFaber, 3, 1, 2, no
164382929,  Pie_84, 4, 1, 3, no
72546841,  Andrew_Hunting, 3, 1, 2, no
704986438,  michele_tin, 28, 13, 15, no
794676312103415808,  AuriAury53, 8, 3, 5, no
2364563704,  brishan80, 12, 5, 7, no
700592900544053248,  simonamoma1971, 6, 2, 4, no
3144136294,  genovesechrist1, 5, 1, 4, no
2442105406,  robertabg72, 45, 21, 24, no
3414864718,  UmbertoStr, 15, 7, 8, no
2372154501,  roal_139, 12, 4, 8, no
140066629,  Lucy_822, 15, 6, 9, no
1226074158,  CGhila, 3, 1, 2, no
2791644545,  99a43db3e4644ff, 10, 4, 6, no
2197813964,  SoftVsc, 27, 13, 14, no
801762901769981952,  Bmc90672827, 12, 5, 7, no
1295979390,  vincent_cerullo, 3, 1, 2, no
117863568,  anglotedesco, 5, 2, 3, no
514712257,  2pesi2misure, 7, 3, 4, no
982932835,  adrianabiffis, 20, 5, 15, no
1244857718,  APastarini, 16, 4, 12, no
557246302,  partenopeoswiss, 13, 6, 7, no
511569049,  SaraMuggittu, 9, 2, 7, no
783366855952064516,  giovannibacci36, 28, 13, 15, no
634892475,  VaiVieni, 22, 6, 16, no
614259382,  conmatteorenzi, 6, 2, 4, no
4382544027,  StefanoRaso3, 9, 3, 6, no
3902887697,  gianfrancotafu1, 3, 1, 2, no
713555902385795073,  WomenForTrump16, 4, 1, 3, no
262649381,  angelomagda, 6, 2, 4, no
744453072601161728,  mariantferrante, 14, 4, 10, no
3291933754,  Marranna57, 6, 1, 5, no
1286897317,  yubileo1, 8, 3, 5, no
1344746178,  maggipat, 6, 1, 5, no
2570957394,  semedada, 25, 6, 19, no
4908499649,  rosydl_1510, 15, 6, 9, no
420409929,  andrealievore, 4, 1, 3, no
168493532,  gmoniaci, 3, 1, 2, no
2498148194,  BETTONITIZIANA, 15, 6, 9, no
721961955079102464,  papavero8, 11, 4, 7, no
370223450,  salvoflo, 12, 5, 7, no
3687479603,  infopastore1, 12, 5, 7, no
3207511185,  MariaElenaBozz1, 21, 7, 14, no
2360784420,  flavirostris, 6, 2, 4, no
2247093145,  fabiottofab, 7, 2, 5, no
2273740121,  fabriziolupi73, 8, 2, 6, no
419500576,  robegalli, 5, 1, 4, no
754299309236117504,  intersilvia48, 4, 1, 3, no
433227573,  Rinoga1, 3, 1, 2, no
743187888205078529,  CasariniR, 5, 2, 3, no
440739435,  davide_pezza, 10, 3, 7, no
1098501367,  LetiziaGamberin, 58, 28, 30, no
1384017114,  danielesordi27, 23, 9, 14, no
396743688,  micio1975, 12, 5, 7, no
2943742474,  CarlottaCeraulo, 6, 1, 5, no
915385926,  cuprum49, 13, 5, 8, no
2421033249,  GPettoruti, 7, 3, 4, no
3022753349,  patrizia_lat, 7, 2, 5, no
725592726025154562,  Anielloportier1, 16, 6, 10, no
2945794889,  dgallo1982, 9, 3, 6, no
12946492,  paolodiazzi, 3, 1, 2, no
2871007730,  _grisdel_, 6, 2, 4, no
329766972,  Maximo_Catena, 5, 2, 3, no
1361683034,  BrunoContebruno, 4, 1, 3, no
93719647,  gianlucagrossi, 10, 4, 6, no
972003932,  ItaloPantaleone, 4, 1, 3, no
500122789,  Diego_Maugeri, 25, 12, 13, no
469580096,  dandrea_dandrea, 9, 4, 5, no
1387466808,  di_monica75, 3, 1, 2, no
782793637,  DavideSchiesari, 3, 1, 2, no
995642131,  gio66_, 16, 6, 10, no
3369644489,  EdWarnerGK, 3, 1, 2, no
2472634306,  neo_dymium, 6, 2, 4, no
183283202,  GCugini, 7, 3, 4, no
992998202,  capricornofede, 6, 2, 4, no
717022003354583040,  Rosy1162, 16, 7, 9, no
2290924705,  roberto_marcato, 6, 1, 5, no
51107478,  FabsNYC, 5, 2, 3, no
761818936614805504,  65prontotopo, 6, 1, 5, no
2758218200,  tulipano_95, 21, 10, 11, no
385132187,  asromamioamor, 15, 5, 10, no
882473480,  bellia1950, 6, 1, 5, no
2813412750,  gcesarepaperini, 3, 1, 2, no
3044957079,  IIITALIA, 6, 1, 5, no
400701610,  larosasteve, 7, 3, 4, no
198633968,  NevaBAlessio, 13, 6, 7, no
3093271402,  denis_saullo, 5, 2, 3, no
292063590,  carmelino75, 5, 2, 3, no
798181337433829376,  carlo34620830, 33, 7, 26, no
83396222,  Freddieafk, 3, 1, 2, no
714457631151296512,  mauromonti_ho, 3, 1, 2, no
701835995226968064,  Antonel93665749, 3, 1, 2, no
2660179878,  ivangallo80, 5, 1, 4, no
396563069,  winni_vincent, 5, 2, 3, no
718807833463123969,  Giomil2, 3, 1, 2, no
1886063070,  EuroMasochismo, 3, 1, 2, no
754403068725301249,  peppe844, 10, 4, 6, no
737142202481016832,  chidambara09, 5, 1, 4, no
803010732,  stefanocimarell, 6, 2, 4, no
740257403178999808,  annabul62, 10, 2, 8, no
70353394,  Appalto, 11, 5, 6, no
1358915466,  ADUSBEF_Tanza, 5, 1, 4, no
2704662807,  figliolaraf45, 13, 2, 11, no
800566259561574401,  ValerioVolpi6, 13, 3, 10, no
3344669734,  fraunetwork, 11, 5, 6, no
846045162,  TerryEmpyre, 26, 12, 14, no
794218079878266880,  biasetabon, 6, 2, 4, no
3290570284,  iolanda_pitti, 7, 3, 4, no
435153058,  l_taran, 6, 2, 4, no
734976214163726336,  GiusyCortese5, 4, 1, 3, no
1702025438,  QueVincenzo, 7, 2, 5, no
363401195,  LUCALANGELLA1, 3, 1, 2, no
3325251946,  cla76canepa, 17, 8, 9, no
3324571887,  maurodelfavero1, 8, 1, 7, no
2289972189,  francorol1, 9, 3, 6, no
2389161486,  Roberta_P68, 4, 1, 3, no
785027790961778688,  nerobastard, 5, 2, 3, no
789046049788821504,  IaconoLia, 3, 1, 2, no
1586673164,  colatre1, 13, 4, 9, no
418772810,  IvanoBressan, 15, 3, 12, no
318030346,  dimafab67, 5, 1, 4, no
397853516,  ferroice40, 20, 8, 12, no
423416522,  claudioarch01, 5, 2, 3, no
802097584332558336,  CassandraSere, 7, 3, 4, no
761151413330255872,  CorradoPluchin1, 5, 2, 3, no
701156972364701696,  MarcolandoM, 7, 2, 5, no
804413937907208192,  Alessan04156164, 31, 15, 16, no
805799470793363456,  Svitoreon, 3, 1, 2, no
2225786343,  armandopiu, 8, 3, 5, no
2208789310,  rumar55, 7, 3, 4, no
411368819,  ByronLaura, 3, 1, 2, no
800979325042495492,  paolopietro9, 5, 1, 4, no
3086975528,  lorella1959, 13, 6, 7, no
102516490,  EarlMountChrist, 14, 4, 10, no
2876447163,  Gigiu2014, 3, 1, 2, no
544221226,  rosyrock47, 7, 2, 5, no
234659784,  gocedimemoria, 7, 3, 4, no
137003322,  cardmyk, 5, 1, 4, no
200648626,  gabrieleporri, 10, 2, 8, no
1283299418,  Lo_speziale, 7, 2, 5, no
2985400847,  bonatiriccardo, 12, 5, 7, no
780690044730220544,  fierdlametera, 5, 2, 3, no
4485269080,  andrea_cavucci, 7, 1, 6, no
415071140,  caorle44, 6, 1, 5, no
2370723536,  aiardi1, 5, 2, 3, no
579867137,  ddcommerciale, 9, 3, 6, no
764509784,  GmailRocco, 3, 1, 2, no
2396856942,  MarcelloBotzo, 6, 1, 5, no
410892254,  CicciBignotti, 7, 1, 6, no
801741532218925056,  Luca_illy, 3, 1, 2, no
3080004435,  gianni_damore, 11, 4, 7, no
791569798790582272,  LegaperItalia, 9, 4, 5, no
792349473548697600,  votaSalviniFI, 9, 4, 5, no
771997084039929856,  nessuno150757, 5, 1, 4, no
815134452,  sergiolinari1, 3, 1, 2, no
441483457,  iamfrankie79, 5, 2, 3, no
2787878581,  BarbascuraX, 3, 1, 2, no
428515597,  G_Valditara, 30, 11, 19, no
785540126277570560,  sindaciperilno, 10, 3, 7, no
1052352102,  SaborPepe, 16, 5, 11, no
1030566912,  i_giovannigra, 11, 3, 8, no
1914960499,  RVestri80, 44, 9, 35, no
2349893558,  brasov4, 9, 2, 7, no
581973855,  FedeGarofalo, 3, 1, 2, no
513497583,  TwittGiorgio, 12, 4, 8, no
803711058779271168,  Iose14432990, 5, 2, 3, no
2787508709,  giovannipispico, 15, 7, 8, no
197381599,  Marzia_M, 5, 2, 3, no
2772505510,  max_luise, 3, 1, 2, no
2364603574,  SoccorsiG, 22, 3, 19, no
1040080075,  asofort, 8, 3, 5, no
2427478331,  marisa_pace, 3, 1, 2, no
742027791990968320,  angeloanauel, 13, 6, 7, no
632324504,  EttaLisetta, 4, 1, 3, no
785907890011840513,  CBrunonanni, 5, 2, 3, no
2273249119,  _elysun, 4, 1, 3, no
2841263939,  Bernattia, 6, 2, 4, no
2361959873,  CiroSterchele, 15, 3, 12, no
797161661283045376,  RoMario975, 4, 1, 3, no
2375301992,  DaniMazzaferri, 4, 1, 3, no
1565412319,  RecineMichele, 17, 7, 10, no
497752969,  LorenzoSchiliro, 7, 3, 4, no
752617406191767552,  Arzente_LV, 5, 2, 3, no
68161227,  fabiogigli, 6, 2, 4, no
627317336,  30mirella51, 29, 14, 15, no
738491898688622592,  Simonet09059430, 43, 19, 24, no
3662356395,  stregatto1965, 88, 32, 56, no
2554846117,  UomodiMelma, 3, 1, 2, no
405430528,  fra_c22, 10, 1, 9, no
498952433,  ChryTheking, 10, 3, 7, no
219273566,  giuanlortista, 9, 1, 8, no
1235548266,  Paolo63pa, 3, 1, 2, no
328966256,  claraspada, 11, 4, 7, no
271466783,  LoMassi, 4, 1, 3, no
108876723,  gaetiannone1971, 5, 1, 4, no
995457626,  LippolisA, 12, 5, 7, no
737691796701097985,  peppinobordone1, 3, 1, 2, no
1221955844,  sintesi160, 13, 3, 10, no
548276767,  RonnyBandiera, 6, 1, 5, no
798573571723423744,  IvanLyon9, 3, 1, 2, no
3090189012,  savi_con, 3, 1, 2, no
783745267707281408,  Pietronucciogm1, 7, 1, 6, no
2354315379,  roberto_corazza, 5, 2, 3, no
711343781644255233,  Katiushja2, 11, 3, 8, no
233531154,  mayfrayn67, 13, 6, 7, no
4525011809,  tonipiazza67, 12, 3, 9, no
779986090707021824,  willybion, 13, 3, 10, no
3207456845,  GiorgioMoltedo, 8, 2, 6, no
2193774492,  roberto_ruscio, 17, 8, 9, no
1157260398,  MirabileNino, 3, 1, 2, no
541061131,  cristianbattis3, 8, 3, 5, no
1196533130,  farneseantonio, 3, 1, 2, no
4209118828,  fiorialsole15, 8, 1, 7, no
2921948057,  zazagab2, 47, 22, 25, no
1696619809,  a70199617, 17, 2, 15, no
863413130,  ivanmartelli, 5, 2, 3, no
888895441,  flagstarr, 7, 3, 4, no
529431381,  BRUGALISIMONE, 28, 8, 20, no
3314962654,  erfoggiadezeman, 8, 3, 5, no
705451641,  AndreaMonfroni, 28, 4, 24, no
559409782,  VinGalante, 5, 1, 4, no
3107605546,  paolasinger70, 13, 5, 8, no
491284250,  FabioMassiConti, 5, 2, 3, no
1064367553,  SundanceDAmore, 18, 8, 10, no
795739255440048128,  mortisia2708, 6, 2, 4, no
591983888,  GioLombar, 21, 5, 16, no
864123438,  maxtrot68, 6, 1, 5, no
719307983856001029,  GoldenFauvi, 3, 1, 2, no
2257560786,  ValerioC1, 3, 1, 2, no
1278423985,  trecchinese, 7, 2, 5, no
2751256629,  BerziLiliana, 28, 6, 22, no
712081496,  beppemicelli, 16, 7, 9, no
77031813,  Linus2k, 8, 3, 5, no
3931969841,  Ardito80054160, 73, 36, 37, no
2166645995,  swordy05, 9, 2, 7, no
1032520350,  tommaso_addabbo, 17, 1, 16, no
2756645690,  antonellafrezz5, 5, 2, 3, no
1242047258,  BoboZangief, 10, 2, 8, no
384214851,  Gio_Deiu, 12, 3, 9, no
725269025144619008,  Na1007751, 4, 1, 3, no
407179725,  MikieTitti, 5, 2, 3, no
769543337527345152,  Sig_Bertrand, 26, 10, 16, no
4848941248,  giopad66, 13, 6, 7, no
1227226388,  MelchiorreMario, 5, 2, 3, no
1009031150,  SOLCALIENTE2, 13, 2, 11, no
2305403337,  vitulloa911, 3, 1, 2, no
2910818007,  ildisinformatto, 5, 2, 3, no
2361317193,  tittistama, 5, 2, 3, no
1291556816,  bromByron, 5, 2, 3, no
1219626002,  AlvaroDelfi, 5, 2, 3, no
2266096538,  EttoreViglione, 7, 3, 4, no
2357343035,  PaoloPdv, 12, 5, 7, no
110454337,  gianvitosibilio, 13, 6, 7, no
4868607605,  vltptt, 4, 1, 3, no
774327465133084672,  GIAMMI_LUNA, 3, 1, 2, no
745004825738346496,  cesy8285, 7, 3, 4, no
426200281,  mcarda90, 8, 3, 5, no
2196158901,  satyagrahaaa, 3, 1, 2, no
469584786,  GioDiGiugno66, 11, 5, 6, no
67420706,  RobGallaurese, 5, 2, 3, no
371865254,  Estrafill, 9, 4, 5, no
1504710145,  mauronycity, 13, 6, 7, no
2720826652,  CanevazziCarlo, 17, 2, 15, no
268182887,  Raneristefano, 3, 1, 2, no
2372381341,  burney_gumble, 11, 5, 6, no
524236416,  GiuseppeSpadone, 30, 6, 24, no
77336255,  gincarbone, 8, 3, 5, no
244574767,  florianoiodice, 3, 1, 2, no
1322710969,  JejaNovelli, 5, 2, 3, no
3243194073,  andymaga50, 3, 1, 2, no
50588269,  mik3llo, 9, 3, 6, no
787588319957966848,  Michele78814171, 24, 8, 16, no
259731992,  polomarco67, 3, 1, 2, no
470349216,  vitalozzo2012, 5, 1, 4, no
2860530848,  GAlidori, 4, 1, 3, no
2271553504,  marcosantoro67, 7, 3, 4, no
195057236,  attilioluigi, 4, 1, 3, no
387855536,  babbo100, 4, 1, 3, no
2455915345,  tiz_mic, 16, 1, 15, no
975895578,  pmontina, 3, 1, 2, no
2483582362,  StefanoCComi, 8, 3, 5, no
1180622503,  ppsfollower, 8, 3, 5, no
306123184,  mimmoef, 3, 1, 2, no
460408863,  dtolux, 8, 3, 5, no
798612590284931072,  Farota20161, 3, 1, 2, no
802183609822146560,  ClaudianoVe, 8, 3, 5, no
3335478268,  figliolaraf67, 7, 3, 4, no
906858110,  chiseloricorda3, 5, 1, 4, no
4871813147,  LuciaVa12, 9, 4, 5, no
2210419316,  TrimixdiverIt, 7, 3, 4, no
2437027374,  Angelo_Pacifici, 5, 2, 3, no
799887615335903236,  MarcelloBonell4, 6, 2, 4, no
579147580,  Ed96webchannel, 16, 6, 10, no
2940585718,  fracasto, 12, 4, 8, no
4266384617,  lellus1969, 4, 1, 3, no
4078323682,  ilpzini12, 6, 2, 4, no
254998344,  vivielotta, 35, 7, 28, no
751104484969947136,  andirollo, 7, 3, 4, no
2897057014,  VScrimieri, 3, 1, 2, no
4551592522,  Gelso22, 6, 2, 4, no
286168631,  diotimauri, 9, 3, 6, no
762934873057292288,  4gennaro10, 29, 2, 27, no
244270709,  alexbeldi, 3, 1, 2, no
429127192,  gattozeki, 7, 2, 5, no
946023379,  AndreaMsg71, 12, 5, 7, no
938933701,  ivobartot1, 7, 1, 6, no
3230927109,  leoperri995, 5, 2, 3, no
3317354183,  gabsybn, 10, 2, 8, no
3075686139,  markfener1986, 13, 3, 10, no
456554589,  ASciandrone, 3, 1, 2, no
132585811,  marcocampo, 3, 1, 2, no
3258031089,  marukosocial, 4, 1, 3, no
146544730,  Magic197710, 6, 2, 4, no
3159761662,  64_michy, 17, 8, 9, no
632332554,  Bottarello, 4, 1, 3, no
736205254560231424,  MiglioratiNino, 23, 3, 20, no
421753222,  paolotwix, 9, 2, 7, no
542895669,  Lorbertal, 3, 1, 2, no
159791142,  lollofaber, 7, 3, 4, no
110722335,  MCEL88, 5, 2, 3, no
25289817,  pimpumpam, 5, 2, 3, no
2224989113,  BeppeMarzola, 5, 2, 3, no
28998953,  elyswifty, 9, 4, 5, no
1086641828,  sembronio, 15, 6, 9, no
3141569843,  RelliRellilu70, 5, 2, 3, no
1932231254,  LdmMedola, 19, 6, 13, no
518991807,  NancySquitieri, 3, 1, 2, no
749355813228142592,  Giusepp87897234, 4, 1, 3, no
2854853057,  EnricoVellucci, 9, 3, 6, no
140024375,  Jabberwocky_95, 9, 4, 5, no
130822947,  FabioPandiscia, 5, 2, 3, no
787324511330918400,  pieduantonio, 14, 4, 10, no
3158540328,  Carmine60C, 4, 1, 3, no
704317090749161473,  SalvatoreVestut, 5, 2, 3, no
2338465050,  Stefania_cochi, 8, 2, 6, no
2903545671,  dracul473, 28, 5, 23, no
994626132,  maxcrespino, 4, 1, 3, no
297866031,  babbominkia, 22, 3, 19, no
79984224,  s1fab, 10, 2, 8, no
2505433479,  lucaberetta78, 5, 1, 4, no
1039674703,  leoncinakelly, 6, 2, 4, no
1176687842,  CrocFabio, 8, 1, 7, no
4909253914,  DnlCsz, 3, 1, 2, no
3208643200,  forti66, 3, 1, 2, no
3954682097,  renabulgari, 3, 1, 2, no
397153198,  IAzzimonti, 3, 1, 2, no
432766701,  RobertoParigi, 10, 4, 6, no
143264776,  SteveTheRat, 3, 1, 2, no
2724148806,  mail20115, 5, 2, 3, no
2626177428,  paolerei, 8, 1, 7, no
2467961561,  93607bc97c2b480, 10, 2, 8, no
337321550,  FusionFai, 6, 2, 4, no
804398406286381056,  SimoneG77488308, 4, 1, 3, no
1085979823,  pola1945, 3, 1, 2, no
726161324355510272,  Federic22429687, 3, 1, 2, no
71293003,  brendonrex, 3, 1, 2, no
4187056599,  Giank1970, 12, 1, 11, no
828812155,  AndreaBarocci, 7, 2, 5, no
2336792358,  RenzoMedici, 3, 1, 2, no
91429105,  ggg19621962, 3, 1, 2, no
2402581961,  Sieger73, 4, 1, 3, no
485713784,  RitaPirro, 3, 1, 2, no
796332127059058688,  jediroda, 6, 2, 4, no
2472029332,  oriente_andrea, 5, 2, 3, no
789609471211438081,  Elvis_1971, 3, 1, 2, no
389087761,  Sasha_Zurich, 5, 2, 3, no
803410022243962880,  3SIMONER4, 9, 4, 5, no
4245105094,  Yrr100, 9, 3, 6, no
1159915009,  darianichele, 5, 1, 4, no
1207677883,  DTurchino, 4, 1, 3, no
313196161,  nonnociccetto, 9, 1, 8, no
65977946,  chiiicco, 13, 3, 10, no
2264537521,  niri64, 3, 1, 2, no
7048432,  colas, 6, 2, 4, no
3094077212,  Milo54Matte, 5, 2, 3, no
2527434074,  evibenti, 4, 1, 3, no
3164117122,  mrboo80, 5, 1, 4, no
123920914,  Libero_official, 5, 2, 3, no
2854770215,  miquiz86, 3, 1, 2, no
465739646,  ivan_cast7, 3, 1, 2, no
751315632134717440,  Er_Bipolare, 6, 2, 4, no
2742489819,  gbpasini, 4, 1, 3, no
717532001,  FrancoCallegar1, 8, 2, 6, no
490529086,  ritaadivinaf, 3, 1, 2, no
381419274,  sandrosedita, 18, 3, 15, no
4436365575,  grazi2777, 18, 6, 12, no
3298972078,  stoiko76, 5, 2, 3, no
1680697170,  Gianni_Bitonti, 46, 9, 37, no
573743846,  marino_giuseppe, 5, 2, 3, no
1482937470,  merissmile, 3, 1, 2, no
319234711,  iKissBieberLips, 3, 1, 2, no
429094402,  pepedondo, 3, 1, 2, no
2276303197,  mikaelsovn, 5, 2, 3, no
318524279,  omnis16, 6, 1, 5, no
1318423074,  TheRealPoci, 13, 3, 10, no
1706397632,  briganti_andrea, 6, 2, 4, no
794560492337594368,  Andwecan1, 7, 3, 4, no
187896196,  ACabas, 3, 1, 2, no
245969509,  noitre32, 5, 2, 3, no
1951047476,  pillolina2, 7, 1, 6, no
778643052873285632,  michaelvegini, 7, 3, 4, no
2356790750,  cavacava1975, 3, 1, 2, no
3309749434,  ColajLjuba, 3, 1, 2, no
249697063,  bellasicilia78, 5, 2, 3, no
490548353,  ohmyramsey, 3, 1, 2, no
2245688323,  GiglioliCarlo, 6, 2, 4, no
2324049793,  sambuccoa, 12, 2, 10, no
805333672001961984,  dongiogi, 11, 5, 6, no
805553284337586176,  Grower757, 4, 1, 3, no
1272666296,  monacelt, 3, 1, 2, no
385456063,  carlodaverona, 44, 16, 28, no
416542224,  Ntonio71, 4, 1, 3, no
485634584,  GiancarloPasqu1, 10, 1, 9, no
2828728746,  bolzonipaola1, 12, 4, 8, no
901957920,  filomezza, 3, 1, 2, no
1142192286,  _manrico, 18, 3, 15, no
54849589,  bettigiu, 26, 1, 25, no
386988527,  Luminami_, 5, 1, 4, no
2797539111,  quintonoimbrog1, 67, 4, 63, no
708150988,  APizzocchero, 3, 1, 2, no
1951828382,  Piovegovernolad, 3, 1, 2, no
519696949,  AlbeNGiuliari, 16, 3, 13, no
1562419639,  Giadina_Blue, 17, 8, 9, no
712004079791124481,  klarolinebest, 5, 1, 4, no
309933112,  Sergioelm, 5, 2, 3, no
447945408,  Italy_Mauri, 8, 3, 5, no
797840909626998788,  mauriziodelunas, 13, 6, 7, no
603484908,  giannguerr, 3, 1, 2, no
3207310307,  Esiste_Dio, 27, 11, 16, no
702593712489172992,  Paola95516704, 4, 1, 3, no
2288643866,  Franciscovota, 3, 1, 2, no
4926458867,  lucio1455, 3, 1, 2, no
1081038630,  rscalt76, 3, 1, 2, no
4826987211,  London753, 3, 1, 2, no
1063454497,  fbcardio, 4, 1, 3, no
2366872745,  fabiobompadre, 3, 1, 2, no
4081240757,  butterMV14, 9, 2, 7, no
493833883,  MarilenaAll, 8, 3, 5, no
786445441,  lomoEffe, 16, 6, 10, no
488856416,  frencysor, 8, 3, 5, no
317659038,  adragnawalter, 7, 3, 4, no
794543370530095104,  sblindaman, 15, 4, 11, no
3126510327,  FurioGarbagnati, 43, 13, 30, no
480629483,  SimoSaletti, 15, 7, 8, no
1477936178,  damialesslazio, 4, 1, 3, no
1658559944,  AmerigoHeronn, 7, 3, 4, no
404811072,  Wizard_1979, 5, 2, 3, no
423533699,  gLizzie98, 3, 1, 2, no
97700741,  TheLaurieD, 15, 2, 13, no
163595230,  Ale_Landi, 7, 2, 5, no
474002963,  lucabaroncini85, 5, 2, 3, no
95088046,  antoniovincenti, 3, 1, 2, no
841814256,  Lore_Bellucci, 15, 2, 13, no
752239189685665792,  watohal, 3, 1, 2, no
3302939500,  14Wolly, 14, 4, 10, no
3004185915,  DeLaMarcus92, 4, 1, 3, no
1350936138,  linoannunziatac, 4, 1, 3, no
106731377,  morens3000, 3, 1, 2, no
428272958,  valentinacons, 9, 4, 5, no
413426849,  SirDistruggere, 4, 1, 3, no
67710936,  alessandrorenzi, 3, 1, 2, no
2352298477,  leonedatastiera, 3, 1, 2, no
1004844222,  ggreco66, 5, 1, 4, no
527881710,  AntonelloEspos, 4, 1, 3, no
513253779,  darioloverde, 10, 2, 8, no
381532659,  JosephCeglia, 3, 1, 2, no
39240661,  manginobrioches, 12, 5, 7, no
271865832,  Serra_nda, 5, 2, 3, no
720622101762351104,  non_guido, 4, 1, 3, no
754207227435704320,  elia1489, 5, 2, 3, no
229912717,  noemi_rx, 5, 1, 4, no
797104188434120704,  GiuseppeBuzzan1, 5, 1, 4, no
1219503126,  Lunakepassa, 3, 1, 2, no
242954953,  zizionice, 8, 2, 6, no
2987950900,  AimKiut, 14, 1, 13, no
244596457,  Lando51, 10, 4, 6, no
422670896,  crescenzocrisp1, 3, 1, 2, no
117297806,  MunguntuulO, 6, 2, 4, no
919784479,  losmattolos, 3, 1, 2, no
22009952,  DebAttanasio, 4, 1, 3, no
702408683,  DarioTosetto, 11, 5, 6, no
2160445253,  Alecroquo, 4, 1, 3, no
407093504,  filotesa, 7, 3, 4, no
3387809782,  Giacomolatona, 3, 1, 2, no
592806761,  GiaGiann, 4, 1, 3, no
128258536,  Lord_Berto, 5, 1, 4, no
58778773,  decapoa, 4, 1, 3, no
20134451,  margieblondon, 6, 1, 5, no
418174291,  JackyRose73, 3, 1, 2, no
1385042468,  elisabettares, 7, 2, 5, no
598449387,  NelloAvellani, 4, 1, 3, no
514237368,  StefanoBrannett, 7, 3, 4, no
1254398576,  GiangiFalcioni, 5, 2, 3, no
483284044,  Maudi2, 4, 1, 3, no
1061139054,  GabrieleManzo1, 3, 1, 2, no
3435663177,  Farquad93, 6, 1, 5, no
805722984350711808,  luciacroc, 6, 2, 4, no
140814256,  pietrinimatteo, 12, 1, 11, no
526710455,  MimWitcher, 5, 2, 3, no
733317428,  Enzo6547, 3, 1, 2, no
1367005093,  stillbesideliam, 7, 3, 4, no
23578155,  benjistyler, 3, 1, 2, no
18978455,  alemerini, 3, 1, 2, no
1379519166,  BenfenatiArrigo, 6, 2, 4, no
1180392648,  zerotegole, 3, 1, 2, no
3344426679,  globe_tweets, 4, 1, 3, no
2809454593,  ErViperetta, 3, 1, 2, no
155319474,  MANUEL1008, 19, 9, 10, no
805074067,  MatteoGarofano1, 3, 1, 2, no
105382067,  theliberalscum, 5, 1, 4, no
91853277,  a_guerci, 5, 2, 3, no
4157712015,  MgabriellaElle, 3, 1, 2, no
755683659538137092,  _elgorditoo, 13, 6, 7, no
127650290,  gio_dim, 3, 1, 2, no
400791209,  denysmaio, 3, 1, 2, no
414063300,  NunziaMorgani, 3, 1, 2, no
1222815008,  giusepperollo2, 4, 1, 3, no
941531808,  kadreg1, 3, 1, 2, no
767413359448842240,  _oinex_, 9, 4, 5, no
3248222176,  FearTheCera, 5, 2, 3, no
1347344792,  InsalatinaMista, 27, 5, 22, no
403505287,  PalaMatteo, 9, 1, 8, no
610172160,  DomeGian, 3, 1, 2, no
175389691,  Afirelove_xx, 3, 1, 2, no
2169771406,  rosaaggazio, 18, 5, 13, no
3331482819,  fckmehl, 3, 1, 2, no
1900353330,  followPagliacci, 5, 2, 3, no
4861701649,  stefanotweetta, 7, 3, 4, no
559054823,  LongoSilvana, 7, 1, 6, no
2513098776,  williceres, 5, 2, 3, no
57279615,  studiobugelli, 26, 1, 25, no
742089966315012097,  Kala0912, 3, 1, 2, no
1447489770,  CivettaSauro, 6, 1, 5, no
985298582,  AnnaCongelata6, 5, 2, 3, no
614362165,  MaraTahnee, 15, 4, 11, no
1406189706,  TerribilisEst, 7, 1, 6, no
631810976,  mm1064, 3, 1, 2, no
2537460423,  Pucci963, 9, 4, 5, no
455367559,  marcoarchimede, 11, 2, 9, no
493054513,  deleomarco, 28, 2, 26, no
720632435306807296,  albertodiladyme, 8, 2, 6, no
2944294475,  MASSIMO097, 3, 1, 2, no
2437660149,  FovarisDaniele, 3, 1, 2, no
1883118666,  ilCianci, 4, 1, 3, no
76904458,  Rivoltapopolare, 5, 2, 3, no
45316640,  salvatoremonaco, 3, 1, 2, no
4860620442,  VerraUngiorno, 4, 1, 3, no
3094759553,  decimohangar, 5, 2, 3, no
1037837900,  manuelatamburi1, 11, 3, 8, no
722878628250460160,  giuliodessi_, 4, 1, 3, no
585845073,  giulia1250, 9, 3, 6, no
1223801485,  clanguss, 7, 2, 5, no
443932900,  spartachisti, 5, 1, 4, no
785467653175513089,  ohgiuse, 3, 1, 2, no
3304520524,  Aemilius1977, 12, 5, 7, no
2369010655,  angelerrimo, 34, 10, 24, no
754082430055833600,  FURQUAHART, 7, 1, 6, no
795677947428503552,  noRiformaRenzi, 3, 1, 2, no
123589310,  Lauretta76, 3, 1, 2, no
4903606601,  patriarchian, 3, 1, 2, no
2199283209,  BuonRossi, 7, 2, 5, no
568209601,  adrianogasti, 5, 2, 3, no
2440253132,  lutherblassett, 7, 3, 4, no
4081124067,  anaid1958, 7, 3, 4, no
3047862489,  Butter_Fly_1, 7, 3, 4, no
580042949,  IolandaBaccarin, 8, 3, 5, no
1112761910,  isabellangelo, 3, 1, 2, no
289021157,  lucamo, 3, 1, 2, no
558842881,  FededAudino, 6, 2, 4, no
2765052793,  psikonerd, 14, 3, 11, no
3558401356,  Aldo20328433, 5, 1, 4, no
767420353,  _TommasoP, 5, 1, 4, no
4836437745,  MirnaMonti, 3, 1, 2, no
418615937,  biaprile59, 6, 2, 4, no
582909177,  PCirinoPomicino, 3, 1, 2, no
3356708404,  Paolis995, 13, 0, 13, no
396691435,  babitabby, 17, 4, 13, no
4040505046,  donatodinovi, 4, 0, 4, no
542372059,  CarlaRo38873721, 14, 3, 11, no
422708925,  spok52, 10, 1, 9, no
703511639,  mandelli_andrea, 5, 0, 5, no
254229084,  gaiatagliabue, 3, 0, 3, no
799030343475089412,  masparri, 5, 0, 5, no
875517908,  arrigotoffolatt, 2, 0, 2, no
210847731,  linusant, 9, 0, 9, no
235628934,  proudGhe, 4, 0, 4, no
496967858,  OrBellaMonella, 2, 0, 2, no
1606820196,  de0_0, 2, 0, 2, no
2288684791,  AlbertoBastai, 2, 0, 2, no
734261803140669441,  SimoGBVilla, 2, 0, 2, no
398155586,  vito_dib, 2, 0, 2, no
2943709047,  GiorniDaFavola, 2, 0, 2, no
51518999,  tiennegolf, 2, 0, 2, no
760763901889871872,  MichelaMichel12, 7, 3, 4, no
802439518947254276,  alberto2487988, 3, 0, 3, no
3870837869,  buodiammello, 14, 0, 14, no
3395984483,  stellaary1, 9, 4, 5, no
783982490860056577,  NoneonLamp, 2, 0, 2, no
251508201,  Matteo_Marenco, 2, 0, 2, no
96309027,  tigrealata, 2, 0, 2, no
1471885916,  isisargolex, 2, 0, 2, no
267714400,  GabrieleCorrado, 3, 0, 3, no
1898705130,  DSaponi, 2, 0, 2, no
2228571569,  vdafrittole, 9, 1, 8, no
175052857,  rickytatanka, 2, 0, 2, no
279301177,  bianchiga, 2, 0, 2, no
66651754,  ermetallo, 2, 0, 2, no
4883355514,  luca_greg_nico, 8, 0, 8, no
411769941,  tappocane, 2, 0, 2, no
30464221,  jacodeauss, 2, 0, 2, no
416582648,  beppeconte86, 2, 0, 2, no
2869334632,  silvietti737, 3, 1, 2, no
2336519569,  HobbesKalvin, 2, 0, 2, no
1332209119,  GMetitiero, 9, 2, 7, no
32152226,  Dumromae, 5, 1, 4, no
3380703819,  andreamarc94, 2, 0, 2, no
3294159100,  Berniecavalli, 6, 0, 6, no
453644661,  Pachelbel1980, 2, 0, 2, no
192939414,  matteozenatti, 6, 1, 5, no
805375471,  MauroAsara, 3, 0, 3, no
101014254,  davidebassani, 5, 2, 3, no
374592692,  redjonn, 2, 0, 2, no
2394411554,  Pmalerban, 3, 0, 3, no
802126039610785793,  odiolasinistra, 2, 0, 2, no
740649472552775681,  Irenedivvu, 2, 0, 2, no
223614136,  LeGentz_, 2, 0, 2, no
164590811,  Ste_Panta_Rei, 2, 0, 2, no
60286672,  DjNiky84, 2, 0, 2, no
724523436056428544,  nira_mm12, 4, 0, 4, no
115167975,  guidoKereze, 2, 0, 2, no
429070398,  ArmandoGiampier, 2, 0, 2, no
712741795264925696,  LeMiePassioni, 3, 0, 3, no
448911654,  FrancescoFibbi, 2, 0, 2, no
945453433,  piadonis, 5, 1, 4, no
383812478,  giunz, 2, 0, 2, no
964906940,  RafLuise, 3, 0, 3, no
4082854757,  SilviaTruini, 2, 0, 2, no
312660734,  Ezio_vim, 2, 0, 2, no
617997188,  Aurelio_Mazza, 2, 0, 2, no
102099568,  Marcellinosuper, 5, 0, 5, no
3012254517,  t_montinari, 5, 2, 3, no
458620740,  gastaldi_paolo, 4, 0, 4, no
758933464460648448,  anddam1258, 15, 0, 15, no
3230974558,  londinia37, 7, 3, 4, no
423537634,  MarcoRuzzi, 4, 0, 4, no
4905012609,  BeastLory, 2, 0, 2, no
3065583423,  luciovoreno3, 4, 0, 4, no
231750043,  VaranasiEle, 2, 0, 2, no
3700008443,  mirco_venturato, 2, 0, 2, no
1118920148,  resid_le_rose, 7, 0, 7, no
746282182038134784,  FrankBassF9Ca5, 7, 1, 6, no
1269373038,  Andrewetrusco, 5, 1, 4, no
2740699095,  GsSpada, 8, 0, 8, no
1341865640,  diacolare62, 4, 0, 4, no
321949553,  maniello71, 2, 0, 2, no
2895110417,  officinacaccamo, 13, 0, 13, no
555997804,  carmenfuriosa, 5, 0, 5, no
1117323301,  gianninomerlo, 28, 5, 23, no
4033150696,  AmericoPalmieri, 2, 0, 2, no
108764403,  PietroCalabrese, 3, 1, 2, no
788047861342691328,  bartologrimald1, 57, 0, 57, no
711879250572345344,  BalliniGiuliana, 6, 1, 5, no
146799199,  marianosisimbro, 2, 0, 2, no
769549749833916416,  Lavoratori_Ama, 10, 2, 8, no
4273172801,  GEvVC, 19, 9, 10, no
85258045,  margherita1974, 13, 3, 10, no
136308372,  ciambellano1235, 6, 1, 5, no
299040343,  beyondme87, 3, 1, 2, no
63961997,  jadajin, 3, 1, 2, no
770213977553047552,  GerardoFulgion1, 15, 2, 13, no
462486093,  genti_lik, 2, 0, 2, no
752979558,  sommino, 4, 0, 4, no
388362333,  gio_querelato, 10, 3, 7, no
785774096613126144,  HannaPatry, 4, 1, 3, no
394957022,  robbertoni, 26, 2, 24, no
1037335069,  BrizziValentino, 5, 0, 5, no
3257070727,  TiCommento, 9, 1, 8, no
838138819,  PDLOnesto, 68, 1, 67, no
2353250347,  LRagosi, 51, 1, 50, no
2349895098,  Picchipremier, 55, 1, 54, no
435187030,  MauriziaPicci, 2, 0, 2, no
701484965272416257,  cgilbas, 2, 0, 2, no
109083682,  prandigno, 3, 0, 3, no
50657628,  giancalsp, 11, 2, 9, no
17648551,  commazero, 15, 6, 9, no
496343408,  gabriella_turra, 20, 8, 12, no
405514210,  AlexRussello, 4, 1, 3, no
20008166,  Neurocrawler, 3, 0, 3, no
3007811949,  vivianacruciani, 3, 1, 2, no
2938357835,  lindherot, 2, 0, 2, no
151639390,  AntonioVeritas, 16, 2, 14, no
543602727,  GabrieleGucc, 2, 0, 2, no
93947421,  AndreAzzol, 4, 0, 4, no
291604982,  Holdfast77, 7, 0, 7, no
236139428,  ubbiubbi, 3, 1, 2, no
65008580,  Manusweet, 4, 1, 3, no
840304898,  fabolik, 5, 1, 4, no
1129269444,  a_iervolino, 26, 11, 15, no
2269505163,  thegulliver, 3, 1, 2, no
799642016888012800,  m5Stesso, 7, 1, 6, no
2992982729,  ModusInRebusEst, 11, 2, 9, no
432584137,  Manu_Tweety, 3, 0, 3, no
1137093510,  GiacomoBeria, 3, 1, 2, no
701480889084207105,  SenecaNana, 2, 0, 2, no
404022377,  oneshot971, 16, 4, 12, no
919778352,  vvncrv, 6, 2, 4, no
270896923,  lorenzoromani, 6, 0, 6, no
2361121173,  manuela_cirone, 8, 1, 7, no
561304474,  sgonfialepalle, 2, 0, 2, no
794554811714830337,  Dalemiani, 4, 0, 4, no
1229549244,  lucaniasi, 6, 2, 4, no
908512855,  TrioloMario, 2, 0, 2, no
4144725976,  lumi_stan, 5, 2, 3, no
242225250,  stebortuzzo, 2, 0, 2, no
213735396,  FimCatania, 2, 0, 2, no
802530080639643648,  iperione_, 13, 1, 12, no
2305531562,  jusi_lee, 9, 2, 7, no
2380747454,  MKForgione, 14, 2, 12, no
1708309334,  montemilon, 27, 0, 27, no
3056847964,  carlagen2015, 13, 3, 10, no
2348272160,  menesbatto_, 12, 2, 10, no
1326344736,  Gg2008Gianni, 6, 1, 5, no
1573555616,  disfareilpd, 2, 0, 2, no
1389988651,  Gastone_derolla, 3, 0, 3, no
3385958710,  jennifer_rosati, 12, 0, 12, no
495419596,  GianAbbasc, 9, 4, 5, no
855369620,  aranciolucy, 17, 7, 10, no
471334188,  GiuseppeZuelli, 8, 3, 5, no
2992351714,  Cgil_Napoli, 2, 0, 2, no
2566805621,  Frassannino, 3, 1, 2, no
377405042,  SimoneBarbieri2, 2, 0, 2, no
1364231341,  AlxIxAn, 36, 0, 36, no
601016936,  gpaolo_c, 5, 0, 5, no
736441270881640448,  Virgil1309, 22, 0, 22, no
2875783329,  eingel80, 5, 0, 5, no
2762114060,  gpsegala, 2, 0, 2, no
731393402,  Gatto_Mannaro, 17, 5, 12, no
3082109127,  MOsudorg, 9, 2, 7, no
2448102733,  DiabolMark, 29, 4, 25, no
111937466,  virtusi, 5, 0, 5, no
3252260663,  EffeEva, 4, 1, 3, no
703609955555917825,  Seamarin151, 3, 0, 3, no
785367204703461376,  froggyfroggy25, 8, 2, 6, no
946170176,  RistoriDuccio, 8, 3, 5, no
33994488,  ItalianPolitics, 9, 4, 5, no
3109897131,  MarinaBrunazzi, 13, 2, 11, no
3015774443,  nove_silvia, 31, 1, 30, no
628367790,  silviafranchi2, 23, 10, 13, no
206180236,  EdoardoMartino, 33, 5, 28, no
1068681522,  CarlottaDiMarco, 21, 4, 17, no
4227664641,  273_333, 58, 8, 50, no
150608013,  andreacreativo, 17, 2, 15, no
1268045520,  ennioflyano, 11, 3, 8, no
411586879,  Pinodef, 8, 3, 5, no
2353564274,  tittilatitti, 20, 2, 18, no
261705959,  ortyzapple, 9, 1, 8, no
115618304,  stefanoballeari, 3, 1, 2, no
4921156757,  RobyDi1, 5, 2, 3, no
3049067538,  HUBgiovani, 23, 2, 21, no
251094642,  kiarobsten, 38, 13, 25, no
974511188,  RMcM86, 26, 6, 20, no
81335749,  ilbeccaccino, 7, 1, 6, no
2892020627,  sport_politic, 3, 1, 2, no
3296477548,  andreabriz, 5, 2, 3, no
470977705,  AdrianoCaorsi, 6, 2, 4, no
2216107671,  gianfrancoanto7, 4, 1, 3, no
166475743,  Dedantibus, 3, 0, 3, no
20581857,  Viceitaly, 1, 0, 1, no
3200053252,  UnicronPlanetM, 53, 2, 51, no
1462993410,  311titti, 6, 2, 4, no
790250578588864512,  eleinad55, 1, 0, 1, no
3065758708,  karljuliaD, 1, 0, 1, no
777876616676466689,  Deepak65633627, 1, 0, 1, no
2974879767,  mtcaruzzo, 17, 5, 12, no
350184411,  panettos, 31, 3, 28, no
574871295,  rafcirone, 6, 0, 6, no
703877219685425152,  corinnadilelio, 1, 0, 1, no
767600300,  Beailesoloio, 18, 5, 13, no
537221457,  sconsoladdolo2, 1, 0, 1, no
242399306,  micheleserafin1, 12, 0, 12, no
759449605,  Domiko8, 1, 0, 1, no
486892441,  simone_mirko, 5, 2, 3, no
925782877,  SandroDini1, 6, 0, 6, no
2574023704,  MassimoBraga1, 8, 2, 6, no
929277121,  VALDAGRI5STELLE, 3, 0, 3, no
798640448558497792,  Toni43821316, 19, 0, 19, no
799907142484578304,  NadiaDiMartino7, 4, 0, 4, no
757917606707916804,  Malest2000, 14, 2, 12, no
2358353824,  bettap13, 9, 0, 9, no
1249912915,  pimonte5stelle, 9, 0, 9, no
256958384,  LuigiMuraca, 1, 0, 1, no
1411322347,  Barone5S, 5, 2, 3, no
4909204947,  SimoneSignorel3, 3, 0, 3, no
1558348513,  GiovannaChiaese, 1, 0, 1, no
1222087430,  AlessandraPannu, 3, 0, 3, no
600847079,  robibianchini, 18, 2, 16, no
4706326756,  gragnano5stelle, 6, 0, 6, no
373950389,  I_AM_IM_, 9, 1, 8, no
759511811964231684,  acissej07723372, 17, 0, 17, no
1222967826,  M5SVicoEquense, 6, 0, 6, no
793496531508793344,  claudia99234955, 6, 2, 4, no
76622281,  anto219, 6, 0, 6, no
1348975974,  Sica92Luigi, 22, 2, 20, no
2957131078,  sofonisba55, 37, 0, 37, no
2742709167,  papa5_pasquale, 15, 4, 11, no
461013719,  BobGhirhouse, 3, 0, 3, no
198683785,  Bruno_Brunelli, 4, 0, 4, no
398787729,  JackPlasters, 1, 0, 1, no
2986029209,  FerdiAysi, 1, 0, 1, no
555357391,  DiegoBenevento, 5, 0, 5, no
2676044931,  kingmile98, 1, 0, 1, no
22172093,  giacomos, 3, 1, 2, no
2421892166,  LauraS_1978, 7, 0, 7, no
2512944834,  MaTic2015, 6, 1, 5, no
2956918469,  Muscoli_info, 9, 2, 7, no
2466016514,  vittovolte, 3, 1, 2, no
270348042,  pierluigiluisi, 2, 0, 2, no
1470432672,  Mingus2011B, 2, 0, 2, no
2569072195,  tomtweet3, 32, 9, 23, no
909777890,  RobertoCelano, 4, 1, 3, no
1039809685,  MicheleCeoGeom, 1, 0, 1, no
347755387,  Camillanesb, 1, 0, 1, no
11418002,  ppinguinOJ, 1, 0, 1, no
308582871,  Lumen79, 1, 0, 1, no
1266792098,  peppebarbaccia, 3, 0, 3, no
830081490,  comodiceusted, 11, 3, 8, no
1354142214,  robypellegrini, 15, 5, 10, no
3070433050,  PapaPascali, 3, 1, 2, no
805405547629572096,  Marianna0054, 3, 0, 3, no
2354548375,  doc_ba, 2, 0, 2, no
2334400204,  Garnet77Luca, 2, 0, 2, no
3491171117,  paolinaLina2, 52, 1, 51, no
477844374,  kastalrogo, 2, 0, 2, no
394861796,  recymax, 24, 0, 24, no
789374017673236480,  correnteparma, 2, 0, 2, no
2187027482,  Brontolo2013, 2, 0, 2, no
395196509,  Tor72V, 2, 0, 2, no
1081906242,  CbvitoCom, 2, 0, 2, no
456081980,  mauriziorossi15, 4, 0, 4, no
8678952,  davesio, 4, 0, 4, no
4561319014,  AntonioAle5, 5, 0, 5, no
546791475,  OmnibusLa7, 6, 1, 5, no
265408261,  andreafacchini1, 13, 2, 11, no
1015870262,  red_mask9, 40, 3, 37, no
1920965048,  Hunternehmer, 7, 2, 5, no
435693275,  gianfrancosabia, 2, 0, 2, no
1456739846,  lacordacura, 5, 0, 5, no
371619032,  SimoAlex61, 4, 0, 4, no
278188295,  SalvatoreRuffo, 7, 0, 7, no
315786202,  FrancescoFiorin, 3, 1, 2, no
117407713,  AnnalisaChirico, 7, 1, 6, no
312166162,  John_Doe_1001, 10, 4, 6, no
4149937405,  FrancescoC1977, 4, 0, 4, no
594906158,  erzappa, 2, 0, 2, no
53670791,  14Arcano, 3, 0, 3, no
204955368,  tuttamagia, 3, 0, 3, no
557183767,  monnalisa65, 5, 0, 5, no
2238224184,  Gaudius97, 5, 2, 3, no
2519252925,  pabapa11, 2, 0, 2, no
47641058,  rinhello, 2, 0, 2, no
1070407046,  DonaPinna, 5, 1, 4, no
286914213,  il_teo, 4, 0, 4, no
382265822,  m_selis, 9, 3, 6, no
2351401893,  elenaghezzi73, 6, 0, 6, no
957510175,  Marco_Mazzariol, 2, 0, 2, no
800374608989818880,  Audrey17051990, 4, 0, 4, no
2404302998,  Daviddino79, 11, 3, 8, no
3062692251,  Ilariatattaresu, 2, 0, 2, no
384927198,  gparagone, 4, 1, 3, no
4305700001,  RosiDelullo17, 3, 1, 2, no
4172823213,  girossi7710, 17, 6, 11, no
2265684361,  AgostinoBianchi, 10, 1, 9, no
3296744735,  raffarsen, 5, 2, 3, no
361403479,  DaustoC, 5, 2, 3, no
1565108870,  AngeloMaranesi, 5, 2, 3, no
933043896,  boboclucianicol, 4, 1, 3, no
141612687,  MattTomato, 6, 1, 5, no
585941279,  GhostRock72, 5, 1, 4, no
3051404948,  Carlo_Scn, 9, 2, 7, no
418638857,  BFbieffe, 5, 0, 5, no
799900104123707392,  federicodescb, 14, 2, 12, no
497763567,  siciliantonio, 11, 1, 10, no
19106485,  mzzfederico, 5, 2, 3, no
172382368,  naxdistefano, 19, 0, 19, no
2984349707,  frulrobyn, 3, 0, 3, no
104485125,  mara_carfagna, 13, 0, 13, no
145561037,  tizianacarmela, 19, 6, 13, no
1749764352,  BonazzolaA, 4, 1, 3, no
602712735,  SalvScollo, 7, 1, 6, no
2815762865,  NicolaGrolla, 3, 1, 2, no
2473375067,  prestia_fabio, 4, 1, 3, no
909810168,  xeroxud, 4, 1, 3, no
2895843244,  BrokenwindowsRm, 6, 2, 4, no
561482122,  VeronicaBuffone, 5, 1, 4, no
1351561135,  KikkaJolie, 20, 3, 17, no
3514615637,  gabrie_6253, 5, 0, 5, no
862592018,  ComEroe, 15, 0, 15, no
724154607254011905,  AntonioViscomi5, 18, 0, 18, no
1222977236,  Rondo_31, 2, 0, 2, no
1372207340,  DottssaRosadeMa, 10, 0, 10, no
3384474441,  EmmaPaoli_Emma, 6, 0, 6, no
44673590,  zagor70, 11, 1, 10, no
2151696938,  1AdrianoPerrone, 1, 0, 1, no
694926126351847429,  zlatickangelo, 3, 0, 3, no
1006967593,  crisblog, 2, 0, 2, no
1014884664,  acquaviva5stell, 8, 0, 8, no
796237284,  AndreaMarchell0, 25, 3, 22, no
2487043426,  AmatoLiber, 3, 0, 3, no
923055876,  stiv1865, 2, 0, 2, no
453812693,  AntonPor, 2, 0, 2, no
1404635250,  contigiu, 8, 2, 6, no
228030987,  MeloGiunta, 2, 0, 2, no
599651301,  metalnarz, 27, 5, 22, no
2802290616,  SalameEro, 5, 1, 4, no
87286001,  danytorino, 18, 2, 16, no
236138836,  GiamBuonomo, 7, 2, 5, no
972872618,  contessaelvira, 16, 2, 14, no
268905980,  giannichiodi, 20, 7, 13, no
396823374,  fo1984, 26, 2, 24, no
94765165,  zemmu, 3, 1, 2, no
823416241,  LaGrevia, 3, 1, 2, no
467472024,  Pinjo1964, 8, 0, 8, no
47626792,  cgilnazionale, 2, 0, 2, no
466582888,  CgilBologna, 3, 0, 3, no
110669722,  RadioArticolo1, 3, 0, 3, no
104270122,  gianpiguido, 10, 0, 10, no
372746457,  DomenicoFoti, 9, 3, 6, no
773054104549593089,  riventheripper, 32, 7, 25, no
50794286,  fra_tizy, 1, 0, 1, no
2881244285,  pasangel1, 16, 6, 10, no
1179157244,  PietroLazzara, 21, 3, 18, no
407124229,  CarmelaAriosto, 3, 0, 3, no
4070811365,  Giuseppefar63, 4, 0, 4, no
452151464,  GianniGenziani, 8, 0, 8, no
3379698886,  carlabarani23, 4, 0, 4, no
518934318,  gessler_, 14, 2, 12, no
287334707,  EmaSigis, 18, 5, 13, no
853678268,  JessyMarchetto, 34, 3, 31, no
318446896,  MBellandi, 18, 2, 16, no
252088941,  M5SIMOLA, 2, 0, 2, no
789130468469899264,  DariaInVersilia, 15, 4, 11, no
2939751015,  Vultimodinosau, 4, 1, 3, no
185607318,  albyio, 3, 0, 3, no
414373079,  paulolden1, 11, 0, 11, no
4321424481,  antonellagabr, 3, 0, 3, no
760551532815351808,  lorandreoli, 2, 0, 2, no
773980492031004672,  leo1976na, 3, 0, 3, no
295284193,  msantarella, 4, 0, 4, no
518430422,  notavterzovalic, 1, 0, 1, no
1067773668,  ebbyit, 5, 2, 3, no
459317071,  stil64, 13, 0, 13, no
2383742853,  robimichelon, 1, 0, 1, no
835923896,  IMartire, 6, 2, 4, no
3068039679,  pmattoccia, 41, 8, 33, no
783976877669122048,  Akkauntdiprova, 10, 1, 9, no
42395949,  AleSalvi12, 4, 1, 3, no
101556020,  flavioquara, 2, 0, 2, no
158017561,  akakarolina, 12, 5, 7, no
597252435,  CostanzaNOCCHI, 2, 0, 2, no
389642629,  enricomlepri, 5, 0, 5, no
4584262996,  GFranco0, 3, 1, 2, no
223575921,  elakelly, 5, 1, 4, no
2992145253,  OhCumi, 2, 0, 2, no
285077023,  CelesteRotondi, 2, 0, 2, no
417091566,  Geugnagna, 2, 0, 2, no
422480814,  LFerlaino, 2, 0, 2, no
904491504,  faustoigorcampo, 4, 0, 4, no
414127619,  giovannibat46, 2, 0, 2, no
258554422,  LoZioYuri, 6, 0, 6, no
4913717650,  asMareliber, 4, 0, 4, no
493991580,  doloresgalli, 4, 0, 4, no
53030535,  alesolinas, 2, 0, 2, no
418798723,  ErmannoTarozzi, 3, 1, 2, no
1309041114,  GPasqualucci, 2, 0, 2, no
4893303449,  MrGioppino, 2, 0, 2, no
442833297,  vit978, 2, 0, 2, no
2371576541,  davidirus79, 5, 0, 5, no
2478979036,  iivannoteii, 2, 0, 2, no
545264740,  innominato77, 6, 0, 6, no
355422495,  Salvatoremanga, 3, 1, 2, no
379112362,  MonicaSpissu, 2, 0, 2, no
3081629057,  caglie17, 3, 0, 3, no
368338436,  dante4710, 9, 1, 8, no
487521897,  GNuti, 4, 0, 4, no
3559735215,  aleritamaria, 14, 0, 14, no
477096884,  pietrolecca, 8, 0, 8, no
779336944916504576,  Segnaliamoli, 32, 0, 32, no
750717566818119680,  lamiamam, 6, 0, 6, no
776823999678517249,  PrimumRerum, 2, 0, 2, no
2323497080,  RIKKIA77, 3, 1, 2, no
706086767523405824,  GaleonisV, 16, 0, 16, no
864509790,  StipendioXTutti, 2, 0, 2, no
373940749,  l22672, 2, 0, 2, no
425659307,  dadecase, 2, 0, 2, no
147551178,  alexitalian1, 2, 0, 2, no
1082553030,  davidenicolosi3, 2, 0, 2, no
613870699,  VaccariMv, 6, 0, 6, no
567185278,  BabboOrso, 2, 0, 2, no
385844069,  antonioinoki10, 2, 0, 2, no
209080471,  StePeduzzi, 4, 1, 3, no
2493829429,  nannarella60, 11, 0, 11, no
2778824457,  Va_Tutto_Bene, 15, 3, 12, no
765293676671168513,  sage2408, 2, 0, 2, no
89668286,  MarioAbbruzzese, 6, 0, 6, no
854521818,  alebuccelli, 5, 0, 5, no
415820835,  GualtieroCarini, 8, 0, 8, no
386753792,  valeriodimauro, 4, 0, 4, no
2841747857,  isix82, 3, 0, 3, no
80891401,  tamy79, 4, 0, 4, no
3088659569,  giuliomancini91, 10, 1, 9, no
4875252683,  CROCE_CELTICA, 3, 0, 3, no
438676662,  MeloniGabriele, 2, 0, 2, no
794799817495085056,  PlecoDi, 2, 0, 2, no
3610537156,  XPuglia5Stelle, 19, 0, 19, no
465428994,  andreagmelillo, 1, 0, 1, no
2417405263,  moniquepot1, 1, 0, 1, no
514243349,  m5sbari, 21, 0, 21, no
1285373419,  gcichetti3, 4, 0, 4, no
761809560,  pani_elilippa, 11, 0, 11, no
4838940477,  Aladin1099, 1, 0, 1, no
3412818976,  Puglia_M5S, 5, 0, 5, no
934053559,  AlfredoGiusti3, 10, 1, 9, no
1250267900,  mazzanti_giu, 3, 0, 3, no
3033189805,  BringTheLightKP, 4, 1, 3, no
2509994134,  GuidoSchiavulli, 24, 1, 23, no
399663966,  danybaby0001, 10, 0, 10, no
2164608279,  MirkoRefatti, 43, 7, 36, no
2202015179,  vindimaso, 4, 1, 3, no
1220072246,  GNN1960, 25, 1, 24, no
233704986,  Frenk36, 6, 1, 5, no
2752094872,  spadafora_luca, 3, 1, 2, no
3853195053,  daniele_pelli, 4, 0, 4, no
1898454535,  Giocoleria1, 47, 3, 44, no
1212975134,  burbero1961, 16, 2, 14, no
634832081,  officinainforma, 11, 3, 8, no
3552957021,  Enzo71428603, 3, 0, 3, no
1008813289,  bellafavapasqua, 3, 1, 2, no
1244200904,  giuseppe45G, 10, 0, 10, no
393352465,  franco_martino, 4, 0, 4, no
702443682126041089,  b_lore97, 8, 2, 6, no
2608508709,  carloggranara, 7, 2, 5, no
2919268179,  Angelo03557182, 3, 0, 3, no
3357276724,  ngr_angela, 3, 1, 2, no
2335353948,  saffina4, 8, 1, 7, no
614852872,  Sassi1965, 2, 0, 2, no
3047851452,  crisfilippelli, 15, 0, 15, no
3949425333,  johncotton1585, 4, 1, 3, no
182737832,  amorlupi, 5, 0, 5, no
2195935780,  tpw039, 2, 0, 2, no
2292963709,  tommaso_valleri, 5, 2, 3, no
773891042198351872,  Stefano_Striano, 2, 0, 2, no
1374984048,  forzapd, 11, 3, 8, no
742361647818395648,  Angelo77306451, 2, 0, 2, no
1076337458,  deluca_linda, 2, 0, 2, no
744856218771009536,  LuciaLeone14, 5, 1, 4, no
793461328081985536,  SalviniIltosco, 3, 0, 3, no
467568195,  Mr_siro87, 4, 0, 4, no
4186808596,  borntobecyclist, 2, 0, 2, no
799217632264200192,  DannyBull91, 2, 0, 2, no
385028903,  GianlucaFidene, 2, 0, 2, no
2964565162,  pinabiondi58, 3, 0, 3, no
413330025,  brazo66, 3, 1, 2, no
216720717,  saramo2, 2, 0, 2, no
2181642961,  zenit5458, 3, 0, 3, no
2364617093,  roselli80, 4, 1, 3, no
788366990956236800,  MorenoCarpaneto, 2, 0, 2, no
802149923873521664,  _LadyWinterfell, 6, 0, 6, no
3027177286,  cosv99, 3, 0, 3, no
803169294389510144,  Lupetto52807502, 8, 0, 8, no
39058202,  barbaramodesti, 2, 0, 2, no
1368025074,  emiliano978, 8, 0, 8, no
475965087,  mfrascatano, 21, 4, 17, no
2570849169,  ro_datt, 3, 0, 3, no
609894475,  ChiaIod, 3, 0, 3, no
410942100,  maxmor2, 2, 0, 2, no
55250984,  miky512, 4, 1, 3, no
58201131,  kopulos, 9, 1, 8, no
1336547604,  Jay_Kappa, 2, 0, 2, no
4611169457,  Dasansei, 4, 1, 3, no
2572257123,  vittiveronese68, 2, 0, 2, no
1547443927,  Davide_Thor, 3, 0, 3, no
409518536,  FrancescaCose, 10, 0, 10, no
1311177253,  filrug, 2, 0, 2, no
2889612136,  _d_a_n_i_e_l_e_, 49, 4, 45, no
805461075458146304,  68tifosonapoli, 5, 0, 5, no
222442719,  ggamberonci, 12, 3, 9, no
796005053534498818,  Carusoluigi5, 5, 0, 5, no
339874904,  Ilenya68, 4, 1, 3, no
279542176,  Instinctkube, 2, 0, 2, no
3068049551,  TEsposito95, 8, 0, 8, no
370169443,  BergamoEmanuele, 4, 0, 4, no
327003115,  AntonioMandolfo, 3, 1, 2, no
737298834385166340,  Renato01384155, 2, 0, 2, no
238909327,  francescoparava, 2, 0, 2, no
474303874,  rihannasbboobs, 14, 3, 11, no
95385414,  policoalf, 4, 1, 3, no
1284039450,  energymanu, 2, 0, 2, no
3128584955,  adolisa, 2, 0, 2, no
1525243567,  anna_blrd, 4, 1, 3, no
963073442,  c_appendino, 11, 2, 9, no
1539421987,  estrojos, 55, 10, 45, no
1092172458,  baraldop, 4, 0, 4, no
465631373,  lidialoffredo, 48, 3, 45, no
2501199751,  UmbogyVella, 5, 2, 3, no
3007835170,  GhinottoFab, 5, 0, 5, no
948730916,  mteresaGHorta, 2, 0, 2, no
1007270076,  LorenzoPalesti1, 6, 0, 6, no
3527260401,  rinosiconolfi1, 225, 0, 225, no
791724313552547849,  Dravil97, 2, 0, 2, no
118740741,  angelobellusci, 2, 0, 2, no
767423908404457472,  MicheleBrunell6, 2, 0, 2, no
438518215,  monicarizzini1, 2, 0, 2, no
706606079774486532,  drifer8, 2, 0, 2, no
3419697862,  emrico_balella, 2, 0, 2, no
2173760019,  gabryfabiano, 4, 1, 3, no
630459182,  67Malaguti, 15, 2, 13, no
309533058,  zizigong, 5, 0, 5, no
452960309,  farina_domenico, 2, 0, 2, no
245378986,  cupidovj, 28, 0, 28, no
281097296,  GalleriaDAMarte, 3, 0, 3, no
242776975,  tore75, 2, 0, 2, no
793048979948929024,  SilviaVivarell1, 2, 0, 2, no
543690939,  MarcoAretino, 3, 0, 3, no
757257628263276544,  vittorinho60, 4, 0, 4, no
2735509463,  ri_cara, 2, 0, 2, no
1855609550,  mila1035, 2, 0, 2, no
541752926,  PaoloGiangrasso, 2, 0, 2, no
96327375,  Tizianamanca, 2, 0, 2, no
45522065,  italiandream48, 5, 2, 3, no
703348631261282304,  caiazzostefy, 2, 0, 2, no
428032196,  igiulz, 2, 0, 2, no
783407476330889216,  isdri96, 2, 0, 2, no
787255535947091968,  SirianaFinotti, 2, 0, 2, no
567633436,  ileggend, 2, 0, 2, no
513598801,  sylilla, 2, 0, 2, no
767616854,  adelmocastagnet, 7, 0, 7, no
794498319808663556,  franksinopol, 2, 0, 2, no
2331733877,  Michel79086762, 5, 0, 5, no
568393612,  claudiababu, 3, 1, 2, no
1044954534,  checcofiori, 2, 0, 2, no
773029583583076352,  EPiccolo48, 6, 0, 6, no
409332025,  SavonaAccursio, 12, 1, 11, no
1013093844,  alemaste73, 2, 0, 2, no
143235905,  frafec, 2, 0, 2, no
952558944,  elche67, 10, 0, 10, no
764448838434390016,  simone_attilia, 2, 0, 2, no
2304228233,  LisaLacanfora, 2, 0, 2, no
50598789,  mariomosca, 2, 0, 2, no
482042101,  emura1976, 3, 1, 2, no
405854311,  annaangelini1, 2, 0, 2, no
2942440745,  to_elia, 4, 0, 4, no
3179223957,  Mic_a_e_la, 24, 0, 24, no
2890463488,  Mrck86, 2, 0, 2, no
4083826618,  Ora1234567, 2, 0, 2, no
19110013,  bulini, 3, 0, 3, no
603441494,  GuerriereAmedeo, 2, 0, 2, no
599608633,  RiccardoCioni2, 2, 0, 2, no
1702730929,  980Luca, 3, 1, 2, no
1479417662,  SPEVENTIMANAGEM, 2, 0, 2, no
3902631803,  erpvet58, 2, 0, 2, no
552242754,  sirottatwitt, 2, 0, 2, no
3652269263,  NinoCarlao, 31, 10, 21, no
1622970242,  adrimarcotulli, 45, 2, 43, no
831854412,  Orsobianco68, 8, 0, 8, no
558534010,  monicapipitone, 11, 0, 11, no
799774009072226308,  MaxPODz, 2, 0, 2, no
2375711402,  Walter5Stars, 5, 0, 5, no
574765497,  VanessaCarrozza, 10, 0, 10, no
515561206,  twicolombotter, 3, 1, 2, no
789058472860082176,  mikjred, 3, 0, 3, no
1194815508,  Livio_Sicily, 6, 1, 5, no
499080594,  scerbanton, 2, 0, 2, no
4892570230,  ft093962, 3, 1, 2, no
2824712309,  kpuoma, 12, 0, 12, no
4877257138,  laeli67, 3, 0, 3, no
802795895767134208,  Michel34945515, 4, 0, 4, no
3094380329,  mimmo_2015, 2, 0, 2, no
4046146715,  fabionicolet, 2, 0, 2, no
1555265359,  liarossi15, 2, 0, 2, no
4416614361,  AliquidLucis, 4, 0, 4, no
2367591444,  nannipalex, 4, 0, 4, no
459180701,  Matthew_T_Kent, 2, 0, 2, no
1699274312,  GMiglioranzi, 2, 0, 2, no
700244333,  GiacomoNesci, 2, 0, 2, no
3299950450,  riply_biz, 4, 0, 4, no
194515238,  susarda, 2, 0, 2, no
1008939038,  alecerio, 2, 0, 2, no
586804044,  TizianoTorielli, 15, 2, 13, no
2312465170,  LucaLucas0777, 2, 0, 2, no
2306567981,  SserCarlo81, 2, 0, 2, no
194196738,  GrazyBell, 7, 0, 7, no
742180351821418496,  AlexFiori121, 2, 0, 2, no
459464288,  sabrylomb, 3, 0, 3, no
1257745957,  billobillo2, 5, 1, 4, no
975582895,  patbenvenuti, 2, 0, 2, no
4251078683,  IL_DUCA_MOCCI, 4, 1, 3, no
3131346994,  DiegoAn0n, 4, 0, 4, no
1869414950,  milljfiori, 18, 0, 18, no
261542509,  vittoriobarile, 22, 0, 22, no
3384471478,  Victor24852, 3, 0, 3, no
2933177745,  YariDolo, 2, 0, 2, no
2739348212,  costajoe40, 3, 0, 3, no
355545085,  andreazannoni2, 8, 0, 8, no
3027987772,  bdecbec75d784b2, 9, 0, 9, no
804674615528292352,  NicFranc3, 3, 0, 3, no
1324659536,  AleMonster97, 2, 0, 2, no
2694520743,  matkava96, 3, 0, 3, no
712275596001288192,  LorenzFKT, 2, 0, 2, no
943120548,  RosannaMagnani1, 7, 0, 7, no
3261477083,  ciullgius, 4, 0, 4, no
96666156,  millarockstar, 7, 1, 6, no
849387156,  luca190771, 15, 1, 14, no
1157854118,  nocitovirginia, 3, 1, 2, no
634737656,  renoZed, 3, 0, 3, no
1036938613,  SofiaMa07413947, 28, 1, 27, no
2832119268,  vlista65, 2, 0, 2, no
292164334,  MarinaTerribile, 2, 0, 2, no
507724462,  Shabbar84, 5, 2, 3, no
269212676,  ninoaccardo, 2, 0, 2, no
617532607,  Paolowab, 2, 0, 2, no
719102022591639552,  emmygrams2, 2, 0, 2, no
88051558,  gigifuiano, 4, 0, 4, no
499152966,  RolandoCerullo, 2, 0, 2, no
1246988113,  ernesto_quaglia, 2, 0, 2, no
348374702,  ilcastelli, 2, 0, 2, no
3105772210,  StefaniaGandos1, 2, 0, 2, no
197424739,  NickCrive, 10, 0, 10, no
814747711,  Pietro3591, 65, 25, 40, no
723845674043858944,  CristinaNegrin3, 2, 0, 2, no
1099195932,  montitemagna, 2, 0, 2, no
1036168604,  MastronardiGino, 2, 0, 2, no
2362418930,  andreafari_, 20, 0, 20, no
1303512036,  MarioUrsumando, 3, 0, 3, no
727844588459835393,  giorgiomari16, 3, 1, 2, no
1208685920,  OGGIMAESTRALE, 4, 0, 4, no
536451917,  adryfog, 6, 1, 5, no
3102687059,  aragorn2966, 2, 0, 2, no
792614406135873537,  Loredan60699004, 11, 0, 11, no
702152442239180800,  deme_19, 2, 0, 2, no
748253339469643777,  Carla89092568, 4, 1, 3, no
597518498,  Irenerusso60, 2, 0, 2, no
733722041585655808,  ealges56, 7, 0, 7, no
2261638041,  MessuaShandar, 9, 0, 9, no
795950031916376065,  arzachena5star, 6, 0, 6, no
3065317450,  aldillasyarli, 2, 0, 2, no
2744571067,  MCavallerin, 2, 0, 2, no
1001956213,  piebor, 5, 2, 3, no
101280803,  stascrivendo, 2, 0, 2, no
510360682,  konzenDj, 15, 0, 15, no
615152166,  gisondo, 5, 1, 4, no
776144101850943488,  mangiaracina77, 3, 1, 2, no
772179889877295104,  Mikeledanzilli, 3, 0, 3, no
415784288,  FrancyU2, 2, 0, 2, no
2731843617,  milesi_mirko, 2, 0, 2, no
47493493,  yuzaman, 2, 0, 2, no
1215629552,  94Catalano, 2, 0, 2, no
803130723246940160,  morenashanti, 2, 0, 2, no
1531397095,  luciadelloiacov, 15, 2, 13, no
4115046268,  barbarademarco9, 2, 0, 2, no
1057961011,  LucBorzelli, 2, 0, 2, no
4252762821,  PrimoPrimero, 5, 0, 5, no
1017498192,  paolodannunzio2, 2, 0, 2, no
437747012,  gabrieppe, 3, 0, 3, no
501153654,  SergioBraga55, 3, 0, 3, no
124162915,  IJCSLYMJ77, 5, 0, 5, no
1933284714,  Freegolor, 19, 4, 15, no
1858478731,  sacchaw0, 2, 0, 2, no
222914046,  HanzoHattori23, 2, 0, 2, no
3342653327,  AndreaGemignanj, 13, 0, 13, no
520291889,  macisimi, 20, 1, 19, no
1074741745,  fabal_, 2, 0, 2, no
804991669972176896,  Nello13011952, 6, 0, 6, no
2192692641,  cima_luisa, 6, 0, 6, no
2317495928,  CLagoM5S, 21, 0, 21, no
2874154983,  FrancescoLau83, 6, 0, 6, no
357464260,  Paolo__Ferrara, 23, 0, 23, no
939620869,  ManuelaLarena, 13, 6, 7, no
783315138497642496,  sannio46, 3, 0, 3, no
435003460,  FedericoErminia, 2, 0, 2, no
2169813478,  bazzani64, 3, 0, 3, no
453959464,  marcovic79, 24, 1, 23, no
3300230453,  Ninalabarbera, 19, 6, 13, no
2530314205,  M5S_Europa, 22, 1, 21, no
2327584543,  manolouser, 7, 0, 7, no
407817358,  sparowM, 8, 0, 8, no
761997788662169605,  ILpiddinoRocco, 15, 3, 12, no
1650664062,  ritaenello, 2, 0, 2, no
219712189,  zeldarenata, 4, 0, 4, no
1186844724,  mariogiuseppem1, 2, 0, 2, no
706826094,  FaustoBartolini, 2, 0, 2, no
2846746942,  bertoldino00, 7, 0, 7, no
2354230935,  nicola39901992_, 2, 0, 2, no
784829018457636864,  Trpvnt95Vito, 2, 0, 2, no
940945716,  SandroPaderi, 2, 0, 2, no
786135013729402880,  pep_zap, 21, 5, 16, no
457819169,  teoz1993, 2, 0, 2, no
248669477,  Lucagibbe, 2, 0, 2, no
793522021263179776,  Filippo87081261, 3, 0, 3, no
58990105,  TeresaDonato, 3, 0, 3, no
1281404929,  ubongarzoni, 2, 0, 2, no
413060957,  GianpietroG, 9, 1, 8, no
793749599899058176,  sarah_14285, 2, 0, 2, no
980577650,  netdany75, 3, 0, 3, no
574433501,  ElkoGaetano, 3, 0, 3, no
398290240,  otisblue58, 10, 4, 6, no
1058019872,  morenograssi, 4, 0, 4, no
3987990022,  Michele97067287, 2, 0, 2, no
804694899136270337,  guido_chiovato, 2, 0, 2, no
2745818051,  adrianaobreja1, 2, 0, 2, no
454009387,  Smellymelly84, 13, 2, 11, no
542146146,  nino_aiello, 11, 1, 10, no
381076830,  serafinosalerno, 2, 0, 2, no
796393148066988032,  cla_delgobbo, 2, 0, 2, no
1044233354,  MarcoVantin, 3, 0, 3, no
1947918198,  ASignoroni, 2, 0, 2, no
2358597147,  LeandroPetrotta, 2, 0, 2, no
781793383052374017,  MauroPelliccia8, 8, 1, 7, no
212500329,  noveturbo, 2, 0, 2, no
870137624,  Monia__95, 2, 0, 2, no
319634872,  lorenzolippolis, 4, 0, 4, no
3175658951,  misteryo60, 3, 0, 3, no
86455803,  Solarthought, 4, 0, 4, no
305854390,  GianlucaRonca, 2, 0, 2, no
2153292263,  CameddaJacopo, 2, 0, 2, no
2478145269,  CaroSandracaro, 2, 0, 2, no
15408344,  tatomix, 12, 0, 12, no
735414206,  orni_vedo, 2, 0, 2, no
758752401474121729,  giakkagiakka, 2, 0, 2, no
3397648523,  Niccol79827807, 32, 0, 32, no
4861365023,  luca_fezzi, 6, 0, 6, no
410894122,  paolomelzi, 6, 1, 5, no
235877809,  mauriziopica, 1, 0, 1, no
3347471813,  _Marco_81, 1, 0, 1, no
137278976,  antonio_vinci, 1, 0, 1, no
4901364209,  The_collector22, 5, 0, 5, no
228189307,  ZipBlu, 3, 1, 2, no
2153319320,  antoss00, 2, 0, 2, no
523200808,  AntoninoMartin1, 6, 0, 6, no
83865444,  gnaojones, 8, 0, 8, no
3006219351,  67Gentile, 1, 0, 1, no
416272206,  duiliogennari, 1, 0, 1, no
601855480,  cata_gianni, 4, 0, 4, no
33897141,  mirkocavion, 5, 1, 4, no
2313567032,  bondinisergio, 2, 0, 2, no
184936094,  rkmontanari, 3, 1, 2, no
4256624122,  teomine68, 1, 0, 1, no
128859858,  Hatch2676, 6, 1, 5, no
803943194,  petrogalli67, 1, 0, 1, no
267313733,  PFB969, 2, 0, 2, no
96370832,  lucagrazzini, 1, 0, 1, no
917041897,  MassimoBertoni3, 8, 1, 7, no
1565122411,  robertamercorio, 1, 0, 1, no
406884836,  spadanuda, 1, 0, 1, no
2930397267,  a13b44a597fb434, 1, 0, 1, no
906745448,  antossina5, 1, 0, 1, no
3036233567,  ZadarOfficial, 5, 0, 5, no
886485402,  claudiaimpressi, 1, 0, 1, no
468467131,  pennettablu, 1, 0, 1, no
525836240,  AlessandroDevi, 1, 0, 1, no
888385988,  nardinicarlotta, 3, 0, 3, no
888353958,  lucacarli0, 2, 0, 2, no
2413125525,  socialmatte, 2, 0, 2, no
375285024,  Jorida1977, 1, 0, 1, no
374447222,  reterurale, 4, 1, 3, no
3438806667,  walsabatini, 1, 0, 1, no
411005470,  g_esentato, 1, 0, 1, no
4157934987,  db56Pa, 1, 0, 1, no
2721197602,  teocentonze100, 2, 0, 2, no
323446144,  Francesco_Vozza, 2, 0, 2, no
3064631746,  AnSantorum, 5, 2, 3, no
919871334,  xavierhue007, 5, 2, 3, no
2392084666,  luchi50135, 14, 6, 8, no
239143892,  nenciafi, 13, 3, 10, no
1868295402,  fdegasperi, 6, 0, 6, no
494475884,  GotorMiguel, 13, 3, 10, no
187452064,  rodolfobellini0, 13, 4, 9, no
406907103,  LBesi, 2, 0, 2, no
1068896102,  marletta2003, 8, 3, 5, no
3247838446,  giovaUg, 5, 1, 4, no
2306444410,  freecookies_, 9, 1, 8, no
411046193,  whasshappenss, 3, 0, 3, no
1613475049,  ycnarF1988, 10, 1, 9, no
520560735,  seremart, 9, 3, 6, no
1681073648,  gianpaolag18, 15, 2, 13, no
753218253598625792,  Giancar37600182, 5, 0, 5, no
2938546498,  mario__lavezzi, 3, 0, 3, no
462764304,  StefanoMenenti, 11, 2, 9, no
143393223,  ignaziocorrao, 6, 2, 4, no
249620286,  Earthfriend88, 1, 0, 1, no
2372863064,  Alba35582229, 5, 0, 5, no
282240212,  GennaAndrea, 2, 0, 2, no
319782293,  NicolettaOmezzo, 20, 0, 20, no
1063345483,  Agenzia_Funebre, 3, 1, 2, no
2527443220,  tottoi70, 1, 0, 1, no
3035292231,  stefanocoli47, 3, 0, 3, no
2369091619,  Antoniocricm, 1, 0, 1, no
2314008111,  stefanorossi825, 5, 2, 3, no
407194493,  damorantonio, 43, 6, 37, no
847495968,  andreatornago, 1, 0, 1, no
139464051,  GrandePas, 1, 0, 1, no
3304582408,  michelepace324, 1, 0, 1, no
1384478448,  ElisabettaDAle1, 12, 0, 12, no
1734072200,  MaraTurini, 3, 0, 3, no
730429888977641472,  EnricoBiccarin3, 1, 0, 1, no
1580269218,  LeuciLuigi, 2, 0, 2, no
312615662,  garat_o_meter, 2, 0, 2, no
1455581167,  lberto67, 3, 0, 3, no
460355867,  marco67mm, 1, 0, 1, no
707318418677092353,  VincentMA, 2, 0, 2, no
2394796134,  FIMezzocammino, 2, 0, 2, no
1062998066,  RossiEmilioS, 1, 0, 1, no
2286663444,  seboleanza, 1, 0, 1, no
139086039,  Vane_ace, 2, 0, 2, no
1026122636,  NicoloGiraldi, 1, 0, 1, no
1224152383,  fantaliz, 8, 3, 5, no
2447717504,  masdepasca2, 10, 0, 10, no
551339829,  EliGaravaglia, 1, 0, 1, no
2763305468,  alessand_mella, 5, 0, 5, no
565750845,  Antony_Mammino, 3, 0, 3, no
2896170585,  enricoperte, 1, 0, 1, no
703327398859816960,  RisoStolto, 2, 0, 2, no
1966564285,  ravischumber, 4, 0, 4, no
1040471648,  annalisabaroni, 2, 0, 2, no
595613960,  FrancoSalis, 4, 1, 3, no
131238747,  stefanopolastri, 13, 0, 13, no
715421276563701760,  123schiodati, 1, 0, 1, no
1343953026,  Valemont20, 2, 0, 2, no
45803546,  GiorgioDelfino, 1, 0, 1, no
1526069822,  voce_riccardo, 1, 0, 1, no
54168213,  angelofrighetto, 1, 0, 1, no
764034561814716417,  karlokarli9, 3, 0, 3, no
1655636611,  LaGabbiaTw, 15, 5, 10, no
157950019,  luigi_ci, 7, 3, 4, no
269799316,  monicandsugar, 1, 0, 1, no
802320974,  pisani_anna, 14, 5, 9, no
1179455066,  ppppyellow, 4, 0, 4, no
709467172,  ulfton, 4, 0, 4, no
232503766,  DanieleBassini, 1, 0, 1, no
1062966253,  lveronese65, 7, 1, 6, no
1453854996,  salfium, 1, 0, 1, no
606602735,  mara_venezia, 2, 0, 2, no
370206198,  andrearamos1971, 6, 0, 6, no
777852967504506880,  danipoppo, 1, 0, 1, no
567086543,  LiveandletLie, 8, 0, 8, no
795393269559656449,  Shady_Sequy, 1, 0, 1, no
1385284172,  mat77farina, 1, 0, 1, no
514794207,  mgiuscaffagnini, 4, 1, 3, no
1369902319,  astronomhy, 2, 0, 2, no
789181592564404224,  MinaMurray75, 7, 0, 7, no
864186162,  LuigiPiccirilo, 13, 1, 12, no
318882223,  LucianoBec, 18, 0, 18, no
1638278257,  dellorco85, 35, 0, 35, no
529656077,  xilax65, 1, 0, 1, no
491353254,  DonZauker1, 6, 1, 5, no
791043991714299904,  Isabell93255846, 1, 0, 1, no
2754731478,  MpPatrizia, 19, 1, 18, no
1885749720,  DinoPadovano, 4, 0, 4, no
496982040,  AngeloBozzoni, 3, 0, 3, no
799175088423706624,  Mad_Sound83, 5, 0, 5, no
129482901,  vmaggio, 5, 2, 3, no
434839840,  lauracesaretti1, 28, 8, 20, no
2367661536,  steffan3065, 12, 2, 10, no
3949073254,  Ambra03461759, 11, 3, 8, no
469717295,  paolinojper, 13, 6, 7, no
2707254209,  MarazitiMassimo, 5, 2, 3, no
1070288839,  Lucone71, 9, 2, 7, no
783244525728915456,  instantaneparis, 1, 0, 1, no
727483794467463169,  alvaroretorico1, 1, 0, 1, no
752520131553660928,  lisasciltian1, 1, 0, 1, no
770271033119178752,  annalisabuscem1, 1, 0, 1, no
803269234209988608,  bennyschrai, 1, 0, 1, no
785096776122507264,  ErwanKermagoret, 1, 0, 1, no
757926274522288129,  LogicAttenuante, 1, 0, 1, no
355724715,  silviastaerman, 1, 0, 1, no
335547677,  macastal, 6, 1, 5, no
1248044209,  nomicrochips, 11, 2, 9, no
2296214830,  ccpensi, 3, 0, 3, no
1356468979,  angida118, 5, 2, 3, no
519619381,  arturodelisi, 16, 4, 12, no
1926643158,  daniela61778885, 11, 5, 6, no
1377266593,  g_bianchi59, 4, 1, 3, no
3295658451,  _DJM__, 16, 4, 12, no
4765490783,  matteo5104, 4, 1, 3, no
490367299,  GOccorsio, 16, 3, 13, no
2469776817,  simobona75, 6, 2, 4, no
101218055,  cezar073, 17, 5, 12, no
732661771836755968,  Bet69Rossi, 3, 1, 2, no
13899542,  blugalu, 3, 1, 2, no
221774529,  alf_crisci, 3, 1, 2, no
426178907,  pasqu85, 6, 2, 4, no
4768175920,  walterdagal, 3, 1, 2, no
718895818305048576,  CorrMaupa, 5, 2, 3, no
778859035122601984,  sylbolid, 4, 1, 3, no
2557627068,  MezzadridItalia, 6, 2, 4, no
135806832,  lesferedeldrago, 3, 1, 2, no
116803999,  raffaele_trano, 3, 1, 2, no
2786310392,  The_Last_Gasp, 4, 1, 3, no
3369127809,  IreneBrin2015, 7, 3, 4, no
743565574555504641,  francescospuma_, 3, 1, 2, no
595878183,  danbertsamp, 53, 23, 30, no
64789750,  marcoavvo, 5, 1, 4, no
2892298719,  luciabruno113, 14, 4, 10, no
557074159,  ImmaIavarazzo, 14, 1, 13, no
791171156489408512,  Tigro99371447, 4, 1, 3, no
483057595,  WebGinMovimento, 3, 1, 2, no
1262566346,  valeria_ci, 16, 2, 14, no
3482470821,  lokoloko711, 7, 3, 4, no
408246656,  massimoscaleia, 9, 4, 5, no
3303241126,  ef97d3e33fca439, 3, 1, 2, no
498191944,  neri_valeria, 3, 1, 2, no
66298874,  peppedimiccoli, 9, 3, 6, no
478995914,  beppemg60, 4, 1, 3, no
16182995,  cosmic53, 4, 1, 3, no
517389774,  Max_Puccio, 7, 3, 4, no
615303191,  anghpel, 4, 1, 3, no
756771079981522944,  DanielaDodo2016, 3, 1, 2, no
783035081116049409,  salvatoredavola, 4, 1, 3, no
131236751,  PupiParis, 5, 2, 3, no
795565851265159168,  vviola14, 5, 2, 3, no
4544396435,  e_c_o_c, 5, 1, 4, no
291763976,  sciltian, 7, 2, 5, no
87677127,  MarX_77, 3, 1, 2, no
428601367,  Andredpi, 7, 2, 5, no
1621368146,  dinamoandrej, 15, 6, 9, no
3399065008,  fernandohz55, 10, 4, 6, no
444612914,  DanieleColonna, 8, 3, 5, no
410040461,  biblos65, 8, 2, 6, no
1472638976,  ImmaEvan, 7, 3, 4, no
2277568157,  Dalpha42, 4, 1, 3, no
1528759902,  Alburen, 14, 3, 11, no
2298294082,  romano_ciluzzi, 9, 4, 5, no
450585386,  luisabosco, 9, 3, 6, no
3412690750,  js_avvamericano, 3, 1, 2, no
596833964,  darkzam89, 7, 2, 5, no
1037982133,  danilobigi, 3, 1, 2, no
340972113,  LorenzoMiglior1, 29, 7, 22, no
568298608,  Stecaligola, 8, 2, 6, no
1006949785,  gvignatg, 6, 1, 5, no
444225252,  colvieux, 11, 2, 9, no
3844243173,  Debby_Sprint, 6, 2, 4, no
1024778318,  VendraminA, 3, 1, 2, no
218093343,  Alessandro_S_, 3, 1, 2, no
2883813258,  lindavitale11, 3, 1, 2, no
547635512,  Pau_e_Pauino, 6, 2, 4, no
3840758295,  lelesoulx, 3, 1, 2, no
128355143,  folleragione, 4, 1, 3, no
445699557,  vitale_paolo, 4, 1, 3, no
4588008687,  RIPORTO, 20, 1, 19, no
805791194462691329,  WPAOLA_RH, 16, 7, 9, no
3402412755,  mcdallicardillo, 56, 6, 50, no
3166156053,  MikeZapMG, 18, 6, 12, no
763405961205800961,  enzo97457178, 23, 3, 20, no
1317107058,  chiaramortari1, 3, 1, 2, no
464691892,  ca_ste, 7, 3, 4, no
1066796996,  CortesiLorena, 7, 3, 4, no
556620797,  ManuelTundis, 5, 2, 3, no
2808346126,  melarosag, 9, 1, 8, no
1145650134,  MarcoCivolani, 12, 5, 7, no
2232029869,  RossiGabrio, 7, 1, 6, no
593759199,  Iron_Iceman, 5, 2, 3, no
1934151967,  valentistrada, 3, 1, 2, no
1339067298,  Andranikat, 4, 1, 3, no
3436934397,  monicadidomeni, 5, 2, 3, no
789589519,  bettape, 9, 2, 7, no
369702714,  Anmagiuffreda, 3, 1, 2, no
404836757,  EGardini, 13, 5, 8, no
4203955936,  Antonunna, 4, 1, 3, no
595267886,  AnpiBrescia, 41, 17, 24, no
517717792,  LillyLilly79, 14, 6, 8, no
615539623,  Barzaglier, 20, 6, 14, no
3124736901,  jacopocoghe, 11, 4, 7, no
4730040141,  Gnomo_armato, 3, 1, 2, no
528917055,  toscano_sergio, 3, 1, 2, no
65311995,  hispaunique, 3, 1, 2, no
95106953,  paolopaterno, 16, 7, 9, no
553556334,  66oznerol, 3, 1, 2, no
133032441,  andrea_ispanico, 3, 1, 2, no
1057682683,  acord1410, 3, 1, 2, no
2921043755,  CoxPerseo012, 7, 1, 6, no
3773920703,  eugeniocaldo52, 3, 1, 2, no
711323552054697985,  GViglietti1, 4, 1, 3, no
1947835710,  swonsae, 3, 1, 2, no
408760297,  Feversinger, 15, 6, 9, no
3381470813,  imbalsamto, 3, 1, 2, no
1533213979,  laumik2, 8, 3, 5, no
2173103482,  FBellafiore, 3, 1, 2, no
2863798143,  famularim, 3, 1, 2, no
2574452613,  calvi_lorenzo, 14, 1, 13, no
2310684649,  00Zucchi, 3, 1, 2, no
377199894,  bennyscud, 12, 5, 7, no
441651345,  UGLNazionale, 154, 4, 150, no
714968789,  gaspaAndrea84, 5, 2, 3, no
1957607898,  torepira, 5, 2, 3, no
798053129048756224,  coruccicarlo2, 3, 1, 2, no
787888638,  giotina74, 10, 2, 8, no
394850579,  steilcapo, 14, 3, 11, no
499910613,  UGOACANFORA, 6, 1, 5, no
72257237,  frankdi63, 5, 1, 4, no
2997639443,  bea7shon, 3, 1, 2, no
83224596,  gabrcip, 9, 3, 6, no
1364981654,  giusepp30016367, 8, 1, 7, no
1334666292,  RenzIsis, 9, 4, 5, no
740302141676523520,  Luc_Giannotti, 7, 1, 6, no
418762910,  gianvitodapri, 12, 2, 10, no
2471692167,  55Pierno, 7, 2, 5, no
517330794,  MarvasiT, 3, 1, 2, no
479289781,  catmassimo, 5, 2, 3, no
503199826,  giacintociminel, 64, 1, 63, no
827788441,  depaolo2, 3, 1, 2, no
827716970,  bellomo69, 25, 11, 14, no
373287402,  DanieleKeshk, 6, 2, 4, no
164687938,  Fedescony, 10, 3, 7, no
805827223966060545,  Patrizi13439455, 3, 1, 2, no
477654099,  paolo_croci, 5, 2, 3, no
70091993,  gianlucarlesso, 3, 1, 2, no
2870408529,  MariaZafarana, 4, 1, 3, no
983013728,  fflaccomio, 15, 2, 13, no
2402701895,  fabiotave, 8, 1, 7, no
312616250,  MadamPopper, 7, 3, 4, no
561447448,  dani030968, 9, 3, 6, no
2846982226,  RitaNigronr, 14, 3, 11, no
292649689,  VeraQuantoBasta, 13, 3, 10, no
1360369249,  LuciaBi9, 13, 4, 9, no
2903859657,  colleanto, 5, 2, 3, no
25477483,  the_mindflayer, 13, 4, 9, no
2385763608,  lapaticoamilano, 9, 2, 7, no
3149261163,  PaoloPichierri, 6, 1, 5, no
441851951,  bobtrobb, 8, 3, 5, no
38438354,  mircomorello, 26, 4, 22, no
3067687355,  Oltrap18, 9, 4, 5, no
406443794,  InArteDrago, 10, 4, 6, no
775774416768761856,  N4nn4gorl4, 9, 4, 5, no
364740628,  Enghelus, 6, 2, 4, no
3420601067,  TeclaGrillo, 5, 2, 3, no
735045646005227520,  juvefp211897, 5, 2, 3, no
29045944,  claudiocerasa, 7, 1, 6, no
726295360537255936,  Ipoetisociali, 30, 7, 23, no
2817083455,  HoppipollaFede, 6, 2, 4, no
855410450,  ilghiozzo, 12, 5, 7, no
537504735,  jeanpaul_b, 7, 2, 5, no
447234708,  tonirombo, 3, 1, 2, no
2148100210,  manu161294, 4, 1, 3, no
702545722386849792,  finisterrae58, 3, 1, 2, no
791154802549985280,  Santo82047117, 8, 2, 6, no
97502899,  bikediablo, 5, 2, 3, no
60281313,  arredi_sardi, 7, 3, 4, no
4534673776,  FedericoImprot4, 5, 2, 3, no
431117026,  VissaAlan, 5, 2, 3, no
2807459157,  3249848Alberto, 10, 3, 7, no
767272709105524736,  vicce63, 3, 1, 2, no
562823508,  denvergo7, 23, 5, 18, no
953265385,  RobertoAgo1, 29, 8, 21, no
417095223,  hom79, 6, 1, 5, no
389456032,  frmandelli, 3, 1, 2, no
2207927540,  MarcoBiasotti, 6, 2, 4, no
423011868,  ganosk, 7, 2, 5, no
1325008650,  lmx69, 8, 3, 5, no
912845659,  debugsi, 3, 1, 2, no
733785341476384769,  MBMB20839858, 9, 4, 5, no
1601862823,  peccia_carlo, 11, 2, 9, no
22343118,  Micheleplati, 3, 1, 2, no
937620956,  DanieleValle3, 3, 1, 2, no
594793423,  gba65, 9, 2, 7, no
743151944437501952,  fra_me_e_te, 3, 1, 2, no
504290176,  matteo19631, 3, 1, 2, no
2434254386,  pallaro51, 6, 2, 4, no
783762422721048576,  fraffri85, 7, 1, 6, no
925089097,  giacomotambo, 6, 2, 4, no
798535442610188289,  robertigraziot1, 11, 2, 9, no
179059785,  Diariodelweb, 11, 4, 7, no
2326462552,  joker270879, 3, 1, 2, no
2504528224,  FeracoFiore, 8, 3, 5, no
275455208,  romperis, 6, 2, 4, no
302765721,  LetiAcciaro, 3, 1, 2, no
719147371045765120,  GiuliaT_95_luce, 8, 2, 6, no
66975806,  batmarco, 9, 4, 5, no
919526072,  LucioMalan, 10, 3, 7, no
520251134,  chiarafed75, 7, 3, 4, no
2314315157,  SimoRussoNa83, 5, 2, 3, no
2576915331,  SimSvizzera, 5, 2, 3, no
730685457529511936,  pieroebasta, 4, 1, 3, no
2867740125,  stefanopapalov, 4, 1, 3, no
2876387074,  Alessandro_SBAM, 8, 2, 6, no
801397532958031872,  EttoreMajoranaa, 9, 4, 5, no
799246755414048768,  gianfrancootta2, 17, 6, 11, no
964764067,  maraff2, 4, 1, 3, no
1068491160,  v_verusca, 11, 5, 6, no
1608490903,  DonghiMauro, 7, 2, 5, no
1200882961,  marietto85, 5, 2, 3, no
795384502734487552,  leopoldino2392, 3, 1, 2, no
995283966,  mzulbi1, 5, 2, 3, no
771649594509791232,  FTiriolo, 3, 1, 2, no
3795933213,  AleAlf81, 6, 2, 4, no
1888878594,  sdellamotta, 5, 2, 3, no
520256703,  paolaelisaconte, 5, 2, 3, no
512932071,  Cipo_Dani, 10, 1, 9, no
1924748329,  PontiChristian, 3, 1, 2, no
2214308771,  gaeta_nicola, 5, 2, 3, no
29411886,  AlessiaManca, 6, 2, 4, no
2180427250,  robydigi, 10, 2, 8, no
363160035,  DiegoCassetti, 9, 2, 7, no
3488504303,  frankrosini, 8, 2, 6, no
507066425,  robfreddy, 3, 1, 2, no
779236559908442112,  natolibero68, 9, 4, 5, no
800021935,  UrbaniNoemi, 7, 1, 6, no
4875148079,  mario99511336, 3, 1, 2, no
2960938695,  filcap76, 3, 1, 2, no
2559355769,  gdinolfo25, 5, 1, 4, no
504329845,  cicciopalu, 6, 2, 4, no
303932486,  AleDeGregoriis, 3, 1, 2, no
303307834,  DanielaEster5, 9, 4, 5, no
551427696,  ValeRagonesi, 3, 1, 2, no
107582221,  alessioviola, 3, 1, 2, no
1001753942,  aledipie, 7, 2, 5, no
2385940537,  APropositoDiAle, 3, 1, 2, no
2445645806,  SabrinaPileri67, 16, 5, 11, no
261838075,  Marco_Sarra, 6, 1, 5, no
359886824,  recchiedgomm, 5, 2, 3, no
473838165,  Elsorio, 5, 2, 3, no
529355511,  AnthonyAiello2, 16, 1, 15, no
1543155518,  GiuseppeLipariP, 7, 3, 4, no
720157781324656641,  MauroFuso, 7, 2, 5, no
237422784,  Frankiez86, 3, 1, 2, no
598932565,  citiamo, 4, 1, 3, no
1081169252,  grazia_natola, 3, 1, 2, no
1241355780,  serging77, 3, 1, 2, no
1566553698,  GianniCuperIoPD, 5, 1, 4, no
32830281,  pvechi, 6, 1, 5, no
221581460,  corradoval, 12, 5, 7, no
957357619,  sabrina_rilievo, 5, 1, 4, no
195421730,  matteoleo17, 3, 1, 2, no
870169790,  MimmoGy88, 22, 2, 20, no
3142613151,  uvastro, 3, 1, 2, no
261910864,  gianniPerrino, 10, 1, 9, no
739646939998900224,  CharlyTheSurfer, 4, 1, 3, no
788754994262581248,  dantonidario1, 3, 1, 2, no
264978128,  Ale_Spike77, 3, 1, 2, no
2345750573,  APetetti, 3, 1, 2, no
68735558,  serpente1, 15, 1, 14, no
942291529,  MontagnaRosario, 4, 1, 3, no
2854719148,  Grujic_Sergio, 7, 1, 6, no
2751643757,  FVerdi79, 3, 1, 2, no
283602058,  Luciosalis, 5, 2, 3, no
484337760,  francoinzirillo, 7, 1, 6, no
398609882,  PasqualiPaolo, 15, 7, 8, no
64702834,  valentinoben, 3, 1, 2, no
4720298007,  dominyksenti, 3, 1, 2, no
631428101,  LaMiaLazio1900, 3, 1, 2, no
1227969776,  Bruce8691, 11, 4, 7, no
876454694,  blasfede, 7, 2, 5, no
1099289419,  Handwriting01, 3, 1, 2, no
4885325417,  loziocane_, 4, 1, 3, no
300226654,  sarah_shb, 4, 1, 3, no
789390786991263744,  maura_rocca, 6, 2, 4, no
2333388469,  AlbertMaltese, 3, 1, 2, no
370182507,  RobyGuarino, 13, 5, 8, no
2745834673,  LanciniLucia, 5, 2, 3, no
505803378,  ellysisland, 3, 1, 2, no
244936627,  optimistique_, 7, 3, 4, no
594548423,  matteglam, 7, 1, 6, no
337644410,  Marxtrixx, 10, 3, 7, no
4871567830,  Paolo77900268, 3, 1, 2, no
773825985590484992,  matdep88, 8, 2, 6, no
329830899,  mig_box, 9, 1, 8, no
145592403,  goffredodotcom, 4, 1, 3, no
435671501,  PaolaToccaceli, 5, 2, 3, no
714845919288692737,  annadibarium, 7, 1, 6, no
1316007410,  Andrea_Aloisio, 14, 6, 8, no
1028180126,  TysonPERA, 14, 1, 13, no
778177707234451457,  IlPresidente4, 8, 1, 7, no
3069555215,  1959maryrose, 5, 1, 4, no
799874546862014465,  KronicaM5S, 3, 1, 2, no
1247071002,  Calem_grande, 9, 4, 5, no
498031195,  NRiglietti, 3, 1, 2, no
552941521,  Fabbris97, 8, 1, 7, no
920435114,  LuigiGallo15, 4, 1, 3, no
235171152,  Mottavia, 3, 1, 2, no
433538171,  giannipizza1982, 3, 1, 2, no
1165684578,  ScarpaGabriele, 3, 1, 2, no
441273511,  alessarno, 3, 1, 2, no
472301391,  gaia796, 6, 1, 5, no
61419304,  maurosays, 6, 1, 5, no
4842523900,  brizz1963, 7, 2, 5, no
517721087,  l_direnzo, 8, 2, 6, no
737201584057286656,  EnzoMv70, 3, 1, 2, no
121612157,  milanonoko, 3, 1, 2, no
90548758,  dandhicks, 4, 1, 3, no
753499324915519488,  fabrizio1322, 5, 1, 4, no
487403092,  giorgiachetti, 4, 1, 3, no
4218775445,  federicoursitti, 6, 2, 4, no
13725552,  darioberna, 10, 2, 8, no
4462664181,  acoro11, 6, 1, 5, no
858153835,  machecaxxo, 3, 1, 2, no
2731876079,  LuciaRizzari, 5, 2, 3, no
3136892145,  VincenzoVinc51, 3, 1, 2, no
132253492,  okaka2013, 4, 1, 3, no
433181204,  RenzoPolesel, 3, 1, 2, no
737955839735123968,  Cuor_di_Cardo, 3, 1, 2, no
554347347,  EvelinaMassa1, 8, 2, 6, no
2604719213,  stellacristal79, 5, 1, 4, no
885207620,  archiviobici, 5, 2, 3, no
3072811918,  LupiMirco, 3, 1, 2, no
4828257199,  WorldBambino, 16, 1, 15, no
4211779384,  IrisPiccam, 4, 1, 3, no
456677700,  mellamonicolas, 5, 1, 4, no
461369880,  annatortora3, 3, 1, 2, no
548471623,  nikmanser, 3, 1, 2, no
558038204,  FedeCast1982, 13, 1, 12, no
2935641575,  marinuccitizia2, 3, 1, 2, no
2349348009,  Giopigli, 23, 2, 21, no
712712005287813122,  CamilloTarocci, 20, 5, 15, no
410738333,  enzacolatutto, 3, 1, 2, no
890639928,  RRCapitale, 6, 1, 5, no
3023901389,  ColangeloKatia, 6, 2, 4, no
408382868,  Ingesicurezza, 3, 1, 2, no
397084851,  Alex_Chiapetto, 7, 1, 6, no
2875667218,  Amaranth1902, 6, 2, 4, no
513481122,  FatosShehu, 14, 1, 13, no
4194649347,  paolotestaverd2, 3, 1, 2, no
722437795,  elianazannone, 4, 1, 3, no
425310939,  CarloCoratelli, 3, 1, 2, no
721993269568225280,  landau_janina, 3, 1, 2, no
186372018,  Milanonicola, 3, 1, 2, no
1017786078,  mariopippo5, 4, 1, 3, no
496038655,  GioRebuscini, 5, 2, 3, no
546255957,  FedeIsu, 3, 1, 2, no
2991872159,  Lucio77001623, 13, 5, 8, no
33024957,  bonanniluca, 5, 2, 3, no
627351730,  lucaolandese, 7, 1, 6, no
2814172805,  PolitoEnrico, 9, 1, 8, no
2901394836,  FI_giovaniFvg, 4, 1, 3, no
2863873709,  matteo_zaccaria, 3, 1, 2, no
437309303,  FGuarnier, 4, 1, 3, no
397601369,  PierDei, 5, 2, 3, no
492580283,  GiuseppePiazza9, 6, 1, 5, no
2182502256,  fasulo_antonio, 9, 3, 6, no
635490690,  Cla_Car, 6, 2, 4, no
749369737080176640,  MassimilianoF75, 18, 6, 12, no
2154040684,  pietro_didio, 3, 1, 2, no
2180073286,  embecerto, 10, 3, 7, no
303172080,  VinsMarques, 5, 2, 3, no
757361610222624768,  Massimo105431, 6, 2, 4, no
949425925,  IamBerry29, 9, 2, 7, no
439622452,  Myla731, 5, 1, 4, no
2343639954,  LiberoPens, 8, 2, 6, no
3170325538,  infoscensura, 3, 1, 2, no
1694143957,  idnbh, 3, 1, 2, no
25788082,  Angelo1997, 5, 2, 3, no
48461963,  epiclove_, 5, 2, 3, no
59416453,  markheart80, 3, 1, 2, no
389768787,  ukipwebmaster, 4, 1, 3, no
328715454,  AlexiusAsr, 11, 2, 9, no
201680143,  Benjamin5Reilly, 11, 2, 9, no
728056298,  psiko, 4, 1, 3, no
396743588,  SilvanoMatranga, 5, 2, 3, no
198689110,  IsmaMonzon, 3, 1, 2, no
4882196008,  pallottaomar, 3, 1, 2, no
440345487,  DarioGhezzi1, 3, 1, 2, no
131486969,  isabbah, 5, 2, 3, no
88223869,  charlierock12, 5, 1, 4, no
397189518,  MirkoGaravaglia, 4, 1, 3, no
4738886235,  SelenaRampi, 4, 1, 3, no
245700162,  veronica25p, 4, 1, 3, no
724699433271758848,  TonyStark300181, 5, 1, 4, no
2498399355,  gianrollandi, 9, 1, 8, no
431887124,  craaash80, 20, 7, 13, no
333441243,  DanicoGnisci, 14, 3, 11, no
399964269,  mororosso, 5, 1, 4, no
3435506849,  dino81bras, 3, 1, 2, no
534223695,  bovans01, 3, 1, 2, no
2348529975,  fioresie, 3, 1, 2, no
160578815,  Jozannyme, 4, 1, 3, no
2838223366,  dangdaide, 4, 1, 3, no
2569249636,  MauroSanfelici, 4, 1, 3, no
1350411,  jlazaro, 9, 1, 8, no
504524011,  cecco1976, 5, 2, 3, no
804512863,  simoAsso210, 5, 1, 4, no
1356872376,  Alicenonce, 6, 2, 4, no
610101483,  AlbertoSchepis1, 3, 1, 2, no
2340529119,  BattaglioFelice, 3, 1, 2, no
735022891583016960,  macgio1964, 5, 1, 4, no
864457176,  capoccione2, 13, 1, 12, no
458495032,  Gatti__Nicola, 3, 1, 2, no
339559937,  DucaSimakiku, 3, 1, 2, no
1013334853,  oryblu, 5, 2, 3, no
45439845,  pimpiripette, 3, 1, 2, no
205627167,  palmarocchim, 6, 1, 5, no
4688280565,  Mauhdeeb, 5, 2, 3, no
3063912075,  Caoscalmo63, 8, 1, 7, no
433702678,  BonazziFederico, 17, 2, 15, no
1703447346,  Spillo_90, 5, 2, 3, no
790254593720614912,  domenico823, 4, 1, 3, no
22006895,  alexarmuzzi, 3, 1, 2, no
361787988,  urlodalsilenzio, 9, 4, 5, no
20615164,  NicolettaTurci, 3, 1, 2, no
3404352773,  il__Mauro, 14, 5, 9, no
803536150371696640,  GabRizzi1, 11, 1, 10, no
4830695975,  senator_it, 6, 2, 4, no
411841520,  gnnali, 7, 2, 5, no
4044502341,  Rochy35451447, 11, 5, 6, no
421952674,  ssaintpablo, 7, 2, 5, no
1362033247,  mar_paladino, 3, 1, 2, no
1037846899,  fava_giuseppe, 9, 4, 5, no
1148239141,  Luciano12199379, 5, 1, 4, no
723554886651142144,  mbx1900, 7, 1, 6, no
416290762,  fioresalvino, 18, 2, 16, no
396826432,  cardinali_carlo, 9, 1, 8, no
1139018790,  mancinigraziano, 3, 1, 2, no
488844512,  giordi63, 4, 1, 3, no
709389043,  GS_LAbbate, 10, 1, 9, no
574047334,  PeveriMauro, 3, 1, 2, no
1202345928,  barby_fari, 3, 1, 2, no
2353760868,  ghigoghigo2, 8, 1, 7, no
528833475,  massimo1175, 3, 1, 2, no
1073080100,  TW_SilverSurfer, 8, 2, 6, no
717943272,  FazFabio, 4, 1, 3, no
1099421017,  mmanuela07, 3, 1, 2, no
400289790,  destinazroma, 4, 1, 3, no
394086402,  ceccotto74, 5, 2, 3, no
233892110,  wiskyno, 8, 2, 6, no
2801711627,  vikidesideri, 4, 1, 3, no
451083998,  Ellessephoto, 9, 3, 6, no
3124581651,  e_caciolo92, 3, 1, 2, no
748847098234302466,  guglielmomaz, 3, 1, 2, no
400630126,  marco_nemecek, 3, 1, 2, no
3314862999,  chiamami411, 3, 1, 2, no
772569713268359169,  asterixderoma, 7, 1, 6, no
1830717614,  schesirnature, 4, 1, 3, no
796795293316612097,  Incazzante, 27, 1, 26, no
360830746,  Luisella49, 9, 4, 5, no
224351032,  theoretro, 3, 1, 2, no
862986014,  Ale_Manho, 27, 4, 23, no
376765802,  SilviaGuzzo, 23, 1, 22, no
1065279234,  Antonio051250, 3, 1, 2, no
2353177690,  lucadipietro7, 3, 1, 2, no
1078819266,  aleselmi8, 3, 1, 2, no
1958200020,  OrnellaPetillo, 3, 1, 2, no
712308188863971329,  carlotta_padua, 3, 1, 2, no
1485951925,  verificatore1, 8, 3, 5, no
740167265606336512,  marscu46, 3, 1, 2, no
65986070,  cosechadel83, 3, 1, 2, no
60159920,  AttilaRock, 12, 4, 8, no
600232964,  CettaFerrara, 3, 1, 2, no
4706663313,  Frances10187327, 8, 2, 6, no
229821777,  svippy, 8, 1, 7, no
536340991,  amicodelpopolo1, 6, 2, 4, no
2503841804,  Giuse_B149, 5, 1, 4, no
935131632,  giovannire8, 4, 1, 3, no
399560982,  julien883, 4, 1, 3, no
2694146772,  ChistoliniFede, 3, 1, 2, no
741250447781040128,  Antoniouferraru, 3, 1, 2, no
2417069802,  partnerdigitale, 7, 2, 5, no
1452431508,  ottolibero, 4, 1, 3, no
3424532134,  Antodls22, 5, 2, 3, no
1642443505,  Estcheema, 9, 1, 8, no
1213596138,  ErsilioL, 4, 1, 3, no
72381260,  fantalex, 5, 2, 3, no
1956114378,  FrancescChirico, 3, 1, 2, no
735551927392567297,  p_Myskyn, 6, 0, 6, no
349749435,  luigidecristofa, 4, 0, 4, no
95647096,  Gianluca_73, 3, 1, 2, no
374069207,  jokerGianlu, 1, 0, 1, no
2392648392,  antopillosio, 1, 0, 1, no
749991934165385217,  ElisaPistolesi1, 11, 0, 11, no
721281920747839488,  CarCarlomcc, 4, 1, 3, no
482228231,  BrunoRedditi, 2, 0, 2, no
2534314678,  depalmavito, 6, 0, 6, no
1327139821,  IdamiladyG, 1, 0, 1, no
612576300,  fornarilorenzo, 2, 0, 2, no
2212866474,  salvogambi, 1, 0, 1, no
4414252179,  FIgiovani_Bas, 3, 1, 2, no
1140366230,  frau_simonetta, 1, 0, 1, no
726852195501629440,  silvia_pispico, 2, 0, 2, no
797923040692535300,  No89582127, 5, 1, 4, no
1263967111,  belgi11, 1, 0, 1, no
447352763,  ASciullo, 4, 1, 3, no
775959412087193600,  RosarioFrancese, 4, 0, 4, no
565252532,  SindacoCampagna, 1, 0, 1, no
946012470,  RufoloTeresa, 1, 0, 1, no
447231795,  deboraDDI, 5, 1, 4, no
2314042430,  giosparver, 4, 1, 3, no
55038103,  rubiku, 3, 1, 2, no
1146253243,  BioMedMax, 5, 2, 3, no
452858854,  OmbrettaBuzzi, 32, 1, 31, no
119178709,  francopercolla, 6, 1, 5, no
1707513894,  CINOdaFIRENZE, 9, 3, 6, no
463591267,  namarte15, 11, 3, 8, no
238105558,  solarplexus75, 5, 1, 4, no
1474536614,  RubertoFrances, 6, 1, 5, no
403684823,  MarinoTodesco, 12, 1, 11, no
406366657,  titticri, 9, 1, 8, no
272382855,  Brigaden5s, 42, 2, 40, no
1265375377,  TinaRengo, 6, 1, 5, no
4902200932,  Ricky83pa, 11, 0, 11, no
2288512031,  MCustro, 9, 3, 6, no
501095818,  GiovanniBFucini, 4, 0, 4, no
801473324744376320,  garz66, 2, 0, 2, no
1903397372,  forzaitaliaud, 5, 0, 5, no
493318360,  370849, 8, 0, 8, no
1068878065,  graffa83, 7, 2, 5, no
3389194037,  rivcristiana, 36, 0, 36, no
393392832,  Dondolino72, 4, 1, 3, no
2242019356,  MarcoMarcotimex, 12, 1, 11, no
768014298,  85giampiero, 3, 1, 2, no
3119868942,  brunogab73, 7, 1, 6, no
472893871,  ernestoluciani, 11, 5, 6, no
803747368390848512,  Moonmadness12, 6, 1, 5, no
3241115409,  saverio_va, 6, 1, 5, no
1037651766,  anna_annalu, 8, 3, 5, no
760254962966364160,  tito707110651, 5, 2, 3, no
390297468,  giustigiovi, 3, 1, 2, no
2250936137,  gfvlxx, 7, 1, 6, no
740965050836455424,  Crisantemo12345, 4, 1, 3, no
1318670960,  fiorealieno, 14, 2, 12, no
82902889,  Dudu2507, 25, 3, 22, no
524809983,  ienapriski, 28, 4, 24, no
562023808,  fabiomisha, 5, 0, 5, no
230453692,  mobertos, 32, 14, 18, no
183556691,  eSseTiGiA, 2, 0, 2, no
513213473,  GattiAldo, 1, 0, 1, no
701747343339741184,  linuxian_5s, 15, 0, 15, no
4527310402,  ChetriL, 5, 0, 5, no
234868966,  chesko76, 6, 1, 5, no
167014241,  bolartur, 14, 0, 14, no
242392452,  amorbide77, 10, 0, 10, no
533332467,  gabriel7022, 28, 1, 27, no
1171904442,  lucapuc62, 3, 0, 3, no
1026484628,  VincenzoCanon, 4, 1, 3, no
3032272127,  GiannarelliM5S, 26, 0, 26, no
742455271,  MedaEmanuele, 14, 1, 13, no
240389640,  thor3u, 2, 0, 2, no
947223368,  CrifCrifasi, 1, 0, 1, no
203717084,  probo8, 14, 0, 14, no
2751782307,  AvvocatoLorenti, 4, 0, 4, no
531746865,  AlessandGr, 3, 0, 3, no
930237486,  vanessacombttll, 1, 0, 1, no
464536669,  stefanocolombi3, 10, 0, 10, no
1113910442,  LinaGalLina, 3, 0, 3, no
906224444,  09Zouzou, 40, 1, 39, no
4353226283,  Annamar14426970, 1, 0, 1, no
2465437060,  gelosiale, 4, 1, 3, no
803591105413545984,  aloia2_antonio, 6, 2, 4, no
4008843159,  roberto_pella, 7, 0, 7, no
136561250,  CinziaPitru, 7, 3, 4, no
738626681418579968,  renataburl1, 3, 0, 3, no
2984271976,  paolamaranelli, 2, 0, 2, no
451607723,  AlessioTres, 1, 0, 1, no
480215189,  MilaByNight, 1, 0, 1, no
3401298100,  claudigili1965, 1, 0, 1, no
1160507178,  Astra_x_Aspera, 19, 3, 16, no
168605766,  Marco_Giacomini, 1, 0, 1, no
20336368,  mikimod, 2, 0, 2, no
2225287925,  massimpp60, 1, 0, 1, no
250336400,  Frankmazzo90, 2, 0, 2, no
87048339,  markbezdicek, 3, 0, 3, no
374006406,  sarahmarty78, 2, 0, 2, no
2359281943,  TatyLorenzini, 10, 0, 10, no
268910347,  emanuelapatti, 15, 0, 15, no
587677613,  Giorgio1951, 3, 0, 3, no
259778195,  ski12665, 4, 0, 4, no
3223932303,  socec_jasnica, 41, 0, 41, no
574117698,  leoaifon, 3, 0, 3, no
47252494,  MarioBubu, 6, 2, 4, no
526606808,  stelladiterra, 10, 0, 10, no
2307296066,  suzettepetillo, 4, 0, 4, no
887379080,  raffaelejosesti, 1, 0, 1, no
203915389,  cla_cominardi, 4, 0, 4, no
1679376193,  __Nemesi_, 12, 2, 10, no
774525301175029760,  abelebogarellim, 4, 1, 3, no
714891080349704193,  Angelo853480981, 1, 0, 1, no
2323711273,  claudio96875335, 3, 0, 3, no
277460126,  Chiara_DiBe, 3, 0, 3, no
2318230960,  F_Abeja82, 2, 0, 2, no
194706083,  GabrieleCelso, 3, 0, 3, no
2615032505,  FhdmMax, 2, 0, 2, no
2721968416,  nu_vola, 4, 0, 4, no
199413728,  ubbi57, 3, 1, 2, no
193663495,  GiovyCadeddu, 1, 0, 1, no
84274436,  Bul_Von_klark, 4, 0, 4, no
79003916,  Valeriopetrucci, 1, 0, 1, no
777777871,  DipRoss, 11, 2, 9, no
2278659026,  iphoneapple6S, 3, 0, 3, no
605614784,  ElioLannutti, 27, 7, 20, no
238781806,  weddelll, 7, 1, 6, no
4857911091,  mariannade47, 5, 0, 5, no
1229398160,  Curti8Curti, 3, 0, 3, no
390978069,  MaxPinelli, 3, 0, 3, no
2450692721,  triamilton, 6, 2, 4, no
1490741580,  PAmbruosi, 3, 0, 3, no
2389335829,  tru3dom, 2, 0, 2, no
555323868,  scampoli3, 6, 2, 4, no
1038389942,  Rase81, 3, 0, 3, no
432948268,  fede_corsi, 2, 0, 2, no
1070320532,  cit58, 11, 1, 10, no
342308195,  mara_cogoni, 8, 3, 5, no
418683219,  SemioLogico, 5, 0, 5, no
264300089,  annamariavasile, 13, 0, 13, no
540455433,  AlmaGiusyRosa, 1, 0, 1, no
737734557777178624,  DeerEwan, 12, 0, 12, no
1065242010,  BernabeiPiero, 1, 0, 1, no
446122798,  kavitina, 14, 1, 13, no
2970333513,  melcinzia, 8, 1, 7, no
39975495,  popolinotwits, 53, 1, 52, no
570144271,  luci560, 11, 2, 9, no
65939345,  sonostorie, 6, 2, 4, no
581167908,  MACMURA77, 3, 1, 2, no
1262138317,  SusyBelm, 16, 2, 14, no
35181867,  luigicristaldi, 4, 1, 3, no
3131360284,  SolutionCenterP, 3, 1, 2, no
3081057804,  3c2314ce1af64ce, 3, 1, 2, no
174237217,  DamianoBrattoli, 4, 0, 4, no
792734918552018944,  Antonio38506681, 3, 0, 3, no
2365416492,  fberrys, 2, 0, 2, no
747492094881726464,  ugl_saaf, 4, 0, 4, no
508825719,  fabiopise1, 2, 0, 2, no
919864976,  MariPeppeKa, 3, 0, 3, no
1602804482,  liuk71rm, 15, 0, 15, no
12679502,  MarcoFanteg, 2, 0, 2, no
1163339742,  FrancoBianc, 12, 2, 10, no
274694406,  il_democritico, 3, 1, 2, no
793696853451743232,  Casalingitudine, 3, 1, 2, no
419094387,  dellandro58, 11, 2, 9, no
479569415,  MelGerbino, 3, 1, 2, no
702989036391112704,  ernesto06492956, 23, 2, 21, no
800959920132780032,  mirianasole1, 5, 2, 3, no
3199220876,  emmpad2, 25, 2, 23, no
2447306083,  VivaSankara, 8, 0, 8, no
713725818548199424,  Flavian17544897, 6, 1, 5, no
869896987,  Claudio59Lecce, 2, 0, 2, no
341954217,  nicola_lucchi, 7, 0, 7, no
528515428,  AAAMARIO, 5, 1, 4, no
1262874817,  Alinax2311, 2, 0, 2, no
54964317,  catetom, 2, 0, 2, no
757833847572574208,  TwittaLibro, 3, 0, 3, no
910601880,  albertigiannaro, 12, 4, 8, no
507570761,  MarcoFaccendi1, 2, 0, 2, no
2327807238,  verafale, 3, 1, 2, no
1220767266,  librella15, 5, 2, 3, no
975443228,  vincenzobifulc3, 5, 2, 3, no
253207225,  fmanca, 3, 0, 3, no
1307817714,  gri_gio_69, 8, 1, 7, no
47593206,  artistasacro, 2, 0, 2, no
700445613842964481,  BrunaGandolfi2, 2, 0, 2, no
2967051688,  ilpiucompleto1, 4, 0, 4, no
85670395,  Alise0, 6, 1, 5, no
1895164603,  NotiziedalM5S, 21, 1, 20, no
2904244365,  the_longo, 2, 0, 2, no
2730634557,  Sam_12345_, 3, 0, 3, no
260912864,  Bruce0770, 3, 0, 3, no
893666054,  iostoconlafiom, 3, 0, 3, no
37768869,  Adrastea_it, 3, 0, 3, no
4830186521,  franziesc, 2, 0, 2, no
2198507410,  VoyagerAlmayer, 2, 0, 2, no
247737545,  Amoreperilbuio, 2, 0, 2, no
1014721082,  onofriorossini, 6, 0, 6, no
52881654,  rsantopietro, 2, 0, 2, no
2986302741,  GloriaFugginani, 3, 0, 3, no
478620962,  MikemixBo, 3, 0, 3, no
461190832,  LuckyMario82, 8, 1, 7, no
733914785780236288,  pinovichingo, 2, 0, 2, no
3377153333,  FrancoConti60, 11, 0, 11, no
419862356,  pananost, 13, 4, 9, no
2653454464,  Gino51Gl, 2, 0, 2, no
2181771883,  fkaLaMusa, 3, 0, 3, no
1164081451,  LiceLicetta, 6, 2, 4, no
701849940809662464,  Umberto_Ecco, 4, 1, 3, no
2375430686,  raffaelefus, 2, 0, 2, no
14145846,  flavia_marzano, 31, 3, 28, no
777919508250030080,  Maura_Master, 6, 0, 6, no
2370797451,  angelo_fornaro, 8, 0, 8, no
780089815786283008,  giovann13963232, 57, 5, 52, no
1114905660,  GiuseppePesce3, 2, 0, 2, no
425122600,  Andrea_Manci, 5, 0, 5, no
2767422555,  luca_masoero, 26, 4, 22, no
1257072463,  fraga801, 2, 0, 2, no
81318149,  semplicefabio, 20, 5, 15, no
605377369,  DottMilone, 11, 0, 11, no
1372859420,  AntonellaCrima2, 15, 5, 10, no
2324228217,  GrimaniFilippo, 3, 0, 3, no
486077820,  ciemme71, 8, 0, 8, no
738803856906301440,  Valter14032653, 9, 1, 8, no
1555357356,  SpinaTourViaggi, 3, 0, 3, no
984851042,  AnnareColonnese, 5, 1, 4, no
2460943169,  nat201012, 1, 0, 1, no
2938235393,  Sarago85, 8, 0, 8, no
265494725,  vitoperrino, 6, 2, 4, no
568604367,  Pasquorum, 8, 3, 5, no
941761956,  Mitch1978Ar, 6, 0, 6, no
159910237,  Stefaniscion, 2, 0, 2, no
425257616,  calogeromanera, 1, 0, 1, no
1018018543,  CampitelliMarco, 3, 0, 3, no
220390146,  lucasolo, 3, 0, 3, no
84582608,  massimo0551, 2, 0, 2, no
525240553,  Bapattis, 8, 3, 5, no
355400655,  kalos6868, 4, 0, 4, no
1095188802,  Ernesto_Bazan, 7, 3, 4, no
2508454141,  ViterboFra, 5, 0, 5, no
1639844875,  enzopalazzo4, 1, 0, 1, no
1161727848,  brunopisani9, 1, 0, 1, no
316374588,  AndreaBacchio, 4, 0, 4, no
4898877849,  PuntoebastaBas, 1, 0, 1, no
499626957,  AndreaForoni1, 1, 0, 1, no
791764138498387968,  ilgrilloparlan2, 3, 1, 2, no
2353012439,  MattiaIervella, 7, 1, 6, no
762727876286410752,  sogncin, 13, 5, 8, no
4437690677,  piero_1959, 1, 0, 1, no
4394191913,  pietro_tassani, 2, 0, 2, no
730931221841256448,  socialtvntw, 14, 2, 12, no
1226139085,  oriettariccetti, 13, 0, 13, no
3298371244,  piccio1968, 2, 0, 2, no
862701492,  osimo5stelle, 5, 0, 5, no
270679712,  BourneInTexas, 1, 0, 1, no
318400179,  vitopetrocelli, 5, 0, 5, no
938810556,  roberto__73, 1, 0, 1, no
473072448,  FrancescoLamana, 3, 1, 2, no
204701915,  qiov4nni, 5, 0, 5, no
139345099,  Zenigarda, 1, 0, 1, no
1167315614,  spumettina, 1, 0, 1, no
886499509,  CamilloAuricchi, 8, 0, 8, no
421319874,  BrunoMaggi, 4, 1, 3, no
731343264,  massimo_avv, 2, 0, 2, no
14184504,  latente_flickr, 5, 0, 5, no
471390400,  db_anna, 1, 0, 1, no
1650015702,  RobertaRodelli, 2, 0, 2, no
479440108,  SabbaZion, 6, 0, 6, no
118401565,  fabiogiannetti, 5, 2, 3, no
791726904856416257,  matthewhashstar, 2, 0, 2, no
321463844,  Enrico_Casalino, 4, 1, 3, no
612374141,  paolamodenaa, 11, 4, 7, no
3032986251,  MariaPetruccel3, 1, 0, 1, no
251732759,  paramorwth, 2, 0, 2, no
204820142,  stormy8530, 1, 0, 1, no
1107334009,  OrioliAlberto, 1, 0, 1, no
764201799217717248,  Ivianti777, 20, 5, 15, no
431976775,  rob_rio, 11, 1, 10, no
407816941,  Rocco_mitico, 6, 0, 6, no
926261881,  LauraBignami1, 15, 1, 14, no
1071018919,  StefaniaProfili, 3, 0, 3, no
1042739358,  MatteoZagheno, 5, 0, 5, no
365935751,  ilQuintuplo, 24, 0, 24, no
1111625298,  lucaantonini6, 3, 0, 3, no
1495775148,  miriamberzi, 1, 0, 1, no
191364077,  Fanti1959, 4, 0, 4, no
2321086998,  LucaDelVitto1, 2, 0, 2, no
1331997001,  ReputationAGCY, 5, 0, 5, no
2774524642,  VellaCristiano, 2, 0, 2, no
803286709253341184,  teresagervasio1, 2, 0, 2, no
81315998,  andreacasadeiVE, 1, 0, 1, no
237332532,  c_calvano, 4, 0, 4, no
3323385291,  cbergy69, 3, 1, 2, no
978121892,  RaffoGagliardi, 1, 0, 1, no
1855341199,  44Mallamace, 1, 0, 1, no
241862771,  darlaspesso, 1, 0, 1, no
489577086,  IulianoPino, 1, 0, 1, no
2884807616,  maurizio_crippa, 1, 0, 1, no
389115081,  nicolarosetti1, 4, 0, 4, no
97281454,  gmboccanera, 1, 0, 1, no
16824428,  commercialista, 6, 2, 4, no
1610426412,  SCG341, 9, 3, 6, no
1101713905,  mschiavone75, 9, 4, 5, no
440749601,  ChelsLllli, 1, 0, 1, no
2985415239,  _giunio_, 5, 1, 4, no
425438518,  LeonorIvorla, 1, 0, 1, no
452666770,  Adam0459, 1, 0, 1, no
2377412736,  SienaconPicchi, 7, 0, 7, no
2380646586,  ArezzoconPicchi, 6, 0, 6, no
2394211062,  EmpoliconPicchi, 8, 0, 8, no
277876200,  smllysportsgirl, 1, 0, 1, no
290495349,  94No_Love, 1, 0, 1, no
433778232,  DandKMenswear22, 1, 0, 1, no
426207687,  OkiahomaTheBand, 1, 0, 1, no
281949979,  bethdt0rre, 1, 0, 1, no
17532492,  Rinascimento65, 6, 1, 5, no
630499526,  VittorioPerazzo, 1, 0, 1, no
283465791,  ItsT0byBear, 1, 0, 1, no
301580701,  __xavi__fernand, 1, 0, 1, no
3303841109,  PistoiaxPicchi, 6, 0, 6, no
477202343,  anicole073, 1, 0, 1, no
282034070,  sldcrawford, 1, 0, 1, no
463311374,  gladlnsam, 2, 0, 2, no
446770906,  BekkahSorens0n, 1, 0, 1, no
474546913,  joboblshere, 1, 0, 1, no
277902589,  PollSciMTSU, 1, 0, 1, no
296894564,  michealvidal074, 1, 0, 1, no
412283744,  Dtre0Short, 1, 0, 1, no
433926099,  KINGDJ951, 1, 0, 1, no
425425345,  futbollssa, 1, 0, 1, no
465864274,  BCMHarlsr, 1, 0, 1, no
81656841,  EnricoVerga, 2, 0, 2, no
40745772,  autolavaggio, 1, 0, 1, no
283468448,  HushQulets, 1, 0, 1, no
464798861,  athletellfesty, 1, 0, 1, no
427919826,  TaYyBo5gS, 1, 0, 1, no
3312025672,  2016Milano, 1, 0, 1, no
2426870389,  AntonioVivoli, 1, 0, 1, no
964091312,  BozzoliGiovanni, 1, 0, 1, no
2377429910,  CampixPicchi, 1, 0, 1, no
823262870,  ForzaItaliaEU, 2, 0, 2, no
2395047265,  FILucca, 1, 0, 1, no
871677924,  FIBruxelles, 1, 0, 1, no
2417204762,  ForzaItaliaQ4, 1, 0, 1, no
2415583820,  ForzaItaliaSen, 1, 0, 1, no
2349873744,  ForzaItaliaEuro, 1, 0, 1, no
2369170723,  ForzaItMondo, 1, 0, 1, no
2386617072,  ForzaFiesole, 1, 0, 1, no
4255982193,  CentrodestraMi, 1, 0, 1, no
1457630209,  FirenzeRinasce, 1, 0, 1, no
833314411,  DarioGuriotto, 1, 0, 1, no
2415564908,  siCelafaremo, 1, 0, 1, no
828687679,  EuroViva, 1, 0, 1, no
2415549036,  AzzurroDonnaFI, 1, 0, 1, no
2351311585,  le_cure, 1, 0, 1, no
2386639135,  FISestoFiorenti, 1, 0, 1, no
3306407121,  ForzaItaliaPisa, 1, 0, 1, no
2386635408,  FIScandicci, 1, 0, 1, no
2406613610,  FITavarnelle, 1, 0, 1, no
2356425302,  ForzaItaliaQ5, 1, 0, 1, no
2354417048,  ForzaItLondra, 1, 0, 1, no
2354451132,  FIQuartiere1, 1, 0, 1, no
2395025780,  FIAltopascio, 1, 0, 1, no
2417193085,  MatteoStaiSeren, 1, 0, 1, no
1878638162,  ForzaItaliaFi, 1, 0, 1, no
857964139,  ItaliaFuturaMon, 1, 0, 1, no
4425663915,  CdxToscana, 1, 0, 1, no
2356378256,  NovoliconPicchi, 1, 0, 1, no
984785090,  italia2p0, 1, 0, 1, no
943600765,  GigliErica, 1, 0, 1, no
1457632182,  PicchiSindaco, 1, 0, 1, no
4426336102,  CdxGermania, 1, 0, 1, no
2443720207,  No_Renzi, 1, 0, 1, no
2380661778,  PiemonteconPicc, 1, 0, 1, no
2452964504,  VotaBianchi, 1, 0, 1, no
4255793344,  circolocdx, 1, 0, 1, no
855378650,  FIBelgio, 1, 0, 1, no
943649954,  PDLGermania, 1, 0, 1, no
2353222434,  GiorGrandi, 1, 0, 1, no
1474478119,  OltrarnoxPicchi, 1, 0, 1, no
2395010906,  FIFigline, 1, 0, 1, no
602788028,  PDLMondo, 1, 0, 1, no
2369149224,  MissioneAzzurFI, 1, 0, 1, no
288176791,  ladyqualnt, 1, 0, 1, no
270249473,  kndanner981, 1, 0, 1, no
832963470,  LiberOpinione, 4, 0, 4, no
439660692,  MearEdlts, 2, 0, 2, no
471836919,  InstantiyMary, 1, 0, 1, no
473457759,  MarkCalvin__, 1, 0, 1, no
1437778471,  RagnacciG, 11, 5, 6, no
66133398,  bavarese, 6, 2, 4, no
1079592241,  Mistakenness, 4, 0, 4, no
1882963957,  peterpark06, 3, 0, 3, no
135267045,  vincentconsulti, 9, 3, 6, no
463911801,  CamillaGalante, 8, 3, 5, no
266213305,  DioIAm, 4, 1, 3, no
2614952764,  l_o_s_t_e_r, 5, 2, 3, no
413916151,  GuidoCrosetto, 32, 8, 24, no
281457720,  Giofrassinesi, 5, 1, 4, no
439362823,  erremonte, 5, 1, 4, no
2895469174,  MessicoMinister, 9, 4, 5, no
618934256,  StefanoDUffizi, 3, 1, 2, no
3740658136,  marco_marcangio, 3, 1, 2, no
947272602,  GianniScapellat, 83, 41, 42, no
2734322301,  Rizzo89Prizzo05, 7, 3, 4, no
53994592,  frankforu, 3, 1, 2, no
1385256108,  LiberoParrotta, 5, 1, 4, no
746201381912993794,  j_drum123, 4, 1, 3, no
741452070,  FrancescaPepe12, 3, 1, 2, no
33676387,  giulezio, 7, 3, 4, no
73193003,  DiegoMalara, 7, 3, 4, no
4860906586,  NuNuZ_00, 3, 1, 2, no
2194433942,  chinasky11, 13, 5, 8, no
2755001196,  Rossana7336, 16, 7, 9, no
3191176588,  ritagraziano48, 12, 3, 9, no
421098765,  millybrightstar, 13, 2, 11, no
2987000517,  il_quoti, 13, 5, 8, no
2942275894,  stefania2205, 30, 5, 25, no
514592290,  AlessandroCochi, 3, 1, 2, no
3227683351,  Umberto_D_G, 4, 1, 3, no
778530030,  topoloninobg, 7, 1, 6, no
2584582892,  luisthenewblack, 3, 1, 2, no
4691712930,  Guardiandelfar, 9, 4, 5, no
957926748,  PCazzani, 6, 1, 5, no
730123768350314498,  388_759, 5, 1, 4, no
2572210756,  _easiertorun, 3, 1, 2, no
1853722758,  Wanda_Porrani, 11, 4, 7, no
1218580224,  ManuelaGilardi1, 4, 1, 3, no
774232452806086656,  lucianoviviani3, 6, 2, 4, no
18188941,  mzeloni, 9, 3, 6, no
216771953,  RacchiMarco, 5, 2, 3, no
1166339754,  MaraMobile, 19, 9, 10, no
3241758183,  agostino31139, 3, 1, 2, no
792796905558446081,  marco_celtico, 6, 2, 4, no
4075468583,  Apo_Strofo, 6, 2, 4, no
458670095,  lucilla171, 5, 1, 4, no
455939725,  Barabba1, 3, 1, 2, no
3326859207,  AssistenzaInter, 6, 1, 5, no
1201732994,  morachiche, 3, 1, 2, no
954274980,  daniloconversi, 3, 1, 2, no
563999084,  marini_samuele, 7, 3, 4, no
18582562,  OfficialGattara, 10, 3, 7, no
627784163,  jeanontwitt, 5, 2, 3, no
798261254536183808,  TeamTrump4, 7, 3, 4, no
4370394857,  paolomalfy, 4, 1, 3, no
20940460,  IraMency, 15, 7, 8, no
3321312502,  CatiaButterfly, 5, 2, 3, no
845468852,  AnnaLoppo, 3, 1, 2, no
1428360464,  datomasino, 3, 1, 2, no
87967184,  Occidentale, 4, 1, 3, no
1857838688,  FLIBLOC, 11, 3, 8, no
1891067288,  shaddai7777, 5, 2, 3, no
413235901,  luca_sbardella, 3, 1, 2, no
1254580586,  TIZIANABELLINA1, 4, 1, 3, no
410808584,  FedeAngeli, 13, 6, 7, no
53481195,  marcello252, 5, 2, 3, no
757974675083370496,  Eugenio15028208, 4, 1, 3, no
2737168551,  giomarangi, 3, 1, 2, no
2169551812,  pietro_giannini, 3, 1, 2, no
408050299,  cheratoconico, 3, 1, 2, no
455620250,  carmarano, 3, 1, 2, no
709601106,  OriettaTabanell, 4, 1, 3, no
4233541725,  ITINERARIASmart, 6, 1, 5, no
200803896,  patriziamolina, 3, 1, 2, no
433754193,  AntonioCampo4, 9, 4, 5, no
2415846904,  EEnzogrosso52, 3, 1, 2, no
2457219327,  brantolo69, 7, 3, 4, no
2260290943,  falsus63, 4, 1, 3, no
249625261,  Scarlet_Agnes, 8, 3, 5, no
1063503469,  Insp_Chateau, 3, 1, 2, no
1225534116,  zuc_g, 4, 1, 3, no
1904885862,  verdiana_v, 6, 2, 4, no
353894758,  asvaresino, 3, 1, 2, no
512987105,  barbarabovone, 4, 1, 3, no
2430411374,  Tomtomtof, 23, 9, 14, no
2885393529,  almabalz_alma, 7, 1, 6, no
303936344,  Robisign, 3, 1, 2, no
2977709325,  CharlesDeche, 5, 2, 3, no
927724410,  MarinaBaronti, 3, 1, 2, no
708270672817082369,  gstmnc1, 10, 2, 8, no
495717341,  estermirry, 8, 2, 6, no
115675193,  matterice, 11, 3, 8, no
1282918945,  WhisperCar, 3, 1, 2, no
248459008,  Ssiu_, 3, 1, 2, no
462900728,  ephemerol1, 3, 1, 2, no
235660726,  Luckyluciano971, 3, 1, 2, no
1605328957,  BePietro, 6, 2, 4, no
489630689,  _Mbuton, 3, 1, 2, no
70946877,  novelune, 3, 1, 2, no
242698861,  salvyx88, 5, 2, 3, no
910465218,  AntonucciAldo, 8, 2, 6, no
732701339801780224,  tricellla, 3, 1, 2, no
706117842815623168,  maxpix6251, 4, 1, 3, no
2981642447,  stefania_poggio, 3, 1, 2, no
2541569407,  ragazzodagliocc, 5, 1, 4, no
1460431345,  AndreaGhiringh2, 3, 1, 2, no
3014227258,  piglione_laura, 4, 1, 3, no
482852345,  Axmar75, 3, 1, 2, no
706397427,  PasCoNaples, 3, 1, 2, no
491167846,  celhoceruleo, 3, 1, 2, no
478894654,  Keynesblog, 3, 1, 2, no
103077927,  Dan_skorpio87, 7, 2, 5, no
2512612640,  rubino7004, 3, 1, 2, no
987114463,  padella39, 5, 1, 4, no
1129073232,  idolsakamyljfe, 5, 2, 3, no
411304327,  quoquetu, 4, 1, 3, no
2494379611,  CalcagnileG, 6, 2, 4, no
409539899,  france_sor, 4, 1, 3, no
30892269,  gianbor, 7, 3, 4, no
4068202785,  giornalecchismo, 7, 1, 6, no
4143185404,  V_M5S_, 8, 1, 7, no
703307259607126016,  sauchack, 7, 2, 5, no
3050023667,  improta80, 4, 1, 3, no
2169041137,  civettexcivati, 5, 1, 4, no
141975784,  jan_sobi, 9, 4, 5, no
3344602564,  raff8181, 9, 1, 8, no
412230108,  ilariovs, 5, 2, 3, no
213510449,  JesBF, 3, 1, 2, no
520808720,  9953_maria, 5, 2, 3, no
2233502635,  ilmerdone, 14, 3, 11, no
278156769,  rougeBLN, 9, 3, 6, no
732270119167119364,  martinasant8r, 5, 1, 4, no
6532332,  binarioloco, 13, 1, 12, no
75113071,  vontrotta, 3, 1, 2, no
2780466756,  lascallons, 11, 5, 6, no
352308407,  la_stordita, 3, 1, 2, no
269221313,  CarloOneto, 3, 1, 2, no
2346624322,  holyvirtute, 3, 1, 2, no
1365384444,  EnricoAnzuini, 3, 1, 2, no
624903,  vittoriopasteris, 3, 1, 2, no
24026780,  Simone_1985, 3, 1, 2, no
728344128,  ayradw, 3, 1, 2, no
1954450338,  ninolofaro, 12, 2, 10, no
621823364,  cucinapergioco, 9, 4, 5, no
2704308742,  AngeloMaggioni3, 7, 1, 6, no
369481356,  TheBanale, 3, 1, 2, no
2591260712,  CapuPatriote, 3, 1, 2, no
3312841702,  sopadepa, 3, 1, 2, no
741690938683215874,  nuvolinatw, 7, 3, 4, no
3361208621,  CLotirchio, 3, 1, 2, no
761405641,  AkealaLeu, 3, 1, 2, no
2779103913,  hidethebone74, 3, 1, 2, no
747084291910287360,  SpainBrexit, 3, 1, 2, no
462298361,  davids7683, 8, 1, 7, no
4902342166,  rosaria74733, 21, 1, 20, no
2999816867,  JacopoCairoli, 5, 1, 4, no
803979599210233856,  alerota1126, 16, 6, 10, no
448091207,  OrnellaCostanzo, 3, 1, 2, no
747062107636637697,  IvanDellaRocca1, 28, 9, 19, no
715186946616725504,  minpiper, 5, 1, 4, no
922613564,  mightyguy1357, 10, 1, 9, no
96233686,  HELY91, 31, 2, 29, no
84307195,  neurocaos, 4, 1, 3, no
2820362326,  AgtAlesii, 5, 2, 3, no
871789964,  irenetta, 3, 1, 2, no
1095354780,  massimogara, 3, 1, 2, no
792455432765894656,  MikiDarnel, 5, 2, 3, no
2970015723,  MariaGiuliaDelf, 9, 4, 5, no
2203727552,  neribrixia, 9, 4, 5, no
3317634244,  SpudFNVPN, 3, 1, 2, no
40354809,  maplewhite1912, 5, 1, 4, no
118905925,  Budoia2005, 3, 1, 2, no
805587481320194048,  IgnoranzaDelNo, 15, 6, 9, no
2558870687,  callevaleria7, 5, 1, 4, no
2979063580,  BlogAncien1, 3, 1, 2, no
25265895,  zarkoh, 3, 1, 2, no
246417264,  daddacasula, 4, 1, 3, no
429301006,  GianpieroMarron, 3, 1, 2, no
70969794,  domenicogatto, 5, 1, 4, no
1145616823,  paolo_calosso, 7, 3, 4, no
1697296957,  Ale80178, 7, 1, 6, no
597492087,  cangelmar, 3, 1, 2, no
330252561,  Vetriolo_, 4, 1, 3, no
1316416861,  adiosu46, 5, 1, 4, no
454349258,  ritalxp, 3, 1, 2, no
512591252,  echelonbrother, 4, 1, 3, no
2241302364,  ANDREAESCIT, 3, 1, 2, no
222224368,  giovy1967, 19, 6, 13, no
635689685,  StefanoTrabalza, 3, 1, 2, no
118072089,  clarrkeent, 3, 1, 2, no
817620290,  marcobobo89, 3, 1, 2, no
2256287230,  FLampunio, 6, 2, 4, no
2754985382,  dursogiacinto, 3, 1, 2, no
372238164,  lellone_, 6, 2, 4, no
1420722031,  mod_moonie, 3, 1, 2, no
4148028263,  Superman5Stelle, 3, 1, 2, no
4053878974,  M5S_IX, 3, 1, 2, no
199923959,  MarPiColl, 19, 3, 16, no
3888190043,  smarts_24, 5, 1, 4, no
150172108,  antonella17162, 5, 2, 3, no
380526746,  mrcllznn, 10, 4, 6, no
4133772051,  littleovetto, 3, 1, 2, no
2154514886,  LiberaDestra, 15, 0, 15, no
264652421,  robobot1999, 1, 0, 1, no
450639758,  Stevu75, 3, 0, 3, no
3155718400,  salvatore_dovi, 1, 0, 1, no
3136185147,  enzomedda62, 1, 0, 1, no
218246478,  gianpollano, 1, 0, 1, no
3007673747,  paolagott62, 6, 0, 6, no
221351837,  miyamotodan, 1, 0, 1, no
456508187,  laurauras, 10, 0, 10, no
538885766,  ScaramuzzaMiky, 4, 1, 3, no
2341941243,  ollilud, 2, 0, 2, no
415401236,  corradoserrenti, 1, 0, 1, no
4031602695,  catatimpano, 5, 0, 5, no
544319967,  EmanueleG1972, 1, 0, 1, no
373040181,  antolipari, 1, 0, 1, no
624454857,  AlessandroSusa1, 2, 0, 2, no
2234800475,  Alfodifi97, 1, 0, 1, no
2296120900,  EmanueleRaimon2, 1, 0, 1, no
1341410430,  FlagiellAlfredo, 2, 0, 2, no
1492135807,  nefelef, 5, 1, 4, no
1830959977,  damiano_tozzi, 1, 0, 1, no
858113870,  BartoloMeotti, 4, 1, 3, no
3149527702,  hevi_dilara, 1, 0, 1, no
2817019830,  ideadestra_, 4, 0, 4, no
427357728,  tagliocentrale, 9, 0, 9, no
326693198,  MicheleBottaro, 1, 0, 1, no
1375116127,  PaoloZobolip, 2, 0, 2, no
1091619487,  Mauri_Massari, 1, 0, 1, no
2172441530,  AlesCardone, 1, 0, 1, no
16476536,  ultimenotizie, 3, 0, 3, no
254554605,  ultima_ora, 3, 0, 3, no
4894384605,  AzioneNazTriest, 4, 0, 4, no
4794325156,  AzioneNazBari, 4, 0, 4, no
3017305876,  ClaudioM87, 4, 0, 4, no
543426963,  MazzittiRosella, 1, 0, 1, no
1325375234,  stefimilan74, 1, 0, 1, no
4164611393,  AMelito86, 1, 0, 1, no
798854842785546240,  garpnat, 1, 0, 1, no
4587842841,  FriuliVG_AN, 4, 0, 4, no
4588321522,  puglia_an, 4, 0, 4, no
796684829014245376,  LiberaDestraPug, 4, 0, 4, no
794484184979017728,  droitfuturista, 1, 0, 1, no
2327387029,  ncd_liberopensi, 2, 0, 2, no
2469173094,  GiuseppeBiond14, 1, 0, 1, no
553638765,  RobertoCuman, 1, 0, 1, no
405095429,  ClaudioTerni, 1, 0, 1, no
803112131793219584,  Andrea28696938, 1, 0, 1, no
429063865,  strescino, 2, 0, 2, no
394798713,  lanfrancoorland, 2, 0, 2, no
1254184530,  Peppe_Borrata, 3, 1, 2, no
1091721907,  38salpri, 1, 0, 1, no
464894684,  GenSangiuliano, 2, 0, 2, no
187238066,  mbc87, 2, 0, 2, no
2375818687,  Gianluc75932250, 1, 0, 1, no
1080986425,  eliodanna2, 2, 0, 2, no
87650574,  notiziepolitica, 2, 0, 2, no
391562318,  andrea_gardin, 1, 0, 1, no
3141952751,  luciopatalano63, 1, 0, 1, no
139055024,  antoniopascuzzo, 6, 0, 6, no
712710953503170560,  MicheleFurlan9, 5, 0, 5, no
224619251,  mathwess, 1, 0, 1, no
552242067,  RobertoRanucci, 2, 0, 2, no
2779138041,  monica_ghelardi, 1, 0, 1, no
3201479849,  Gian_Sparascio, 5, 0, 5, no
282752093,  Italpress, 1, 0, 1, no
2856356531,  70Castaldi, 2, 0, 2, no
4818340347,  mov_ideaToscana, 11, 2, 9, no
38405320,  DODO_from_roma, 2, 0, 2, no
796449951643529216,  glucairish743, 3, 0, 3, no
996823994,  MarcoDeStefano_, 1, 0, 1, no
424281659,  giovaniperlalib, 1, 0, 1, no
989129461,  MarcoMFrisone, 1, 0, 1, no
464561589,  AntonioFiore68, 1, 0, 1, no
756546140644974596,  gdarm55, 20, 0, 20, no
475254497,  monica_tacchini, 19, 4, 15, no
386471970,  danieleocchi, 2, 0, 2, no
417230292,  gianluca_fabi, 10, 2, 8, no
194768449,  andreacecconi84, 4, 0, 4, no
440684594,  gherbitz, 2, 0, 2, no
82138891,  Bernaud21, 8, 1, 7, no
2710647804,  diegodalboni, 3, 0, 3, no
17439787,  AndreaTj, 26, 1, 25, no
56473208,  alessandro613, 8, 0, 8, no
549936262,  Mork81cesarini, 2, 0, 2, no
745410799,  mmpbowen, 3, 0, 3, no
345698303,  GervasoLaPorta, 6, 0, 6, no
3405224997,  rossana306, 5, 0, 5, no
3065904687,  logos_kosmos, 3, 1, 2, no
193261391,  lucianodarda, 18, 6, 12, no
9925862,  ilmiotg, 1, 0, 1, no
489199735,  alessandro_cant, 9, 4, 5, no
575688660,  livello5, 3, 0, 3, no
2514776575,  SelmiMary, 1, 0, 1, no
1092927026,  tordos57, 2, 0, 2, no
429242244,  ildernano, 2, 0, 2, no
97650801,  Michele_Potenza, 5, 1, 4, no
390642467,  Triwu, 1, 0, 1, no
2961401357,  VMozzato, 1, 0, 1, no
27992407,  RoccoCipriano, 38, 1, 37, no
782645175327739904,  Gianfrancobel16, 1, 0, 1, no
1114933988,  Dock32M, 5, 1, 4, no
2608189724,  OmarFerrari1991, 8, 0, 8, no
748035974647648257,  ggagliardi59, 7, 0, 7, no
1137933350,  santomik1, 1, 0, 1, no
84193474,  ivanl1987, 1, 0, 1, no
3032263864,  AlessiAnicca, 2, 0, 2, no
796742250961268741,  JFP_11, 2, 0, 2, no
154488615,  micheletarantin, 1, 0, 1, no
3232694020,  bora_carla, 2, 0, 2, no
462129103,  massimiliano_ri, 1, 0, 1, no
269856706,  bas5stelle, 5, 0, 5, no
221153691,  fDY026, 3, 0, 3, no
44370691,  DiegoDeLorenzis, 11, 1, 10, no
137388733,  CVR74GRANATA, 3, 0, 3, no
466841459,  andperro74, 1, 0, 1, no
2930584301,  zabulaghi, 1, 0, 1, no
2207330516,  Andy_Cortese, 7, 0, 7, no
61703985,  unozerozer0, 10, 2, 8, no
4720868602,  disabilitainmov, 2, 0, 2, no
1249848746,  73Orlando73, 4, 0, 4, no
737633633356369921,  Cesare24900199, 1, 0, 1, no
37507247,  Riccardo_Nuti, 3, 0, 3, no
370200598,  variselli, 1, 0, 1, no
719515530001063937,  LeggieriM5S, 5, 0, 5, no
1269390866,  _corona1973, 4, 0, 4, no
267824934,  ioioeio, 5, 0, 5, no
3121989501,  30b59cc2fc574f7, 1, 0, 1, no
501691674,  cinziabfc, 14, 1, 13, no
755281777,  liviomaretti, 5, 0, 5, no
2237570059,  mimiartino, 5, 1, 4, no
485408545,  AntoniaDartizio, 1, 0, 1, no
1035238824,  DavideRicci1973, 5, 1, 4, no
2239964759,  renemonf, 12, 0, 12, no
723150361112903680,  dbonfanti1341, 1, 0, 1, no
1326890640,  BlackcatMB, 1, 0, 1, no
3439290718,  tretretre333, 13, 3, 10, no
244451947,  BritishInside_, 2, 0, 2, no
2879971325,  SalPanaia, 2, 0, 2, no
2165533154,  davidedinoia, 2, 0, 2, no
318371203,  ludurdelfe, 7, 3, 4, no
192948690,  MysteryMiki, 2, 0, 2, no
4461052161,  EmanuelaBarrano, 6, 1, 5, no
531260671,  renatozanello, 3, 1, 2, no
2611745579,  MTrentini, 1, 0, 1, no
2865595678,  waliva1957, 18, 0, 18, no
13284492,  marcoscialdone, 2, 0, 2, no
805145682063589380,  mlchrr, 19, 0, 19, no
200313023,  Maria_Roberti_, 1, 0, 1, no
713698855032905728,  Michela73592286, 3, 0, 3, no
3077112633,  marty0576, 3, 0, 3, no
3355724674,  Carl6y6, 16, 7, 9, no
1119456882,  ferdisantoro, 3, 0, 3, no
1219049394,  LawViceconte, 1, 0, 1, no
839050856,  adrianvagnozzi, 4, 0, 4, no
483132641,  Marcopalmaxv, 13, 2, 11, no
462876561,  romabertone, 6, 0, 6, no
546658485,  giacomopenati, 5, 1, 4, no
46879002,  BitterStinger, 6, 0, 6, no
475134082,  JulesKemper, 20, 0, 20, no
188057072,  assenzio65, 2, 0, 2, no
2860212599,  Blu_Cad, 6, 1, 5, no
754269921949937665,  Muoviti66, 55, 0, 55, no
805663974431850496,  fabrizio1973f, 3, 0, 3, no
2311589125,  Piero1612, 2, 0, 2, no
1273356337,  menokk, 2, 0, 2, no
4592599288,  vinsci78, 2, 0, 2, no
3785335761,  MU5SsmarcoinL, 8, 0, 8, no
783587469744803840,  Notech_Store, 2, 0, 2, no
604613783,  logobenvenuto, 4, 0, 4, no
397897565,  massy11gsxr, 7, 0, 7, no
2349128023,  fabcolasanti, 2, 0, 2, no
950543234,  grlomo, 10, 0, 10, no
583877210,  apaschetti, 13, 1, 12, no
76768352,  charing89, 3, 0, 3, no
892912476,  RosGianluigi, 9, 3, 6, no
785731753700761600,  carmelomura1, 2, 0, 2, no
1219850648,  sidewayseye, 2, 0, 2, no
3517606996,  marcelolissand1, 2, 0, 2, no
3050315554,  stecco27, 3, 0, 3, no
1825976557,  Fioreadriano50, 2, 0, 2, no
1314002262,  RaffaeleManca2, 8, 0, 8, no
2568980217,  zed1684, 2, 0, 2, no
2819926689,  CarbonaraIng, 2, 0, 2, no
158949892,  iL3nia27, 5, 0, 5, no
2891108139,  lauraestatusquo, 10, 0, 10, no
497390214,  PetulaBrafa, 1, 0, 1, no
4728590782,  verdecar, 3, 0, 3, no
469254466,  borriroberto, 7, 0, 7, no
56064083,  stulimpetti, 4, 1, 3, no
784315996370722818,  rivadestract, 1, 0, 1, no
3425973148,  GMoncelsi, 4, 1, 3, no
358835137,  MassimoAndretta, 3, 0, 3, no
540605500,  DEABRAIDA, 1, 0, 1, no
1166480390,  mirkomignolli, 2, 0, 2, no
3360851079,  donaturtle1, 3, 1, 2, no
395803614,  PTrivi, 2, 0, 2, no
2603850468,  Antigiornalista, 23, 4, 19, no
73598124,  flinx15, 3, 1, 2, no
2746107033,  SondrioFederica, 4, 1, 3, no
562522191,  oss5s, 7, 2, 5, no
1224876152,  PiccolaPap, 3, 1, 2, no
3874001362,  siamotuttipoeti, 13, 6, 7, no
4164928408,  AlebottAlessan, 6, 2, 4, no
371154850,  FuocoMarco, 2, 0, 2, no
2776126551,  LaMombelli, 11, 0, 11, no
560997857,  francesco_scoma, 1, 0, 1, no
1125370914,  arcobalenoclub, 2, 0, 2, no
1246689782,  PetrucciAlfredo, 1, 0, 1, no
411011613,  CommFuturo, 7, 1, 6, no
1303161607,  1massiminimo, 1, 0, 1, no
3037110123,  carrozzini74, 2, 0, 2, no
2336516311,  fdarivagrechi, 2, 0, 2, no
705120695173390336,  FIRovato, 9, 0, 9, no
3169141887,  attiliof2, 1, 0, 1, no
474180138,  FraMariaRegina, 1, 0, 1, no
481552150,  GiovanniFirrito, 1, 0, 1, no
2882593798,  bertonid51, 1, 0, 1, no
4125963802,  franco49522481, 1, 0, 1, no
2310609029,  duduiani, 22, 1, 21, no
130134758,  MCTOGNINI, 1, 0, 1, no
373893572,  diego_jejo, 1, 0, 1, no
2356457670,  GiovanniLaMonic, 9, 0, 9, no
476224016,  CattozziRoberto, 2, 0, 2, no
587805027,  lauraravetto, 11, 1, 10, no
945145027,  maxnannoni, 3, 0, 3, no
724192261,  AProfCelli, 1, 0, 1, no
1427233322,  gaccervia, 8, 1, 7, no
468751102,  MirkoGhidini, 1, 0, 1, no
716989892954296320,  6ae86058d91f487, 2, 0, 2, no
1166191856,  ForzaAcqui, 2, 0, 2, no
2541176620,  john89930, 3, 1, 2, no
1257819193,  liquorigiovanni, 1, 0, 1, no
2443200701,  angela_galeone, 1, 0, 1, no
759087284356575233,  ritanuvola1955, 1, 0, 1, no
3058851983,  stevemcorin, 12, 0, 12, no
1142895247,  EnricoNardiTw, 4, 0, 4, no
2717296943,  AndreDelorenzi, 4, 0, 4, no
416309230,  pistelligoffr, 3, 1, 2, no
1087029078,  gianpaolomartel, 2, 0, 2, no
382238648,  SalvatoreMerlo, 2, 0, 2, no
19779684,  orkydea, 3, 0, 3, no
2002721,  dasar, 6, 2, 4, no
729787922644381697,  BellezzaLaura05, 2, 0, 2, no
1191081025,  FrancoFurcas, 8, 3, 5, no
2781366593,  nariucciopetra1, 6, 2, 4, no
544218009,  DonatoRobilotta, 3, 1, 2, no
2199379837,  nannidanzi, 6, 2, 4, no
551428995,  n_kraljevic, 3, 0, 3, no
1041470562,  nonvotatexMonti, 3, 1, 2, no
2323933241,  mdemarco55, 3, 1, 2, no
1024992674,  SixInTheStable, 4, 1, 3, no
1214739008,  paolo69edge, 5, 1, 4, no
2985256906,  simonechiav, 3, 1, 2, no
66378035,  maurofilippini, 6, 1, 5, no
710046420821286912,  IlCarmi73, 9, 3, 6, no
221531806,  enrinic, 3, 1, 2, no
296778555,  Daniela_Liotti, 6, 1, 5, no
875347244,  davidrodino, 8, 3, 5, no
3621950242,  FerranteSandro, 9, 0, 9, no
4735498517,  Antonio89806538, 1, 0, 1, no
424216485,  barbarajerkov, 3, 0, 3, no
703551569,  dario_balconi, 3, 0, 3, no
750313888344895488,  M__Guerrieri, 2, 0, 2, no
394059966,  poltronaggio, 4, 0, 4, no
239996328,  agoingenito, 1, 0, 1, no
1353939044,  Mattiagiaco92, 1, 0, 1, no
631061599,  dissezione, 1, 0, 1, no
1389944444,  AndreaOlma, 3, 1, 2, no
427789815,  PAnnicchino, 8, 0, 8, no
3760553777,  Azizzamri2, 9, 0, 9, no
237878540,  giannisgarbi, 3, 0, 3, no
22621566,  Walentina, 1, 0, 1, no
350236337,  nickgiannelli, 1, 0, 1, no
602729119,  france_melo, 1, 0, 1, no
988343473,  editta_fazzi, 2, 0, 2, no
1662392210,  giovagi1, 1, 0, 1, no
233611005,  lumiazy, 1, 0, 1, no
803354984440020993,  Gidema79, 1, 0, 1, no
509044457,  caniobrando, 3, 0, 3, no
36626879,  FedeBridge, 1, 0, 1, no
2545761557,  aenigmatica_, 1, 0, 1, no
2217779195,  mortariaq, 6, 0, 6, no
2415768917,  Walter_Mauriel, 3, 0, 3, no
436255240,  ForteFlavio, 1, 0, 1, no
428166307,  GiochCecconi, 1, 0, 1, no
118035662,  presidentegio, 1, 0, 1, no
511778772,  emanuelemoraldi, 1, 0, 1, no
871931652,  antopirolo, 11, 2, 9, no
349043533,  Simone_Dela, 10, 0, 10, no
2181109997,  b_baolo, 6, 2, 4, no
317278701,  affinitomichele, 1, 0, 1, no
1344040164,  ClaudioTocco87, 1, 0, 1, no
46065438,  Frakrt89, 1, 0, 1, no
2682728206,  CSignorotto, 2, 0, 2, no
207939445,  galietti82, 1, 0, 1, no
1367163644,  gaetano_amato, 1, 0, 1, no
58797291,  mariasiano, 1, 0, 1, no
40436213,  malabruzzi, 3, 1, 2, no
132526509,  AntonioMatto, 3, 0, 3, no
726842542722023424,  pippo_bassi, 1, 0, 1, no
1015313437,  PetrolioGrezzo, 3, 0, 3, no
106378808,  ROBIX1, 1, 0, 1, no
800779578,  dburani83, 3, 1, 2, no
335249305,  GLFurano, 3, 1, 2, no
417252855,  patriziafiori, 3, 1, 2, no
586037920,  Fornaro62, 6, 0, 6, no
871317662,  DZoggia, 3, 0, 3, no
88203349,  n_iacono, 2, 0, 2, no
122976053,  tiziodesio, 3, 0, 3, no
1654874078,  CollesanoGMario, 10, 1, 9, no
3005113455,  gianfrac57, 6, 1, 5, no
254704627,  remo_ricchetti, 2, 0, 2, no
1068928062,  usckok, 6, 2, 4, no
706803356,  maestrale53, 4, 1, 3, no
613452196,  BeDifferent_xXx, 4, 1, 3, no
932443237,  ZaffAntonio, 5, 0, 5, no
796061968486502400,  PietroLePera26, 5, 0, 5, no
205327727,  EBattestini, 4, 0, 4, no
423376068,  nicorigi, 3, 0, 3, no
413337087,  Enzo_Riontino, 3, 0, 3, no
3095660203,  FIGiovaniVeneto, 3, 0, 3, no
4529531674,  pierogeremia, 3, 0, 3, no
426076826,  FI_Giovani, 7, 0, 7, no
1441064498,  MoscatoDario, 3, 0, 3, no
2976611614,  FIgiovaniMolise, 3, 0, 3, no
372280583,  Federico_Menna, 21, 2, 19, no
1024040808,  AndreaPace92, 3, 0, 3, no
1269885642,  figsardegna, 3, 0, 3, no
4818686225,  ca_giovani_fi, 3, 0, 3, no
15719088,  PpCassoni, 3, 0, 3, no
747008536102699009,  figtortoliOG, 4, 0, 4, no
747011427270017024,  figmamoiadaNU, 4, 0, 4, no
4734022421,  figolbiatempio, 4, 0, 4, no
798275720,  FigiovaniNuoro, 3, 0, 3, no
3172830191,  FIGiovaniPn, 3, 0, 3, no
473718857,  AndriSerio, 3, 0, 3, no
1001820151,  CabMassi, 3, 0, 3, no
332346345,  UldericoDL, 3, 0, 3, no
2851471793,  fig_roma, 6, 0, 6, no
3345310611,  alexmarino824, 3, 0, 3, no
906269360,  tripodimaria, 8, 0, 8, no
2422714453,  ChriChiumera, 3, 0, 3, no
2971664825,  marziaspagnuol1, 3, 0, 3, no
2800353611,  AbruzzoFIGiov, 3, 0, 3, no
78334750,  adalonzo, 3, 0, 3, no
780698798473359361,  figiovanipe, 3, 0, 3, no
2343344779,  FIAbruzzo, 4, 0, 4, no
314839768,  alepontecorvo, 3, 0, 3, no
1228581132,  pirotz, 4, 0, 4, no
706945040149561352,  pillolo3, 3, 1, 2, no
4288995452,  7Vanessa8, 3, 0, 3, no
2896572294,  liciaoleando92, 3, 0, 3, no
434135494,  OlleiaValentina, 4, 0, 4, no
2427964266,  FISRemo, 21, 3, 18, no
23582145,  dacasati, 1, 0, 1, no
764395460,  SimbaGio, 1, 0, 1, no
458719075,  guidoolimpio, 1, 0, 1, no
491617371,  ErmannoArkam1, 1, 0, 1, no
2878366108,  Giuss_Calcio, 1, 0, 1, no
2761804163,  coimbraazevedo, 1, 0, 1, no
4546813439,  MrMojoRisin_27, 1, 0, 1, no
3256585139,  lucaf_1980, 1, 0, 1, no
4249515683,  lucadg75, 2, 0, 2, no
1299394213,  M5S_No_Grazie, 11, 1, 10, no
743579496574492673,  Lollowitz, 1, 0, 1, no
3296476839,  antf80, 1, 0, 1, no
334157137,  MattiaGiusto, 1, 0, 1, no
144581129,  Conte_Stefan, 1, 0, 1, no
487722575,  AbatiAl11, 8, 1, 7, no
182087936,  IlPaoloGiordano, 1, 0, 1, no
159528333,  DMassimiliano, 1, 0, 1, no
223986815,  MalkoPink, 1, 0, 1, no
3384217258,  Nicoloimmesir, 1, 0, 1, no
25373528,  Polichic79, 1, 0, 1, no
3080949119,  Infofatti, 7, 0, 7, no
702599188324941826,  GlovesQueen, 1, 0, 1, no
2609643615,  brumma_c, 3, 0, 3, no
454730135,  marcomontagna95, 4, 0, 4, no
2839630066,  StranieroAngela, 7, 0, 7, no
14073125,  Robbetta, 3, 1, 2, no
409500620,  LaZanzaraR24, 3, 0, 3, no
424102462,  pezzodiferro, 2, 0, 2, no
482349619,  LucaNameiswolf, 1, 0, 1, no
537241066,  RossettiCinzia, 1, 0, 1, no
4867474714,  Huffindogpost, 1, 0, 1, no
789256274,  RossiAnnachiara, 1, 0, 1, no
410960872,  Griso3, 3, 1, 2, no
105090713,  cauz_, 1, 0, 1, no
212163360,  danielelozzi, 3, 0, 3, no
315914335,  Dan33lo, 1, 0, 1, no
3907730538,  VVundabar, 3, 1, 2, no
660823,  biagio, 1, 0, 1, no
792638720486825984,  manueldipaolo99, 2, 0, 2, no
157409984,  Treklu, 1, 0, 1, no
1482475178,  CaroneTweet, 1, 0, 1, no
89455780,  alfredobini75, 1, 0, 1, no
132600522,  Ssalvatore13, 1, 0, 1, no
2249088026,  fradipiazza, 1, 0, 1, no
568519738,  Psss_Psss, 1, 0, 1, no
602637632,  enzofilia, 1, 0, 1, no
1427359140,  ApuntoD, 1, 0, 1, no
722130030,  PaoloPorcellum, 8, 3, 5, no
3302759115,  AlexItaliaTweet, 4, 0, 4, no
1001641908,  Giulio__Mariani, 3, 0, 3, no
1702340275,  RugnaChiara, 1, 0, 1, no
2754596762,  GiuliaS07, 1, 0, 1, no
3002109657,  monicaelucky, 1, 0, 1, no
3001111939,  nadiamartines58, 1, 0, 1, no
390778324,  francescocat89, 1, 0, 1, no
1975677404,  gostanel, 1, 0, 1, no
575746752,  gianni_matteo, 1, 0, 1, no
549331011,  ABinotto, 1, 0, 1, no
209645583,  Z3uSXp, 1, 0, 1, no
4208700496,  GiubyLeo, 1, 0, 1, no
413181958,  F4Fake1, 1, 0, 1, no
426642251,  94Gregorio, 1, 0, 1, no
598697094,  andreacarianni, 4, 1, 3, no
2167053595,  GioMatrella86, 3, 0, 3, no
541695689,  swordsmanlight, 4, 1, 3, no
755471173308276736,  il_Mirmidone, 2, 0, 2, no
150591923,  mRaccu, 1, 0, 1, no
4894984156,  PaoloCoc92, 1, 0, 1, no
796348634027753472,  albondilblond, 1, 0, 1, no
774270867014574080,  AlfPnz, 2, 0, 2, no
251192598,  stefanodeiuliis, 2, 0, 2, no
1416465541,  prof_giuseppe, 5, 1, 4, no
99997947,  willy6123, 1, 0, 1, no
426478566,  TizianoMosa, 1, 0, 1, no
432451617,  pigrof, 1, 0, 1, no
3504091637,  Chopin_Hauer_, 1, 0, 1, no
534425432,  francescafagnan, 4, 1, 3, no
4349538382,  mariuccienrico1, 1, 0, 1, no
3111223163,  fcalzia, 1, 0, 1, no
2221430782,  IlCeretti, 2, 0, 2, no
709471830,  EmilioERCaranti, 1, 0, 1, no
3569280136,  telecronacatrap, 1, 0, 1, no
757596839688466432,  Salvo94_, 2, 0, 2, no
126693711,  GG_995, 1, 0, 1, no
110409975,  MassimoMelis, 2, 0, 2, no
710594448728723456,  alesio1982, 1, 0, 1, no
2908475859,  ReRalf75, 1, 0, 1, no
762951852283617280,  NicoQuaranta9, 2, 0, 2, no
803183834003083264,  andreadabatini, 1, 0, 1, no
474764300,  drewscop, 1, 0, 1, no
400958605,  RobertoBortoli1, 1, 0, 1, no
978934117,  1_starrynight, 3, 0, 3, no
18600275,  orsobianco, 1, 0, 1, no
790133846,  CatalanoSanto, 1, 0, 1, no
223504287,  TommasoBalliera, 2, 0, 2, no
381742265,  GiorgioVelardi, 1, 0, 1, no
280548207,  fanfulla53, 1, 0, 1, no
181949906,  mic_tod, 2, 0, 2, no
2259128423,  gioTebaldi, 1, 0, 1, no
2791966276,  ClodoGiannini, 1, 0, 1, no
1934968448,  AlbertoArtico, 4, 0, 4, no
384823761,  michelepolizzi, 1, 0, 1, no
770534999158317056,  simone_lt, 1, 0, 1, no
248669645,  gion1974, 1, 0, 1, no
2504987971,  ValeDDR, 6, 0, 6, no
1726058940,  lisogena, 2, 0, 2, no
477992458,  MariaVarranca, 2, 0, 2, no
1606375039,  AlbertoBonici, 2, 0, 2, no
2354818038,  giagaz007, 8, 0, 8, no
518305107,  mirko8925, 2, 0, 2, no
33725783,  1nessuno100k, 1, 0, 1, no
2407607705,  pasqametrano, 2, 0, 2, no
28085918,  ale_futuro, 1, 0, 1, no
315901933,  lmercogliano, 1, 0, 1, no
1026894067,  ArsenaleKappa, 1, 0, 1, no
1341448514,  Olem_Rac, 1, 0, 1, no
2725517289,  vitodet, 2, 0, 2, no
765904821262151681,  grandealex1, 1, 0, 1, no
3014273699,  Fawn__Effe, 3, 1, 2, no
732098609336991744,  TrustThaProcess, 1, 0, 1, no
2508091577,  RaffaeleRicci10, 1, 0, 1, no
2258424567,  Miriam_dn1995, 4, 1, 3, no
179486797,  chiusin88, 1, 0, 1, no
343940079,  S89Tommy, 2, 0, 2, no
81670783,  RickyBauscia, 5, 1, 4, no
551690279,  foglioverde, 5, 0, 5, no
52063355,  ilcacciatore1, 4, 0, 4, no
2979813760,  PaolaSmoking, 7, 0, 7, no
702759586328137728,  SimoneBerto98, 2, 0, 2, no
781392022800306176,  Marty_Loca80, 1, 0, 1, no
496193538,  FrancescoLibe, 3, 1, 2, no
2540965137,  mattia_mariotti, 1, 0, 1, no
883730372,  tlalegname, 7, 0, 7, no
2469570907,  ElidaCrosara, 12, 0, 12, no
463938365,  tuttototo, 3, 0, 3, no
2949178589,  MischiFrancesca, 3, 0, 3, no
230117459,  Francescamanca8, 1, 0, 1, no
4593044481,  taizgem, 2, 0, 2, no
2392450085,  Djdariodimauro, 2, 0, 2, no
203422096,  dcavedon, 1, 0, 1, no
2736523546,  PerryPoletti, 14, 0, 14, no
304308840,  Flavio_MfM, 1, 0, 1, no
140130394,  JESS_3093, 1, 0, 1, no
300390026,  Onofrio_Greco, 1, 0, 1, no
155623600,  andtwet, 1, 0, 1, no
1392155702,  WendellGee1985, 2, 0, 2, no
4833575914,  Mimma240770, 8, 1, 7, no
513745663,  Emanuele676, 1, 0, 1, no
289541478,  adrianapian, 7, 0, 7, no
223115007,  The_Real_Toto, 1, 0, 1, no
2187901177,  GaetanoBellitto, 7, 0, 7, no
4193719577,  valerio19366025, 1, 0, 1, no
1300746456,  JeanPierSabagh, 1, 0, 1, no
441123748,  nappiluciano1, 1, 0, 1, no
1019759222,  MauroMolari, 2, 0, 2, no
490426715,  MARCANTESAVERIO, 17, 0, 17, no
232798646,  _juhan, 1, 0, 1, no
1239391705,  aviopene, 3, 0, 3, no
723515103530852352,  Necxiuspuntodue, 9, 1, 8, no
2810932438,  Nunzia5Stelle, 1, 0, 1, no
1049036017,  AraannFive, 1, 0, 1, no
773793565851942912,  mario_granozio, 8, 1, 7, no
2317777141,  FabrizioBander1, 6, 1, 5, no
473107684,  DalilaNesci, 5, 0, 5, no
371174340,  mikeja2, 8, 0, 8, no
802792437479575552,  BernardoPizzit, 3, 0, 3, no
1123071420,  viviana06743560, 5, 0, 5, no
99361454,  emmazanni, 14, 5, 9, no
417951504,  MarcoRattoLIBRI, 3, 0, 3, no
983131412,  MassimoLiveIt, 2, 0, 2, no
476857175,  arutav, 16, 0, 16, no
723584112586530817,  BorghiArianna, 2, 0, 2, no
974102796,  MirkoBusto, 1, 0, 1, no
727775762074488832,  1studioradi1, 1, 0, 1, no
2802157801,  leo_leo75, 3, 1, 2, no
754269659998855168,  Nikoklark, 3, 0, 3, no
517517175,  loredan28293976, 3, 0, 3, no
3750084076,  SestoCalendeM5s, 5, 0, 5, no
3148025625,  RemolinoGae, 5, 1, 4, no
2281231953,  MaxFaber58, 15, 0, 15, no
1907538607,  MaydaBucci, 5, 0, 5, no
773517618187730944,  Franniebb77, 1, 0, 1, no
624734124,  NuovOrdine, 2, 0, 2, no
4383831976,  Graziamamma4, 2, 0, 2, no
522542520,  AndreD81, 3, 1, 2, no
3056320343,  He_ismyhero, 2, 0, 2, no
1668102216,  xsuggomez, 1, 0, 1, no
366233317,  OrnellaLaviano, 1, 0, 1, no
479054996,  robfratt, 4, 0, 4, no
150856099,  LeoOlivera26, 5, 0, 5, no
876085555,  FrancisLafra, 20, 0, 20, no
982667311,  MarioSpinazzola, 3, 1, 2, no
309920258,  justinssollg, 1, 0, 1, no
4892696093,  GiampieroBoni, 1, 0, 1, no
787295659074387968,  matteonardisail, 4, 0, 4, no
2921313147,  Giada_Paron, 1, 0, 1, no
2978470539,  moonvjharry, 1, 0, 1, no
386162082,  andriguez, 1, 0, 1, no
805711764868440064,  lvcyblue, 1, 0, 1, no
462768170,  _den89_, 1, 0, 1, no
252499114,  Lucia2713, 3, 0, 3, no
332940060,  peppears, 1, 0, 1, no
445424014,  vam237, 12, 1, 11, no
1151527296,  nuzzolo51, 8, 0, 8, no
2211353832,  GarauSilvana, 22, 1, 21, no
444099350,  ErikaPissarello, 1, 0, 1, no
1419010075,  niko6958, 11, 0, 11, no
983253218,  UnoNemoNessuno, 12, 0, 12, no
1071451754,  pesceregina, 7, 0, 7, no
418253203,  LucaCellamare, 10, 1, 9, no
142034488,  PeterDelleAlpi, 7, 1, 6, no
206671784,  fabryxfg, 11, 5, 6, no
2198397882,  guair1_guair, 3, 0, 3, no
351750061,  pinco9, 6, 0, 6, no
419131342,  gloriastolfo, 5, 2, 3, no
950796283,  GaetanoGorgoni, 3, 0, 3, no
910243676,  archipep, 3, 0, 3, no
1262704657,  GMettifogo, 6, 0, 6, no
940100618,  federicadieni, 1, 0, 1, no
936533587,  giovannafadda4, 16, 2, 14, no
2438727459,  A58Anna, 4, 1, 3, no
264117723,  Biberkopf76, 6, 1, 5, no
242490259,  maurovecchietti, 15, 4, 11, no
3028103830,  giovmaraglino, 6, 2, 4, no
417370434,  mattia_mat, 7, 3, 4, no
1038366410,  TheHuom, 3, 0, 3, no
720297033651863552,  ScoziaC, 8, 0, 8, no
1061259396,  Margelletti, 2, 0, 2, no
263582790,  CentroStudiInt, 1, 0, 1, no
430718992,  2ndDemocracy, 4, 1, 3, no
30631198,  fioborel, 13, 0, 13, no
1212034646,  PinkFreud009, 12, 1, 11, no
340614513,  Mar_venx, 3, 1, 2, no
751820450,  che_fidel2, 4, 1, 3, no
1233824197,  RaffaeleDino, 5, 2, 3, no
8556542,  pipcoman, 16, 7, 9, no
3297837127,  LaskaJuventus, 13, 3, 10, no
721766834815549441,  gabrielebar1, 3, 1, 2, no
142227794,  MadCow78, 5, 2, 3, no
100991438,  massitognetti, 11, 0, 11, no
587492925,  DadaFonta, 2, 0, 2, no
743075984350543873,  LauraPrinz2, 1, 0, 1, no
242092114,  rockorizzo, 3, 0, 3, no
2948657619,  CitoCinzia, 1, 0, 1, no
801539266597814272,  raia_vittorio, 2, 0, 2, no
621033928,  PaoloMartone, 1, 0, 1, no
389602747,  malapunta, 1, 0, 1, no
55186493,  kimeracineclub, 1, 0, 1, no
1055870916,  NadiaValente2, 1, 0, 1, no
2489572129,  patriziap52, 1, 0, 1, no
704275570000064513,  chiarasmar, 1, 0, 1, no
1160208637,  giocogio1, 2, 0, 2, no
1930484058,  manupioppo, 1, 0, 1, no
882039175,  ORNELLAFEDELI, 1, 0, 1, no
758661601797046272,  ElisabethPiro, 1, 0, 1, no
3585095897,  piercirogianni, 2, 0, 2, no
2301647622,  FabiolaMilioni, 1, 0, 1, no
706918990543790080,  emess_90, 1, 0, 1, no
20278277,  solortravels, 1, 0, 1, no
2576727319,  SasaLieto, 2, 0, 2, no
217023602,  EssereVivi, 1, 0, 1, no
440842714,  MMontiglione, 2, 0, 2, no
1112031457,  mcristinatambur, 1, 0, 1, no
448036732,  antonio_davino, 1, 0, 1, no
945454573,  Sabrinamontuori, 1, 0, 1, no
448389529,  carmine_riccio, 1, 0, 1, no
952590944,  giaffredaa, 1, 0, 1, no
3378796144,  WweElisabeth, 1, 0, 1, no
780171107018088452,  mimmonero56, 1, 0, 1, no
800867623177228288,  UboldiPaolo1, 1, 0, 1, no
1627306938,  domenico743, 1, 0, 1, no
3446437582,  dettoripA, 1, 0, 1, no
787452075244449792,  FranceNa966, 2, 0, 2, no
376224033,  pvittorio81, 1, 0, 1, no
3156185302,  info_micropedia, 1, 0, 1, no
733224884,  NicolettaMilett, 1, 0, 1, no
1472981390,  Lucadeflorentis, 1, 0, 1, no
2193116548,  criscuolo1955, 1, 0, 1, no
4078539741,  Rosalba_Salzano, 7, 0, 7, no
2208690588,  vitnicalt, 1, 0, 1, no
1252378069,  LGiunti, 1, 0, 1, no
2158847927,  antonellaze, 1, 0, 1, no
926231262,  concettatorlett, 1, 0, 1, no
3214370294,  AriannaMonica1, 1, 0, 1, no
98369303,  frateAndrea, 1, 0, 1, no
801133353126756356,  Riccardoc16, 1, 0, 1, no
799719119213895680,  CharlySailor, 1, 0, 1, no
4319725823,  rosaria1925ll4, 4, 0, 4, no
805893299923984384,  ermanno_pastore, 1, 0, 1, no
470917159,  MircoRigari, 1, 0, 1, no
1250016204,  FiorileChiara, 12, 0, 12, no
433207635,  GSilingardi, 5, 1, 4, no
1283360828,  cristiancaloni, 1, 0, 1, no
294675329,  AldoSkoda, 1, 0, 1, no
133644326,  Galaxiam, 1, 0, 1, no
16041612,  FabioA, 2, 0, 2, no
563585325,  musto_mario, 1, 0, 1, no
710379738,  LiberIdeAle, 2, 0, 2, no
743218418032218112,  dimauropas, 2, 0, 2, no
278907226,  busettodavide, 1, 0, 1, no
1149263083,  carmencita_DR, 1, 0, 1, no
432874982,  mussivanacore, 1, 0, 1, no
815756892,  PieroCoutinho, 1, 0, 1, no
863031162,  nelpaeseit, 3, 0, 3, no
100453216,  EoloRob, 1, 0, 1, no
803976818038571008,  Federico_Dema, 1, 0, 1, no
1556702114,  VincenzoP86, 4, 0, 4, no
497829386,  reowyn_, 1, 0, 1, no
788487071304482816,  AnnaMtima, 2, 0, 2, no
533604015,  allatatina, 1, 0, 1, no
290020510,  lascialfari, 1, 0, 1, no
57698379,  LucaMaglione, 1, 0, 1, no
369989109,  vincenzogargiu3, 1, 0, 1, no
143426592,  AntonioMusella, 1, 0, 1, no
2929672425,  edoardo_go, 2, 0, 2, no
585805278,  sergioscognas, 1, 0, 1, no
497298464,  VNobil, 7, 0, 7, no
49064205,  faber1980, 1, 0, 1, no
355158846,  manuelparlato, 1, 0, 1, no
93193032,  joepocket, 1, 0, 1, no
1675709983,  DUVAFerdinando, 5, 0, 5, no
374200554,  gianlucafava, 1, 0, 1, no
513116263,  GalantoMassimo, 3, 0, 3, no
327861190,  imascolo, 1, 0, 1, no
997977180,  enrico_perna, 1, 0, 1, no
734385926240112641,  G1adaross1, 2, 0, 2, no
2933917370,  Blumeide09, 48, 0, 48, no
886453284,  HOMO_REUS, 1, 0, 1, no
405477731,  dompePrignon, 2, 0, 2, no
502118586,  BenniN1, 1, 0, 1, no
1317253111,  acoppeto, 1, 0, 1, no
253265973,  raf_ambrosino, 1, 0, 1, no
149167222,  mmaritato, 2, 0, 2, no
802563684992249856,  marcogaleota, 1, 0, 1, no
2789385720,  Orlowski_MSZ, 2, 0, 2, no
8286932,  santopaolo, 1, 0, 1, no
483990953,  nello_pastore, 1, 0, 1, no
418169040,  AnnaMariaBova, 3, 0, 3, no
1921317079,  marini_adele, 1, 0, 1, no
98125196,  gun60, 3, 0, 3, no
2987918104,  antlucig, 2, 0, 2, no
439110992,  Sasyarm, 1, 0, 1, no
15677686,  VinceDOnofrio, 1, 0, 1, no
164225784,  corrmezzogiorno, 5, 0, 5, no
596711664,  cevagrimaldi, 1, 0, 1, no
2351925668,  DPartenopeo, 1, 0, 1, no
131591161,  maucanna, 1, 0, 1, no
1926686792,  gigi_rai, 1, 0, 1, no
1168618789,  Angelnigro, 4, 1, 3, no
379800904,  ziaemanu, 1, 0, 1, no
492639680,  Rossi335635xxxx, 1, 0, 1, no
934200967,  VeroVernetti, 1, 0, 1, no
2295598174,  Ilbiondo73, 2, 0, 2, no
119674844,  lellosomma, 1, 0, 1, no
532609427,  brikkoncella, 1, 0, 1, no
700397967262556162,  Mambo974, 2, 0, 2, no
795323216159997952,  VITTORI84320258, 2, 0, 2, no
554272894,  PasqualeBellott, 1, 0, 1, no
272756812,  gennydimare, 1, 0, 1, no
3040413968,  AlessiaGallo54, 1, 0, 1, no
794913233769549828,  ScaleNapoli, 1, 0, 1, no
24919799,  Marzius67, 3, 0, 3, no
1015801046,  gigitodino, 1, 0, 1, no
1927514694,  meroni_mauro, 19, 0, 19, no
1097904109,  framasashige, 13, 0, 13, no
195005069,  Graziella1128, 7, 2, 5, no
3298910494,  AbraminiAlberto, 1, 0, 1, no
3164958129,  DesilvestrisS, 1, 0, 1, no
784079540373118976,  lozito_leonardo, 2, 0, 2, no
787924963802148864,  cla00001, 1, 0, 1, no
1327803948,  gloriakoan, 14, 3, 11, no
293372970,  FancelloAdriano, 12, 2, 10, no
2242729885,  percivalgull, 14, 0, 14, no
3027236165,  Rossyf04, 1, 0, 1, no
332678373,  orsoperso, 10, 1, 9, no
354867767,  MartaCompagnone, 3, 0, 3, no
776388048561078272,  anna_muoio1, 4, 1, 3, no
1273237951,  giorgio_zu, 1, 0, 1, no
3086983167,  GiuppyAlb, 1, 0, 1, no
1015743302,  rominamoser2, 2, 0, 2, no
2535282981,  martaranucci, 3, 0, 3, no
408429579,  Saretta_big, 1, 0, 1, no
533959367,  bcarosini1, 5, 1, 4, no
798284445581266945,  CarloVergnano, 2, 0, 2, no
730498917176061953,  vincenzocorra48, 4, 0, 4, no
2302034329,  FI_Campania, 22, 0, 22, no
756456006331297792,  CampaniaPerilNo, 3, 0, 3, no
2302070180,  DomenicoDeSiano, 10, 0, 10, no
44120419,  p_right, 4, 0, 4, no
778559501213560832,  ilsudperlitalia, 3, 0, 3, no
1026144254,  NazarioPagano, 4, 0, 4, no
791376904221814784,  NonMaisSabas, 1, 0, 1, no
349374311,  bikenewsPhoto, 1, 0, 1, no
109659461,  StefanoCaldoro, 5, 1, 4, no
558746401,  RonghiSalvatore, 1, 0, 1, no
1455940584,  mistibis, 2, 0, 2, no
256595208,  INVIDIO, 9, 2, 7, no
2666051378,  severino_nappi, 12, 0, 12, no
13047402,  MusicTvOfficial, 1, 0, 1, no
1415054761,  semisrl, 3, 0, 3, no
238298324,  liliusm, 1, 0, 1, no
431100290,  PaoloTerrile, 1, 0, 1, no
696831186820329473,  SodduGiovanna, 2, 0, 2, no
803659890967318534,  Antonio54173054, 1, 0, 1, no
1687856598,  BelvisiBattista, 1, 0, 1, no
2405206161,  Cesaro_FI, 8, 0, 8, no
4784064865,  ForzaItalia_Mel, 10, 0, 10, no
2482442108,  MafaldaAmente80, 7, 0, 7, no
383140351,  Mauro_di_Roma, 1, 0, 1, no
3198806519,  morrisbattist, 1, 0, 1, no
715947181652451328,  Giusepp61982271, 7, 0, 7, no
2903619039,  FIG_Campania, 9, 0, 9, no
467736340,  Allesmarke14, 1, 0, 1, no
3354137837,  fi_regcampania, 6, 0, 6, no
712223648,  max_strippoli77, 1, 0, 1, no
1259556817,  ManuelApeddu, 1, 0, 1, no
2729449693,  BulantiValter, 1, 0, 1, no
431736458,  Mcpaders, 2, 0, 2, no
2373453494,  mariliven, 1, 0, 1, no
3984178583,  krcuel, 6, 0, 6, no
1704844459,  AnnaAdamo24, 15, 0, 15, no
128960061,  Davide_4444, 1, 0, 1, no
585661410,  splitalia, 5, 0, 5, no
373947833,  FrassinettiP, 1, 0, 1, no
1374146521,  PentangeloA, 9, 0, 9, no
266189786,  armandocesaro, 15, 0, 15, no
796293348340408320,  addeopaolo2853, 1, 0, 1, no
4806902709,  realmarcodemo, 1, 0, 1, no
455178157,  GViglietta, 1, 0, 1, no
4264670643,  FIcalimera, 1, 0, 1, no
1086628860,  bern1972, 3, 0, 3, no
1394582718,  Uglpuglia, 72, 2, 70, no
2902379002,  FI_Prov_Napoli, 6, 0, 6, no
3296210343,  PasqualePrisco5, 3, 1, 2, no
2707601247,  villovale, 3, 0, 3, no
510553990,  andreadifra, 1, 0, 1, no
71797055,  DamascelliD, 11, 1, 10, no
2862441234,  cla_cly88, 3, 0, 3, no
719872797103824896,  fi_bari, 1, 0, 1, no
2665954830,  ForzaItaBaiano, 3, 1, 2, no
2389245857,  sarapalermini, 2, 0, 2, no
772778458845941760,  pasqu27, 4, 0, 4, no
794520564866154496,  lin_kalinda, 1, 0, 1, no
1010779513,  MarcoFIORelly, 1, 0, 1, no
4078806327,  _SaBrInA92_, 1, 0, 1, no
3347777716,  renatoguaglian1, 2, 0, 2, no
1707145292,  massimoomar, 1, 0, 1, no
309554233,  clubfpanico, 6, 0, 6, no
2149138327,  nespoli50, 27, 0, 27, no
3093504958,  TittyRomeo, 6, 0, 6, no
1615106850,  AleCampigli, 4, 0, 4, no
363616037,  peppe_federico, 5, 0, 5, no
4635341237,  nappovincenzo7, 1, 0, 1, no
452612282,  Marco_Fattorini, 1, 0, 1, no
2791419194,  DilettaRossi80, 4, 0, 4, no
396535606,  nildigna, 3, 1, 2, no
2996879087,  JJR1789, 1, 0, 1, no
364138262,  vincentfanini, 4, 0, 4, no
417287720,  MussoFilippo, 1, 0, 1, no
2297690535,  Leogixxer, 1, 0, 1, no
2872053178,  FIG_Marche, 1, 0, 1, no
516680545,  ezanna2011, 2, 0, 2, no
802828276481847297,  AbateCapitano, 1, 0, 1, no
400608432,  PittoreGiovanni, 1, 0, 1, no
2739082443,  BChiabotto, 2, 0, 2, no
717637263,  ubi_ubaldo, 1, 0, 1, no
2387583082,  gengalas, 5, 2, 3, no
1043319710,  chrimip, 1, 0, 1, no
397059204,  GiovanniGiuli, 1, 0, 1, no
3203361705,  eddacavedoni, 1, 0, 1, no
184677819,  SgangadaTRE, 1, 0, 1, no
4258635879,  BSevergnegne, 2, 0, 2, no
3559416569,  Mario_221047, 1, 0, 1, no
730751401194860544,  _gaetanocimmino, 5, 0, 5, no
857921246,  robertoaiello63, 4, 0, 4, no
447484344,  FioreFyore, 3, 0, 3, no
71108187,  PALUROMA, 1, 0, 1, no
321973192,  MaurizioBarbero, 1, 0, 1, no
1346887926,  ElyUGL, 3, 0, 3, no
2788974663,  adriano_scanu, 1, 0, 1, no
264845229,  MafeGutierrezCo, 1, 0, 1, no
1254951806,  nino_losa, 1, 0, 1, no
65617191,  paolosantin, 1, 0, 1, no
2183181957,  elibettyboni, 1, 0, 1, no
453379084,  caligola1974, 2, 0, 2, no
407844018,  mariolinacioppi, 1, 0, 1, no
2502574254,  GaldiAnt, 2, 0, 2, no
332092446,  Giuggiola_81, 3, 0, 3, no
484980283,  TVizziello, 1, 0, 1, no
3246732970,  angelicaniola, 1, 0, 1, no
27259807,  albertfinz, 1, 0, 1, no
2547906484,  mariabelvisi3, 2, 0, 2, no
327334660,  radio_milano, 3, 1, 2, no
1063397041,  AntonioMiele10, 6, 0, 6, no
135842886,  iannuz86, 1, 0, 1, no
1055240222,  reavincedomrea, 5, 0, 5, no
156900346,  teocom91, 1, 0, 1, no
2406348895,  Rob_Persiani, 1, 0, 1, no
401536744,  stfrance60, 1, 0, 1, no
54621250,  bedotwit, 1, 0, 1, no
556228078,  AlfredoMelita, 1, 0, 1, no
573049351,  mauroparodi3, 5, 0, 5, no
46245160,  erpy83, 2, 0, 2, no
151815328,  doudeelle, 3, 1, 2, no
2363546506,  CusmaiAntonella, 1, 0, 1, no
3253906285,  franceschinian2, 1, 0, 1, no
188704744,  daju29ro, 1, 0, 1, no
2203274991,  Giovi_Torresin, 1, 0, 1, no
409277280,  mdmford, 2, 0, 2, no
1183100450,  NaldoneJake, 1, 0, 1, no
327606075,  claudioiezzim, 1, 0, 1, no
2265734054,  RobertoBonac, 1, 0, 1, no
2778113365,  anto19331445, 1, 0, 1, no
4483387102,  EcletticaDance, 6, 0, 6, no
3710766262,  Nicoooo82, 5, 0, 5, no
118468298,  apro31, 1, 0, 1, no
4160702363,  antoniopisani17, 1, 0, 1, no
493235188,  ferdinantripodi, 2, 0, 2, no
602704576,  ManlioNeri, 3, 1, 2, no
192580291,  setterediroma, 2, 0, 2, no
416970995,  CarnovaleNicola, 1, 0, 1, no
559478963,  maredoggy, 1, 0, 1, no
485685744,  elvirasavino, 3, 0, 3, no
511705621,  albatrosday, 1, 0, 1, no
476290271,  LorLiga, 8, 0, 8, no
2409004844,  Salernitano_63, 1, 0, 1, no
1032249271,  VergognAtac, 2, 0, 2, no
752821878453141504,  Napoleone_III, 14, 0, 14, no
2905245363,  cesarep59, 12, 0, 12, no
543377842,  AtzeniAlex, 5, 0, 5, no
41914935,  SandraColombino, 4, 0, 4, no
769978369903566848,  Antonella121119, 1, 0, 1, no
1637909371,  broggalf, 1, 0, 1, no
708438713852891136,  MarcoRocco17, 2, 0, 2, no
1040432420,  GVaregliano, 1, 0, 1, no
259813792,  DSiracusano, 1, 0, 1, no
339173161,  61_sissi, 6, 2, 4, no
391338911,  CimbroEleonora, 1, 0, 1, no
101349228,  megalarmsicurez, 1, 0, 1, no
379347952,  FuffaForte, 24, 0, 24, no
489694873,  francesco_botti, 1, 0, 1, no
3031199740,  FloresMontem, 1, 0, 1, no
1593869209,  MaurProietto, 1, 0, 1, no
2609786247,  bugsytwenty, 1, 0, 1, no
742800361614934018,  tophtw, 1, 0, 1, no
425204698,  MauroCedarmas, 2, 0, 2, no
3434229274,  PdSegreteria, 3, 0, 3, no
3295067231,  PdSinistra, 4, 0, 4, no
716881918323765248,  genxcambas, 16, 0, 16, no
434256410,  DeliaOrsillo, 1, 0, 1, no
295535267,  LaPresse_news, 4, 0, 4, no
534534709,  Alessio_rouge, 1, 0, 1, no
1213656799,  vincenzotav53, 1, 0, 1, no
601118618,  papinus64, 2, 0, 2, no
2338374654,  Margherita_ol, 1, 0, 1, no
1037049708,  francesca_effe_, 1, 0, 1, no
1251629106,  rossidav81, 3, 0, 3, no
1552953278,  cato_edu, 1, 0, 1, no
722475496831901697,  Capponi4Fabio, 1, 0, 1, no
2776213765,  CristofariMarco, 1, 0, 1, no
463649801,  coliandro73, 3, 0, 3, no
805327474766839808,  LeoneZero, 1, 0, 1, no
2936070221,  giordanodorti1, 7, 2, 5, no
412993265,  FabrizioMercuri, 1, 0, 1, no
1222231279,  SBESSINA, 10, 0, 10, no
143051153,  nicoladelduce, 3, 0, 3, no
374984254,  codadilupo81, 1, 0, 1, no
398832307,  CarloDess, 2, 0, 2, no
485985971,  MariangelaBrind, 12, 0, 12, no
1941448963,  Claaaaaaudiooo, 3, 0, 3, no
3587858295,  FredMockingbird, 2, 0, 2, no
113622523,  palumb67, 2, 0, 2, no
709890005158772740,  EddiPavan, 1, 0, 1, no
889585220,  olipepe63, 1, 0, 1, no
227855396,  rosmontes, 1, 0, 1, no
1581655399,  ComodoEgidio, 6, 1, 5, no
742029848982491136,  TeodoroLascella, 11, 0, 11, no
327379455,  IvanTaverniti, 5, 1, 4, no
1285829190,  Ilferocecabaret, 5, 0, 5, no
252586553,  BeatriceLioi, 2, 0, 2, no
434150529,  Dcaminiti69, 2, 0, 2, no
237177428,  lacqui80, 2, 0, 2, no
396835780,  andreazoup, 3, 1, 2, no
1109576202,  Nino_1954, 1, 0, 1, no
453264684,  mareclaru88, 1, 0, 1, no
306921218,  ernestodelnible, 3, 0, 3, no
135082456,  williamsverta, 2, 0, 2, no
420335251,  LuisaBlive, 1, 0, 1, no
752957312072093696,  nicola_lecci, 1, 0, 1, no
2564287481,  pellicioli60, 1, 0, 1, no
1084226922,  CicconeNadia, 2, 0, 2, no
2321069222,  FedericaZaino, 1, 0, 1, no
2317508289,  CGMeloni, 2, 0, 2, no
2341734769,  massimo09421979, 1, 0, 1, no
721768316130430978,  Toty_Cx, 2, 0, 2, no
2330252382,  mimmoocapone, 2, 0, 2, no
745231964488237056,  NeroWolf9, 5, 0, 5, no
421678899,  antonioromiti, 1, 0, 1, no
839635759,  digiacomodonato, 1, 0, 1, no
805780793515769857,  Giulio54029688, 2, 0, 2, no
1563980484,  lorena_barbieri, 3, 0, 3, no
843380563,  jobmeteo, 2, 0, 2, no
1061527033,  agiulix, 2, 0, 2, no
25368436,  biugo, 2, 0, 2, no
2610976925,  patrj73, 1, 0, 1, no
15182465,  eraclito, 3, 0, 3, no
3027347596,  girucc, 2, 0, 2, no
821561744,  donatellabarus, 1, 0, 1, no
887224824,  mariowurz, 1, 0, 1, no
292651184,  ChiaraValerioti, 1, 0, 1, no
132500352,  rewindlive84, 3, 0, 3, no
2716757798,  tamburel63, 1, 0, 1, no
222629836,  LucaCaricato, 1, 0, 1, no
763318811961483264,  Francoviola11, 3, 0, 3, no
3589159876,  aimar17582, 9, 1, 8, no
164787954,  mirna_fusaro, 4, 0, 4, no
2153653584,  AsinoTw, 6, 1, 5, no
880981915,  giovannilaverd, 3, 1, 2, no
37616894,  nickomoni, 1, 0, 1, no
2342507018,  tonyarpino, 1, 0, 1, no
4713876442,  PaolotheBeatles, 4, 1, 3, no
554724544,  nikolay012, 2, 0, 2, no
98174343,  CEDPONTACCIO12, 2, 0, 2, no
526379568,  teresaciternesi, 8, 0, 8, no
1002201066,  Massimo5stelle, 10, 0, 10, no
76694254,  AlessMazzanti, 1, 0, 1, no
439245001,  streghina62, 7, 0, 7, no
878503224,  trentino5stelle, 22, 0, 22, no
447981049,  tex973, 10, 4, 6, no
152179876,  crisbo69, 3, 0, 3, no
342077520,  twicram, 9, 0, 9, no
723392517081718784,  0e876a478ac743c, 7, 1, 6, no
477025365,  IolandaNanni, 8, 0, 8, no
967938882,  palmalasi, 7, 0, 7, no
822200874,  insomniac39012, 3, 0, 3, no
483660718,  FrancescoDonMax, 1, 0, 1, no
1037579658,  andrearossiba, 6, 0, 6, no
2405656973,  Karm3nB, 5, 0, 5, no
974896261,  giancarlopinto2, 1, 0, 1, no
4229455444,  MyraFrida, 2, 0, 2, no
1219848883,  BastianCuntraiu, 15, 2, 13, no
164205065,  AndreaViviani, 11, 2, 9, no
3295211331,  Antonio_Cufari, 1, 0, 1, no
423726669,  margaart, 1, 0, 1, no
505805390,  LuisaPensabene, 1, 0, 1, no
1345401194,  Nicola_Mercurio, 2, 0, 2, no
4850499688,  salaris97, 1, 0, 1, no
523613502,  iena46, 21, 3, 18, no
474720885,  Diegos53, 2, 0, 2, no
461254969,  A33ROSSI, 2, 0, 2, no
553392203,  RomyHellas, 17, 2, 15, no
1183448389,  VPensabene, 7, 3, 4, no
391034680,  EugenioGangale, 6, 0, 6, no
1251322195,  maxcamerata, 29, 1, 28, no
2420640549,  FabioBellissimo, 3, 0, 3, no
62024752,  vincearma, 2, 0, 2, no
208197262,  elettricor, 1, 0, 1, no
2413327976,  Rodi1893, 4, 1, 3, no
430033517,  benedettademori, 10, 0, 10, no
405432607,  bartpatgrillo, 2, 0, 2, no
484133390,  giampieromarti1, 9, 0, 9, no
105538883,  glamourino, 11, 2, 9, no
374145405,  Btigerish, 2, 0, 2, no
612633942,  LivioOrtombina, 5, 1, 4, no
1177010244,  m_pe7, 2, 0, 2, no
3131316279,  DottVignolo, 15, 0, 15, no
570178300,  simone0781, 2, 0, 2, no
264686296,  luigipixel, 3, 0, 3, no
185120890,  RaymondoM, 1, 0, 1, no
1859667852,  _whenom_, 14, 1, 13, no
1228441892,  CVergato, 1, 0, 1, no
2884770762,  latinila1, 1, 0, 1, no
1238691594,  CarolcleaCarola, 6, 0, 6, no
1852433868,  kostasusi, 9, 0, 9, no
1008326401,  amicaxamica, 4, 0, 4, no
2467422972,  enzo26maggio, 6, 0, 6, no
539865019,  PierluigiPauli, 5, 0, 5, no
108273678,  LupusInFabula83, 1, 0, 1, no
280617318,  Billygun83, 3, 0, 3, no
1219792052,  tannico72, 3, 0, 3, no
2997728404,  odoanto1, 3, 0, 3, no
979279446,  bruttocoso, 21, 0, 21, no
798910302,  gi_pavanello, 1, 0, 1, no
1215433375,  gegenluc, 3, 0, 3, no
3224620169,  rockysal1979, 1, 0, 1, no
2238971784,  Antonio14663, 1, 0, 1, no
1017105506,  JaqIrene, 2, 0, 2, no
317951602,  scichi, 12, 5, 7, no
542573422,  MagicoPaola, 2, 0, 2, no
2438340445,  giuroby, 13, 0, 13, no
397358182,  GiQadro, 4, 1, 3, no
257884666,  silviafossiblog, 5, 0, 5, no
2244779704,  perrero_s, 2, 0, 2, no
200794803,  PPColasanti, 3, 0, 3, no
583687484,  eltheus, 3, 0, 3, no
799170605945942016,  giustodeigiusti, 1, 0, 1, no
1517691259,  LeoDende83, 9, 0, 9, no
564492621,  nadia26552904, 2, 0, 2, no
2896345199,  TheFabrizious, 19, 0, 19, no
510080672,  CarloCiccio, 1, 0, 1, no
785123317858590720,  extremexxx78, 2, 0, 2, no
2198111423,  SunjaSan, 1, 0, 1, no
2342104352,  banjopeloso, 18, 5, 13, no
1320078122,  marirosmari, 9, 0, 9, no
2815160163,  gigicozzo, 2, 0, 2, no
2865791827,  olindasilvagni, 5, 1, 4, no
116863508,  nicolamarzia, 2, 0, 2, no
387745397,  oriama1969, 2, 0, 2, no
798416925466521601,  biste71, 10, 0, 10, no
2442530351,  DiMauloEleonora, 1, 0, 1, no
112790908,  iLoveSaraJean, 4, 0, 4, no
2734425083,  mei_fabrizio, 1, 0, 1, no
1071485604,  il_Ghisa, 47, 0, 47, no
1506815232,  apollore62, 7, 1, 6, no
10100482,  PaoloZardi, 1, 0, 1, no
340911437,  Floiudice, 1, 0, 1, no
3387963069,  grace_vielle, 2, 0, 2, no
715828512,  EVerzotti, 13, 1, 12, no
1476164527,  fed_naz, 1, 0, 1, no
53126023,  andrein1982, 1, 0, 1, no
400959041,  doratempesta, 4, 0, 4, no
3110219361,  PozziJessica, 1, 0, 1, no
1684754797,  redbear201165, 1, 0, 1, no
2196650893,  steal61, 10, 2, 8, no
819650503,  carlozeuli, 1, 0, 1, no
81230879,  fiordinotte, 9, 0, 9, no
1540545835,  LuigiCelli1988, 4, 1, 3, no
425584732,  EnricoReboscio, 1, 0, 1, no
3346629027,  f4fad58cff11498, 6, 0, 6, no
1215238064,  MaddPagin, 1, 0, 1, no
223214082,  tuotrading, 5, 0, 5, no
717020986764165120,  RicardoAylin, 1, 0, 1, no
593547387,  xamlab, 2, 0, 2, no
3938197216,  samueleg849, 2, 0, 2, no
783760924649947137,  MikidiTreviso, 4, 1, 3, no
29066634,  alecola66, 1, 0, 1, no
2650978150,  michelelanzo, 27, 2, 25, no
2331189472,  Frak83, 1, 0, 1, no
452174282,  salvatorericci8, 2, 0, 2, no
23930852,  kaufmannbruno, 2, 0, 2, no
795355429798891521,  Puzzipa, 2, 0, 2, no
2383579672,  francescamir48, 1, 0, 1, no
1337403674,  gimaggioni, 6, 2, 4, no
749384694219800576,  Marco44981294, 16, 0, 16, no
148771890,  philpal79, 3, 0, 3, no
481944150,  CarloMarrone, 9, 1, 8, no
852980726,  Luka__76, 15, 4, 11, no
487914485,  milkoscaglione, 11, 1, 10, no
592127497,  VitoGulli, 10, 0, 10, no
472170881,  Gaetano_twit, 10, 4, 6, no
540994558,  toraldina, 1, 0, 1, no
925871864,  Frastabile70, 5, 0, 5, no
168513045,  selv4x, 1, 0, 1, no
1363019598,  AlexTheLondoner, 1, 0, 1, no
109361238,  andreadrus, 2, 0, 2, no
290992864,  LucaCimo, 15, 0, 15, no
3490660817,  BiTperMinute, 2, 0, 2, no
598942493,  enzafanelli, 1, 0, 1, no
2340302399,  tutto1altro, 2, 0, 2, no
17688757,  didaclopez, 2, 0, 2, no
182859208,  DeborahDirani, 2, 0, 2, no
135084834,  RickyTR74, 1, 0, 1, no
2782670885,  ulisse7555, 1, 0, 1, no
1600253772,  palmiericar, 2, 0, 2, no
504778376,  giuseppecampis6, 1, 0, 1, no
306343284,  errex2008, 1, 0, 1, no
2510778660,  katzetony, 8, 1, 7, no
2725677691,  AssiaPat, 1, 0, 1, no
261146261,  Falcomichele, 1, 0, 1, no
60928211,  MassimoLupi, 1, 0, 1, no
2980882067,  maldida_suerte, 1, 0, 1, no
254625981,  akexjoao, 24, 0, 24, no
490692382,  pasqua57, 1, 0, 1, no
186977143,  Queerrilla, 3, 1, 2, no
621916117,  Salnashmartelli, 1, 0, 1, no
384391965,  Nellopoint, 1, 0, 1, no
394119695,  ElSabrosoDJ, 1, 0, 1, no
242707729,  AnSignorini, 1, 0, 1, no
268811761,  panterarosa_113, 5, 1, 4, no
109823487,  the_kodes, 1, 0, 1, no
595001996,  MarioCappell8, 3, 0, 3, no
425915941,  ElysabettaM66, 3, 0, 3, no
787001238579740672,  marianogiardin6, 5, 0, 5, no
4899492155,  DomenicoSimon15, 8, 0, 8, no
3761998763,  RobediGianchi, 2, 0, 2, no
2868084261,  CanteleRoberta, 5, 0, 5, no
405382064,  Milla_58, 2, 0, 2, no
961283478,  Talktowind, 38, 1, 37, no
3027820086,  DamianoLiguori, 9, 0, 9, no
727087787506319360,  StefanoIncocci2, 3, 0, 3, no
537538390,  alevarriale78, 12, 1, 11, no
378056903,  elisa_1967, 3, 0, 3, no
70681623,  MejoBarone, 2, 0, 2, no
581948637,  Winnieprue, 2, 0, 2, no
437396261,  GiorgettoFelici, 1, 0, 1, no
49940464,  milotrombin, 1, 0, 1, no
61216272,  Jpbluesinger, 1, 0, 1, no
597277298,  stefanonatalin1, 1, 0, 1, no
4903865757,  raimonda2016, 1, 0, 1, no
742226059265859584,  M5Matteo, 1, 0, 1, no
80040362,  cmnit, 5, 0, 5, no
448838002,  SorMichele, 1, 0, 1, no
2366108005,  70_avelino, 6, 0, 6, no
64692701,  AlbertoKrebel, 3, 0, 3, no
2524571118,  LimongelliPaolo, 7, 0, 7, no
3630722294,  Xabat77, 15, 0, 15, no
112544526,  vfrangipane, 2, 0, 2, no
330392789,  G__G46, 6, 1, 5, no
255199851,  amicoFaralla, 1, 0, 1, no
2247433494,  5stelletv, 27, 0, 27, no
1974968564,  Fabozzi84Vince, 4, 0, 4, no
335544532,  indie_louise, 1, 0, 1, no
749668349605515264,  Gianluc59816521, 17, 0, 17, no
2692140600,  kalmapiatta, 4, 0, 4, no
459664582,  bartthechef, 5, 0, 5, no
124765553,  passionanime, 3, 0, 3, no
701732204,  cardipasse, 3, 0, 3, no
2931182735,  VotorioA, 1, 0, 1, no
272521191,  taberlet, 2, 0, 2, no
42020911,  caretta_caretta, 2, 0, 2, no
735827949107171328,  mauroallianz, 1, 0, 1, no
713748288,  NMocanu, 3, 0, 3, no
2816273194,  mauriziogetuli, 15, 2, 13, no
168732280,  marcopiumi, 3, 0, 3, no
21750761,  BeamaBeorg, 10, 2, 8, no
2527227066,  Arjuna5s, 19, 0, 19, no
740069666106802176,  elenambelli4, 2, 0, 2, no
1061905068,  isolu44, 4, 0, 4, no
1064151775,  ErasmoGiammaria, 5, 0, 5, no
2741066872,  rigoletto1955, 1, 0, 1, no
2862624867,  CriCrices, 1, 0, 1, no
802252735668219904,  halberome1979, 1, 0, 1, no
1326609169,  MinnucciGian, 4, 1, 3, no
2294999142,  michelegolinno, 1, 0, 1, no
776002390428266497,  Armandox1234x, 1, 0, 1, no
1647932094,  Ginorad, 1, 0, 1, no
352976610,  andrew_diver, 2, 0, 2, no
455279517,  AScarfogliero, 1, 0, 1, no
3093445126,  giordlain, 31, 0, 31, no
428447147,  tarabbo, 9, 0, 9, no
4734101189,  francesco4733, 5, 2, 3, no
326271326,  1976TA, 5, 0, 5, no
1036575512,  elisabe89376579, 9, 0, 9, no
85049014,  antoniogiocondo, 1, 0, 1, no
289218172,  BBnetlog, 1, 0, 1, no
3049025107,  dadasara_daiana, 1, 0, 1, no
2514019774,  NildeArcangeli, 1, 0, 1, no
2550102229,  madfily, 1, 0, 1, no
3959228235,  ulissearte, 1, 0, 1, no
2465900299,  cristin36558432, 6, 0, 6, no
758935701698191361,  enju186, 21, 7, 14, no
1370688006,  assemblerboot, 1, 0, 1, no
448937526,  sandroantonini1, 3, 0, 3, no
1389805699,  Ribemore, 8, 0, 8, no
701451907441827840,  beste4k, 6, 0, 6, no
1222888213,  CFenudi, 5, 0, 5, no
853635661,  incazzatissimo1, 17, 2, 15, no
846230053,  ImInhuman_, 3, 0, 3, no
2188197909,  GCiarlone, 1, 0, 1, no
1135851289,  fiorano623, 2, 0, 2, no
536639916,  MagnanoDanilo, 1, 0, 1, no
2166961182,  dnl4531, 1, 0, 1, no
804317201260052480,  byblu71, 2, 0, 2, no
1261505730,  DPanadisi, 1, 0, 1, no
1058536814,  MaxBellotto73, 2, 0, 2, no
776771798,  m5sScandicci, 4, 0, 4, no
4871354697,  Zuxon2, 1, 0, 1, no
133019285,  nicky0461, 5, 0, 5, no
2286400352,  crivarof, 1, 0, 1, no
2173149525,  hathor1968, 7, 0, 7, no
4300445913,  spigolos, 2, 0, 2, no
22018222,  giorted, 1, 0, 1, no
2202860345,  dariofmorgante, 3, 1, 2, no
1226086274,  l_b74, 1, 0, 1, no
425479495,  giovannifederi2, 6, 0, 6, no
2958716921,  gennarolanni9, 1, 0, 1, no
329920477,  Tonyskie, 1, 0, 1, no
332492607,  ikatsuja, 2, 0, 2, no
2523337780,  ForenzaAnna, 3, 0, 3, no
403507902,  ziofranky5, 5, 0, 5, no
1195933742,  jaco_pa62, 3, 0, 3, no
3115342936,  ae7ded6150e24fe, 8, 0, 8, no
1225720460,  ermenegigio, 2, 0, 2, no
465771339,  chamazzoleni, 10, 0, 10, no
552015376,  stellamagica07, 1, 0, 1, no
1030992019,  Mario_Giannetta, 16, 5, 11, no
456702091,  patriziaiusco, 1, 0, 1, no
130111210,  lorenzo1940, 7, 2, 5, no
354364814,  gioseffina, 2, 0, 2, no
113050066,  Bodyguard45, 9, 1, 8, no
3500694082,  teddan2008, 1, 0, 1, no
2909622107,  dricadigiulio, 6, 1, 5, no
462313463,  luca_battaglini, 3, 0, 3, no
500763650,  pisano_michele, 1, 0, 1, no
773602742,  lasciatemisolaa, 29, 1, 28, no
1067019276,  MarsilioLaura, 4, 0, 4, no
1089499380,  AreaRivista, 13, 0, 13, no
833640918,  r_bertollini, 1, 0, 1, no
779350232052142080,  RomaVotaNo, 4, 1, 3, no
3182809755,  _ANNADEBBY_, 4, 1, 3, no
753178402497044480,  Sott_lazapp, 6, 1, 5, no
1277350656,  TolomeoAntonio, 8, 2, 6, no
2435140633,  antonel82984126, 4, 1, 3, no
221840484,  TinaGrazioli, 9, 1, 8, no
778883788575236096,  Casella_Chris77, 5, 1, 4, no
720232920653434883,  Sellitti_MR, 4, 1, 3, no
801911337211281408,  gianmarco_lori, 4, 1, 3, no
1341242756,  gian_lori, 4, 1, 3, no
794943746508984320,  Eleonor66294831, 4, 1, 3, no
711220906987757568,  Rizzocrats, 4, 1, 3, no
398036674,  vincenzogiampi, 3, 1, 2, no
2256124088,  LucaNatural70, 14, 2, 12, no
767119569899155456,  ManunzaTonio, 4, 1, 3, no
65077794,  rumba_magica, 7, 2, 5, no
803336895820341249,  RevolutionITA17, 3, 1, 2, no
696473558990614528,  marcella_pompei, 3, 1, 2, no
987640627,  marcop1it, 15, 7, 8, no
2430808297,  pier2856, 4, 1, 3, no
501084838,  AxSrm, 5, 1, 4, no
259869205,  EmanuKant, 5, 1, 4, no
1101847890,  iamodioo, 3, 1, 2, no
1146441836,  intraprenSocial, 4, 1, 3, no
480453928,  brumainardi, 10, 3, 7, no
1251862548,  FabioFratiniRA, 6, 2, 4, no
1068604638,  maurizio_sole, 14, 6, 8, no
2169534491,  mlmorini49, 5, 2, 3, no
4504836677,  dharmajago, 8, 2, 6, no
1427377026,  lakystef, 3, 1, 2, no
4007831482,  leda021055, 8, 2, 6, no
1052927598,  GioSallusti, 3, 1, 2, no
4008290355,  rabbiaeterna, 10, 3, 7, no
38964269,  presvallelunga, 3, 1, 2, no
513356824,  paogpi, 4, 1, 3, no
84416696,  peppez87, 3, 1, 2, no
755745950,  LittlePigo, 5, 2, 3, no
93937195,  mannyzone, 5, 1, 4, no
517846120,  FPennacc, 6, 1, 5, no
1367914478,  vercingetorice1, 4, 1, 3, no
4798473051,  marcojuventus21, 4, 1, 3, no
55202918,  sossioc, 3, 1, 2, no
1684079311,  giudice_p, 3, 1, 2, no
999371760,  FronteAntiRenzi, 5, 2, 3, no
752944386472865792,  ComNOgrazie, 4, 1, 3, no
756916144838176768,  Annaeddj, 5, 1, 4, no
391034014,  Elcento82, 4, 1, 3, no
411657903,  ronconimaurizi, 6, 2, 4, no
519217736,  ibcerr, 5, 1, 4, no
3230326396,  gattusdom, 3, 1, 2, no
48053946,  giaccari, 3, 1, 2, no
3155475373,  antoniobiondo12, 4, 1, 3, no
470063815,  MCarolina_Izzo, 3, 1, 2, no
459308081,  67Titty, 3, 1, 2, no
2887357012,  luca_russomando, 5, 1, 4, no
506170223,  ANTONINORABOTTI, 3, 1, 2, no
4251035097,  anis_epis, 12, 5, 7, no
1322551362,  Acidelius, 20, 5, 15, no
3208883674,  f631b769d99f4ed, 3, 1, 2, no
999889903,  ftribotti, 5, 1, 4, no
1334978426,  berzin78, 6, 1, 5, no
1941612414,  DaniOrabasta, 3, 1, 2, no
3007938557,  alexpisapi, 3, 1, 2, no
3678021317,  Luana45486112, 3, 1, 2, no
239784688,  redazioneiene, 5, 2, 3, no
3085902740,  AlessandroAima1, 4, 1, 3, no
4053837041,  fierardi799, 3, 1, 2, no
374792968,  marry_rn, 3, 1, 2, no
1234446558,  stedistefano, 5, 2, 3, no
248412930,  salvo_vinci, 3, 1, 2, no
61160450,  edorixi, 4, 1, 3, no
2291480669,  calimero132, 3, 1, 2, no
3003054298,  edoventu97, 3, 1, 2, no
54890247,  Fedechino, 5, 2, 3, no
2780048603,  icone50, 3, 1, 2, no
774541927463157761,  MariaGrazMilaur, 4, 1, 3, no
2367130649,  EmanueleZenobi, 2, 0, 2, no
621937390,  MrSpock75, 6, 0, 6, no
1524985099,  FBonavero, 2, 0, 2, no
271306726,  petrosino73, 3, 1, 2, no
3368334621,  Snaffer78, 4, 1, 3, no
1223309749,  GuzzardoB, 4, 1, 3, no
89253972,  mbaldi79, 5, 2, 3, no
398739728,  StefanoeDaniela, 4, 1, 3, no
560540704,  LivAlice11, 7, 1, 6, no
1077925266,  AmaryllisRouge, 5, 2, 3, no
100478960,  mesosbrodleto, 6, 2, 4, no
4211706467,  URBY65_, 6, 2, 4, no
337377041,  BinettiGiuseppe, 3, 1, 2, no
492050077,  RLoscialpo, 5, 2, 3, no
174718343,  Mishima16, 3, 1, 2, no
497996910,  errikrock, 20, 1, 19, no
263882239,  Dundu92, 3, 1, 2, no
4765095501,  cyberpunktrade, 3, 1, 2, no
74489551,  RobertoRettura, 4, 1, 3, no
1211906816,  claudiozisa, 6, 2, 4, no
167845063,  mammarinu, 16, 4, 12, no
965239081,  nonvotoilpd, 14, 1, 13, no
484170638,  givarts, 5, 2, 3, no
772840526840270848,  luixiv, 3, 1, 2, no
468454344,  SilvioTirelli, 3, 1, 2, no
390978339,  AntonioValiante, 8, 1, 7, no
330342815,  erFabius, 7, 2, 5, no
3052854105,  mamba2015, 7, 1, 6, no
799517654746800128,  medialabunipi1, 3, 1, 2, no
2785214645,  RaiStudio24, 10, 2, 8, no
1228742550,  GiancarloCantel, 4, 0, 4, no
123963892,  VictorFuentesT, 2, 0, 2, no
83580827,  AleCostanzo, 2, 0, 2, no
300616972,  daoandrea, 1, 0, 1, no
577287680,  SerinoSerena, 1, 0, 1, no
476154614,  alpalfa, 1, 0, 1, no
1380510872,  GassmanGassmann, 5, 0, 5, no
407675976,  lucioconsiglio, 1, 0, 1, no
2987441667,  ertappetaro, 2, 0, 2, no
388768139,  ilariallegro, 1, 0, 1, no
802944388825513984,  Erika645911341, 1, 0, 1, no
413992630,  LiborioNatali, 1, 0, 1, no
1560982220,  NestolaLucia, 1, 0, 1, no
4274769735,  QUS67, 2, 0, 2, no
495243061,  anna_foglietta, 5, 0, 5, no
3169486113,  TeatroEliseo, 3, 0, 3, no
2710954486,  Fmeuamorzinho, 1, 0, 1, no
2846820109,  AndreaTrupia01, 1, 0, 1, no
185716948,  add_editore, 1, 0, 1, no
453340945,  rossbrescia, 1, 0, 1, no
2852352323,  carlabettoni1, 2, 0, 2, no
340128358,  destefanoaless, 1, 0, 1, no
455673855,  paolasquarcia, 2, 0, 2, no
108024320,  spl884, 1, 0, 1, no
384885948,  preponismywife, 1, 0, 1, no
2242442758,  Angelenepj, 1, 0, 1, no
1166582510,  mictar1, 1, 0, 1, no
3318915569,  tonimancuso, 11, 2, 9, no
1080855186,  maria0780, 2, 0, 2, no
458533247,  Iloveujb4everr, 1, 0, 1, no
703974865859117056,  camionforever, 1, 0, 1, no
426542237,  KohlManu, 1, 0, 1, no
97911351,  s6carlo, 7, 0, 7, no
407077433,  brunieradino, 1, 0, 1, no
1175727986,  bybica1, 52, 0, 52, no
574543006,  il_populista, 10, 0, 10, no
392056373,  V1pra, 6, 0, 6, no
2248023058,  jaxmax1680, 16, 5, 11, no
175127426,  KenartsTheKing, 6, 2, 4, no
378741753,  ramilla62, 7, 3, 4, no
462336529,  Berlusconipresi, 8, 0, 8, no
3356662759,  MrPoliglot, 12, 2, 10, no
42084305,  for_ma, 4, 1, 3, no
235623530,  doppioflash, 3, 1, 2, no
1693764404,  Morning_Coat, 2, 0, 2, no
491524623,  caesargasp, 2, 0, 2, no
289858783,  IvanTirrito, 3, 0, 3, no
775935410841071616,  Vincenz71636853, 5, 0, 5, no
3288126430,  corrattini, 2, 0, 2, no
610079443,  Maria_Lucia_Dip, 1, 0, 1, no
383887742,  brix975, 1, 0, 1, no
360779424,  AlessiaNigro1, 1, 0, 1, no
705038728302092288,  littlerobe1, 1, 0, 1, no
3395317595,  BlackWhitePanth, 1, 0, 1, no
397287735,  MauroNicastro, 1, 0, 1, no
1073285989,  PARTIDAQUI, 21, 2, 19, no
869416494,  smeschis, 5, 0, 5, no
1158214129,  SanTenChan, 8, 0, 8, no
802141581662941184,  rubini89912, 3, 0, 3, no
2328781484,  Lodi_73, 2, 0, 2, no
507545031,  Angelacoco3, 2, 0, 2, no
477813810,  EnzoDICARMINE, 3, 0, 3, no
56657613,  _Lotus_3, 2, 0, 2, no
768816467676717057,  romapiupulita, 2, 0, 2, no
891964664,  ATom_4979, 2, 0, 2, no
51285035,  Antoxs, 6, 2, 4, no
60898263,  9granieri, 2, 0, 2, no
144840782,  LARRYDJ82, 1, 0, 1, no
291624735,  MegaSpaziale, 5, 0, 5, no
1402879052,  M5SBarletta, 3, 0, 3, no
2369854366,  GuerriRolando, 3, 0, 3, no
765933168,  DarioMaura, 9, 0, 9, no
1270664520,  KapaMarci, 8, 0, 8, no
740973386499825664,  ghiani_massimo, 3, 1, 2, no
2467758148,  GandolfoMariu, 1, 0, 1, no
384516505,  amangela75, 3, 0, 3, no
549964088,  micheilucia, 1, 0, 1, no
461297042,  FantasticoD, 5, 0, 5, no
6835912,  futuro5stelle, 6, 0, 6, no
4182246959,  manucalucci, 1, 0, 1, no
267894166,  gracco63, 7, 0, 7, no
593752362,  Ketty247, 1, 0, 1, no
723594761488228354,  latinaolimpalus, 4, 0, 4, no
432302964,  GiaomoSoppelsa, 1, 0, 1, no
2174187752,  krlunk, 2, 0, 2, no
191490413,  bravimabasta, 6, 0, 6, no
729861715970658308,  EmyRoyaleagle, 5, 0, 5, no
398172550,  MarcoMurari, 1, 0, 1, no
2480179630,  rdern8, 1, 0, 1, no
2282472413,  LonigroEmanuele, 7, 0, 7, no
728029848,  riccardovici, 1, 0, 1, no
4353321141,  clagreste2015, 3, 0, 3, no
433565657,  Didos73, 2, 0, 2, no
404380686,  Gio_589, 4, 0, 4, no
420253558,  branstock, 1, 0, 1, no
31405544,  natrpn, 1, 0, 1, no
319095713,  ricciomarino, 4, 0, 4, no
3444171,  debe, 2, 0, 2, no
146040638,  Ainely88, 1, 0, 1, no
435314449,  randy3est, 6, 0, 6, no
2526968245,  politicMemory, 15, 1, 14, no
2352371168,  mattfish1089, 4, 0, 4, no
1039563697,  giangrifasi, 9, 0, 9, no
97925608,  terminator6719, 9, 0, 9, no
179193344,  zorc1978, 1, 0, 1, no
91573724,  AlemannoCosimo, 5, 0, 5, no
1277296867,  CampoEnrico1, 12, 0, 12, no
1614878936,  andreaprogetti7, 1, 0, 1, no
1385237533,  E_Scagliusi, 1, 0, 1, no
805557852744118277,  EmPodda, 1, 0, 1, no
784265755508420608,  MichelaBarattu1, 20, 0, 20, no
31137106,  nexus2019, 1, 0, 1, no
612456796,  silvia_megara, 4, 0, 4, no
4755949588,  Mariamaryjb, 20, 0, 20, no
1142481625,  carbonarim5s, 3, 0, 3, no
1370176568,  sonoioarc, 3, 1, 2, no
581792033,  aldopadovano, 2, 0, 2, no
2317316210,  pa_nogaro, 2, 0, 2, no
274157896,  parlantiandrea, 1, 0, 1, no
411775601,  mesancheno, 3, 0, 3, no
101535431,  lucaptrainer, 3, 0, 3, no
476650928,  LalaPoops, 2, 0, 2, no
1104728414,  sarabesna, 1, 0, 1, no
550870326,  SDebbia, 6, 1, 5, no
1189814130,  Darkenmass, 1, 0, 1, no
253975868,  albertcampailla, 1, 0, 1, no
163165271,  paulengelhard, 1, 0, 1, no
2404016685,  borgoste, 2, 0, 2, no
2519577459,  gomez__claudia, 2, 0, 2, no
3813052822,  MauroTognoli, 2, 0, 2, no
1315379233,  LaisoLuca, 2, 0, 2, no
2359694207,  bizzarri_paolo, 2, 0, 2, no
376130704,  ilrezzo, 2, 0, 2, no
1059877728,  gyomax8, 1, 0, 1, no
2788727236,  deborahmenna, 1, 0, 1, no
417887820,  SONOSOPHIA, 5, 1, 4, no
29723197,  stevedivemaster, 3, 0, 3, no
768460411628838912,  avv_moretti, 1, 0, 1, no
2281925530,  PaoloMoles, 8, 0, 8, no
738997137820811264,  ElioDAmore, 3, 0, 3, no
304449851,  carlopagliani, 5, 0, 5, no
778556999118286848,  Luigiandreozzi5, 1, 0, 1, no
619418274,  rgmz44, 1, 0, 1, no
1049009424,  PaceGiusy, 6, 0, 6, no
792751011861594113,  piroddiavvant, 1, 0, 1, no
395179479,  MoniaZurria, 1, 0, 1, no
13065292,  matteodallosso, 6, 0, 6, no
524807407,  satrapox, 5, 0, 5, no
3822033796,  ZizzaMichele, 1, 0, 1, no
407079267,  GCagnino, 9, 3, 6, no
335292394,  MatteoSelva1, 9, 0, 9, no
1055367092,  dopiot, 14, 1, 13, no
330205544,  NaimaV, 3, 0, 3, no
1163789540,  NuzziR, 1, 0, 1, no
718396521390194688,  Lugixxo, 1, 0, 1, no
406906451,  annaantonini1, 1, 0, 1, no
743412865948860420,  Michele77109967, 3, 0, 3, no
2951442201,  mirasolecarlo91, 15, 1, 14, no
491225607,  giovo77, 11, 2, 9, no
3069973995,  lama_che, 1, 0, 1, no
787056705188356096,  marilena6475, 6, 0, 6, no
3065887655,  noveidsr, 1, 0, 1, no
130861875,  michelecama, 3, 0, 3, no
799585803739496449,  _automobili_it, 1, 0, 1, no
558975152,  umbertograglia, 6, 2, 4, no
390339077,  PPaolo1963, 2, 0, 2, no
775245163346165760,  DanielaMondorff, 2, 0, 2, no
2272854847,  CVergini1972, 5, 0, 5, no
2915603344,  Nazzare68291189, 2, 0, 2, no
3349425513,  AgostinoCosma, 4, 1, 3, no
478803640,  caminotta, 3, 0, 3, no
874311997,  per_piacere, 3, 0, 3, no
435973196,  dlacara, 3, 0, 3, no
188066910,  cloud1055, 1, 0, 1, no
3341739995,  lorenzorausa1, 7, 0, 7, no
796416761126158336,  Valeria15043257, 1, 0, 1, no
380314015,  haldoc, 2, 0, 2, no
108396613,  marioasroma, 1, 0, 1, no
72283097,  pietrogarzione, 2, 0, 2, no
503366650,  McpaniPani, 6, 0, 6, no
390575090,  tiziano5481, 1, 0, 1, no
719552036136738816,  PpPietrogrande, 1, 0, 1, no
390887380,  AlbertoLembo, 1, 0, 1, no
381611850,  PaoloParentela, 2, 0, 2, no
14273179,  Coinquilina2000, 3, 0, 3, no
1465195916,  gufogufato, 8, 2, 6, no
2809827694,  giuliasword72, 5, 0, 5, no
435943823,  rizzfede1970, 1, 0, 1, no
731884829642493952,  Lambiaseanna1, 2, 0, 2, no
3143255746,  ChiaraHookii, 1, 0, 1, no
2764987058,  RimEgil, 1, 0, 1, no
2409273144,  silvanaparolisi, 18, 1, 17, no
552924569,  explosivebells, 1, 0, 1, no
1259494134,  katia8318, 7, 1, 6, no
560086917,  ThePRagno88, 7, 0, 7, no
503670941,  cribabirc, 13, 5, 8, no
4539264436,  thankyou0103, 1, 0, 1, no
2465918593,  Nasca64, 1, 0, 1, no
84554567,  umbertomagni, 4, 0, 4, no
469750828,  franziosef, 16, 0, 16, no
1611267908,  6annapia, 1, 0, 1, no
2984075727,  abe_norifumi, 1, 0, 1, no
448343412,  annagrossi3, 11, 3, 8, no
708649686,  blackpanther4y9, 1, 0, 1, no
634887537,  Oscar57Cotta, 2, 0, 2, no
73855053,  cannelli, 3, 0, 3, no
719828254371106816,  Giusepp01920730, 3, 0, 3, no
2158689967,  gleescovers, 1, 0, 1, no
283111349,  jooranieri, 1, 0, 1, no
1002649244,  RFaloci, 2, 0, 2, no
111357858,  AleSans1, 2, 0, 2, no
4846321492,  motusanimae, 1, 0, 1, no
2637040723,  katy_purpose, 1, 0, 1, no
715889187,  AmbraMaioli, 1, 0, 1, no
4046597542,  lauraa_garau, 2, 0, 2, no
55556322,  sarah_corna, 2, 0, 2, no
2239529617,  somerhaldeyes, 1, 0, 1, no
2581628565,  GiammarcoFer, 1, 0, 1, no
38481918,  The_profundis, 1, 0, 1, no
499782176,  stefanofares, 1, 0, 1, no
574674189,  Luna_Corvonero, 1, 0, 1, no
217611854,  Dungueli_Bonbon, 1, 0, 1, no
367139151,  bemyian8, 1, 0, 1, no
22813056,  aannibal, 5, 0, 5, no
4904009595,  8614lukino, 1, 0, 1, no
280738990,  marcosabait, 3, 0, 3, no
1226957078,  giacomomanto, 3, 0, 3, no
407629213,  isadesimio, 1, 0, 1, no
1039429350,  MarioCardone73, 2, 0, 2, no
3070745903,  MollerAlberto, 1, 0, 1, no
1161058597,  mattei_manu, 3, 0, 3, no
209820549,  Naglio999, 3, 1, 2, no
572128310,  CatalfoNunzia, 1, 0, 1, no
370342943,  oneenrico, 7, 0, 7, no
796749112100134920,  Giusepp30729870, 6, 0, 6, no
3148116022,  chiarakomm, 5, 0, 5, no
801526123851055105,  polemicamente5, 3, 0, 3, no
216884788,  Byrorossa, 5, 0, 5, no
2515047351,  RobyRoby2210, 6, 0, 6, no
129257660,  smascherai, 1, 0, 1, no
781449420281876480,  nigertweet, 3, 0, 3, no
347707519,  Tramy2011, 3, 1, 2, no
272354189,  Ljuba2000, 3, 1, 2, no
1069116288,  SereGamby, 4, 1, 3, no
239734640,  ostroghoff, 4, 1, 3, no
169649919,  NoExcuses68, 8, 3, 5, no
1008565081,  46Oliver, 9, 1, 8, no
515638711,  LucianoLavecchi, 9, 1, 8, no
2422164068,  scire79, 6, 1, 5, no
1867212703,  AtoBorr, 3, 1, 2, no
2729415801,  ty_fiorentino, 11, 2, 9, no
556658329,  ClaudiaDUlisse, 3, 1, 2, no
455266102,  artiolim, 4, 1, 3, no
566150054,  Arena_Anto, 7, 2, 5, no
802227674001326081,  1989Yanez, 3, 1, 2, no
2323995158,  LucaTerzaroli, 6, 2, 4, no
783319162550644736,  Possibile_KR, 18, 1, 17, no
3345161205,  ArezzoPossibile, 134, 1, 133, no
1055797022,  GRonchieri, 6, 1, 5, no
4121342697,  darwinpollo1, 3, 1, 2, no
383359173,  mmastrapasqua, 7, 3, 4, no
636035398,  mazzon_ste, 6, 2, 4, no
3289975816,  ziacarlacar, 5, 1, 4, no
469186831,  IlarioCaserta, 4, 1, 3, no
2788127629,  alexanco07, 5, 1, 4, no
2845007506,  DavideCM5S, 5, 1, 4, no
260119817,  mirkoambro, 5, 2, 3, no
796287775549034496,  BusyBee137, 4, 1, 3, no
1852450694,  ciwainside, 41, 4, 37, no
1725431600,  clarissa_gmai, 5, 2, 3, no
104651157,  silvanhoe, 20, 7, 13, no
1408827164,  quaranta_vito, 3, 1, 2, no
1104732752,  rosSsa101, 10, 1, 9, no
712640136081776640,  Fabio_1103, 14, 3, 11, no
77547900,  bistrottissimo, 4, 1, 3, no
393501472,  DaniloTomassoni, 3, 1, 2, no
1038122826,  eleonorabraile, 7, 2, 5, no
987485588,  PaoloAdobati1, 3, 1, 2, no
760941857652301824,  AnaMari45036206, 3, 1, 2, no
51465605,  edmondo_minisci, 5, 1, 4, no
416346211,  carlottafree, 5, 2, 3, no
787323208752037888,  RPortas2002, 8, 1, 7, no
88725905,  gramezzana, 16, 5, 11, no
1270735285,  morris141269, 3, 1, 2, no
949743282,  AdrianoTolomio, 3, 1, 2, no
468764915,  TheLipglossary, 3, 1, 2, no
2380908872,  ugoboca, 3, 1, 2, no
634535867,  CilibertiSimone, 5, 2, 3, no
381695631,  AgildoGildao, 3, 1, 2, no
1030314744,  soniasirizzotti, 5, 2, 3, no
801070456619077632,  myquorum, 3, 1, 2, no
2562622972,  freemind120, 3, 1, 2, no
762618011144577024,  FrancoBracale, 3, 1, 2, no
923060941,  roberto64russo, 6, 1, 5, no
37282173,  Neverland65, 3, 1, 2, no
1968518298,  FormilliStefano, 5, 1, 4, no
588238264,  MarcoMugnai2, 11, 2, 9, no
2373193840,  scrosella, 4, 1, 3, no
451419549,  RigoniLuigi, 3, 1, 2, no
120846773,  rodolfoziberna, 3, 1, 2, no
1142996647,  Simone_Risoli, 5, 2, 3, no
318487854,  1OneShotOneKill, 14, 3, 11, no
742963347507810304,  CammaranoM5S, 4, 1, 3, no
719953453737492481,  Paolobonacina_, 3, 1, 2, no
233648379,  123stefano, 5, 1, 4, no
7912442,  tigella, 7, 2, 5, no
489222429,  MenzaPietro, 8, 1, 7, no
2227178944,  Tavellik, 3, 1, 2, no
2766062542,  gjoegl, 13, 3, 10, no
2895666573,  albachiara64141, 11, 1, 10, no
433125456,  murruandrea, 4, 1, 3, no
1069275696,  lucaccini_carla, 3, 1, 2, no
4657568061,  alessan70617102, 3, 1, 2, no
38693336,  korean1977, 6, 1, 5, no
784614624,  Daydream76_, 3, 1, 2, no
771464957124804608,  BlogNews77, 15, 5, 10, no
394018745,  serenadigioia, 4, 1, 3, no
783232466156920832,  Gemmap49, 6, 1, 5, no
366840828,  vgaltieri, 3, 1, 2, no
231073683,  nina_x72, 3, 1, 2, no
325790346,  AntoMariella, 3, 1, 2, no
1022288858,  Aringoogle, 54, 14, 40, no
718173627062083584,  smallyesbigno, 3, 1, 2, no
138047421,  SergioGatteschi, 3, 1, 2, no
2339947944,  Jimmy_146, 15, 2, 13, no
283939901,  fancio_original, 17, 2, 15, no
366084580,  paolosalio, 3, 1, 2, no
1250202577,  aIex_cat, 10, 2, 8, no
1068801092,  adriatzara, 9, 2, 7, no
1096419438,  Ercole1185, 4, 1, 3, no
714047317,  michele_padoan, 8, 1, 7, no
3290361172,  pinocaccavaro51, 3, 1, 2, no
4321227377,  Ssimeoli63, 4, 1, 3, no
458490168,  bacarasi, 3, 1, 2, no
242306600,  dario16564, 5, 2, 3, no
150993426,  robertomicheli, 4, 1, 3, no
3833171361,  ArmyRenzi, 11, 1, 10, no
3035060441,  credendo_vides_, 9, 1, 8, no
2600970999,  gg_gue, 7, 2, 5, no
394021004,  RADIOCARCERE, 3, 1, 2, no
3168011729,  alias16g, 16, 3, 13, no
211226743,  maxixhw, 22, 3, 19, no
34932457,  carlo24, 4, 1, 3, no
972884324,  damstop83, 15, 5, 10, no
4184406562,  CikAtell, 28, 4, 24, no
2366997321,  sommascabis, 4, 1, 3, no
4309935400,  Arnaldo40187933, 4, 1, 3, no
4581314793,  Ciarvins, 3, 1, 2, no
584528289,  bassismarco, 4, 1, 3, no
1162323121,  NMatteis, 4, 1, 3, no
426606498,  Rosalbauscidda1, 3, 1, 2, no
2603715699,  kekkopensa, 15, 2, 13, no
1528783652,  maxzonair, 4, 1, 3, no
731928017564512256,  libmo4, 3, 1, 2, no
70231136,  FlavioMarino, 5, 1, 4, no
2177864810,  piccolojason, 5, 1, 4, no
138775233,  EmmaSanti_, 5, 1, 4, no
262539190,  AnyVitale, 7, 3, 4, no
476161307,  Gekosauro, 3, 1, 2, no
3047714690,  mauro60asr, 4, 1, 3, no
307465305,  GiusiSalis, 5, 2, 3, no
2362345730,  fabiop70, 8, 3, 5, no
781520339780116480,  Agatirso81, 3, 1, 2, no
1400701532,  VittorioBanti, 10, 3, 7, no
715593055789826048,  guforealenapoli, 13, 5, 8, no
240310965,  senisregna, 3, 1, 2, no
2375448565,  SermonetaFutura, 4, 1, 3, no
770354017096589312,  JonesViky, 12, 2, 10, no
597696640,  battistageti, 7, 1, 6, no
759129447022862340,  RosarioTrimarc1, 9, 1, 8, no
615969319,  sebasticulo, 3, 1, 2, no
412209140,  NicolaGiocondo, 4, 1, 3, no
3299546625,  PossibileIt, 83, 1, 82, no
354901534,  valentinaWally, 120, 1, 119, no
2166946698,  floriana_luchar, 3, 1, 2, no
453275298,  magicabionda, 4, 1, 3, no
395242306,  EnricaTonola, 17, 1, 16, no
2148746163,  fanema64, 3, 1, 2, no
1617818378,  VannaRicci, 5, 2, 3, no
763315505910480896,  MaoNo1968, 3, 1, 2, no
714451248,  Sandro_Sartor, 7, 3, 4, no
970979858,  anna_sorbi, 7, 1, 6, no
416234718,  andreapupo77, 4, 1, 3, no
232231711,  clagres, 7, 1, 6, no
951842702,  Vincenzoiena699, 5, 2, 3, no
3176625754,  OrizOrizzonte, 7, 1, 6, no
2356251718,  LaraAmmendola, 24, 2, 22, no
354314814,  grossivan, 6, 1, 5, no
609984521,  _FreeAndWild_, 7, 1, 6, no
480390700,  cantamiodiva, 6, 2, 4, no
3656005667,  TosiniPietro, 5, 1, 4, no
732141236178587648,  waltertwin, 6, 2, 4, no
1052983992,  78Patelli, 3, 1, 2, no
770905842,  PaoloMostarda, 5, 2, 3, no
573081544,  SFrancio63, 10, 4, 6, no
15387167,  elihh3, 6, 1, 5, no
2870669794,  fabdomi, 9, 2, 7, no
1040920220,  GianlucaPuntara, 7, 3, 4, no
744263355536392192,  arch_cmag, 5, 1, 4, no
788879371,  938103Massimo, 3, 1, 2, no
72132769,  gpoko, 4, 1, 3, no
3654961996,  RM_II_Possibile, 17, 2, 15, no
433293009,  eziof1978, 165, 1, 164, no
4906280991,  bricologo, 7, 1, 6, no
848045168,  AbitareFuturo, 7, 2, 5, no
852687006,  Kottomano, 6, 2, 4, no
1250188950,  micheledibened8, 5, 2, 3, no
3954502719,  AlessioTHEnurse, 7, 2, 5, no
1065851646,  gdg_di, 5, 1, 4, no
323449293,  anpisarzana, 38, 3, 35, no
2472775153,  ALBACELANO, 6, 1, 5, no
608149538,  AgostinoTuzzoli, 5, 1, 4, no
450517687,  maf6372, 11, 1, 10, no
2334501166,  zorzi46, 5, 2, 3, no
993110552,  petrettoanto, 5, 2, 3, no
1569513372,  RamoloG, 10, 2, 8, no
1132188114,  danielaba28, 6, 2, 4, no
17546069,  juanmjm, 4, 1, 3, no
478561355,  antonietta_db, 6, 1, 5, no
2211358579,  AliceAdele27, 5, 1, 4, no
340300921,  GMPbike, 4, 1, 3, no
390273635,  martmagorium, 4, 1, 3, no
1619961732,  peppinozola, 3, 1, 2, no
791392103876202496,  ReporterSette, 11, 2, 9, no
2232688633,  X_Maurizio_X, 3, 1, 2, no
2416029024,  mari82xox, 7, 3, 4, no
2390989461,  BelcastroSalv, 3, 1, 2, no
541596083,  Val_Fus, 5, 2, 3, no
1336605439,  ale_petraglia, 3, 1, 2, no
92956054,  gspartano, 6, 2, 4, no
2847253456,  MauroBen55, 5, 2, 3, no
621194070,  M5SRoma3, 15, 1, 14, no
766740702982205441,  AndreaBonacalza, 3, 1, 2, no
68361266,  Kwaaibabatjie, 4, 1, 3, no
158262409,  steppatek67, 8, 2, 6, no
738805348476260353,  StefanoLonghi2, 4, 1, 3, no
705158956,  Paternoster85, 5, 1, 4, no
1044958567,  agbiuso, 4, 1, 3, no
328531828,  AmedeoRota, 3, 1, 2, no
2510430251,  maninblack53, 6, 1, 5, no
552949047,  elena_degre, 3, 1, 2, no
3021582753,  cdpropris, 5, 1, 4, no
2927207759,  lupakkiotto85, 5, 1, 4, no
2314403526,  Vendicsolitario, 7, 1, 6, no
597499995,  lorenzo3107, 3, 1, 2, no
4045990383,  carla_pantano, 7, 1, 6, no
2352132366,  val_capp, 5, 1, 4, no
712376322,  Acaruso3Caruso, 19, 3, 16, no
436213501,  cbillitteri, 3, 1, 2, no
94801793,  pinkra, 3, 1, 2, no
156651046,  CarlottaSartori, 3, 1, 2, no
2400294800,  atanor7, 7, 1, 6, no
3233782181,  JoongWu, 8, 1, 7, no
586498147,  civisromanusTW, 19, 2, 17, no
2348837399,  sdeangelis56, 3, 1, 2, no
3242519025,  SCUOLATUTTIUNIT, 12, 2, 10, no
2647873162,  DanDansuxx, 3, 1, 2, no
1131812641,  mare8861, 6, 1, 5, no
162192942,  LorenzoMoscia, 3, 1, 2, no
477731116,  emi_indream, 4, 1, 3, no
3410081393,  annanamia, 4, 1, 3, no
782535732950958080,  dona2466, 11, 5, 6, no
3045043101,  andreasantoro25, 11, 3, 8, no
1234080900,  rita_19_76, 6, 2, 4, no
109960399,  RegoliClaudia, 5, 1, 4, no
439290200,  carlopao86, 3, 1, 2, no
202220952,  FerzanOzpetek, 11, 4, 7, no
371415996,  edosala8, 4, 1, 3, no
631501567,  JacopoSacVen, 3, 1, 2, no
1017039686,  eleonoraleorat1, 4, 1, 3, no
1244644430,  ilpozzoparlante, 6, 2, 4, no
798876490796593152,  iEnrico9, 3, 1, 2, no
485493017,  gianniconta72, 4, 1, 3, no
2257832343,  oissela73, 3, 1, 2, no
2762345533,  pieropolitano, 6, 2, 4, no
269425726,  tinas48, 7, 2, 5, no
543703916,  EmilianoSilv74, 9, 1, 8, no
489562627,  Giungato29, 22, 1, 21, no
3094835193,  michelecalia58, 7, 3, 4, no
931280858,  antoniettafolch, 9, 2, 7, no
401258888,  Thomas_cas, 7, 1, 6, no
417196887,  quintierocar, 16, 1, 15, no
726540842660409344,  RaffaeleAcampo1, 4, 1, 3, no
34883455,  franrascacci, 4, 1, 3, no
521090462,  RoselliRoselli, 48, 2, 46, no
42604254,  Xabaras89, 5, 1, 4, no
1696504896,  ercuoco72, 9, 2, 7, no
85180107,  JacopoOrlando, 3, 1, 2, no
2456227901,  F35535029, 9, 1, 8, no
794174439072133120,  GeoSkill, 3, 1, 2, no
1004239573,  GingoGio, 3, 1, 2, no
1134403255,  EBadella, 3, 1, 2, no
47912534,  antnqu, 3, 1, 2, no
2752773988,  cristinapitzal1, 4, 1, 3, no
1304437381,  spinarosanna, 11, 1, 10, no
171447577,  skyqueen1991, 13, 2, 11, no
1322447304,  mau50rm, 4, 1, 3, no
524257238,  EANOMIS, 3, 1, 2, no
428135247,  DaMurtas, 7, 1, 6, no
226326062,  AlbertoCaranti, 4, 1, 3, no
372264289,  giuliaViggi, 4, 1, 3, no
295071149,  giofox79, 3, 1, 2, no
344802896,  fsrana74, 3, 1, 2, no
67574568,  AlexSamele, 10, 1, 9, no
550061396,  muzzarca, 7, 3, 4, no
1087094706,  parodi_lucio, 3, 1, 2, no
265335910,  lmcastaldi, 4, 1, 3, no
2949402237,  DemocraziAlert, 13, 6, 7, no
2222183850,  EsercitoCrucian, 5, 1, 4, no
761278850286424064,  gabryprofff, 7, 1, 6, no
2531011964,  StefaniaStefyss, 3, 1, 2, no
1160328079,  veschitelli, 7, 1, 6, no
220724497,  se_elfie, 3, 1, 2, no
10703162,  AvvDeMarchis, 4, 1, 3, no
738960168768180224,  EsterSpaziani, 3, 1, 2, no
1104598880,  luisapagliarani, 6, 1, 5, no
939170569,  tonlizet08, 5, 1, 4, no
781880881900380164,  Fabrizi87986591, 4, 1, 3, no
416370078,  enribarbieri, 4, 1, 3, no
2639918968,  m_pupita, 6, 2, 4, no
1014738026,  frenk_franco, 6, 2, 4, no
406127621,  franpiace, 10, 2, 8, no
501706273,  fadebellis, 4, 1, 3, no
234504218,  stefanomarti, 7, 1, 6, no
1261644342,  antdel48, 3, 1, 2, no
3079210283,  MeSoRott0, 8, 1, 7, no
3288432659,  Franco_Benfi, 6, 2, 4, no
317831571,  maruko_84, 3, 1, 2, no
456453383,  linolamb, 3, 1, 2, no
252755652,  Chiara_Formenti, 3, 1, 2, no
510529704,  NildePaonessa, 6, 2, 4, no
2516067038,  adrianapolys, 3, 1, 2, no
493878618,  roberto_carboni, 6, 2, 4, no
2319051527,  matarazzate, 11, 1, 10, no
432832773,  lucreziavalia, 6, 2, 4, no
1480351040,  LucaErma, 13, 1, 12, no
531198622,  nodoallacorda, 10, 4, 6, no
486583213,  LeftAvvenimenti, 3, 1, 2, no
1436270562,  MarcoBraia, 5, 1, 4, no
2244571279,  assataram, 3, 1, 2, no
600554581,  Cester88, 4, 1, 3, no
2164878096,  bigarelloM5S, 10, 1, 9, no
323160947,  maxx781, 3, 1, 2, no
2775981333,  rivellandrea, 10, 2, 8, no
1218836317,  VincenzoTheOLd, 3, 1, 2, no
254203042,  NelloFlorio, 6, 1, 5, no
4891899964,  ale220982, 6, 2, 4, no
1346199541,  GabriMulder81, 3, 1, 2, no
789714366,  vito_ostuni, 3, 1, 2, no
2895641883,  tralepagine, 3, 1, 2, no
49685654,  Franc_Pomponio, 8, 3, 5, no
515912743,  foxremi, 3, 1, 2, no
498666191,  Arthos_Neo, 5, 2, 3, no
244836131,  stokkista62, 4, 1, 3, no
46499363,  sassari74, 4, 1, 3, no
4018507636,  GianlucaGori63, 3, 1, 2, no
3335316244,  4d142645840147d, 6, 1, 5, no
81832300,  Oigroigos, 3, 1, 2, no
432259780,  francescaalban2, 4, 1, 3, no
2865314139,  fpcgilprovTO, 22, 2, 20, no
317507759,  gasparebattista, 4, 1, 3, no
1059013326,  marilisa0853, 5, 1, 4, no
2216026485,  DiegoElcome, 6, 2, 4, no
411428698,  ungiovaneuomo, 4, 1, 3, no
2998534481,  simoventurini1, 17, 4, 13, no
2870507268,  berninienrico11, 4, 1, 3, no
2173672641,  new_vinc, 7, 1, 6, no
542488894,  francpassarelli, 5, 2, 3, no
567557901,  Lauraludovica, 3, 1, 2, no
72058480,  Maximsx, 5, 1, 4, no
29807231,  elibrunetti, 3, 1, 2, no
492081280,  gboccanegra, 7, 3, 4, no
166500904,  mcarradori, 3, 1, 2, no
82316945,  tizianaderrico, 3, 1, 2, no
45300696,  dariochierchia, 5, 2, 3, no
1638762523,  IlFidaDiLapo, 5, 1, 4, no
270586505,  tonino10000, 4, 1, 3, no
1632483738,  karuaugustine, 3, 1, 2, no
3841392257,  xissur2, 3, 1, 2, no
2888026811,  AnnaT1414, 6, 1, 5, no
1260045176,  waltercomer, 7, 2, 5, no
482482833,  valentinadigrav, 9, 1, 8, no
304661441,  lastue, 6, 1, 5, no
49358807,  costanzog, 3, 1, 2, no
796191021294125058,  MoraschiE, 3, 1, 2, no
1277394462,  antoniosicilia6, 4, 1, 3, no
2809989688,  Roberto24170, 3, 1, 2, no
3381526636,  Sinopya, 3, 1, 2, no
1221818034,  Mauro5686, 10, 2, 8, no
2356163072,  jackfolla1959, 3, 1, 2, no
322037405,  GasperiniLuca, 7, 2, 5, no
215224614,  Arsenio_, 13, 1, 12, no
799981099166404608,  Giampie01791011, 3, 1, 2, no
558929345,  PaolofromRome, 7, 1, 6, no
2384955978,  pasqualekp, 3, 1, 2, no
785554968103313408,  Marco6820, 5, 1, 4, no
1635205140,  Wally_G_Fin, 3, 1, 2, no
4845010499,  negrelli14, 4, 1, 3, no
709304095375495168,  AdpTaranto, 3, 1, 2, no
2764203485,  d_acierno, 10, 1, 9, no
422502823,  AntonioIngroia, 6, 1, 5, no
760168608890818564,  rosannaprocacci, 3, 1, 2, no
719945822348144640,  sicurarmor, 4, 1, 3, no
700417503944695808,  martucciauccia, 3, 1, 2, no
126454439,  BARBYD3, 3, 1, 2, no
1676734230,  AntonBattaglia, 12, 2, 10, no
411197067,  riccardocadiz, 6, 2, 4, no
395260015,  DaliaDalu, 4, 1, 3, no
392656492,  rep_bari, 16, 3, 13, no
201412456,  Didi1648, 5, 1, 4, no
2709633235,  PerlArtemisia, 3, 1, 2, no
3226296935,  morini1712, 3, 1, 2, no
2848223301,  scrigno71, 5, 1, 4, no
1000366015,  amset68, 25, 1, 24, no
796824766548234240,  Alelelele7, 4, 1, 3, no
1089979686,  CiccioAmarante, 8, 2, 6, no
278743750,  Marinotoma, 6, 0, 6, no
1364992884,  Andwolfli, 1, 0, 1, no
406277596,  cioffi_marco, 1, 0, 1, no
635446554,  NicolaMolteni, 5, 1, 4, no
338524973,  Nottesenzaluna1, 3, 1, 2, no
797910575728721921,  PrincipeDeiPove, 6, 1, 5, no
800981529983877121,  ZenoSiri, 6, 1, 5, no
804453720872415232,  PinoChiodi, 6, 1, 5, no
3319178885,  antonelloscarl2, 5, 2, 3, no
709291269135187968,  Ildebrandodisoa, 5, 1, 4, no
1134720390,  bonoboforever, 10, 1, 9, no
4119726443,  miriamgamadi, 3, 0, 3, no
467708411,  FILIPPOELMoRo, 3, 0, 3, no
4739059103,  EuroMacht, 1, 0, 1, no
112386378,  grox77, 2, 0, 2, no
3084719191,  pap_pina, 6, 2, 4, no
816389954,  RafaeleFigliola, 3, 0, 3, no
2482335605,  ClaudioDurigon, 31, 0, 31, no
259206260,  michele_valente, 4, 0, 4, no
1876700449,  effemedica, 16, 0, 16, no
732504227961044992,  Autoferro_Ugl, 23, 0, 23, no
3090093706,  MillochFabio, 38, 1, 37, no
983347904,  pomax67, 1, 0, 1, no
1154282738,  1IlMigliore, 18, 2, 16, no
725591918,  Pater_Pat, 2, 0, 2, no
2768905294,  stefanofrascaro, 5, 0, 5, no
731569732151836672,  Rita58256346, 1, 0, 1, no
418966250,  LuciaCavaliere1, 5, 1, 4, no
747460891885604865,  DePasquale_Ugl, 4, 0, 4, no
2477149305,  saraceni_UGLFP, 2, 0, 2, no
1119665262,  gildo_rossi, 161, 0, 161, no
476812303,  piero_peretti, 121, 0, 121, no
943625054,  77Freddo, 109, 0, 109, no
3398643791,  fcappadonia86, 162, 0, 162, no
3439568590,  uglabruzzo1, 35, 0, 35, no
1224387126,  cammi_nando, 44, 0, 44, no
4645739417,  ManderioliLaila, 3, 1, 2, no
455700963,  RosyRoseLeo, 81, 0, 81, no
519365999,  D_Pellerano, 1, 0, 1, no
3041231505,  gmascolo70, 14, 0, 14, no
4905419657,  Vassiliadis_Cos, 35, 0, 35, no
3247710875,  MattiaMalossini, 1, 0, 1, no
3457594222,  s_soniaproietti, 31, 1, 30, no
783439386880999424,  ellafognolane81, 1, 0, 1, no
1303980487,  mroghiUGL, 6, 0, 6, no
1353760267,  uglspera, 11, 0, 11, no
780749266155286528,  uglpolpensicil, 1, 0, 1, no
454915627,  LorenzoMicari, 1, 0, 1, no
2502342492,  74Fasano, 1, 0, 1, no
2472152787,  michelevirg53, 4, 0, 4, no
3020347815,  Ezio_all_59, 1, 0, 1, no
323428736,  CARLODELGIUDIC1, 7, 0, 7, no
575630635,  Riccardo_enki, 2, 0, 2, no
3374467005,  RosaBillo, 5, 0, 5, no
423731914,  LorenzoLaMalfa, 1, 0, 1, no
63791702,  saveriomarino, 3, 0, 3, no
1369083600,  PieroGiovatti, 7, 2, 5, no
754007153187360768,  TarloParlante, 1, 0, 1, no
736299731152961536,  u_ceretto, 2, 0, 2, no
3044896882,  m5s_marche, 6, 0, 6, no
28072761,  beppegi, 6, 1, 5, no
2929621361,  plgiannetti, 3, 1, 2, no
4405224977,  GiovannellaG, 11, 0, 11, no
714085984091111424,  gilbertoghizzi3, 1, 0, 1, no
2902401513,  Altra_News, 2, 0, 2, no
781593851182063616,  Arebilaaa, 3, 0, 3, no
112810232,  Frenkoz, 4, 1, 3, no
378461293,  Marcello_Caputo, 1, 0, 1, no
441623488,  sesa25, 15, 0, 15, no
422037955,  Roby_Bius, 1, 0, 1, no
1688524777,  IZ5UFK, 1, 0, 1, no
804761754899283968,  Romy91353725, 1, 0, 1, no
361386856,  brunomarche, 2, 0, 2, no
1680057799,  grazia_marco, 1, 0, 1, no
728584655079915520,  rc1364, 2, 0, 2, no
599940695,  romafaschifo, 11, 0, 11, no
7200472,  RPlacido, 1, 0, 1, no
803347714104770562,  CheChestefano2, 1, 0, 1, no
1342258555,  AndrewMcCarey, 1, 0, 1, no
711170604486029312,  PaxetIux, 4, 0, 4, no
709724815146545152,  ldalfi, 4, 0, 4, no
353637140,  LauraDalfollo, 4, 0, 4, no
711163800465055745,  AmoR_Marte1, 12, 1, 11, no
3998148285,  CeniFranco, 2, 0, 2, no
4515619593,  AngelaCiardi2, 13, 1, 12, no
3466793483,  Silvio1Di, 1, 0, 1, no
832669237,  rotondo_rotondo, 21, 0, 21, no
696294331716653056,  GinoArseni, 1, 0, 1, no
611557487,  marinox24, 1, 0, 1, no
1013216689,  SBigalli, 1, 0, 1, no
180292368,  cyntes, 1, 0, 1, no
106062337,  Cassandrino, 1, 0, 1, no
1891177956,  mimmociardulli, 1, 0, 1, no
328140558,  MassimoDiana, 1, 0, 1, no
4915140063,  baronegianfran1, 1, 0, 1, no
37669592,  Danetto, 1, 0, 1, no
1009350042,  AnnaMBellosi, 1, 0, 1, no
625487678,  v_salvati, 1, 0, 1, no
790992803916554240,  brunamariamari1, 1, 0, 1, no
383910544,  salvatoredifra2, 1, 0, 1, no
165192608,  HalZanetti, 2, 0, 2, no
1225147400,  BaldoniLetizia, 2, 0, 2, no
448110982,  TiziFr, 1, 0, 1, no
3023877706,  ireastrina, 2, 0, 2, no
803594927959580672,  magnifiko75, 2, 0, 2, no
291928126,  simofons, 2, 0, 2, no
30849011,  marcowait4it, 2, 0, 2, no
615962268,  RITAGLIATO, 2, 0, 2, no
934103166,  AgarPm, 1, 0, 1, no
3389821143,  violipaolo, 1, 0, 1, no
799004369979117568,  ScelgoNOVdA, 1, 0, 1, no
67717371,  carlabrandolini, 4, 1, 3, no
2346750207,  loryadoncecchi, 5, 0, 5, no
1361067690,  GraziaMg2000, 2, 0, 2, no
1262576665,  vincenzoammi, 3, 0, 3, no
367202498,  EndriolDoko, 1, 0, 1, no
303047906,  AntoninoSindona, 1, 0, 1, no
430698104,  Enia50, 3, 0, 3, no
993939740,  stefanello73, 1, 0, 1, no
22988685,  sabinomaggi, 1, 0, 1, no
439877772,  CB990ND, 1, 0, 1, no
187256895,  juliet_hall, 2, 0, 2, no
3531524723,  Lanterna00043, 1, 0, 1, no
481046302,  robsili, 5, 1, 4, no
1045134870,  cmprtr, 1, 0, 1, no
422449941,  jhansen63, 1, 0, 1, no
475829005,  StaffAmbiente, 3, 0, 3, no
550428173,  fiorigorini, 9, 0, 9, no
317336535,  pidemath, 1, 0, 1, no
1041677040,  DomenicoP_1991, 2, 0, 2, no
266084021,  stefu63, 1, 0, 1, no
2525303475,  alessandra5857, 1, 0, 1, no
406831073,  superigig, 1, 0, 1, no
755642990316621824,  RemorenzoRizz, 1, 0, 1, no
261361900,  cinziajo, 1, 0, 1, no
1928092940,  Dibi_Fra, 8, 0, 8, no
781240119881760768,  SIPRomaeLazio, 6, 0, 6, no
420473032,  francescocardil, 1, 0, 1, no
2879642111,  simona676767, 1, 0, 1, no
94377101,  luigicaserta, 1, 0, 1, no
3003467823,  mortcinder1111, 1, 0, 1, no
116193538,  damiano_dd, 3, 0, 3, no
13276922,  maudel15, 1, 0, 1, no
44592301,  nicodina, 1, 0, 1, no
229966869,  emiliotoffano, 1, 0, 1, no
701058764850511873,  sinitSermoneta, 1, 0, 1, no
754680784548667393,  renegate1979, 1, 0, 1, no
410986900,  antonellabizza1, 2, 0, 2, no
420987413,  fabiosilvestri3, 8, 0, 8, no
1377722724,  ChristianPaltri, 1, 0, 1, no
1589606430,  DicintioEn, 1, 0, 1, no
1528766720,  svane_, 1, 0, 1, no
3903990677,  LaurusRavni, 2, 0, 2, no
805349047,  ValerioGulia, 1, 0, 1, no
454710765,  ChiccoRaffaelli, 1, 0, 1, no
3332423949,  68Ary, 1, 0, 1, no
255233338,  mr_etti, 1, 0, 1, no
1242548042,  dario_calzavara, 1, 0, 1, no
472955722,  GraziellaAmenta, 1, 0, 1, no
208447128,  EmaPihk, 1, 0, 1, no
320990787,  fcordio, 1, 0, 1, no
190084519,  JohnnyICS, 4, 0, 4, no
735587915078742017,  Vi_Pi_H, 1, 0, 1, no
436107066,  NUNZIODE, 3, 1, 2, no
116679213,  latrudy, 2, 0, 2, no
2217330908,  afumagalli2, 2, 0, 2, no
4526794900,  annas964, 2, 0, 2, no
1291614584,  tagliapc3, 3, 0, 3, no
117181647,  Johndartois, 1, 0, 1, no
4886966033,  lolli_10, 1, 0, 1, no
736168420719394816,  angimatalone, 1, 0, 1, no
615072676,  RobertoRossini5, 1, 0, 1, no
270337080,  marcogiuf, 1, 0, 1, no
522203766,  aannnnaa1403, 1, 0, 1, no
2492674834,  ladinbel, 3, 0, 3, no
1330947722,  mikisoll, 1, 0, 1, no
865346486,  enzorus2020, 1, 0, 1, no
3207502492,  mariannafiorino, 1, 0, 1, no
262777162,  ulvy3000, 1, 0, 1, no
310215639,  giadanajarro, 1, 0, 1, no
96380866,  falcao83, 5, 0, 5, no
715914627,  keta2167, 1, 0, 1, no
2277360169,  CensoreCatone, 1, 0, 1, no
426498186,  Fabrikios, 1, 0, 1, no
2325858169,  Matteo_NFL, 1, 0, 1, no
55518746,  piulibri2016, 1, 0, 1, no
3438227752,  LAURACARIA2, 2, 0, 2, no
468666230,  bertonesilvio, 1, 0, 1, no
3052866272,  casula63, 1, 0, 1, no
1318605636,  pieroscivoletto, 7, 0, 7, no
78943556,  fra_marchiano, 2, 0, 2, no
1296698486,  formosa_g, 5, 0, 5, no
319822986,  AntonioNegri, 15, 0, 15, no
1192897722,  Mikypa79, 3, 0, 3, no
120176980,  stefany74, 1, 0, 1, no
3751200317,  paolellam147, 1, 0, 1, no
459575207,  AntonioBachis, 2, 0, 2, no
1198833228,  bibalbit, 2, 0, 2, no
424164438,  RobertoFazzolar, 2, 0, 2, no
1620821989,  inniallsarmsxx_, 3, 0, 3, no
397125568,  mbidoni, 1, 0, 1, no
490504850,  PietroMazzara1, 2, 0, 2, no
504501744,  alexbaravelli, 4, 1, 3, no
2954019286,  giampo1975, 1, 0, 1, no
85358343,  bobalsor, 2, 0, 2, no
1219462364,  Vincenzo_Franze, 1, 0, 1, no
2751130101,  roby_lioncastle, 2, 0, 2, no
451425647,  davidenotav, 1, 0, 1, no
237633755,  danisol74, 2, 0, 2, no
21185883,  francesca_bria, 2, 0, 2, no
1001442932,  conteashanti, 4, 0, 4, no
4017605728,  Officine3D, 1, 0, 1, no
274608461,  officinevdl, 1, 0, 1, no
467401158,  sergio_scorza, 9, 2, 7, no
718837077304086528,  BarbaraAzzara, 1, 0, 1, no
4855564132,  V_Capitolina, 3, 1, 2, no
361268701,  MaricaCasoni, 2, 0, 2, no
321903922,  FrancescaG92, 2, 0, 2, no
498994112,  manuel_guidi, 1, 0, 1, no
2214232422,  BariMigliore, 2, 0, 2, no
170769737,  Woodstock_76, 11, 0, 11, no
221064731,  frankowolf1, 2, 0, 2, no
795937245253484544,  BSailsItaly, 1, 0, 1, no
395216654,  MarcoDiMichele1, 8, 0, 8, no
2716622877,  gianpigervasi, 4, 0, 4, no
2596359046,  fc5b81746974419, 1, 0, 1, no
422947099,  rinoseq, 3, 0, 3, no
357100487,  bensilve68, 5, 2, 3, no
3144292696,  CriAutolitano, 3, 0, 3, no
601417871,  ILoveDelenaNian, 3, 0, 3, no
3812572893,  TAXICABria, 5, 0, 5, no
447038194,  StefanoIncolla, 2, 0, 2, no
122072439,  Indigestio, 1, 0, 1, no
498007394,  _645236501049, 5, 0, 5, no
450828495,  rgigino2002, 1, 0, 1, no
3213779287,  Econo167Econo11, 1, 0, 1, no
308042987,  LadyElizabeth93, 2, 0, 2, no
1110771230,  davidepovero, 1, 0, 1, no
69218842,  sergio0463, 5, 0, 5, no
184018328,  desantismar, 4, 0, 4, no
373398962,  MarcoTrozzi1, 3, 0, 3, no
2341326693,  Zio_FranK_1, 6, 1, 5, no
462082356,  AironAngel, 1, 0, 1, no
306021140,  davidantonio136, 2, 0, 2, no
457833517,  bestosoalessand, 5, 0, 5, no
747967353682550784,  ItalianTonyQ, 2, 0, 2, no
780829149950726144,  thatgirlsandra5, 1, 0, 1, no
3668101515,  1776tamara, 2, 0, 2, no
794896448890564608,  taem878401, 1, 0, 1, no
449984080,  matsoc203, 1, 0, 1, no
421203723,  DenDr77, 1, 0, 1, no
634999260,  AlbertoAirola, 16, 3, 13, no
318927329,  lucacarabetta, 1, 0, 1, no
1332412902,  lavi_azz, 1, 0, 1, no
404394458,  dinavilla60, 1, 0, 1, no
731173638435704833,  nidim66, 3, 0, 3, no
391441252,  maxfarano, 1, 0, 1, no
367600267,  MontyGTweet, 4, 0, 4, no
373970310,  LivianaG, 1, 0, 1, no
773214636715995136,  robegatt, 1, 0, 1, no
1320273294,  GiordanaMoltedo, 2, 0, 2, no
3982426332,  UgoMattei, 1, 0, 1, no
492939871,  ToninoCamp, 1, 0, 1, no
1908166152,  ale_villarosa, 1, 0, 1, no
382207939,  PalettaAndrea, 1, 0, 1, no
754275355100413952,  KnightPicardi, 3, 0, 3, no
2843814810,  alter_more, 1, 0, 1, no
2973110446,  nasolec80, 1, 0, 1, no
1164447662,  Alessandrofed16, 1, 0, 1, no
40962257,  violet6femme, 9, 2, 7, no
757879535375360000,  denielg23, 1, 0, 1, no
979243700,  claudiabiella, 1, 0, 1, no
1109838932,  RoviSilvia, 1, 0, 1, no
178112460,  scicorina, 4, 0, 4, no
1264710499,  LocaMatteo, 9, 0, 9, no
753919791140855808,  la_mulas, 1, 0, 1, no
4775755047,  M5SgiovaniTO, 3, 0, 3, no
476591207,  limpidgreen_, 3, 0, 3, no
509058151,  giusepp95340777, 1, 0, 1, no
507758921,  MirkoGiovs, 1, 0, 1, no
2917487926,  DiAmato_Davide, 2, 0, 2, no
783307585206222848,  Sdf4774, 45, 0, 45, no
482513993,  luca7goldenwing, 5, 0, 5, no
537536062,  BarbaraCiolli, 1, 0, 1, no
1588777538,  sydlsd, 2, 0, 2, no
751412274,  Giu_dig, 1, 0, 1, no
2154499070,  FrankCapitone, 1, 0, 1, no
3347508815,  alileo9710, 5, 0, 5, no
797490358305386497,  ShikimyMikashi1, 1, 0, 1, no
69565598,  IlGorga, 5, 0, 5, no
2247573164,  JioalimLimone, 5, 0, 5, no
1190283926,  spartakomax, 8, 2, 6, no
2244108384,  sosground, 2, 0, 2, no
1037624108,  giugoio, 2, 0, 2, no
431747635,  pandeussilvae, 2, 0, 2, no
331795273,  Fede_Navy, 2, 0, 2, no
440142755,  Calvogigi, 1, 0, 1, no
18100097,  pos_kay, 9, 0, 9, no
427671749,  echoof_rain, 2, 0, 2, no
3395095977,  ZarAleinikov, 1, 0, 1, no
950480676,  AlexMaksura, 1, 0, 1, no
263053332,  torino5stelle, 2, 0, 2, no
464687764,  renzalana, 1, 0, 1, no
370596367,  TitoLivio85, 1, 0, 1, no
4227091119,  piopio7831, 5, 0, 5, no
486612789,  marco_box, 1, 0, 1, no
460465100,  adestefanis11, 1, 0, 1, no
2478641336,  _paoloratti_, 2, 0, 2, no
804484172777717760,  hiaviaroffa1975, 1, 0, 1, no
418634231,  GiovanniBucci1, 1, 0, 1, no
47111878,  FloraZanichelli, 1, 0, 1, no
474032443,  thepopexxx, 1, 0, 1, no
234819447,  Gianla79, 2, 0, 2, no
4076765242,  ToscoDomenico, 5, 0, 5, no
417213380,  RAccoss, 3, 0, 3, no
405659403,  PaolaMilani1, 13, 0, 13, no
97240151,  aledurin, 1, 0, 1, no
30626248,  AleKi8, 1, 0, 1, no
307356280,  ManuRobertigna, 1, 0, 1, no
614476004,  bardpt, 1, 0, 1, no
2549720989,  MarcoRm6, 3, 1, 2, no
525783195,  Cal0re, 3, 1, 2, no
808984266,  ronza66, 1, 0, 1, no
81846818,  AndreaLigios, 1, 0, 1, no
603513371,  maurocancellie1, 5, 0, 5, no
63149834,  LIBERALAICO, 3, 0, 3, no
722862976856928256,  GiarruzzoMarika, 1, 0, 1, no
547553319,  CaputoDavide185, 2, 0, 2, no
625012293,  andreacalzecchi, 2, 0, 2, no
636955791,  ChangeItalia, 3, 0, 3, no
255669937,  gioalpha, 13, 1, 12, no
25713289,  GfZucchi, 1, 0, 1, no
1466803693,  GianpaoloZatti, 3, 0, 3, no
126583546,  leotambe, 2, 0, 2, no
1701645288,  Alex_Ssl1900, 2, 0, 2, no
7250482,  biancoraffaele, 1, 0, 1, no
2231898250,  colincogs, 2, 0, 2, no
485187851,  InuUrbanistica, 1, 0, 1, no
1605951806,  carla7310, 5, 0, 5, no
3748044561,  barbaragagliar, 1, 0, 1, no
712917292955385856,  CovertFinance, 1, 0, 1, no
384930259,  RadixOM, 1, 0, 1, no
980693485,  marcoeSseMS, 2, 0, 2, no
435644392,  Antonb60, 1, 0, 1, no
632400257,  machenesoio2, 4, 0, 4, no
64167037,  zoobeno, 1, 0, 1, no
4342527448,  varasano_gianni, 2, 0, 2, no
554160145,  Mspigaroli, 3, 0, 3, no
2464482982,  dema936, 1, 0, 1, no
2330508651,  valro65, 1, 0, 1, no
4218794297,  Eli_Russo_, 1, 0, 1, no
494827982,  annietrop, 10, 0, 10, no
1468332938,  roberto_malanca, 1, 0, 1, no
508088713,  ernestomondo, 3, 0, 3, no
379293784,  skler0, 1, 0, 1, no
1190943824,  cinco21274, 2, 0, 2, no
3252721365,  RossanaTric, 1, 0, 1, no
337372191,  Travagliato, 6, 1, 5, no
1069414741,  alessan49921573, 9, 0, 9, no
2652070796,  g31860794, 3, 1, 2, no
441080032,  MLetiziaRub, 1, 0, 1, no
2154774592,  SPettigiani, 4, 0, 4, no
143113340,  zioterry, 1, 0, 1, no
1245767360,  GSigno47, 2, 0, 2, no
508717801,  francescocantin, 1, 0, 1, no
2353359824,  gattoMostrino, 1, 0, 1, no
828570210,  natascia69, 7, 0, 7, no
551156956,  Direttorex, 1, 0, 1, no
39454215,  isazan, 1, 0, 1, no
2825259495,  FrancjKicca, 4, 0, 4, no
2893109039,  Monica10001, 1, 0, 1, no
421715120,  brunosalustri1, 3, 0, 3, no
724967510072786948,  ilMartello78, 2, 0, 2, no
3384958936,  alespool62, 5, 0, 5, no
273854836,  virfal79, 1, 0, 1, no
1080972302,  SilvestroLuig, 2, 0, 2, no
393398115,  m_tropeano, 1, 0, 1, no
2911669271,  amorfabb, 2, 0, 2, no
433955520,  agostinobarbera, 2, 0, 2, no
286544227,  sanso2011, 4, 0, 4, no
288828205,  Luca15N, 2, 0, 2, no
432552791,  BSapphire27, 1, 0, 1, no
119506508,  frasurano, 1, 0, 1, no
126970118,  vilmamoronese, 13, 0, 13, no
17706954,  Tecnobarbaro, 2, 0, 2, no
508747838,  Davidrugo1, 3, 0, 3, no
103303397,  DolphinAndroid, 4, 0, 4, no
3122188607,  AntonellaBerta2, 2, 0, 2, no
803523999288410112,  ziomario5, 1, 0, 1, no
865077301,  CostanzaNicola, 3, 0, 3, no
2518419121,  CarloCheld08, 1, 0, 1, no
2968679031,  zoleociro_ciro, 3, 0, 3, no
416402068,  emanbj, 4, 0, 4, no
554958008,  fliston12, 1, 0, 1, no
714927852152561670,  Roberto_Sandano, 1, 0, 1, no
1178495641,  cittAgora, 5, 0, 5, no
3407428384,  prato_mauro, 4, 0, 4, no
921116641,  Massimiliano5S, 1, 0, 1, no
341589210,  Errata_0, 1, 0, 1, no
880920932,  raffaellanotar1, 1, 0, 1, no
1235060898,  Gianni_Nocera, 7, 0, 7, no
1905524532,  AntonioFornari2, 3, 0, 3, no
2387695565,  giuseppedm57, 7, 0, 7, no
634991622,  ErnestoMilanesi, 1, 0, 1, no
52824910,  gravitazeroeu, 2, 0, 2, no
1012423344,  rlusci, 1, 0, 1, no
41328420,  FDebenedetti, 2, 0, 2, no
118505502,  LUKA37, 1, 0, 1, no
586513270,  GrandeDibba, 1, 0, 1, no
297945336,  MaaxGargura, 4, 0, 4, no
877456254,  lafratta49, 9, 0, 9, no
396626479,  nella_norma, 3, 0, 3, no
41348383,  _Leti_19, 1, 0, 1, no
3044774409,  ssempreviva1, 2, 0, 2, no
3032760082,  Ema_Olmi, 2, 0, 2, no
220628425,  marchiori_carlo, 1, 0, 1, no
47968034,  Luca_Borio, 1, 0, 1, no
487674751,  ClaudioBianco88, 2, 0, 2, no
843441636,  plume_emulp, 1, 0, 1, no
133663155,  Dunant99, 6, 0, 6, no
1076258972,  camillocarrea, 1, 0, 1, no
804753644,  joseph_cav, 23, 0, 23, no
4642775073,  GiuseppeGiusto9, 1, 0, 1, no
379262450,  foresta233, 1, 0, 1, no
53096801,  GhigoTrieste, 1, 0, 1, no
3373403367,  Giovantoniotw, 1, 0, 1, no
506586076,  FLEPARInail, 1, 0, 1, no
700711428538421249,  DomesDomenico, 1, 0, 1, no
303883951,  chiara149, 1, 0, 1, no
518969832,  sebyliccia, 1, 0, 1, no
3347512257,  PetraReski, 2, 0, 2, no
213588883,  SaraMayaCo, 8, 0, 8, no
1015037964,  CatalanoGianni, 7, 0, 7, no
141686435,  fbernabe, 1, 0, 1, no
1953729241,  78_michela, 2, 0, 2, no
1084011908,  mynightmaresguy, 3, 0, 3, no
1046538596,  samuelrere, 3, 0, 3, no
3179785922,  tripazia00, 3, 0, 3, no
495623215,  Claudestar2012, 6, 0, 6, no
137643354,  giuseppebaggio, 2, 0, 2, no
1243172797,  Saraamor71, 3, 0, 3, no
783627340861538304,  Giornaliste, 1, 0, 1, no
3334095760,  Sharytex, 4, 0, 4, no
224690887,  Plutone999, 2, 0, 2, no
470003688,  GuidoPignoli, 25, 0, 25, no
218067973,  faustofellini, 14, 2, 12, no
602918666,  marcellocurrel1, 3, 0, 3, no
1169245177,  ilcosta72, 9, 1, 8, no
702924803,  ScampoliAntonio, 3, 0, 3, no
2200336955,  fabriziopisu, 1, 0, 1, no
241519703,  HHnoraH, 1, 0, 1, no
2254861851,  dssgpp, 4, 0, 4, no
220627149,  sergiopagliaro, 1, 0, 1, no
1262829973,  Agcaval, 3, 0, 3, no
419676762,  giubecc, 1, 0, 1, no
3928289074,  leoquergdr, 2, 0, 2, no
1708399825,  simonedatorino, 2, 0, 2, no
1001138461,  GianmariaRaboin, 3, 0, 3, no
116907932,  urbanagranbar, 2, 0, 2, no
3905591125,  matteomu1, 1, 0, 1, no
1045064690,  VelloneErcole, 4, 0, 4, no
1012135158,  canaleluca71, 9, 0, 9, no
405697475,  nicolacichelli, 2, 0, 2, no
58788449,  pcautela, 1, 0, 1, no
257491066,  marjsang, 3, 0, 3, no
253194616,  chissa_perche, 1, 0, 1, no
433236708,  rosannaangioi, 1, 0, 1, no
318878875,  paolohippos, 3, 0, 3, no
4695730892,  ulixtulix, 8, 0, 8, no
1616907128,  pacileoangelo, 1, 0, 1, no
2175690087,  PanettaRosita, 1, 0, 1, no
4233859347,  laele28158946, 5, 0, 5, no
3323080689,  antzorb, 1, 0, 1, no
515351678,  pasqualemarina, 8, 0, 8, no
2452102818,  PippyCattiva, 4, 0, 4, no
3031014982,  Michela45754477, 1, 0, 1, no
766703303845699585,  ComitatoNo_UK, 3, 0, 3, no
393551120,  PatriziaBugnano, 1, 0, 1, no
378801199,  MatteoFiaschett, 1, 0, 1, no
1201470660,  lauraorestano, 5, 2, 3, no
2210971446,  FrancescescoV, 1, 0, 1, no
543616855,  StefanoGiraudo, 1, 0, 1, no
740883123379048448,  simone_mondino, 1, 0, 1, no
2227385970,  5stellelonatep, 1, 0, 1, no
418050006,  IvraChanel, 4, 0, 4, no
1039387388,  FrancoLucano, 4, 0, 4, no
2696609369,  bombergiunta, 1, 0, 1, no
191835437,  maxgranata, 1, 0, 1, no
476235682,  kiniron, 8, 0, 8, no
2358680459,  31patt, 1, 0, 1, no
348744693,  FedericoGuiati, 4, 0, 4, no
2696366840,  asialollo15, 12, 0, 12, no
1050542586,  alebezza, 2, 0, 2, no
2297955914,  girasol44247939, 1, 0, 1, no
3107226245,  giulyeh, 13, 0, 13, no
171202259,  fabio_fucci, 2, 0, 2, no
257398221,  spazimau, 12, 0, 12, no
390304031,  pmilite, 3, 0, 3, no
429340113,  amoridellavita, 1, 0, 1, no
330933789,  veronelle1, 2, 0, 2, no
580331655,  AnninaLombardo, 2, 0, 2, no
1172851158,  Classe_74, 3, 0, 3, no
326451864,  maxcon00, 8, 0, 8, no
3396685594,  giaguaro067, 1, 0, 1, no
740663614688890880,  Rosanna49785870, 2, 0, 2, no
258375186,  TOsostenibile, 2, 0, 2, no
129865921,  pinpas60, 1, 0, 1, no
4892651727,  GuglielmoRodati, 6, 0, 6, no
472786126,  dolzasyl, 2, 0, 2, no
445687226,  lorefanto, 2, 0, 2, no
700444597600833536,  Ste3073, 1, 0, 1, no
134487700,  scienzaltro, 1, 0, 1, no
1096100132,  DirettoriHotel, 3, 0, 3, no
1582784514,  ElGranYago, 4, 0, 4, no
2256161788,  GiordanaPaolo, 1, 0, 1, no
491118242,  SoniaBelforte, 1, 0, 1, no
295122999,  Yuri480, 1, 0, 1, no
708689965,  minodigiorgio, 1, 0, 1, no
428304150,  sergiolupo, 2, 0, 2, no
807801223,  AlbertoTrevi79, 4, 0, 4, no
235593445,  celesteondeck, 1, 0, 1, no
541787569,  laurarocci1, 5, 0, 5, no
24926778,  lorenzodamelio, 1, 0, 1, no
3873538582,  giu61ma1903, 1, 0, 1, no
97279759,  PaoloValimberti, 1, 0, 1, no
96746296,  MarjadeSanctis, 1, 0, 1, no
3399351406,  Proof_Jey, 2, 0, 2, no
426114352,  michelemonello, 4, 0, 4, no
2373433018,  CateIngra, 1, 0, 1, no
220858588,  emiliomaglietta, 4, 0, 4, no
353750900,  Mayflower014, 3, 0, 3, no
2504360748,  vero_taba, 1, 0, 1, no
2344839862,  Elisabe250265, 2, 0, 2, no
706545045449678848,  FedeVell, 1, 0, 1, no
1007154330,  PeeGeeDaniel, 1, 0, 1, no
422829258,  donatocalderoni, 2, 0, 2, no
20517522,  Bolets, 1, 0, 1, no
539871980,  FRALOMY, 3, 0, 3, no
349319486,  Samuraikoi, 12, 0, 12, no
56115235,  Chicco_Rossi, 1, 0, 1, no
807358640,  toniolp83, 1, 0, 1, no
271810587,  tony040151, 1, 0, 1, no
2753082201,  enrico_camma, 1, 0, 1, no
29202025,  fraversion, 1, 0, 1, no
418217672,  MarisaTafuni, 1, 0, 1, no
480612566,  rivarobe, 9, 0, 9, no
938561695,  antomaszana, 1, 0, 1, no
2765919539,  UrbaniAda, 3, 0, 3, no
1852088028,  Wolfango83, 2, 0, 2, no
1700280511,  karrielynn88, 1, 0, 1, no
381510554,  macno82, 1, 0, 1, no
134869337,  Sy8i, 1, 0, 1, no
4765032501,  CMeneghetti74, 2, 0, 2, no
882407088,  egizianolombard, 1, 0, 1, no
458368651,  luca_podio, 1, 0, 1, no
759772392444993536,  hickstead1_2011, 1, 0, 1, no
498240204,  riccardogiani, 4, 0, 4, no
515507237,  Vigraf79, 2, 0, 2, no
731072461081595904,  GianfGalli, 5, 0, 5, no
712266973070159872,  fraziggy82, 8, 0, 8, no
800272805304487936,  Unpodisport1, 1, 0, 1, no
318661130,  riderperugia, 3, 0, 3, no
164237295,  farinatommaso, 3, 0, 3, no
111327481,  ItaProtagonista, 3, 0, 3, no
792628448552509440,  piquadromezzi, 3, 0, 3, no
17969850,  AvvMdiBari, 4, 0, 4, no
2830254804,  James64Jessy, 2, 0, 2, no
232534560,  fabioalisei, 2, 0, 2, no
17549059,  giacomo_b12, 1, 0, 1, no
1913735490,  and_gali, 1, 0, 1, no
989485837,  PatriziaAbramo, 3, 0, 3, no
2216727409,  forzaitaliaceri, 1, 0, 1, no
31854945,  Risparmiainrete, 1, 0, 1, no
93023987,  Frankbig62, 1, 0, 1, no
2440218877,  LorenzoColombis, 1, 0, 1, no
2279462713,  cacio68, 1, 0, 1, no
398856511,  GioRampini, 1, 0, 1, no
805010128017756160,  NoMisantropo, 2, 0, 2, no
219715197,  Bernifire, 1, 0, 1, no
407285782,  GroZzio, 1, 0, 1, no
194281145,  fededido, 1, 0, 1, no
304148663,  SavMarco, 1, 0, 1, no
433377978,  gabrigiunchi, 1, 0, 1, no
2756333990,  ops791, 1, 0, 1, no
1972832178,  DiComemai, 7, 0, 7, no
2775983397,  morata94juve, 1, 0, 1, no
508768082,  RobRova, 1, 0, 1, no
428103254,  Irislap, 1, 0, 1, no
78562487,  sheol77, 10, 2, 8, no
440237281,  MassimAngelo, 2, 0, 2, no
570143414,  fonsi57, 1, 0, 1, no
2733321629,  giacobazzipier, 1, 0, 1, no
805780207953186816,  LUIGI72147162, 1, 0, 1, no
136238828,  gerypa, 1, 0, 1, no
457646025,  ombrettabugane, 2, 0, 2, no
466628457,  lnzpcr, 1, 0, 1, no
429817276,  bechilar, 1, 0, 1, no
192886030,  TerreniBrotzu, 5, 0, 5, no
574340003,  fededilo98, 2, 0, 2, no
490342535,  oscarorrei, 2, 0, 2, no
429427800,  giocen1, 2, 0, 2, no
772056899814645760,  alealeNY19, 4, 0, 4, no
4076497583,  umbertosimone1, 1, 0, 1, no
2787709025,  77patrizia1, 3, 0, 3, no
3980609777,  ilSiberiano_, 1, 0, 1, no
3512608043,  giangiocontipe, 1, 0, 1, no
1430875939,  _fefella, 2, 0, 2, no
2987285175,  Hi5tory34, 1, 0, 1, no
4472952436,  chettiperdi, 1, 0, 1, no
2221398780,  GianfrancoTrois, 2, 0, 2, no
3400107676,  JohnCrosta, 3, 0, 3, no
317081203,  Salvo_kun, 1, 0, 1, no
906080510,  BarbaraCongiu, 5, 0, 5, no
470989221,  S1m0n3z, 1, 0, 1, no
991573146,  SimonettaGreco, 1, 0, 1, no
2885796447,  ldiresta, 1, 0, 1, no
113728322,  CALCIOGEMINI, 2, 0, 2, no
2913429669,  MassaroPiet, 8, 0, 8, no
252332089,  andyallnews, 2, 0, 2, no
2983947047,  katechista, 4, 0, 4, no
715993103451234309,  giulorpanna2, 1, 0, 1, no
480248512,  areale7508, 1, 0, 1, no
415619638,  remolabarca3, 1, 0, 1, no
405646874,  ierfra, 1, 0, 1, no
2273749855,  AndreaCosta378, 2, 0, 2, no
4214416708,  giusgio88, 3, 0, 3, no
494875751,  DTramannoni, 1, 0, 1, no
788727641562030080,  AgainFlash, 1, 0, 1, no
483431115,  ilgrandepier, 4, 0, 4, no
2342894531,  annalisa_masi, 3, 0, 3, no
761243555788619777,  Zero_Gradi_C, 2, 0, 2, no
1173315229,  a_casaccio, 1, 0, 1, no
22063717,  drusilla70, 6, 0, 6, no
768834311206346760,  GiacomelliZena, 3, 0, 3, no
142802377,  blufox55, 5, 0, 5, no
701030177262977024,  17Damio, 2, 0, 2, no
2965969887,  simone_lopresti, 1, 0, 1, no
2261802180,  luigim5491, 1, 0, 1, no
240671826,  marcomake, 3, 0, 3, no
1006962451,  SergioNardone1, 1, 0, 1, no
4256851395,  mov_idea, 2, 0, 2, no
379916380,  MatteoDeMei, 1, 0, 1, no
795760051210350592,  emanovizzi, 1, 0, 1, no
2765618325,  justcozze, 3, 0, 3, no
41688102,  nasellofra, 1, 0, 1, no
2293813528,  Belmonte82M, 3, 0, 3, no
799465139154092032,  tortoli_marco, 2, 0, 2, no
447452303,  AndreaAsilo, 1, 0, 1, no
1153571498,  PDLPistoia, 6, 0, 6, no
161464462,  lucianoaforte, 1, 0, 1, no
399250204,  DarioPalugan, 1, 0, 1, no
112812650,  TiberioBrunetti, 1, 0, 1, no
39811956,  yahweahh, 1, 0, 1, no
415081496,  MASSIMOMARUSSI, 1, 0, 1, no
1045056012,  Figliodipooh, 3, 0, 3, no
744972803762454528,  IleanaCiarlegl4, 1, 0, 1, no
61776957,  boksic72, 3, 0, 3, no
1945166732,  OTTOWEBER72, 2, 0, 2, no
2913888338,  forzasilvio2014, 5, 0, 5, no
2270281069,  NunzioPanzarell, 1, 0, 1, no
187305166,  terronpedro, 1, 0, 1, no
63756533,  davidaus82, 1, 0, 1, no
2868479991,  maya20071974, 1, 0, 1, no
1638096936,  campuseverest, 1, 0, 1, no
437745594,  cipollinoso, 1, 0, 1, no
76345466,  mariavenera, 3, 0, 3, no
53416446,  imieitentativi, 1, 0, 1, no
410807255,  doc_giovanni, 1, 0, 1, no
1357458175,  fabioper66, 1, 0, 1, no
475197913,  U_mBertOsTwEet, 1, 0, 1, no
2731877036,  andreagarnero, 1, 0, 1, no
4896166115,  AdessoNon, 1, 0, 1, no
198977983,  CafiDanna, 2, 0, 2, no
1080471613,  BilleraMirko, 1, 0, 1, no
466415211,  buenavidaxxx, 1, 0, 1, no
1305916776,  JimWildChild, 3, 0, 3, no
1662392455,  BellanovaFlavio, 1, 0, 1, no
3957585869,  carlohebdo, 1, 0, 1, no
2732001785,  carlone100, 1, 0, 1, no
423024537,  alerizzo_, 9, 1, 8, no
3963984257,  FrancoGros1, 1, 0, 1, no
30649504,  g_brindisi, 2, 0, 2, no
221681754,  whiskylick, 1, 0, 1, no
206146639,  fourthalf, 3, 0, 3, no
745675802143035392,  lleleeeee, 1, 0, 1, no
405294207,  mlancioni, 1, 0, 1, no
432352683,  logon99, 5, 1, 4, no
194945732,  Ciocco_Laura, 1, 0, 1, no
2946666304,  cortopassi_dan, 5, 2, 3, no
396185916,  tempivillani, 1, 0, 1, no
411820876,  LucianoSavares1, 1, 0, 1, no
2381833319,  ValleDellavalle, 1, 0, 1, no
2565896626,  orfanolorenzo, 2, 0, 2, no
4502398887,  PippoM66, 1, 0, 1, no
254663124,  simonelocci, 1, 0, 1, no
708449047544205316,  giovcammarata, 1, 0, 1, no
200422029,  lucabar2, 2, 0, 2, no
797592047893020676,  francesco301189, 1, 0, 1, no
2738271195,  da78a07f4707422, 1, 0, 1, no
490744618,  vincpezzuto, 2, 0, 2, no
2242177337,  krimm62, 1, 0, 1, no
239892470,  giuder91, 1, 0, 1, no
450045015,  riccardotarulli, 1, 0, 1, no
2482482240,  jolandafederica, 10, 0, 10, no
1103789143,  SimoneViola73, 1, 0, 1, no
747971202166231040,  MattiCalderone, 1, 0, 1, no
37776682,  ITA360COM, 3, 0, 3, no
413247485,  michelgrimaldii, 1, 0, 1, no
703927817885655040,  SalvatoreBacio, 1, 0, 1, no
56748540,  nicolagenovasi, 1, 0, 1, no
487599462,  groppon, 1, 0, 1, no
2927037939,  elisabethend, 1, 0, 1, no
430788723,  ValterDD, 1, 0, 1, no
406162937,  TheSnoopyG, 2, 0, 2, no
1154510216,  m_scala, 1, 0, 1, no
796454452756676608,  frenzissss, 1, 0, 1, no
2724274001,  bruzziches00, 1, 0, 1, no
2677706490,  Vittorietto4, 1, 0, 1, no
63452476,  giovycut, 2, 0, 2, no
427456064,  SDressi, 5, 0, 5, no
4114741037,  noiperilno, 4, 0, 4, no
506539762,  gito96, 1, 0, 1, no
254136151,  EligioDeRoma, 3, 0, 3, no
113750550,  lluca32, 2, 0, 2, no
2156763691,  mariagraziadea2, 1, 0, 1, no
335189017,  AzzopardiJason, 1, 0, 1, no
2651868966,  v_taito, 1, 0, 1, no
4089097761,  Sibillinamente, 2, 0, 2, no
3119633084,  ghislanzoni, 1, 0, 1, no
719529452594675712,  elyfly70, 1, 0, 1, no
740031002,  Luca_Arioli, 25, 3, 22, no
718178467293097986,  MarcinJudzinski, 2, 0, 2, no
49775576,  Whatsmicio, 1, 0, 1, no
247296118,  BOTROMAGNOVINI, 1, 0, 1, no
2930697713,  robertosgro89, 1, 0, 1, no
187419451,  LuigiDeRose, 10, 1, 9, no
1038029066,  Serra92Gianlu, 2, 0, 2, no
228010525,  AlemannoTW, 1, 0, 1, no
930668582,  liveinvektor, 1, 0, 1, no
247472267,  zirio90, 1, 0, 1, no
2995947293,  migliorerosari1, 5, 0, 5, no
756820331331919872,  DeeLouiseWhitn1, 3, 0, 3, no
802814151164825601,  CavalloScemo, 9, 0, 9, no
1343975432,  M5S_Senato, 5, 0, 5, no
330020463,  Mrkiwob, 1, 0, 1, no
1949018238,  GrulliGrullo, 1, 0, 1, no
1028707682,  CBdCavour, 1, 0, 1, no
2219416923,  capitoni_gianna, 2, 0, 2, no
416489772,  MauroVicini, 2, 0, 2, no
1355366514,  udods, 3, 0, 3, no
1060130900,  alinaseb, 1, 0, 1, no
727054163520184320,  scattoselvaggio, 1, 0, 1, no
594155232,  giulianaleoni, 2, 0, 2, no
486633667,  massy_bi, 1, 0, 1, no
467761042,  mariagraziamot1, 1, 0, 1, no
620997183,  VignoliMassimo, 1, 0, 1, no
118140512,  Vincisco, 4, 0, 4, no
799370718324621312,  ruscelli77, 1, 0, 1, no
104609732,  SAMNSS, 1, 0, 1, no
1261773409,  MASSIMILIANOFEO, 2, 0, 2, no
4461464967,  paolocasu76, 1, 0, 1, no
712200530349711360,  giulyz77, 2, 0, 2, no
999127400,  pa50antonio, 2, 0, 2, no
483120454,  Nicocacciatore, 1, 0, 1, no
151389582,  cbocconetti, 1, 0, 1, no
560988400,  DomeCecere, 1, 0, 1, no
371506417,  pocciacarlo, 1, 0, 1, no
2348264148,  deriva50, 5, 0, 5, no
2525278324,  patroleader, 1, 0, 1, no
243227792,  Maurix03, 2, 0, 2, no
3377294939,  percis50, 3, 0, 3, no
7647152,  rujero, 1, 0, 1, no
431749782,  CARACHILLE, 1, 0, 1, no
2354819957,  orlandi492, 1, 0, 1, no
791521154,  _47Ronin_, 5, 0, 5, no
418962970,  iside_vi, 1, 0, 1, no
96314541,  AndreaBellei, 1, 0, 1, no
139346534,  giocosso64, 1, 0, 1, no
280516751,  guidotweet, 1, 0, 1, no
401559083,  FalconeCarla, 1, 0, 1, no
2838629008,  AlfieriFilippo, 1, 0, 1, no
408035333,  AMiracolo, 1, 0, 1, no
409118790,  MorettiGaia, 1, 0, 1, no
246696739,  zanessi, 1, 0, 1, no
296955653,  AngeloNisi1, 1, 0, 1, no
1318706930,  Spiderfrancy, 1, 0, 1, no
4818447916,  Elandkam, 1, 0, 1, no
1188862585,  benedettomineo, 4, 0, 4, no
426726936,  bruna_dini, 1, 0, 1, no
79155963,  GMDeFrancesco, 2, 0, 2, no
70737754,  madaArch, 2, 0, 2, no
2267387652,  ioledana, 1, 0, 1, no
62459428,  Stenopeci, 12, 0, 12, no
436888427,  lo_gio, 1, 0, 1, no
420483264,  FESTA58, 1, 0, 1, no
244848309,  raffaelemad, 1, 0, 1, no
299707371,  ATuretta, 2, 0, 2, no
486781554,  RosatiGino, 2, 0, 2, no
971800837,  stefano_donnini, 1, 0, 1, no
1389298008,  DarioDraghi, 1, 0, 1, no
503061875,  PietroIdili, 1, 0, 1, no
985154594,  AmeliaLoprete, 1, 0, 1, no
79532738,  alaurasparsi, 1, 0, 1, no
1008540553,  maxadam71, 1, 0, 1, no
467802673,  br_santi, 2, 0, 2, no
4707720814,  1947palma42, 2, 0, 2, no
2940718365,  maoretm, 1, 0, 1, no
225319138,  Topogigio_57, 1, 0, 1, no
272847388,  agputzu, 1, 0, 1, no
1050482834,  gianniproce, 2, 0, 2, no
1040351857,  SMordeglia, 4, 0, 4, no
1239450805,  EtziAndrea, 1, 0, 1, no
744590265281839104,  benvenuto_e, 1, 0, 1, no
890891564,  Locoz83, 3, 0, 3, no
314623392,  destefanonicola, 3, 0, 3, no
1641098160,  GianlucaTedoldi, 3, 0, 3, no
373870683,  mauromagnani1, 2, 0, 2, no
610117076,  fabrizioluconi, 1, 0, 1, no
203570539,  ranucchiularo, 2, 0, 2, no
765879972464656385,  maltieri46, 8, 0, 8, no
1829373277,  ABarbesta, 2, 0, 2, no
1280346662,  arrcasati, 1, 0, 1, no
516970620,  Ale__Tarantino, 1, 0, 1, no
1065578654,  lella_marti, 1, 0, 1, no
993692924,  mauriziobazzoni, 1, 0, 1, no
909949962,  Sovra_pensiero, 1, 0, 1, no
462220063,  lazy__jack, 1, 0, 1, no
2508150650,  massiguerra77, 1, 0, 1, no
9047792,  Amfortas, 1, 0, 1, no
2662381998,  CalObama2, 1, 0, 1, no
2776292367,  simoca70, 1, 0, 1, no
1530823356,  frankapizzi, 2, 0, 2, no
322915773,  mariani_nic, 1, 0, 1, no
311392231,  pippo_netti, 1, 0, 1, no
1487707045,  76Caiazza, 1, 0, 1, no
712780797,  bertacchini80, 1, 0, 1, no
2280378259,  digoxin55, 1, 0, 1, no
1222942753,  SMuscetta, 1, 0, 1, no
3233492463,  parisimaria47, 1, 0, 1, no
115447443,  interstellare, 1, 0, 1, no
112474043,  Piconese, 2, 0, 2, no
194681264,  danielpommier, 1, 0, 1, no
4229782887,  MicheleDepalo8, 1, 0, 1, no
235963979,  vernalucy, 1, 0, 1, no
475222684,  Manushry, 1, 0, 1, no
812943912,  BedeEmerem, 4, 0, 4, no
935492714,  maxdea11, 1, 0, 1, no
367301110,  polipodepolipi, 2, 0, 2, no
2816882335,  giorgioperi19, 1, 0, 1, no
374747479,  davidegeddo, 1, 0, 1, no
476049203,  SSargentini, 1, 0, 1, no
1607816904,  riccardokruje, 4, 0, 4, no
1249475719,  Giorgiaro67, 1, 0, 1, no
315997719,  rodavossa, 1, 0, 1, no
1828365332,  maudamcri, 1, 0, 1, no
597752798,  RobertoZanatta0, 2, 0, 2, no
269255378,  camax1V, 2, 0, 2, no
2170390380,  MatteoNeri00, 1, 0, 1, no
1281238016,  mvil_63, 1, 0, 1, no
924212281,  angielongo, 1, 0, 1, no
2362803854,  giustinaluci, 1, 0, 1, no
1221291,  simona_kay_, 1, 0, 1, no
250649897,  paolapica, 1, 0, 1, no
805106423436865536,  ROUGE235, 1, 0, 1, no
805857083178553344,  Bruno23483212, 1, 0, 1, no
742716979392450561,  Seven______7, 1, 0, 1, no
483035480,  carmensasso2, 1, 0, 1, no
406783704,  danilofabbroni, 1, 0, 1, no
1110124999,  greegrace, 1, 0, 1, no
579723244,  GennaroFavale, 1, 0, 1, no
279367690,  gypsystel, 3, 0, 3, no
314851902,  diegoandreotti, 1, 0, 1, no
805440451335585793,  Flavio_DiC, 1, 0, 1, no
255125630,  spapi68, 1, 0, 1, no
358057757,  danigeo72, 1, 0, 1, no
491183275,  seiunozero1, 1, 0, 1, no
99099435,  Parapiero, 1, 0, 1, no
371258463,  Climatec_Srl, 1, 0, 1, no
1267780669,  FIERRODOMENICO, 1, 0, 1, no
342672995,  AndreaBaio, 1, 0, 1, no
792097117162639360,  viumbo71, 1, 0, 1, no
1251431112,  Suethespider_, 1, 0, 1, no
1037146854,  mimisalvo, 1, 0, 1, no
472124094,  LorenzoCapirone, 2, 0, 2, no
4832618572,  69ayylmao69, 1, 0, 1, no
3071993301,  muzzi_mario, 2, 0, 2, no
125942842,  mauriziocelia, 1, 0, 1, no
50608867,  Cirusguti, 2, 0, 2, no
354166819,  lorisemme, 1, 0, 1, no
475194395,  MarianPuosi, 1, 0, 1, no
411617221,  armando_cirillo, 1, 0, 1, no
2389384395,  namoroso80, 1, 0, 1, no
799366283250847744,  AndBassoli, 1, 0, 1, no
52019004,  enricoisopi, 1, 0, 1, no
1069408890,  SauroStacchiott, 1, 0, 1, no
434829316,  fabrizio_rollo, 1, 0, 1, no
1645029769,  Russo3Luisa, 1, 0, 1, no
534111651,  DavideGassino, 1, 0, 1, no
257383300,  GVergnasco, 1, 0, 1, no
2786641987,  9ff332a225b8441, 1, 0, 1, no
1216222302,  mariacaffo, 1, 0, 1, no
2955100415,  oho_zone, 1, 0, 1, no
254079422,  graz_81, 6, 1, 5, no
396787275,  aler06, 1, 0, 1, no
431756712,  valeferdiet, 1, 0, 1, no
407047260,  AAngelini68, 1, 0, 1, no
900152504,  GabrieleGiorgi7, 1, 0, 1, no
1068069210,  FrancoTollerini, 1, 0, 1, no
520518526,  paolied, 1, 0, 1, no
248633006,  AlessandroRaggi, 1, 0, 1, no
15004167,  tomval, 1, 0, 1, no
560439381,  CosimoGoos01, 1, 0, 1, no
3653031257,  ConzadoriAnna, 3, 0, 3, no
463094763,  TLucidi, 1, 0, 1, no
724578776659701761,  attico64, 2, 0, 2, no
394748822,  luigipatarnello, 1, 0, 1, no
477984092,  BONAZZIROMANO, 1, 0, 1, no
747892541400428544,  northias, 4, 0, 4, no
432025754,  Alberto_Belloni, 1, 0, 1, no
998952552,  sirobargiacchi, 1, 0, 1, no
482872015,  porcellinorosa, 1, 0, 1, no
64644350,  pinuccioalia, 1, 0, 1, no
780490807480553472,  sgn70, 1, 0, 1, no
3289847579,  ilbiadolaio, 3, 0, 3, no
1076456299,  CigarroRoberto, 1, 0, 1, no
429898007,  filippoboatti, 1, 0, 1, no
2565011447,  makkiarossa, 1, 0, 1, no
1466641994,  frigo_giancarlo, 1, 0, 1, no
419060272,  GDimporzano, 1, 0, 1, no
50374598,  MurielSowden, 1, 0, 1, no
986564732,  171822elFranca, 5, 0, 5, no
429141884,  MarioCaporali, 7, 0, 7, no
501594854,  cgiltoscana, 1, 0, 1, no
955895382,  wpulze, 1, 0, 1, no
1162344666,  gianniDalla, 1, 0, 1, no
179941490,  avvcervellera, 1, 0, 1, no
50661164,  delfp, 1, 0, 1, no
462233476,  EnidSadedini, 1, 0, 1, no
1049167112,  __sisco__, 1, 0, 1, no
301049143,  ValenCaffieri, 1, 0, 1, no
1157829871,  frialdigraziell, 1, 0, 1, no
2301791792,  ritapasku, 2, 0, 2, no
386463269,  Antonella881, 2, 0, 2, no
1216209888,  torridani, 1, 0, 1, no
593560634,  EffeCati, 1, 0, 1, no
412363318,  ConconiGiovanni, 1, 0, 1, no
1005109537,  kelevra_889, 1, 0, 1, no
432804141,  MarcoMechi, 1, 0, 1, no
33196168,  cinemanu, 1, 0, 1, no
823919240,  campoluc, 1, 0, 1, no
2886677145,  aldo_graziani, 1, 0, 1, no
473109812,  andreamassa4, 1, 0, 1, no
170666252,  ilConteMax24, 2, 0, 2, no
2367438201,  c_sangalli, 1, 0, 1, no
402135794,  JTelmont, 3, 0, 3, no
1366334430,  quantotanto, 1, 0, 1, no
714913659,  LaCiarass23, 1, 0, 1, no
278273822,  silvioingalera, 14, 0, 14, no
3720121229,  paolamzzm, 1, 0, 1, no
381129608,  DasaraShullani, 1, 0, 1, no
228027870,  nemboc, 5, 1, 4, no
849568508,  catdam1, 3, 1, 2, no
251148054,  johnnybeback, 1, 0, 1, no
3292905852,  delmoromassimo, 4, 0, 4, no
38139984,  chiccotesta, 2, 0, 2, no
4722997649,  Camillo86906021, 1, 0, 1, no
801871901006200832,  Bernard31935716, 1, 0, 1, no
649363,  mariocanno, 1, 0, 1, no
228702883,  DemRif, 1, 0, 1, no
855409538,  annalaura_tola, 1, 0, 1, no
256466502,  PaoAlBon, 1, 0, 1, no
141877526,  malam87, 3, 0, 3, no
531715709,  GIACOMOMattegi1, 1, 0, 1, no
22031757,  aleredo, 1, 0, 1, no
2547567674,  aiazzielda, 1, 0, 1, no
489334750,  ZIORIUMA, 1, 0, 1, no
599003292,  DivoElGalante, 1, 0, 1, no
960825452,  AlbertoMazzo99, 1, 0, 1, no
3068102367,  emmacecco, 1, 0, 1, no
399545508,  elisagenti_, 1, 0, 1, no
128811499,  Persian_Coral, 3, 0, 3, no
49288229,  B_MCristina, 1, 0, 1, no
713751156690911232,  maupallavicini, 1, 0, 1, no
37489640,  Dimonios, 1, 0, 1, no
420680501,  ElisabettaMoret, 2, 0, 2, no
805725653563805698,  fabriziarapagna, 1, 0, 1, no
296334489,  GiuseppeDeLeo, 2, 0, 2, no
1068011798,  giampao17175170, 1, 0, 1, no
2900333043,  LazzMenico, 1, 0, 1, no
727150387539664896,  gilsca1480, 1, 0, 1, no
781140776613011456,  GiuseppeAltavi4, 1, 0, 1, no
471443583,  Wladi_Anders, 1, 0, 1, no
245462152,  marc0marav1gna, 1, 0, 1, no
2294935707,  raro5102, 1, 0, 1, no
441696914,  NicoisKastah, 6, 0, 6, no
564629186,  nicolettapetri, 1, 0, 1, no
1394857658,  giova_leo, 1, 0, 1, no
970172977,  bradipo54, 1, 0, 1, no
48003965,  nikands, 1, 0, 1, no
611545736,  Lety28June, 1, 0, 1, no
1861609885,  MattiaMah, 1, 0, 1, no
71218300,  Robplague, 5, 0, 5, no
1365032677,  walter_walessan, 3, 0, 3, no
1291795656,  Tomas1374, 4, 0, 4, no
2292753403,  Torino_14, 1, 0, 1, no
331483394,  augustomoretti, 1, 0, 1, no
420312158,  MarcoImolaGuidi, 1, 0, 1, no
55188515,  diluente, 1, 0, 1, no
3179825100,  ogniqualvolta, 1, 0, 1, no
781921325044604928,  L_P_C64, 1, 0, 1, no
2771313035,  fabmoglianesi, 1, 0, 1, no
407233459,  HaironMen, 2, 0, 2, no
38007650,  cocco2200, 1, 0, 1, no
742417542556332032,  2zeller, 1, 0, 1, no
727209001327427585,  radicale_ignoto, 1, 0, 1, no
3023095461,  _Kynosarges, 1, 0, 1, no
49661882,  lucasaba, 1, 0, 1, no
998771113,  mauriziofortina, 1, 0, 1, no
461173908,  lanfranconp, 1, 0, 1, no
97448438,  sgu45, 1, 0, 1, no
764748993440182272,  Nino42225481, 1, 0, 1, no
2722229206,  expocasacaragl1, 2, 0, 2, no
799413733541998592,  SaverioZanella, 1, 0, 1, no
4041893956,  kocsa42, 1, 0, 1, no
743080755467849728,  alfber2, 3, 0, 3, no
160134796,  jerryMassloII, 1, 0, 1, no
1675944013,  s_signorello, 1, 0, 1, no
2171879132,  Ferroearte, 3, 0, 3, no
238909679,  F_DUva, 7, 0, 7, no
4490969968,  AssocasaNapoli, 1, 0, 1, no
727899457145212929,  alessiaferret, 1, 0, 1, no
403051679,  ChiaraColosimo, 1, 0, 1, no
1174818342,  FabioGarritano, 3, 0, 3, no
2498928031,  3397766924, 5, 2, 3, no
221424835,  priange, 4, 1, 3, no
804080566949859328,  fuocolyquido, 6, 1, 5, no
702508983240814593,  media_funding, 3, 1, 2, no
1104761490,  super_facile, 3, 1, 2, no
802408960414416896,  mabst85, 3, 1, 2, no
369725754,  Casaqaz, 3, 1, 2, no
1132416883,  alessandro7933, 3, 1, 2, no
2798224784,  SuperTWGattona, 3, 1, 2, no
3288265978,  paternogiorgio1, 3, 1, 2, no
564377347,  tierix_75, 3, 1, 2, no
198822370,  luigicontessa, 5, 2, 3, no
96366187,  monicafrassoni, 5, 2, 3, no
435663871,  AndreaBosco4, 12, 3, 9, no
4829216056,  Antonio24574556, 4, 1, 3, no
403366682,  Trico_ria, 3, 1, 2, no
161212876,  serendipity_87, 12, 1, 11, no
855232669,  whiteflour00, 3, 1, 2, no
1162603992,  remartino64, 1, 0, 1, no
2290092179,  nomecognome911, 1, 0, 1, no
3300691827,  NoixMilano, 1, 0, 1, no
1155060330,  paronchi, 1, 0, 1, no
469127838,  claudiettatata, 3, 0, 3, no
1381868022,  gibinter, 1, 0, 1, no
123408064,  avbayon, 1, 0, 1, no
2563847123,  1893_fs, 1, 0, 1, no
4180556788,  isabcor, 1, 0, 1, no
88630804,  giorgioventre, 2, 0, 2, no
357063589,  massimosideri, 1, 0, 1, no
209923,  marcocc, 1, 0, 1, no
34569603,  enriconardelli, 4, 0, 4, no
1152234782,  IleanaMoriconi, 4, 0, 4, no
16592657,  nico_stac, 2, 0, 2, no
614771274,  francy_0207, 5, 0, 5, no
574732560,  RobertoVjlla, 1, 0, 1, no
20790972,  ppiac, 3, 0, 3, no
252045618,  FraC14, 1, 0, 1, no
14637273,  edocolombo, 1, 0, 1, no
17873238,  cfabry, 9, 0, 9, no
637327428,  antonioturi4, 6, 0, 6, no
3289808236,  CuoreDigitale, 1, 0, 1, no
1554152342,  postoccupato, 1, 0, 1, no
193672948,  mcaressa, 1, 0, 1, no
103908511,  biagiosimonetta, 1, 0, 1, no
217709750,  vololontano, 1, 0, 1, no
96028504,  andreacaccia, 1, 0, 1, no
14409745,  maponi, 3, 1, 2, no
120620483,  maxvurro, 1, 0, 1, no
772703285681745920,  pdamore74, 3, 0, 3, no
100264171,  LeonardoBertini, 1, 0, 1, no
494915050,  massimoemme, 1, 0, 1, no
4340457033,  prodigeoIL, 2, 0, 2, no
1011181519,  GRicci1978, 1, 0, 1, no
38135277,  mcanducci, 2, 0, 2, no
14335321,  rscano, 7, 0, 7, no
149077120,  AlessandroZonin, 1, 0, 1, no
11791472,  eugenio_cau, 1, 0, 1, no
26499377,  gioiozzia, 3, 0, 3, no
2596196060,  ComSociale, 1, 0, 1, no
702091089914830848,  LangellaBarbara, 1, 0, 1, no
1359704244,  Daniela27D, 2, 0, 2, no
475516139,  kirsypu, 1, 0, 1, no
178757667,  millozzi, 2, 0, 2, no
1259767670,  FondazioneIBM, 3, 0, 3, no
1568063760,  EPietrafesa, 2, 0, 2, no
617037479,  RodriCip, 1, 0, 1, no
2151597338,  Lutechspa, 1, 0, 1, no
106769415,  AlessioMantegna, 2, 0, 2, no
528940975,  veasyt, 3, 0, 3, no
400607584,  Carlomochisis, 2, 0, 2, no
551653007,  il_leopardi, 1, 0, 1, no
558859189,  DaniDGia, 2, 0, 2, no
2354476783,  asutecoppe, 1, 0, 1, no
428627361,  loregasperini, 2, 0, 2, no
471825793,  astroiogyasf, 1, 0, 1, no
433751931,  CherylCllma, 1, 0, 1, no
412310752,  cigark7, 1, 0, 1, no
494400208,  antonellor68, 3, 0, 3, no
283467587,  Melissa__Peraza, 1, 0, 1, no
1924562743,  maurizio191060, 7, 3, 4, no
201786249,  VincenzoArena, 2, 0, 2, no
368647460,  Paolo_Broglio, 1, 0, 1, no
247714397,  VincenzoBerardi, 2, 0, 2, no
798952638545088512,  morellogianfr, 2, 0, 2, no
465661057,  FabFornaciari, 1, 0, 1, no
3244803611,  FiorellaScarpo1, 1, 0, 1, no
546202998,  goffredov, 3, 1, 2, no
1861590582,  Acerob71, 1, 0, 1, no
418744756,  GiuliaMatteucc1, 1, 0, 1, no
518612766,  DanieleToto1, 1, 0, 1, no
489386062,  marcogrimaldi0, 1, 0, 1, no
755165842862637056,  AttiVistiFoggia, 1, 0, 1, no
1016215621,  MSantoiemma, 33, 0, 33, no
292204573,  mirkomasotti, 1, 0, 1, no
2360515482,  Antonio79B, 1, 0, 1, no
589291887,  paola555999, 3, 0, 3, no
1063230986,  DanielaBeatrici, 2, 0, 2, no
2420044737,  GrazTo, 4, 0, 4, no
455181360,  Valtermiki, 2, 0, 2, no
1034862121,  cosimomanni, 15, 2, 13, no
31882493,  annalolanardi, 1, 0, 1, no
469894513,  giorgiogiomo, 1, 0, 1, no
147889932,  antoniosgobba, 1, 0, 1, no
475952330,  federcomazta, 2, 0, 2, no
720852852,  roccolisi1961, 2, 0, 2, no
863791340,  PaolaAguggia, 2, 0, 2, no
3020356043,  nannoni_daniele, 1, 0, 1, no
1171488392,  Zico21Gylmar, 71, 4, 67, no
2486333230,  claudia061167, 1, 0, 1, no
450950333,  gnammm, 1, 0, 1, no
856244276,  vanni_md, 2, 0, 2, no
1475697865,  filbier, 2, 0, 2, no
1103152945,  TarabellAlberto, 1, 0, 1, no
3000382647,  pastorecarmela1, 2, 0, 2, no
536718541,  mimmodistante, 1, 0, 1, no
797418784848019456,  gcmpucci, 2, 0, 2, no
374314630,  maratreiu, 6, 0, 6, no
246966243,  CalamityVa, 1, 0, 1, no
94656850,  nalial, 1, 0, 1, no
2973738196,  GiovBorz, 3, 1, 2, no
581561624,  FPanico1980, 1, 0, 1, no
83819316,  VideoNewsTV, 3, 0, 3, no
2808761,  okkio, 1, 0, 1, no
3036266535,  Nardoit, 1, 0, 1, no
1231844054,  colellalbina, 2, 0, 2, no
1061399634,  mariodelprete3, 2, 0, 2, no
2718141621,  zenovinci, 2, 0, 2, no
786920361858326528,  sergioCurcio3, 2, 0, 2, no
441730292,  AndreaGreco78, 1, 0, 1, no
306925405,  GiuseppeBuzzanc, 6, 2, 4, no
129265964,  DavidePozzi, 1, 0, 1, no
3044526632,  bumbumblakie1, 2, 0, 2, no
397474839,  LeoPiglionica, 8, 0, 8, no
422857222,  PBicchielli, 1, 0, 1, no
3056392801,  angelico_lilly, 3, 0, 3, no
3205922975,  cataniaFranc, 1, 0, 1, no
203831509,  CiaoNe100, 7, 2, 5, no
408766834,  AlexKannavale, 3, 0, 3, no
3518198235,  CesareVernaleo1, 1, 0, 1, no
782335052084633600,  Cinzia614770521, 1, 0, 1, no
484647669,  filippoimpiccia, 4, 0, 4, no
451090526,  MaridaLomPijola, 1, 0, 1, no
732278814093529088,  aurorarusso74, 1, 0, 1, no
470906034,  MVisceglia, 3, 1, 2, no
303961621,  ParenteSandra, 1, 0, 1, no
309141945,  stino87, 2, 0, 2, no
554993833,  TaleGigi, 1, 0, 1, no
482403856,  mikrobo1, 6, 0, 6, no
902101675,  Anunakyi, 3, 0, 3, no
2805383652,  riccardocallea, 2, 0, 2, no
224594895,  panunziomichele, 20, 0, 20, no
425360766,  TittyRisorseuma, 1, 0, 1, no
1306849784,  RaffaeleTour, 2, 0, 2, no
539341789,  LuiginaSi, 1, 0, 1, no
780004838604173312,  filogaeta, 1, 0, 1, no
1366650288,  restoalsud, 2, 0, 2, no
399337159,  fedegiancane, 1, 0, 1, no
551122649,  CISLFoggia, 2, 0, 2, no
2360365059,  v3rd3acqua, 7, 0, 7, no
3394106926,  OscarOscarnati, 2, 0, 2, no
96562150,  GiuseppeRinaldi, 1, 0, 1, no
391398732,  rafpiemontese, 2, 0, 2, no
746452118651961344,  LAltraala, 1, 0, 1, no
976995883,  TPeppino, 5, 0, 5, no
805900851235713024,  LeMattarellate, 1, 0, 1, no
700692490,  CDipietrangelo, 5, 0, 5, no
513080000,  Angelo_Rossano, 4, 0, 4, no
414253688,  Vito_Mitrotti, 1, 0, 1, no
2936766136,  DiDimiero, 5, 0, 5, no
483910971,  VincenzoRenna3, 2, 0, 2, no
3228896301,  saverioroc, 1, 0, 1, no
312666968,  Jo_Fuck, 3, 0, 3, no
1657542980,  GiosuRosa, 1, 0, 1, no
1086264085,  clara_muollo, 1, 0, 1, no
76634165,  Shivahma, 5, 1, 4, no
951365918,  Telebari, 7, 1, 6, no
426038482,  GMANDOLFO, 1, 0, 1, no
393550671,  blutarsky77, 2, 0, 2, no
1328616810,  WrachienDe, 4, 0, 4, no
528475682,  AntonioLoRe69, 3, 1, 2, no
3749352077,  MirellaMusci, 6, 0, 6, no
4845878153,  allerubino1, 1, 0, 1, no
471401393,  alex_arrighi, 4, 1, 3, no
708801020,  MarchionnaVania, 1, 0, 1, no
4265388017,  ByTheMelodySide, 1, 0, 1, no
227371681,  cronacheorg, 2, 0, 2, no
364331185,  spetrarolo, 1, 0, 1, no
101000387,  yourcenar09, 3, 0, 3, no
2168544166,  angscal77, 1, 0, 1, no
949722102,  beatriceale65, 1, 0, 1, no
2155539577,  dodoclock, 1, 0, 1, no
160949747,  BluGemma, 1, 0, 1, no
798072438445772801,  JpastorePastore, 1, 0, 1, no
834021516,  angcent, 2, 0, 2, no
2942180603,  2epicfail, 1, 0, 1, no
415618260,  peppemanzo, 3, 0, 3, no
757702137451274240,  ValVibrataNO, 1, 0, 1, no
545448505,  A_LisaCorrado, 67, 0, 67, no
4074057137,  ernstred, 5, 1, 4, no
239779690,  Baruch977, 10, 0, 10, no
1277454559,  fr_mont, 1, 0, 1, no
80836295,  stavrinouX, 2, 0, 2, no
386800314,  MarcoFattorini, 1, 0, 1, no
140872133,  michelelomonaco, 1, 0, 1, no
227454770,  ayxel2, 1, 0, 1, no
2499834158,  daniel_dd89, 1, 0, 1, no
2719001525,  AnnaCorsianna, 4, 0, 4, no
1461815022,  Ilikepuglia, 13, 0, 13, no
781973582,  59Gian, 1, 0, 1, no
253664818,  Vito__68, 1, 0, 1, no
3295662571,  m_saccomanni, 1, 0, 1, no
2417446748,  mmontanaro69, 1, 0, 1, no
4864281946,  MaxMarzulli, 2, 0, 2, no
132965464,  lospaziodimauri, 3, 0, 3, no
2601921913,  Zullo_Ignazio, 1, 0, 1, no
2365210698,  venerina57, 3, 0, 3, no
30949900,  andreafattizzo, 1, 0, 1, no
325152794,  LAccogli, 7, 2, 5, no
151200799,  Avv_AleLeo, 1, 0, 1, no
2184159493,  03_manila, 3, 0, 3, no
588553042,  CadauThorelara, 5, 1, 4, no
791363997505359872,  Frances35754479, 1, 0, 1, no
411574224,  MarcoSolci, 9, 0, 9, no
1601362758,  _sorrentino21, 3, 0, 3, no
2798466252,  giumarchitelli, 2, 0, 2, no
733371908750708737,  Ant5410, 3, 0, 3, no
462372902,  DomMarPet, 1, 0, 1, no
238068247,  olgadiasparro72, 1, 0, 1, no
561493985,  ilariabonaccors, 1, 0, 1, no
787376854458109957,  lenovopieroit_c, 7, 0, 7, no
356031456,  lunaendor, 1, 0, 1, no
262133589,  robertomele, 1, 0, 1, no
751351053791158272,  angelo_perrone1, 1, 0, 1, no
124426856,  sologian, 6, 2, 4, no
212669183,  passionerossobl, 1, 0, 1, no
897446522,  LorLegrottaglie, 6, 1, 5, no
469667518,  Falcopellegrin1, 1, 0, 1, no
2155309777,  Conosciilsud, 2, 0, 2, no
1278327180,  ademaradei, 1, 0, 1, no
2584065829,  annalisalatarta, 1, 0, 1, no
503387161,  paolavallati1, 1, 0, 1, no
48272554,  leonardo4it, 4, 0, 4, no
234085296,  djlucio83, 2, 0, 2, no
785128857070428160,  LiberaMarghera, 1, 0, 1, no
455151962,  antonio_scogna, 1, 0, 1, no
32130104,  Al_Brambilla, 3, 1, 2, no
408076062,  erostiaco, 1, 0, 1, no
2483189321,  IdaFava, 1, 0, 1, no
3340132480,  barneypan, 3, 0, 3, no
546275216,  MauroMast, 5, 1, 4, no
427237029,  simmairo, 1, 0, 1, no
2800284308,  IngQuarta, 1, 0, 1, no
919355984,  giovanninistic, 2, 0, 2, no
738613686596554752,  a_manuelli, 7, 0, 7, no
3148108978,  AngelaFrisenda, 4, 0, 4, no
739114742485241857,  giogenetics, 1, 0, 1, no
428393835,  RCalcatelli, 2, 0, 2, no
418116243,  Malam4rco, 1, 0, 1, no
1173116102,  FPugliaVE, 4, 0, 4, no
401634856,  serdefilippis, 41, 0, 41, no
714184584787845121,  la_colecchia, 2, 0, 2, no
2784187913,  DipietrangeloC, 2, 0, 2, no
407873578,  roce03, 1, 0, 1, no
133267422,  Mauro030, 1, 0, 1, no
565035726,  PaceTotopace, 1, 0, 1, no
2699999945,  ugl_uniba, 2, 0, 2, no
993838274,  Vazzano64, 1, 0, 1, no
3918456983,  Fyx3nty, 2, 0, 2, no
405196197,  lamoussina, 22, 0, 22, no
42689668,  anna_mazzone, 4, 0, 4, no
468689162,  jenomy, 1, 0, 1, no
426673401,  EgidioEgi, 1, 0, 1, no
2740676513,  CletoDepalo, 3, 0, 3, no
760091608247328768,  Rigna1Francesca, 1, 0, 1, no
2197493125,  ABosurgi, 5, 0, 5, no
417070549,  Cartvideo, 5, 0, 5, no
1857386930,  v_dalessandro, 1, 0, 1, no
388348486,  BCapula, 4, 0, 4, no
127627436,  grazianoschumy, 3, 0, 3, no
3823323202,  antmaggio, 4, 0, 4, no
1111665702,  marcovivianino, 5, 1, 4, no
2482513896,  Bisceglie24, 1, 0, 1, no
3074652513,  kosma1818, 3, 1, 2, no
1006133983,  MartinoCarriero, 2, 0, 2, no
717973505170608128,  luisella_albano, 3, 0, 3, no
52032507,  tuttodaniele, 2, 0, 2, no
868049126,  PdSudPuglia, 10, 0, 10, no
10329302,  vitodanese, 2, 0, 2, no
821310469,  Marevivo1, 1, 0, 1, no
478470423,  LUIGIZAGARIA1, 1, 0, 1, no
135125831,  Giuseppedibi, 1, 0, 1, no
3706658056,  FernandoANFCMA1, 3, 0, 3, no
723480201599045632,  myfeel67tina, 5, 0, 5, no
542498398,  andreacappozzo, 1, 0, 1, no
1166991482,  ALekVittozzi, 1, 0, 1, no
750786600213381122,  lacurvadigauss, 1, 0, 1, no
465557489,  CapognaDavide, 1, 0, 1, no
2635526840,  madia_satalino, 2, 0, 2, no
272171460,  OssRifiutiFCO, 1, 0, 1, no
991984152,  GianniStanzione, 3, 0, 3, no
3297443457,  superbrein, 1, 0, 1, no
63764089,  saltuccio, 1, 0, 1, no
512927236,  Scioppa75, 1, 0, 1, no
1603515306,  HermesHill, 2, 0, 2, no
577814489,  CiccioMontebell, 1, 0, 1, no
2572860751,  GiuseppeJango, 2, 0, 2, no
1227447218,  teddytep, 1, 0, 1, no
3130649488,  fpaolocampo, 1, 0, 1, no
1098725179,  IvanMorl, 1, 0, 1, no
471250754,  renzilara, 2, 0, 2, no
527379677,  followgiorgio, 1, 0, 1, no
282022150,  Fargo_84, 1, 0, 1, no
2725435126,  denik229, 13, 2, 11, no
2310173294,  ChiArroi, 1, 0, 1, no
150709009,  MORETTI3, 2, 0, 2, no
707879681845010432,  Sciu_Sciu_dolce, 1, 0, 1, no
776846953296588801,  maddalena0108, 4, 1, 3, no
911088012,  f_petrossi, 1, 0, 1, no
189874068,  emigrante81, 2, 0, 2, no
521501519,  NeroneMaurizio, 1, 0, 1, no
3238619722,  JacopoOrtizz, 11, 0, 11, no
456172613,  LancellottiFabi, 2, 0, 2, no
3350975284,  maxmarc69, 3, 1, 2, no
419907704,  giuliofc, 7, 0, 7, no
1413583716,  apeluso76, 1, 0, 1, no
303708603,  DiGioiaLeonardo, 1, 0, 1, no
721432185790705664,  PScianatico, 3, 1, 2, no
487765597,  fabribiondi, 5, 1, 4, no
154808415,  rogendanisalcon, 2, 0, 2, no
2657353205,  colagiorgio51, 1, 0, 1, no
200680504,  gl_wonder, 1, 0, 1, no
964956758,  nascapatata, 2, 0, 2, no
478485142,  martaciccarese, 1, 0, 1, no
1168562678,  Fa_Patti, 1, 0, 1, no
910250568,  thejankus, 1, 0, 1, no
2357226215,  Danielatamillib, 3, 0, 3, no
367194372,  giacomomedugno, 4, 0, 4, no
412894524,  silviarussofrat, 6, 0, 6, no
473984977,  sofiabarbina, 1, 0, 1, no
39464907,  Renato75, 1, 0, 1, no
394903214,  pep_89, 1, 0, 1, no
3159544901,  AnconaKame, 1, 0, 1, no
551331260,  gagino_cri, 40, 1, 39, no
2546075732,  manuelbasso26, 1, 0, 1, no
3485055077,  esra_nasran, 1, 0, 1, no
463690982,  ScaleraPietro, 2, 0, 2, no
708077520999079941,  triaragorn, 2, 0, 2, no
2945995006,  39b93321412d454, 2, 0, 2, no
1857302460,  gmdenicolo, 1, 0, 1, no
413125855,  EnzoGiannico, 2, 0, 2, no
433446505,  DanieleJD78, 1, 0, 1, no
1469191586,  TELADOIOLANIUS, 1, 0, 1, no
63766605,  giuseppeflagex, 1, 0, 1, no
468197270,  mimmocasu, 2, 0, 2, no
97442729,  fabio_iaci, 2, 0, 2, no
147885727,  angrageo, 2, 0, 2, no
3350829082,  SimonLucaSpada, 4, 0, 4, no
2909963555,  KraussAli, 4, 1, 3, no
1150471465,  delucaornella, 1, 0, 1, no
2786004480,  carmenmarta6, 3, 0, 3, no
1551594259,  Nino_Paradiso, 1, 0, 1, no
57617942,  justinoueda, 1, 0, 1, no
825997561,  19BIK, 1, 0, 1, no
379091940,  anIulian, 1, 0, 1, no
353573393,  roccolamonarca, 1, 0, 1, no
426977136,  DewidAlberti, 1, 0, 1, no
3187182555,  angela_merico, 3, 0, 3, no
1278572593,  DonzellaGiusy, 1, 0, 1, no
303072125,  MosconeF, 1, 0, 1, no
2748191567,  AucielloMarisa, 2, 0, 2, no
2591269446,  TeresaD_Leone, 2, 0, 2, no
105462498,  milla1972, 1, 0, 1, no
473132045,  Stefanolopasso, 1, 0, 1, no
442735223,  valfurla, 1, 0, 1, no
2502868003,  piera1957, 2, 0, 2, no
24386364,  andreananni, 1, 0, 1, no
480640741,  AnnaBarison, 1, 0, 1, no
2358815361,  aldo_aloisi, 2, 0, 2, no
219709201,  jjoyx, 1, 0, 1, no
797524210453217281,  MariapiaLeggie, 3, 0, 3, no
96785186,  SandroAcito, 1, 0, 1, no
251141871,  Aryo_Stark, 2, 0, 2, no
991477326,  maisto_maisto, 1, 0, 1, no
146090099,  raffaelegiuoco, 1, 0, 1, no
2997431799,  giugiuli2015, 10, 0, 10, no
2883998483,  PascaliLuciana, 2, 0, 2, no
107025395,  karmaturo, 2, 0, 2, no
3304165457,  massipetrone75, 1, 0, 1, no
820315045,  LsjDeLuca, 1, 0, 1, no
898459140,  B77Mela, 3, 0, 3, no
2359343661,  fuffo, 1, 0, 1, no
253601881,  francescomater, 1, 0, 1, no
735454076847132673,  AndreaDd23, 1, 0, 1, no
4393347915,  LucaNicotra84, 2, 0, 2, no
3226161388,  vocealsalento, 1, 0, 1, no
54232520,  RAF2attac, 2, 0, 2, no
319061161,  RBarchetti, 1, 0, 1, no
2765885890,  Ariele_1234, 1, 0, 1, no
396819051,  rosagravina1, 3, 0, 3, no
749499688546603008,  lavoratoricdr, 1, 0, 1, no
778961456746430464,  AntonioIovino16, 1, 0, 1, no
258460263,  cinziac12, 1, 0, 1, no
1382210870,  RobertoMelis7, 1, 0, 1, no
2477124216,  strangisn, 3, 0, 3, no
2376293973,  AbbinanteV, 1, 0, 1, no
2413811529,  19Francesco75, 1, 0, 1, no
793392004159987712,  Carpino56, 2, 0, 2, no
366149314,  PietroPatti, 1, 0, 1, no
2778219279,  emmeffeti, 1, 0, 1, no
51905142,  adigiorgio, 2, 0, 2, no
517823398,  NicolaRonic, 3, 0, 3, no
1244210036,  AnnaMariaDeFalc, 2, 0, 2, no
415824457,  BaronePietro, 1, 0, 1, no
120574321,  Combass, 1, 0, 1, no
2478535980,  Carladaddetta, 2, 0, 2, no
284654598,  papela17, 1, 0, 1, no
826724414,  Victor77Te, 1, 0, 1, no
342008649,  Marco_Furina, 1, 0, 1, no
442324308,  valeria_tweet, 2, 0, 2, no
454052321,  GiampaoloFagot1, 1, 0, 1, no
576139081,  ILazzaro, 2, 0, 2, no
419513827,  CappeIIaioMatto, 1, 0, 1, no
962736661,  maxiannic, 1, 0, 1, no
2718765850,  gigipezzu, 1, 0, 1, no
3345584741,  taysrecords13, 2, 0, 2, no
1367362759,  AlessPutzolu, 1, 0, 1, no
700117048,  patgio67, 1, 0, 1, no
480216833,  FilippoElba, 1, 0, 1, no
1153892731,  pinoalbero, 1, 0, 1, no
56061798,  USadopted, 2, 0, 2, no
82949077,  alfonso_errico, 1, 0, 1, no
738993503666118656,  TuxMaui, 1, 0, 1, no
3224935295,  Virtus_Leo, 1, 0, 1, no
3242236869,  enricocampo84, 15, 0, 15, no
2208150118,  GiuseppeRuiuAgr, 1, 0, 1, no
138008505,  mookiewi, 2, 0, 2, no
333644386,  FerraTrader, 4, 0, 4, no
481375605,  Tradecon1, 1, 0, 1, no
1063367166,  claudiobelvisi1, 1, 0, 1, no
459460560,  FederossiRossi, 2, 0, 2, no
452828571,  ITALIANBOTTLING, 2, 0, 2, no
67691388,  Marida2, 1, 0, 1, no
2404859790,  emmelle72, 2, 0, 2, no
937257948,  ScorcaMichele, 1, 0, 1, no
3827262383,  01Alegallotta, 1, 0, 1, no
418022254,  andreacarducci1, 1, 0, 1, no
334811128,  STEFANIADIFELIC, 1, 0, 1, no
563047128,  morena_ferrari, 1, 0, 1, no
746826726538383360,  aKos_76, 3, 0, 3, no
251826152,  piratataragna, 1, 0, 1, no
794774793648218112,  silvio041050211, 1, 0, 1, no
421905654,  michelapatruno, 1, 0, 1, no
1015814694,  brunopistolese, 8, 1, 7, no
258787593,  davide_vecchi, 6, 2, 4, no
415135980,  laurafasolino78, 3, 1, 2, no
66363389,  antoniocantoro, 3, 0, 3, no
793769938569822208,  Buon_Pomeriggio, 1, 0, 1, no
891456458,  nickprock, 4, 0, 4, no
2335615140,  IlPerdu, 3, 0, 3, no
3069421049,  marinuzzafra, 1, 0, 1, no
1049521440,  Gigisemart, 1, 0, 1, no
379615563,  ferdiocello, 2, 0, 2, no
58328967,  konan1234, 1, 0, 1, no
47313959,  ale_bau, 1, 0, 1, no
2427052056,  quipugliaonline, 2, 0, 2, no
252308694,  stefanoval1, 1, 0, 1, no
2358287784,  gavefa, 2, 0, 2, no
3233660728,  Gianni76373672, 3, 1, 2, no
2974296478,  Hermesh24Jr, 1, 0, 1, no
2721619085,  vincenzosando, 1, 0, 1, no
382148214,  LoreVegLombardi, 1, 0, 1, no
2321072358,  ProAdelio, 5, 0, 5, no
604023898,  Tunell0, 2, 0, 2, no
417800630,  basaxo, 3, 0, 3, no
425780142,  gianpiero32, 5, 1, 4, no
45120421,  robeffo, 1, 0, 1, no
541704097,  VeronaPossibile, 14, 0, 14, no
428169348,  Sasylongo, 2, 0, 2, no
2366138431,  saviina78, 1, 0, 1, no
795896647,  salvatoregold, 1, 0, 1, no
332222423,  Piero_Farenti, 2, 0, 2, no
1266500113,  lulucammini, 35, 2, 33, no
523306939,  ALESSANDROSPOR1, 2, 0, 2, no
583941667,  elenafrance0, 1, 0, 1, no
748156955974311936,  duedubbi, 3, 0, 3, no
2523972016,  gcfrancavilla, 1, 0, 1, no
763979325888536577,  Mastronardo2016, 1, 0, 1, no
3105346516,  ROMPI1964, 1, 0, 1, no
323769270,  Giurnal, 1, 0, 1, no
454048091,  simpaol, 1, 0, 1, no
420146229,  apeironpaola, 7, 1, 6, no
2359450492,  MicheleVesch, 2, 0, 2, no
461229005,  F_Boccia, 5, 2, 3, no
334321591,  N_DeGirolamo, 9, 1, 8, no
602824919,  sergiopaganotto, 1, 0, 1, no
3417586493,  Db34Daniela, 1, 0, 1, no
507697095,  1952maggio, 7, 3, 4, no
708432352,  morettiroberto3, 4, 1, 3, no
4114189888,  nicomalfer, 3, 0, 3, no
1283915827,  irisdg81, 1, 0, 1, no
299897209,  NicolaVendramin, 1, 0, 1, no
485485288,  enribea62, 1, 0, 1, no
1081297633,  los_diau, 2, 0, 2, no
1213113511,  dreaming05, 1, 0, 1, no
2166800480,  NoSlotOrg, 1, 0, 1, no
556966919,  lucacalia, 1, 0, 1, no
846987439,  zanon_alessio, 13, 0, 13, no
2400072632,  MiCamilleri, 1, 0, 1, no
2909939349,  diegosardellit1, 4, 0, 4, no
264941030,  vitre09, 1, 0, 1, no
128799214,  ilemaggio, 1, 0, 1, no
3030182237,  paradiso_elisa, 1, 0, 1, no
124778919,  VicusMartis, 2, 0, 2, no
31752746,  martamburini, 2, 0, 2, no
831788292,  enzotoia, 1, 0, 1, no
4777584309,  ambroxvez, 1, 0, 1, no
2421124847,  dxmariella, 2, 0, 2, no
460330693,  UnoFRAtanti, 1, 0, 1, no
539009133,  Grufius, 3, 0, 3, no
715668574292074496,  marinomicheleca, 9, 3, 6, no
1048968648,  massimofusini1, 3, 1, 2, no
615945406,  albertotrivelli, 2, 0, 2, no
465408460,  13dontbreak, 1, 0, 1, no
1536486193,  MartinaMusetti1, 2, 0, 2, no
474074110,  mammuthgiallo, 2, 0, 2, no
310925040,  PolGalbusetti, 1, 0, 1, no
67002064,  castagnett, 1, 0, 1, no
977706000,  ricky_pru, 1, 0, 1, no
764080205656981504,  gamberoblu, 1, 0, 1, no
3233551233,  lorenzobellini9, 3, 1, 2, no
253037330,  nembokidy1, 1, 0, 1, no
1565314302,  GiovanniSalvin2, 1, 0, 1, no
487816917,  bl771, 2, 0, 2, no
1565359196,  SimoneAngelanto, 1, 0, 1, no
3221546987,  AnnaRossani, 1, 0, 1, no
1536275011,  MichelaCarli3, 1, 0, 1, no
3298086872,  89Lidiamartini, 1, 0, 1, no
1534824038,  GiovanniBerti4, 2, 0, 2, no
66742297,  locchif, 1, 0, 1, no
4415101463,  sobieski_iii, 1, 0, 1, no
201750208,  3mendie20, 1, 0, 1, no
2252314592,  valtomm, 1, 0, 1, no
2746719371,  vpiazza50, 1, 0, 1, no
1923459475,  LKcultura, 1, 0, 1, no
709078210068217856,  annasag10, 2, 0, 2, no
249751492,  giuseppedgr, 3, 1, 2, no
1897601790,  chiararubin75, 3, 1, 2, no
2196005464,  adrianocappe, 7, 1, 6, no
4172212191,  Ettorelmt, 5, 2, 3, no
2874842817,  stefanolai56_sl, 3, 1, 2, no
68943414,  ErPucce, 4, 1, 3, no
398180854,  PPacioni, 3, 1, 2, no
164608349,  ezia77, 8, 2, 6, no
106473438,  jhonmiglia, 3, 1, 2, no
426842172,  stedipi, 3, 1, 2, no
36392373,  giuseppebarila, 4, 1, 3, no
2909313208,  AndrewCvz, 3, 1, 2, no
89271619,  adrianoschi, 14, 2, 12, no
292924733,  GiacomoGiura, 4, 1, 3, no
1372078580,  lastolfino, 6, 2, 4, no
781578050865627137,  Joseph_Karplus, 7, 1, 6, no
377318801,  st_2351, 9, 2, 7, no
1588323260,  isiberiani, 59, 1, 58, no
1056404035,  Annamaria2058, 3, 1, 2, no
2339402154,  Claudio_Romano_, 8, 1, 7, no
479029869,  Nede46, 3, 1, 2, no
296215921,  Ivan_Pigino, 4, 1, 3, no
331684462,  gilmox0512, 3, 1, 2, no
774267120268050432,  scoRAGGIati1, 20, 1, 19, no
2881464153,  moscatelli69, 5, 2, 3, no
149519170,  angelozanzotter, 5, 2, 3, no
789916703815823360,  piumoncino, 5, 1, 4, no
4927335563,  renatocesare51, 6, 2, 4, no
226641470,  alinidax, 3, 1, 2, no
1651383518,  CeSantoro, 8, 2, 6, no
696738123838070784,  S_H_U_R_E_N, 3, 1, 2, no
1667805188,  Lanadiluna, 3, 1, 2, no
222460953,  angelo_menel, 5, 2, 3, no
2221643012,  annamariaandalo, 9, 2, 7, no
2231585551,  HausderWunder, 5, 1, 4, no
3139667865,  mimmogammella2, 12, 3, 9, no
798087152806543362,  marcobank_sy, 4, 1, 3, no
724068270,  fisioteo, 9, 1, 8, no
603170028,  Manuel19961996, 3, 1, 2, no
424936746,  filoXXL, 5, 2, 3, no
386684448,  cirrid, 3, 1, 2, no
1239689270,  kim_capo, 5, 1, 4, no
3939301649,  Ginko_21, 4, 1, 3, no
231198437,  sadefenza, 5, 2, 3, no
3408525531,  Vendrick7, 5, 1, 4, no
460533065,  pierolacorazza, 6, 1, 5, no
1101021343,  annamariasummon, 7, 1, 6, no
3367479099,  ketty2ts360, 12, 1, 11, no
1295567060,  mbecchi1, 3, 1, 2, no
3975122236,  iamandreaalbano, 6, 1, 5, no
3747207076,  piersicil, 3, 1, 2, no
63705563,  CALentola, 35, 1, 34, no
312846503,  ManzoPower, 3, 1, 2, no
18800996,  Corniciaro, 3, 1, 2, no
561417419,  GianniSozzi, 3, 1, 2, no
2529236481,  annellapasta, 3, 1, 2, no
382052171,  marburdrava, 3, 1, 2, no
146366004,  _intersect, 4, 1, 3, no
507353180,  Daniele_Cardone, 3, 1, 2, no
4568818943,  francy2368, 5, 1, 4, no
305673340,  Bunnister, 3, 1, 2, no
951133896,  AngelaZanello, 3, 1, 2, no
14094007,  poni, 3, 1, 2, no
769427987754254336,  Mr_Gredy, 3, 1, 2, no
715134939155578880,  fr_maione, 17, 2, 15, no
948561824,  Toma1961, 3, 1, 2, no
788422453349519364,  MicheleAlbert59, 1, 0, 1, no
739042129230614528,  diegopornaro, 3, 0, 3, no
731863278062829569,  Groucho979, 1, 0, 1, no
1729830307,  Consuelo_Paola, 2, 0, 2, no
39594048,  DomCiarelli, 1, 0, 1, no
332934650,  ChiaraSe3, 1, 0, 1, no
456786635,  SoccorsaChiara, 1, 0, 1, no
594940967,  SantiGuerrieri, 2, 0, 2, no
419313596,  chiaragian, 4, 0, 4, no
408059944,  CannaCarmela, 2, 0, 2, no
4379409015,  ob_mauro, 5, 0, 5, no
454618588,  CIDRegard, 1, 0, 1, no
711654055924387840,  cristinamenecat, 1, 0, 1, no
501518665,  PezzellaMassimo, 4, 0, 4, no
794263031450632192,  marcell58711337, 4, 0, 4, no
4288578639,  LosaErnesto, 1, 0, 1, no
1166887711,  di_adl, 1, 0, 1, no
241703665,  Violare, 4, 0, 4, no
802393932894273536,  berdekatse1976, 1, 0, 1, no
4079805563,  monymurgia6, 2, 0, 2, no
777940009932484608,  vincenz39105214, 1, 0, 1, no
839372598,  paololuzi3, 1, 0, 1, no
336723287,  StregaBettina, 1, 0, 1, no
1244749964,  emmaesamuele, 4, 1, 3, no
2200777745,  romaba72, 1, 0, 1, no
402132308,  MarelloAndrea, 1, 0, 1, no
4532828368,  Seawolf_IT, 4, 0, 4, no
305561820,  BrianWagner_, 2, 0, 2, no
441714798,  matteotarta7, 1, 0, 1, no
4882556081,  FLughezzani, 1, 0, 1, no
2848098653,  MassimoCaliari, 1, 0, 1, no
17010300,  fedro1016, 1, 0, 1, no
92521732,  claudiangrisani, 1, 0, 1, no
790351717,  NonSonoChiPensi, 1, 0, 1, no
557901492,  MagdaAbbadessa, 3, 0, 3, no
3245894853,  DelpecchiaKiara, 1, 0, 1, no
583617026,  annacecconi, 3, 0, 3, no
457313238,  CriEight, 1, 0, 1, no
710151580406976513,  Melonisindaco, 1, 0, 1, no
14575613,  ardigiorgio, 4, 0, 4, no
2230137172,  malivksun, 1, 0, 1, no
96733636,  GaetanoScavuzzo, 1, 0, 1, no
738937244,  SimoneCuberti, 1, 0, 1, no
3007709236,  M86UK, 1, 0, 1, no
790302002463043584,  samumessina25, 1, 0, 1, no
534208609,  marinaeangelo, 1, 0, 1, no
765908415600361472,  TommasoLamannis, 2, 0, 2, no
2700296955,  LeederRomeo, 1, 0, 1, no
83684008,  kazamagio, 1, 0, 1, no
201200020,  MiSonrisaEsLali, 1, 0, 1, no
1410148940,  Laliesmioxigeno, 1, 0, 1, no
171513237,  Francescofrency, 1, 0, 1, no
2344654174,  guido_dameri, 1, 0, 1, no
410298671,  AlessandroLott1, 1, 0, 1, no
452087285,  SimoneDonati76, 1, 0, 1, no
493487401,  mulazzaniantoni, 1, 0, 1, no
729613256793444352,  SalvatoreSarna6, 12, 0, 12, no
509298472,  cozza_franco, 1, 0, 1, no
142017053,  fabifonfa, 1, 0, 1, no
2977102384,  salastefano71, 4, 0, 4, no
427694799,  susanna769, 1, 0, 1, no
81085097,  faberbros, 2, 0, 2, no
1676481360,  EmileeWaren, 1, 0, 1, no
1898454446,  niccocoppa, 2, 0, 2, no
355734935,  GianfrancoPelus, 1, 0, 1, no
340296465,  DanielaxMarinox, 1, 0, 1, no
4285506867,  garbomichele, 1, 0, 1, no
415686111,  manupivato, 2, 0, 2, no
453384866,  giovannivalen10, 1, 0, 1, no
358162325,  matciamb, 1, 0, 1, no
435575179,  FI_BELGIO, 5, 1, 4, no
589053637,  PaolaSpandrio, 1, 0, 1, no
1120448588,  FrancRosso, 1, 0, 1, no
1121935590,  delucamassimote, 1, 0, 1, no
1123490155,  ReAscione, 1, 0, 1, no
1063565083,  GaiettaLuca, 4, 0, 4, no
401335686,  gufo871, 1, 0, 1, no
247841802,  NellyDogali, 1, 0, 1, no
905462725,  peppe_carbone, 2, 0, 2, no
2560759612,  florianogabrie1, 1, 0, 1, no
319718473,  ErikaRubio50, 11, 0, 11, no
772938597137801216,  flaviotiravento, 1, 0, 1, no
1015689343,  KabirYus, 1, 0, 1, no
542526244,  LucianoOdorisio, 1, 0, 1, no
190957756,  visintinimanlio, 1, 0, 1, no
1068808687,  quibolgare, 1, 0, 1, no
1244285522,  SuperFede93, 1, 0, 1, no
231954707,  leottaantonio, 1, 0, 1, no
2284316591,  antoniominchel2, 1, 0, 1, no
2568933625,  MauroMorandi3, 1, 0, 1, no
4893082468,  gheorghect, 1, 0, 1, no
790218643619602436,  Forza_Italia_PN, 7, 0, 7, no
3602290937,  gius_menna, 2, 0, 2, no
3300222131,  paolovarsi1, 1, 0, 1, no
832111555,  tznab, 2, 0, 2, no
1873095224,  salvogrizzanti, 1, 0, 1, no
2729939422,  peru71andrea, 1, 0, 1, no
1323345139,  bda66, 3, 0, 3, no
987455126,  unarosannina, 1, 0, 1, no
3305641006,  Cinu34H, 1, 0, 1, no
516396544,  GiulioMDiGiulio, 1, 0, 1, no
3101406220,  MatteoTafuri1, 1, 0, 1, no
2324434960,  mrighetti1967, 5, 0, 5, no
215073544,  Irenenenene, 1, 0, 1, no
27212050,  fsoltrash, 2, 0, 2, no
747104008268021760,  belfiore_mattia, 1, 0, 1, no
104850697,  lucadotto, 3, 0, 3, no
14153768,  giamp9000, 1, 0, 1, no
53210593,  DavideGanapini, 1, 0, 1, no
3545919143,  peppemanc2, 2, 0, 2, no
1705424929,  _augustocoletta, 1, 0, 1, no
61311913,  antoniodelfurbo, 1, 0, 1, no
785139179801939969,  CorradoOrfini, 1, 0, 1, no
797431310096723969,  AntonioLeRose93, 1, 0, 1, no
58076869,  paolobertazzoli, 1, 0, 1, no
1306532766,  michelamanfre, 1, 0, 1, no
837208824,  perrier_laura, 2, 0, 2, no
809076650,  SalvatoreAlbeli, 1, 0, 1, no
416277518,  AndreaBacchetti, 1, 0, 1, no
2887842544,  Naninani1960, 1, 0, 1, no
511676243,  paologabi, 2, 0, 2, no
527778059,  GabrieleCocco17, 2, 0, 2, no
73358888,  Biagio71, 1, 0, 1, no
512377659,  rosannadimarzio, 1, 0, 1, no
2282030010,  Thucydides_1973, 6, 0, 6, no
2475286346,  ilbuonfabio, 1, 0, 1, no
250056918,  micmalan76, 2, 0, 2, no
3321233530,  Roberto71362237, 2, 0, 2, no
576326378,  MatteoAndreoni, 2, 0, 2, no
245423060,  mauriziozucca, 1, 0, 1, no
376865529,  DiegoScotece, 2, 0, 2, no
88254217,  lucianabig, 1, 0, 1, no
1142469860,  KellerZoe, 2, 0, 2, no
1077215370,  AndreaGiombi, 1, 0, 1, no
76390097,  yurisantagostin, 2, 0, 2, no
4449540112,  Mant1397, 1, 0, 1, no
487006102,  ReneeRomanelli, 2, 0, 2, no
288329762,  MarcoLifeGuard, 2, 0, 2, no
2985519345,  gioppa1972, 1, 0, 1, no
277137414,  rossmiky, 1, 0, 1, no
737370217,  ArchGrassia, 1, 0, 1, no
2758967786,  robtoselli, 1, 0, 1, no
711956791513505792,  taglianigianni, 1, 0, 1, no
501916645,  enzonardini, 1, 0, 1, no
4819495307,  Riccard40639553, 1, 0, 1, no
2638747113,  kyntia1973, 2, 0, 2, no
713380260260220928,  GiuseppaSessa, 1, 0, 1, no
29205423,  alemaggiani, 2, 0, 2, no
74696107,  FeDe__1984, 1, 0, 1, no
390593484,  cruscapertutti, 2, 0, 2, no
2534395438,  000federico000, 1, 0, 1, no
1371701359,  VitashAv85, 1, 0, 1, no
510229268,  GiacomoFarano, 2, 0, 2, no
2433071495,  IlariaBattino, 1, 0, 1, no
2393374065,  paolo_tode, 4, 0, 4, no
1146000283,  CeccoCatta, 1, 0, 1, no
7697992,  emenietti, 2, 0, 2, no
702428174630649856,  Franzoh95, 1, 0, 1, no
572394119,  tonillo58, 1, 0, 1, no
2164906730,  antondmto, 1, 0, 1, no
156048806,  mariadigregorio, 2, 0, 2, no
4896386734,  Fabrebirth, 1, 0, 1, no
352210194,  Ale_Boriani, 1, 0, 1, no
488853186,  TeobaldelliA, 3, 0, 3, no
567688029,  LucClochard, 5, 1, 4, no
2411361259,  Krispistols, 2, 0, 2, no
4049220777,  eurofollia1, 3, 0, 3, no
2211874822,  flying_pizza8, 1, 0, 1, no
798883998458056704,  annibale711, 2, 0, 2, no
914964973,  EttoreBaita, 1, 0, 1, no
148343334,  fdiYou, 2, 0, 2, no
767811918258143233,  daviregg, 2, 0, 2, no
498835221,  DannyProl, 1, 0, 1, no
501086864,  mastrolucy, 3, 0, 3, no
794287293741858816,  b3al1v1, 1, 0, 1, no
3883143269,  AlessiaDavter, 1, 0, 1, no
389611271,  R_Panarese, 1, 0, 1, no
600524618,  Juventinodoc78, 10, 0, 10, no
2338359262,  michelinacaval2, 1, 0, 1, no
804707884500185088,  ChiaraMorellii, 4, 0, 4, no
2455785021,  xlanapepsi, 1, 0, 1, no
3305144668,  AlongiUmberto, 1, 0, 1, no
1105858195,  finngiaz, 1, 0, 1, no
253667606,  taloscreta1, 2, 0, 2, no
1009779474,  LarryLLoco, 2, 0, 2, no
379804891,  Danifencer, 1, 0, 1, no
1009672723,  manuseggiani, 3, 0, 3, no
402056906,  AndreaPiomboPBS, 3, 0, 3, no
4842635686,  _deactivator, 1, 0, 1, no
27007400,  marianski65, 1, 0, 1, no
3244937621,  stayforljlo, 1, 0, 1, no
2726079623,  rgaspo2005, 1, 0, 1, no
293430350,  _PFontana, 4, 0, 4, no
48398700,  TizianaFG, 1, 0, 1, no
339931105,  Paco_Lab, 1, 0, 1, no
2483411845,  TheStuz, 1, 0, 1, no
793137233586946050,  ClaireBrutionne, 2, 0, 2, no
4290644602,  Roberta30325939, 3, 0, 3, no
422052233,  ClaudioBianchi4, 1, 0, 1, no
1407690270,  ellieBlackSky, 1, 0, 1, no
457395109,  DanieleDandr, 1, 0, 1, no
269808396,  Priorefilippo, 1, 0, 1, no
3052713239,  sestolaplus1, 1, 0, 1, no
160498055,  shyranebruno, 2, 0, 2, no
120029441,  bliss367, 1, 0, 1, no
489878046,  a_dimaso, 6, 0, 6, no
2858495127,  SardixCattaneo, 1, 0, 1, no
301922459,  fabioconti85, 1, 0, 1, no
996192925,  gigliolavalenti, 2, 0, 2, no
804939395522555904,  batbara6, 3, 0, 3, no
229428941,  paolo_mancini, 1, 0, 1, no
3303617854,  istruzione_ap, 1, 0, 1, no
381174004,  lorenzodimari1, 1, 0, 1, no
4202197246,  FioriFranco1, 1, 0, 1, no
2280788664,  s_anb1, 1, 0, 1, no
137921550,  eletati91, 1, 0, 1, no
3437690487,  GiuseppinaMp15, 1, 0, 1, no
304940135,  CiccioPiazza, 1, 0, 1, no
775793042959785984,  CampardoAdriana, 1, 0, 1, no
778531519,  87_carmy, 1, 0, 1, no
2994294622,  gallura3, 1, 0, 1, no
616386306,  MaxMontagnini, 1, 0, 1, no
417138474,  RexTomida, 3, 1, 2, no
1268536039,  bibitibobitibu, 1, 0, 1, no
4928079646,  BluJeans12, 1, 0, 1, no
786170636527767552,  Fracifra90__, 2, 0, 2, no
75837606,  prinpeach, 1, 0, 1, no
24548101,  MrSpritz, 1, 0, 1, no
101718511,  guru63_ch, 1, 0, 1, no
96505348,  SBiral, 2, 0, 2, no
2832590483,  antoniomuzzi1, 2, 0, 2, no
369449071,  cyrusfiancee, 1, 0, 1, no
355049682,  AndreaCereda, 1, 0, 1, no
782177494417960960,  ettorebsndi, 1, 0, 1, no
770413707901956096,  mezzosangue2002, 1, 0, 1, no
267351876,  FRANKYEFFE, 1, 0, 1, no
15191375,  kiakim, 1, 0, 1, no
865106616,  eugeniob3, 1, 0, 1, no
825402350,  Achifelix, 1, 0, 1, no
70124737,  giormagno, 2, 0, 2, no
808552812,  styliny, 1, 0, 1, no
1242349958,  ciro_studio, 1, 0, 1, no
780085489953112064,  marge_tatcher, 2, 0, 2, no
318274569,  thunderbird1789, 1, 0, 1, no
531521560,  AntoniniClaude, 1, 0, 1, no
3004154591,  VixCorreddu, 2, 0, 2, no
71500951,  tetobucchi, 2, 0, 2, no
538566780,  mariannabrl, 2, 0, 2, no
462389431,  FrancescoDondi, 1, 0, 1, no
884435066,  FobioGalmeni, 1, 0, 1, no
424383813,  GiulioGandolfi, 2, 0, 2, no
396921584,  marco_lnz, 1, 0, 1, no
335536456,  giorgiogiangrec, 1, 0, 1, no
1696277574,  lorenzo5103, 3, 0, 3, no
15198449,  Ellyssima, 1, 0, 1, no
2380627679,  tedenzo, 1, 0, 1, no
23741148,  lighea85, 3, 0, 3, no
421976918,  MIorino, 1, 0, 1, no
25975653,  da_cake, 2, 0, 2, no
903557294,  stefanodragotta, 2, 0, 2, no
174290498,  aspy77, 1, 0, 1, no
430244580,  RossiLonghi, 1, 0, 1, no
4182841036,  kei_rocker94, 1, 0, 1, no
1011915158,  FmarcheFederico, 1, 0, 1, no
117738390,  Scubamanu, 1, 0, 1, no
507586722,  GregoryMarinucc, 1, 0, 1, no
1319962368,  PGandolaFi, 2, 0, 2, no
536419265,  NonnoCirillo, 1, 0, 1, no
1264916744,  a_bello23, 1, 0, 1, no
68927547,  Giulian1, 2, 0, 2, no
242667025,  alfadixit, 1, 0, 1, no
3147471767,  07_ssergio, 1, 0, 1, no
2436383674,  tonboffi, 1, 0, 1, no
429391019,  GeopoliticalCen, 1, 0, 1, no
761182919989878784,  frSchio, 1, 0, 1, no
154109023,  teregrimaldidm, 1, 0, 1, no
1086201870,  afranchi67, 1, 0, 1, no
763674351514316800,  Gioblog1970, 1, 0, 1, no
421245685,  silvanavignati, 1, 0, 1, no
751912807,  EsadMehmeti, 2, 0, 2, no
166526251,  giulio_convento, 1, 0, 1, no
381575136,  oiramdivito, 1, 0, 1, no
258760456,  iAmTrysme, 2, 0, 2, no
2264988588,  FurioBottarella, 1, 0, 1, no
3132681590,  laura_pittu, 1, 0, 1, no
1662478286,  il_fab, 1, 0, 1, no
1336992302,  Danys184, 1, 0, 1, no
1668502464,  caniovunque, 1, 0, 1, no
2955736762,  oh_darling22, 1, 0, 1, no
39724785,  CinziaPat, 1, 0, 1, no
488321355,  lorenzobenocci, 1, 0, 1, no
165467059,  elisa_p90, 1, 0, 1, no
584096772,  mingo748r, 1, 0, 1, no
58796712,  serena_marchini, 3, 0, 3, no
2928510341,  GiulianaGrigato, 1, 0, 1, no
1043102054,  Sox1978Sox, 1, 0, 1, no
736882892505251841,  altreamerjche, 1, 0, 1, no
2494397392,  pri_mario, 1, 0, 1, no
3236172064,  rtxall, 1, 0, 1, no
1161371108,  PaloNotsoAlto, 2, 0, 2, no
804758910397743105,  Dardinello, 2, 0, 2, no
68118653,  calabriaonline, 1, 0, 1, no
3242310892,  BorrelloRosario, 1, 0, 1, no
1035334644,  colombsa, 1, 0, 1, no
4186490207,  pausau88, 1, 0, 1, no
1042922816,  marcotarchiani2, 1, 0, 1, no
522438840,  AldoVerdigi, 2, 0, 2, no
45391358,  Consuelo3v, 1, 0, 1, no
130233164,  vinicolamente, 1, 0, 1, no
1430799698,  CellittiMartina, 1, 0, 1, no
38653592,  Lenoide, 1, 0, 1, no
468746327,  CQuagliani, 6, 0, 6, no
4186937854,  vandina1954, 1, 0, 1, no
709330749774757888,  soloperRt, 1, 0, 1, no
2468278049,  realpetuffo, 1, 0, 1, no
421997770,  Stellamatteo, 1, 0, 1, no
82179120,  Alessandra_ama_, 1, 0, 1, no
549050066,  FabioCANDITA, 1, 0, 1, no
3300479032,  giovannicipol11, 1, 0, 1, no
307904463,  5Giop, 3, 0, 3, no
977054768,  R4774ELE, 1, 0, 1, no
1360217082,  felixarpino, 1, 0, 1, no
410942770,  Fra_Rosy, 1, 0, 1, no
2918014485,  df150983, 1, 0, 1, no
3144040683,  lo_loryso1974, 1, 0, 1, no
1446220230,  MAURI59N, 1, 0, 1, no
1424957299,  PaoloGrazioso, 1, 0, 1, no
307362538,  matteomarenzi, 1, 0, 1, no
742644750029819905,  fcbiggie, 1, 0, 1, no
400801252,  MaurizioAlba, 1, 0, 1, no
484540133,  f_quitadamo, 1, 0, 1, no
327525703,  japologaia, 1, 0, 1, no
738839237919944704,  phlcgn, 1, 0, 1, no
96102352,  cipsamat, 1, 0, 1, no
813351918,  francimarras, 1, 0, 1, no
740925871427620867,  simodo13, 1, 0, 1, no
141576538,  Adelina728, 1, 0, 1, no
1257979753,  rosati_luigi, 1, 0, 1, no
2312082696,  thenetwatch, 1, 0, 1, no
1262417935,  aconfal, 1, 0, 1, no
995193895,  DomenicoDDonnie, 1, 0, 1, no
465526247,  scapo1910, 2, 0, 2, no
1398219385,  Cescanner, 2, 0, 2, no
518496696,  DSbrollini, 5, 0, 5, no
133241974,  ciba2000, 6, 0, 6, no
1114520922,  BizziStefania, 2, 0, 2, no
65865007,  Francescapisani, 1, 0, 1, no
584794689,  MarcocciaTony, 1, 0, 1, no
861252402,  effepy49, 6, 0, 6, no
4634526567,  ErikaNobile1, 2, 0, 2, no
261137184,  RicciSimone80, 2, 0, 2, no
573872432,  mbecerto1974, 5, 0, 5, no
522233292,  matteociminari, 1, 0, 1, no
1013833908,  spgiord, 1, 0, 1, no
562168466,  immi_ruah70, 2, 0, 2, no
3214345809,  Katia260787, 7, 0, 7, no
1423657310,  Isotta56, 1, 0, 1, no
3555027683,  eleljp26, 3, 0, 3, no
326368123,  davidepadova, 5, 0, 5, no
3617778570,  Angelo30563133, 2, 0, 2, no
1545899274,  Cogo77F, 6, 0, 6, no
1027369418,  PaolaaaSkin63, 2, 0, 2, no
3240072112,  MarcatoSereno, 2, 0, 2, no
2506050759,  FarroniMassimo, 3, 0, 3, no
1389518442,  SindVeda, 4, 0, 4, no
349775045,  ToscaCappellini, 1, 0, 1, no
730500778637594625,  Gordon_original, 4, 0, 4, no
2735285272,  assane_zudy, 1, 0, 1, no
2695570123,  carlo_sapia, 1, 0, 1, no
403577590,  sedazzari, 2, 0, 2, no
2396753396,  brigetjoan, 1, 0, 1, no
269364736,  wiThDiamONt, 1, 0, 1, no
2851171270,  colalann, 1, 0, 1, no
295064979,  jacop_etti, 2, 0, 2, no
465061130,  SofiaToffee, 1, 0, 1, no
3303214061,  chiaravve, 1, 0, 1, no
1198246940,  FGrosso808, 1, 0, 1, no
4892322659,  pallaicche, 2, 0, 2, no
54906735,  socorros_ad, 3, 0, 3, no
802863869936988160,  Guerrina5, 2, 0, 2, no
3384747941,  AriannaDudine, 1, 0, 1, no
321618982,  FighterOnMars, 2, 0, 2, no
523664680,  FabyScarangella, 1, 0, 1, no
721044827962523648,  AnnaRomaAR, 6, 0, 6, no
2723423525,  iu00088, 2, 0, 2, no
1042270699,  MagnaMagnaMagn, 1, 0, 1, no
2265398249,  iretap, 9, 0, 9, no
562846287,  elenacapodacqua, 9, 0, 9, no
1613023184,  FrancescoDL80, 6, 0, 6, no
2928097725,  erricobis, 1, 0, 1, no
1160659398,  LiberatiCarla, 5, 0, 5, no
447311406,  AlbertoBuscemi, 1, 0, 1, no
2721805613,  namelesstat, 1, 0, 1, no
587415151,  tienimihar, 1, 0, 1, no
717245177,  LisaManu11, 2, 0, 2, no
578086978,  Gamberassimo, 4, 0, 4, no
3930529876,  Daniele48830200, 1, 0, 1, no
96865223,  gioelo, 1, 0, 1, no
1317745008,  luisa_rizzardi, 2, 0, 2, no
2505584184,  Teodoro66992501, 1, 0, 1, no
721150876,  BarbarisiMarina, 1, 0, 1, no
3373840360,  KevinTomasi15, 4, 0, 4, no
3306483027,  ElisabettaNaldi, 1, 0, 1, no
802649713128468481,  massybozza, 3, 0, 3, no
168743399,  Elena3092, 4, 0, 4, no
2400406304,  EvyPizzu, 2, 0, 2, no
739907330070962176,  RitaRiruzza22, 1, 0, 1, no
2415872238,  gabrieleconte93, 1, 0, 1, no
2951276554,  meetuporzinuovi, 1, 0, 1, no
1934445032,  angelo_caramia, 13, 0, 13, no
59133674,  achessa, 1, 0, 1, no
3515611696,  Nicovit80, 5, 0, 5, no
3223863561,  CaiaVince, 2, 0, 2, no
2653950543,  annasilviacipr1, 1, 0, 1, no
350642352,  DoctorSwish, 1, 0, 1, no
2462259980,  MeloMunao1970, 3, 0, 3, no
790103174925393920,  MrCurly12, 1, 0, 1, no
804515981976551424,  mario_cabboiMC, 5, 0, 5, no
603830905,  gioiellogi, 1, 0, 1, no
536613916,  luisaiafulla, 5, 0, 5, no
470039284,  pignatellit, 5, 0, 5, no
418182783,  Pami67, 4, 0, 4, no
1115017122,  FrancescaSgro3, 1, 0, 1, no
1277668488,  SalvatoreLaRo10, 3, 0, 3, no
381422013,  03Antonella09, 3, 0, 3, no
2306325718,  guidi_ile, 1, 0, 1, no
3514403363,  sandrocanala, 4, 0, 4, no
2370183870,  FedericoLoForte, 2, 0, 2, no
427583203,  CampaniLuca, 1, 0, 1, no
3419529063,  maurizio237, 3, 0, 3, no
507308372,  pietrofronteddu, 2, 0, 2, no
1482847554,  oraoccupato, 2, 0, 2, no
2212714795,  ilmagodelsat, 2, 0, 2, no
750057340112670720,  salviusfonta, 1, 0, 1, no
793827760368214016,  Nancy040780, 2, 0, 2, no
2172491427,  luca_catone, 1, 0, 1, no
4925341485,  Barone974C, 3, 0, 3, no
775085130943717376,  AntonioB28483, 1, 0, 1, no
509317962,  maxpsx, 1, 0, 1, no
566387591,  acuto_francesco, 1, 0, 1, no
554309481,  Scarry_On, 1, 0, 1, no
795003042093498368,  nicolasciulli, 1, 0, 1, no
705498619,  Nonminominare, 2, 0, 2, no
562768029,  WallKnight, 3, 0, 3, no
1112425946,  FenixSbiups, 1, 0, 1, no
2897248774,  MassimoBazzani, 2, 0, 2, no
3240372507,  araghesia67, 8, 0, 8, no
1022838002,  chieditilperche, 2, 0, 2, no
791382828500000768,  AssuntaStabile8, 9, 0, 9, no
453966391,  dalpi1, 13, 0, 13, no
711636732995891201,  FrocGuilfro, 1, 0, 1, no
2223294178,  La21Latka, 1, 0, 1, no
150184052,  sissicirce65, 1, 0, 1, no
2510503644,  Brainreset99, 1, 0, 1, no
998109013,  stiacon, 1, 0, 1, no
750732259108487168,  giancarlofeli10, 5, 0, 5, no
420272269,  KirobyManuela, 1, 0, 1, no
749272798565105665,  mauri7521, 2, 0, 2, no
1337421240,  CarloneFilippo, 1, 0, 1, no
221310670,  nononevero, 3, 0, 3, no
3158316394,  Gaetano19771, 1, 0, 1, no
4081630233,  mariazaccone57, 3, 0, 3, no
3864352527,  LauraLena7, 2, 0, 2, no
501762403,  ReiyelR, 2, 0, 2, no
386533778,  Trecaste, 1, 0, 1, no
433414746,  ipasinetti, 2, 0, 2, no
2352594611,  giuseppegallo69, 1, 0, 1, no
3331126263,  primavallerm, 1, 0, 1, no
1585852927,  SalvatoreLeopar, 1, 0, 1, no
264428351,  capigiu, 1, 0, 1, no
285047870,  ilCieloRosso, 2, 0, 2, no
470951423,  Salvo_Magnano, 1, 0, 1, no
1204728828,  hocus_lotus, 3, 0, 3, no
1670738971,  DavideFleur, 2, 0, 2, no
1954593727,  luigi_ruggeri, 1, 0, 1, no
723484151794569216,  MariaMurdica, 5, 0, 5, no
286584440,  Mausoleo87, 5, 0, 5, no
165377436,  arci1977, 2, 0, 2, no
4716622936,  bariccimarco2, 1, 0, 1, no
1932186163,  gianiarmd, 16, 0, 16, no
1091835762,  Vale7905, 8, 0, 8, no
469273038,  alessandracalvo, 18, 0, 18, no
45431726,  aiki86, 1, 0, 1, no
340427756,  mariafarri1, 2, 0, 2, no
2868596572,  alessandrosono, 1, 0, 1, no
753302994427449344,  girella106, 1, 0, 1, no
36182841,  ANOMIS70, 5, 0, 5, no
1106648863,  GiuseppeDAles14, 4, 0, 4, no
711684801040879616,  ladychef90, 1, 0, 1, no
622206916,  Laurie_Angel_89, 1, 0, 1, no
1314457382,  AnnaMarabini, 1, 0, 1, no
793050863052922880,  Mirko61510088, 1, 0, 1, no
483319327,  alessio_susi, 1, 0, 1, no
3425974198,  VeronicaElfani, 1, 0, 1, no
460048386,  MARIELLASCHEPIS, 1, 0, 1, no
2200517830,  Simiona1Giacomo, 1, 0, 1, no
387622699,  cristinaverolin, 3, 0, 3, no
704718743419658240,  carlo_cencioni, 11, 0, 11, no
2785705605,  gfcavallari, 2, 0, 2, no
713678311562612737,  roberto07061961, 3, 0, 3, no
281581221,  Annagiulie, 3, 0, 3, no
4589146755,  LelettaD, 1, 0, 1, no
993634406,  rsantagada70, 2, 0, 2, no
152596271,  TheLynette, 1, 0, 1, no
803005176789528576,  shahrzy28, 3, 0, 3, no
2828225637,  danieleon81, 6, 0, 6, no
527467945,  seraoantonella, 3, 0, 3, no
723840108860977152,  federicagiando1, 1, 0, 1, no
1038107510,  lanza_giuliana, 1, 0, 1, no
1586239232,  johnspring1961, 2, 0, 2, no
3318544162,  marielladbm61, 1, 0, 1, no
390340887,  AleLepri, 1, 0, 1, no
140867097,  enzapiazzolla, 5, 0, 5, no
781570556281888768,  Carlottainvolo_, 1, 0, 1, no
724603972531658752,  FeliceTraccitto, 1, 0, 1, no
906187532,  antoniokana86, 1, 0, 1, no
452318028,  RobertoFerramol, 3, 0, 3, no
3345343780,  yume_mosyume, 5, 0, 5, no
3758749036,  maxzed1972, 1, 0, 1, no
436192547,  OlivieroCasali, 1, 0, 1, no
3398291849,  gbuono23, 2, 0, 2, no
1247348185,  mirta2006e, 1, 0, 1, no
553524295,  MAGIME182, 1, 0, 1, no
1316440566,  GiorgioperG, 2, 0, 2, no
799044681480933376,  ziopower78, 3, 0, 3, no
719094683213946880,  mariarussolill6, 2, 0, 2, no
389725831,  galby1961, 1, 0, 1, no
788813950636986368,  fr4zelda, 1, 0, 1, no
516681772,  SerafiniLorena, 1, 0, 1, no
1006293282,  elviradalessand, 1, 0, 1, no
878654412,  maryolaf, 1, 0, 1, no
2528025827,  SaraButtiniPhD, 3, 0, 3, no
3372172755,  L198753, 1, 0, 1, no
411696745,  alchiumm, 1, 0, 1, no
483324627,  GianninoAntonio, 2, 0, 2, no
767473064129028097,  FrancescoRoto, 2, 0, 2, no
2455009450,  improta71, 3, 0, 3, no
4818638237,  MajorTom_MG, 2, 0, 2, no
171468531,  donatoiampi, 2, 0, 2, no
206077028,  savasa_, 1, 0, 1, no
1006993896,  m_nicodemo, 1, 0, 1, no
443333037,  themajor83, 5, 0, 5, no
3214233568,  06GiuliA3, 1, 0, 1, no
385420948,  monterosahotel, 1, 0, 1, no
151381490,  dobrucamarocla, 1, 0, 1, no
746077685558939648,  simeone973, 1, 0, 1, no
341408808,  gigionetweet, 1, 0, 1, no
461945819,  miasoane, 1, 0, 1, no
372193986,  Sarah_GFStudio, 1, 0, 1, no
744163262124728320,  MoTeo80, 1, 0, 1, no
13459,  mardy, 1, 0, 1, no
4920965056,  DomenicoMonter2, 1, 0, 1, no
538358467,  V3lv3tBlu, 3, 0, 3, no
2186903923,  mariomicangeli, 2, 0, 2, no
3095417459,  BuffoliA, 1, 0, 1, no
557881473,  giovtwit, 1, 0, 1, no
1275345229,  antonioarcieri2, 4, 0, 4, no
297745811,  magdafaccioli, 2, 0, 2, no
742876376,  aleverci, 6, 0, 6, no
793179502046216192,  CastiglioneSt, 3, 0, 3, no
2909203947,  AngeloGabellone, 1, 0, 1, no
1218928308,  Franceshiello6, 1, 0, 1, no
848010049,  pnoce73, 1, 0, 1, no
1076289714,  ivanspalmisano, 1, 0, 1, no
805552084460466176,  SiLvSka, 1, 0, 1, no
1015333748,  BarbaraMariella, 1, 0, 1, no
999729386,  marcooliveri5, 2, 0, 2, no
4854914741,  giorgiozigghy, 1, 0, 1, no
1725457507,  StefanoFlegoTS, 2, 0, 2, no
2340093135,  FasceMaura, 2, 0, 2, no
49301995,  nuogruroi, 1, 0, 1, no
3074444753,  bergantinif, 3, 0, 3, no
477904590,  elviseligio, 1, 0, 1, no
359993281,  FabiolaSmile, 4, 0, 4, no
1259513954,  beatriceravina1, 1, 0, 1, no
2937052317,  OliPelucchi, 3, 0, 3, no
2206448231,  RCoramusi, 1, 0, 1, no
3021934949,  6a0cf794181f44e, 1, 0, 1, no
731380824579379204,  DanselmoElda, 1, 0, 1, no
2199740816,  Stivilla76, 1, 0, 1, no
1642816093,  PieroCalanna, 4, 0, 4, no
3398036302,  Fabio65429206, 2, 0, 2, no
3360526845,  Dreware96, 2, 0, 2, no
2657797725,  RomeiAntonella, 6, 0, 6, no
804069973190725636,  nakusvaus, 1, 0, 1, no
3319129573,  LucaInnocenti10, 1, 0, 1, no
3172328747,  gcialot, 1, 0, 1, no
852688609,  AmorusoEmanuele, 2, 0, 2, no
768726335749513216,  martinacpl, 1, 0, 1, no
124576769,  fabiocatellani, 7, 0, 7, no
2506571955,  giulia_340, 7, 0, 7, no
380608235,  Alen_Iglicar, 1, 0, 1, no
358903756,  giangiove, 1, 0, 1, no
206608050,  Dragonfly_IT, 4, 0, 4, no
4386891287,  romi84550421, 1, 0, 1, no
1006442550,  ritarapidissima, 1, 0, 1, no
2867329397,  gianlucabaldi14, 1, 0, 1, no
1485214532,  aryaforestfawn, 2, 0, 2, no
729250648416464896,  danielegaspari6, 2, 0, 2, no
323381692,  CanzianiAngelo, 1, 0, 1, no
285707038,  frah_3, 1, 0, 1, no
898290865,  Paolo_Elefante, 1, 0, 1, no
447269967,  LuciaRisari, 1, 0, 1, no
999267692,  nadiamenotti68, 1, 0, 1, no
59455690,  gaetanomaisto, 2, 0, 2, no
804947531713089537,  mauriz66, 1, 0, 1, no
803206110912061440,  paolajapy, 1, 0, 1, no
740896451333607424,  DavideL_95, 3, 0, 3, no
501791958,  DIONISIOPUCCIO, 2, 0, 2, no
4876953141,  cosadibellu, 1, 0, 1, no
609965522,  fabios78395608, 2, 0, 2, no
804413634726207488,  JesMia85, 2, 0, 2, no
79829769,  RobertoSulliPE, 1, 0, 1, no
2521545964,  ivanzaina, 1, 0, 1, no
435810536,  fabrizio200176, 1, 0, 1, no
400766387,  WSkrety, 1, 0, 1, no
2209323881,  TiricoGianmarco, 3, 0, 3, no
633333,  Zuzzy, 1, 0, 1, no
792308866449047552,  Emmoverimm, 4, 0, 4, no
2617470937,  skaski4, 1, 0, 1, no
4583781076,  Iaya_68, 2, 0, 2, no
783059860007026688,  Pamela09uk, 9, 0, 9, no
799504439736463360,  DinaHaritoshina, 1, 0, 1, no
1249982101,  artigianima, 4, 0, 4, no
801421989009362944,  antoniotwitte16, 1, 0, 1, no
765564104,  enorpeleinad, 1, 0, 1, no
2902386166,  cresammarco, 1, 0, 1, no
716575881909706753,  kyaxel, 3, 0, 3, no
25660920,  Scapy, 3, 0, 3, no
522133054,  Paolazio260513, 2, 0, 2, no
3031516836,  Max79122253, 2, 0, 2, no
799569944858030080,  KKholueva, 1, 0, 1, no
245989170,  Sibilla86, 3, 0, 3, no
400073548,  andreagallucci1, 5, 0, 5, no
748158878332895232,  marcopepa, 2, 0, 2, no
425931009,  lisabefernandez, 10, 0, 10, no
2268685606,  gamberoni051, 25, 0, 25, no
595882332,  traficantemaria, 3, 0, 3, no
3417691187,  alessemanuela, 2, 0, 2, no
713026866198814720,  francesco19824, 2, 0, 2, no
1346736404,  HotmReimax, 3, 0, 3, no
1399368217,  michebortolini, 2, 0, 2, no
294776244,  Katkat76K, 1, 0, 1, no
4833727648,  giusti252, 1, 0, 1, no
593719448,  piallaccio, 2, 0, 2, no
966194582,  massimolaurean1, 1, 0, 1, no
268850788,  Rimmel2016, 7, 0, 7, no
122413948,  mcecilia1962, 1, 0, 1, no
2216906114,  a_lbrog, 1, 0, 1, no
728935613882314752,  silviaf110873, 4, 0, 4, no
3020693140,  OGildaO, 1, 0, 1, no
527534420,  CarloPalcone, 1, 0, 1, no
2390925721,  WilliamNumbOne, 1, 0, 1, no
1579963952,  Lisas_96, 1, 0, 1, no
437769265,  LucaGiveMeFive, 1, 0, 1, no
3025432512,  salv965, 3, 0, 3, no
764415856092774401,  Concett45774110, 1, 0, 1, no
3125007979,  escapewlore, 1, 0, 1, no
563160230,  SalandinMarco, 1, 0, 1, no
2981965797,  pacellidavide, 2, 0, 2, no
267220891,  quilivorno, 3, 0, 3, no
483374573,  paolo_volpi, 1, 0, 1, no
526293847,  armafan, 4, 1, 3, no
57062126,  GianniFiorani, 1, 0, 1, no
456463624,  SandroGadotti, 1, 0, 1, no
2341285060,  muschio97, 1, 0, 1, no
533599475,  Allibadcitizen, 1, 0, 1, no
53709214,  mito4u, 1, 0, 1, no
436654107,  daninicosia, 1, 0, 1, no
253621163,  esterines, 1, 0, 1, no
799223498145222656,  Imma54945437, 6, 0, 6, no
66161873,  Toscana5Stelle, 2, 0, 2, no
1192340720,  gio_c75, 7, 0, 7, no
61665033,  Empoli5Stelle, 1, 0, 1, no
1254790184,  ZaninottogG, 15, 0, 15, no
421266518,  GioiaPapallo, 4, 0, 4, no
514704736,  mardir71, 1, 0, 1, no
747476723470589952,  carmencapuozzo3, 1, 0, 1, no
801763337986068480,  Gigat74, 1, 0, 1, no
398996708,  zoe_marion, 1, 0, 1, no
250880308,  caramitello, 8, 0, 8, no
411699605,  AldoDAtri, 1, 0, 1, no
953404832,  alari75, 1, 0, 1, no
793405084990341120,  simogio72, 1, 0, 1, no
2799692505,  Tina_Cremona, 1, 0, 1, no
304501871,  IvanoLibero, 1, 0, 1, no
1647624913,  Delena_NianTVD, 1, 0, 1, no
2755345600,  Cecilia__95, 1, 0, 1, no
435850680,  gfliguoro, 1, 0, 1, no
2288690043,  FaustaCasti, 1, 0, 1, no
337977088,  mariaritacarate, 1, 0, 1, no
558409852,  BigRobLocanda, 1, 0, 1, no
412948497,  pablo13461, 3, 0, 3, no
3226396323,  fiorenzo7831, 2, 0, 2, no
4105916662,  luigi28fazio, 2, 0, 2, no
800855052999159808,  edc4ba5613c84d6, 2, 0, 2, no
321530359,  simonavairano, 1, 0, 1, no
1012877600,  tekila100s, 2, 0, 2, no
474982967,  DevaMati, 1, 0, 1, no
165408634,  alessandro1276, 2, 0, 2, no
719961865317715969,  kikaki7, 3, 0, 3, no
3906518420,  kiarakiara72, 4, 0, 4, no
2455729176,  silvio45451321, 2, 0, 2, no
4512939023,  AbueloKejika, 1, 0, 1, no
267728903,  ispirazionidigi, 10, 0, 10, no
531755919,  bravofernando1, 1, 0, 1, no
857003005,  FabriziaBovi, 1, 0, 1, no
923555906,  ter_rob, 4, 0, 4, no
484090897,  AloisiVittoria, 2, 0, 2, no
1053896976,  emanuela_olga, 2, 0, 2, no
801592927067795456,  seousisdome1972, 1, 0, 1, no
474838532,  caposele5stelle, 1, 0, 1, no
2284748301,  giopallo1, 2, 0, 2, no
4354071635,  roberto_sca, 2, 0, 2, no
440037168,  damenundherren, 2, 0, 2, no
420135838,  sabba_25, 2, 0, 2, no
424452650,  PaoloValesi1, 1, 0, 1, no
2771197095,  cd_tw, 2, 0, 2, no
2800847595,  luciavized, 4, 0, 4, no
2353797636,  risoinbianco, 1, 0, 1, no
797727634880864256,  leonard60931373, 2, 0, 2, no
798807159353917440,  kindpalena, 1, 0, 1, no
17783846,  maiux, 1, 0, 1, no
3123387999,  simplyMDA, 1, 0, 1, no
342727106,  MADeFilippis, 4, 0, 4, no
100197573,  davidego, 1, 0, 1, no
4076099719,  Paola33868844, 1, 0, 1, no
437408402,  fiorella0903, 1, 0, 1, no
482532412,  tiri_A, 1, 0, 1, no
318990262,  turchip, 4, 0, 4, no
877388203,  RevelloPartners, 1, 0, 1, no
840234690,  perlaperla7, 6, 0, 6, no
383197591,  frescoroberto, 1, 0, 1, no
552229388,  UMBIZZ1954, 3, 0, 3, no
331572952,  fantonangeli, 5, 0, 5, no
2791795096,  patriziaburla, 8, 0, 8, no
2614748019,  berto7865, 1, 0, 1, no
1365378122,  s_floris, 4, 0, 4, no
444438933,  acofab, 8, 0, 8, no
4798879156,  super_gufo, 2, 0, 2, no
3792460877,  Marcell45782770, 3, 0, 3, no
497119150,  giseppe4, 1, 0, 1, no
2504047919,  meschi_maria, 2, 0, 2, no
552764717,  Lino_Raimondi, 1, 0, 1, no
2356990407,  lucio_marciano, 2, 0, 2, no
240454257,  luicox, 1, 0, 1, no
2712570895,  Noesispotty, 1, 0, 1, no
101888791,  Cruze712, 1, 0, 1, no
2857870217,  DDArkadia71, 2, 0, 2, no
1310389435,  DChistoni, 1, 0, 1, no
559300555,  Marco5Stars, 1, 0, 1, no
3290183709,  73_asia, 7, 0, 7, no
854335436,  ace_storm, 1, 0, 1, no
3909491067,  Gallocchio77, 1, 0, 1, no
2869582841,  __lucyelizabeth, 3, 0, 3, no
802287002,  _ForrestGump_, 1, 0, 1, no
1083460182,  TeresaLaBella2, 1, 0, 1, no
138706772,  MauroDelCorno, 1, 0, 1, no
4289396916,  flavio_crinelli, 1, 0, 1, no
1026789085,  carlo_nardi, 3, 0, 3, no
495366392,  la_bodi, 1, 0, 1, no
2964939255,  FideliFideli79, 2, 0, 2, no
450957612,  raggioblu6, 4, 0, 4, no
4853392221,  Zeneizoide, 5, 0, 5, no
136974486,  adpersonamAnto, 3, 0, 3, no
1419413953,  Antonellodig, 4, 0, 4, no
289833088,  Fabio_V79, 2, 0, 2, no
1472157098,  FranScarpato, 1, 0, 1, no
391275039,  GelindoBaldin, 1, 0, 1, no
469236719,  GBartocci, 1, 0, 1, no
763798165,  typhoonmrc, 1, 0, 1, no
804267044963282944,  Lykos2900, 1, 0, 1, no
3242193825,  CbClabel, 1, 0, 1, no
2155938268,  roby4766, 1, 0, 1, no
559769442,  AndreaBianchi81, 1, 0, 1, no
444137874,  IleniaF1, 1, 0, 1, no
802157141108867073,  cerezo979, 1, 0, 1, no
4864104742,  Maria33759436, 2, 0, 2, no
992690058,  vincenzomazz1, 2, 0, 2, no
1015484834,  paogrilli5, 1, 0, 1, no
487592587,  dago_sky, 1, 0, 1, no
1187057971,  dinomerolli, 1, 0, 1, no
4827234328,  ricspeci, 1, 0, 1, no
1597928726,  maurizioLazze65, 4, 0, 4, no
2315573211,  lavelella, 2, 0, 2, no
801846201578586112,  PaoloSacchetti1, 13, 1, 12, no
3382770388,  itamorax, 3, 0, 3, no
203958586,  Josemm_94, 1, 0, 1, no
398426351,  iStefano85, 2, 0, 2, no
484127871,  VitoArdagna, 7, 0, 7, no
2361666815,  marialuceamelio, 6, 0, 6, no
484059817,  AleC2611, 4, 1, 3, no
606823551,  ierogamos, 1, 0, 1, no
4294512207,  albino_costanzo, 2, 0, 2, no
789869955244257280,  riservafraziona, 3, 0, 3, no
108548308,  barabba47, 1, 0, 1, no
285045023,  GiuliaCasarino, 4, 0, 4, no
412514464,  babyTiff83, 3, 0, 3, no
609827142,  PaserePhotos, 2, 0, 2, no
2227791917,  framiriello, 1, 0, 1, no
2166921829,  StormJts2009, 2, 0, 2, no
802848660551827457,  VetroDi, 3, 0, 3, no
46652864,  andysailor, 1, 0, 1, no
103242506,  UdaFabrizio, 2, 0, 2, no
1122344736,  GiancolaSilvia, 2, 0, 2, no
1006400634,  mikedells, 2, 0, 2, no
519322721,  francesca3197, 2, 0, 2, no
456924097,  IadyHawke, 2, 0, 2, no
522116554,  TittaMorandi, 1, 0, 1, no
97230100,  wollace_fi, 1, 0, 1, no
821776178,  Nicola_Berga, 7, 0, 7, no
720822916,  mt191583, 1, 0, 1, no
1635285210,  LucaStanisci, 2, 0, 2, no
344991357,  AlessandraLanz1, 5, 0, 5, no
1246641648,  mavaivia, 1, 0, 1, no
252245001,  AntoMatrisc, 1, 0, 1, no
433481180,  GaioCostarelli, 3, 1, 2, no
542766889,  DelGallo3, 5, 0, 5, no
2572493888,  MArtePress, 1, 0, 1, no
47618184,  maghirko, 2, 0, 2, no
466420763,  MalcaPortini, 1, 0, 1, no
1413908263,  grifonesrl, 2, 0, 2, no
4475013383,  Rm60Sergio, 1, 0, 1, no
2360686468,  lilfede83, 1, 0, 1, no
763435693699960833,  m_indelicato, 3, 0, 3, no
3384321525,  Mcristinasordi, 1, 0, 1, no
771824918400905216,  TechnoLarotuter, 1, 0, 1, no
275040235,  Dxer72, 1, 0, 1, no
416539898,  Gelsomino_Mimi, 1, 0, 1, no
4912238297,  PierMarcoC, 3, 0, 3, no
729333970261946368,  FilippoVigilia, 2, 0, 2, no
759291903602987009,  ArenaLazio, 3, 0, 3, no
466348695,  AC_1908, 4, 1, 3, no
147991962,  antoguerrera, 1, 0, 1, no
398087952,  giovannibotti2, 1, 0, 1, no
865933076,  GoldenLudo, 1, 0, 1, no
269842693,  massimop1970, 8, 0, 8, no
778710651447353344,  Meryy9000, 3, 0, 3, no
403454736,  gianni02g, 1, 0, 1, no
795278357420240896,  iogreg, 1, 0, 1, no
885184754,  giuseppegrisa, 5, 0, 5, no
3074913665,  L30n4rd086, 2, 0, 2, no
321911895,  liciafederer, 4, 0, 4, no
388229935,  Laura_o78, 1, 0, 1, no
72378735,  cryinglightnin_, 1, 0, 1, no
249723261,  adelaide_musso, 7, 1, 6, no
147622871,  fla_odo, 1, 0, 1, no
373997237,  IlPaolo_Ironico, 1, 0, 1, no
472042644,  MarcellaCaiazzo, 1, 0, 1, no
408370356,  SBuffagni, 4, 0, 4, no
718146673684439040,  hawkmoon1976, 2, 0, 2, no
790103246,  johnlockex, 1, 0, 1, no
1357005222,  rosalbadeangeli, 1, 0, 1, no
804422524838801408,  achetart, 1, 0, 1, no
801525216883183616,  giorgiamastrop, 3, 0, 3, no
2775040101,  GlukaBagatin, 1, 0, 1, no
532463016,  MircoRomanato, 6, 0, 6, no
264843937,  justindietta, 3, 0, 3, no
3150275694,  RamaAlden, 4, 0, 4, no
584025990,  barkovitz, 1, 0, 1, no
3739713681,  ritasei2, 1, 0, 1, no
914573593,  alfopilot, 2, 0, 2, no
99743316,  av0nsbiebss, 2, 0, 2, no
893330910,  dariuxman, 1, 0, 1, no
1063189604,  CentorbiMassimo, 1, 0, 1, no
295088615,  Ale_visual, 3, 0, 3, no
939317492,  AleMar1969, 1, 0, 1, no
492104860,  MatDelD, 3, 0, 3, no
1412456984,  GicoAnco, 1, 0, 1, no
4842510773,  Marialu30506022, 3, 0, 3, no
622267653,  louivsbae, 1, 0, 1, no
517665250,  FrancescaRicky, 1, 0, 1, no
183370196,  francomarsi, 1, 0, 1, no
2339481904,  DreamTravel59, 4, 0, 4, no
862580724,  707_massimo, 1, 0, 1, no
791370438907686912,  Luciasenatore3, 5, 0, 5, no
516923634,  pioli_d, 3, 0, 3, no
748825296,  stefanoguzzi1, 1, 0, 1, no
1137051529,  mimmolimmo, 1, 0, 1, no
415629977,  CiroTozza, 1, 0, 1, no
1259775931,  Leondelaserna, 2, 0, 2, no
581006334,  mend_jul, 4, 0, 4, no
313512813,  Cap_ultimo89, 2, 0, 2, no
100194373,  _Ninaya, 3, 0, 3, no
513526868,  salvo622012, 2, 0, 2, no
857715163,  MargheFlower, 2, 0, 2, no
2606221307,  maurirussowork, 1, 0, 1, no
908206586,  v1nc3n2o, 8, 0, 8, no
368085489,  multexreddito, 3, 0, 3, no
415161218,  mattiamisciali, 1, 0, 1, no
4228349893,  gianlucamuscolo, 1, 0, 1, no
498853740,  ElenaSpe, 1, 0, 1, no
368302931,  bucanevecri, 1, 0, 1, no
2860190313,  ermerlone, 8, 0, 8, no
3308288710,  ilconrad76, 1, 0, 1, no
928572510,  PCabriolu, 1, 0, 1, no
380447858,  micheleFuoco1, 1, 0, 1, no
443105581,  paqqua, 1, 0, 1, no
606394161,  Lorenzo2595, 2, 0, 2, no
2810439424,  puccinialessan1, 1, 0, 1, no
49551708,  DaniellaMasag, 4, 0, 4, no
447235932,  soniapascutto, 1, 0, 1, no
778517474472030208,  giani85, 2, 0, 2, no
395812442,  nikmaino, 4, 0, 4, no
704219861,  CangioliDaniele, 1, 0, 1, no
186369816,  AlbiAllevi, 1, 0, 1, no
52425615,  vikvix, 4, 0, 4, no
2444425252,  FioreseEffe, 1, 0, 1, no
755143705305186309,  CatalloAlessia, 1, 0, 1, no
386025550,  NickSperanza, 1, 0, 1, no
745995221348003840,  marco_favorito, 1, 0, 1, no
3074176598,  agostina1207, 1, 0, 1, no
2613219456,  domenico6208, 1, 0, 1, no
1374198374,  irsuti, 1, 0, 1, no
213998209,  Didenea, 1, 0, 1, no
767843726077071360,  valerioultimo, 1, 0, 1, no
58503950,  giovanni_ebasta, 2, 0, 2, no
371272198,  carlovigo, 4, 0, 4, no
169610638,  lllorik, 4, 0, 4, no
320706097,  DavideMatteoni, 1, 0, 1, no
351139362,  giusycannizzaro, 6, 0, 6, no
1274249790,  grandine66, 1, 0, 1, no
2792654073,  Thallulah, 1, 0, 1, no
719652438110838784,  marinarina47, 6, 0, 6, no
2656936986,  miss_simple407, 1, 0, 1, no
4885484931,  lucamantovano, 1, 0, 1, no
4654542682,  pcasa5, 1, 0, 1, no
1260538849,  colantoni_bruna, 1, 0, 1, no
635629118,  74_francesco, 3, 0, 3, no
1140378518,  ECuffini, 1, 0, 1, no
526465384,  UNIONFELICE, 2, 0, 2, no
469453365,  rrossella75, 1, 0, 1, no
2152454917,  cesare_pirotta, 2, 0, 2, no
781228956112580608,  adagionapulitan, 7, 0, 7, no
574252936,  MARZANIDOMENICO, 1, 0, 1, no
1960706378,  cangaceiro79, 1, 0, 1, no
389353555,  davide_del, 2, 0, 2, no
2235039294,  malatestap76, 2, 0, 2, no
50276763,  crikke77, 2, 0, 2, no
2867979837,  wassilli1975, 1, 0, 1, no
160252784,  0nephilim0, 3, 0, 3, no
2889902770,  LucaCambiasso, 1, 0, 1, no
2362964227,  MartinoMigli, 2, 0, 2, no
3352915611,  missemi1633, 1, 0, 1, no
362563158,  PernecheleD, 1, 0, 1, no
2280644179,  RovereNaturale, 4, 0, 4, no
34635543,  tripleghy, 1, 0, 1, no
400410789,  FrostRiosalso, 1, 0, 1, no
247104999,  starmerks, 1, 0, 1, no
17469056,  GI_Aaron, 1, 0, 1, no
531417062,  danielinocosta, 1, 0, 1, no
2703693450,  brightl63656531, 3, 0, 3, no
424535659,  MCofani, 4, 0, 4, no
1121765677,  cardisa25, 1, 0, 1, no
573945946,  davidpurpura2, 2, 0, 2, no
988188680,  Formicola10, 2, 0, 2, no
3225886745,  LiottaBarbara, 1, 0, 1, no
517876006,  martons1970, 2, 0, 2, no
185696844,  Mikail211, 1, 0, 1, no
765596494380531713,  sark1946, 4, 0, 4, no
4252032136,  excalibur210964, 3, 0, 3, no
2361561634,  lapluffa, 1, 0, 1, no
3110684698,  ElioAllegra, 1, 0, 1, no
157060172,  MrLuka90, 6, 0, 6, no
1187728657,  EzioIt, 2, 0, 2, no
201640247,  Noioutdoor, 1, 0, 1, no
1022092364,  dematwit, 1, 0, 1, no
699554890075365376,  DanySpillo73, 1, 0, 1, no
1284065244,  gaschi84, 4, 0, 4, no
381426536,  rosita17rosita, 3, 0, 3, no
262736023,  glezzerini, 2, 0, 2, no
107847820,  Tremanagheie, 2, 0, 2, no
454283322,  CipollaFabio, 1, 0, 1, no
2572675230,  RodPolisher, 1, 0, 1, no
3311964753,  sissi7772, 2, 0, 2, no
222769177,  mirckqo, 1, 0, 1, no
553784534,  NunzioVioletti, 3, 0, 3, no
698787801748414464,  ElenaGrasso8, 1, 0, 1, no
605296679,  dellavallem5s, 1, 0, 1, no
2244632566,  peppecz85, 2, 0, 2, no
2297725321,  mistertitta, 1, 0, 1, no
1916350796,  lucaspagnoli71, 2, 0, 2, no
1269486295,  Raffol44, 2, 0, 2, no
1495551570,  g_gezzi, 1, 0, 1, no
2361781268,  sergiocucco, 1, 0, 1, no
399337255,  mypaperotta, 1, 0, 1, no
431401642,  francescoilguru, 1, 0, 1, no
45390666,  sardusrebel, 1, 0, 1, no
2475717514,  angelarajad, 1, 0, 1, no
792074788554608640,  vabenecarlo, 1, 0, 1, no
94851431,  AntoBlasi, 1, 0, 1, no
1296641610,  JohnEvansMusic, 2, 0, 2, no
97294115,  Osvi_Mongi, 1, 0, 1, no
299718468,  EnricoNapo, 1, 0, 1, no
380566039,  FrancescaTronca, 1, 0, 1, no
116039315,  taorminavinci, 1, 0, 1, no
555030818,  Gi_dk, 1, 0, 1, no
113714702,  tonino13, 1, 0, 1, no
2951210075,  Darione18dm, 1, 0, 1, no
1915491469,  AspireZ3100, 2, 0, 2, no
486251702,  IrateJay, 2, 0, 2, no
2866614668,  marcobiker81, 2, 0, 2, no
331804210,  antonello3007, 2, 0, 2, no
1103232462,  MariaLindaDebe, 1, 0, 1, no
199632556,  robbie0809, 1, 0, 1, no
1168288627,  ItComponenti, 3, 0, 3, no
2353756873,  driver71g, 7, 0, 7, no
4242264977,  sergioverolebo1, 8, 0, 8, no
1334712547,  sabahelher, 2, 0, 2, no
1502936358,  perstarebene, 1, 0, 1, no
728468647048404993,  profvento, 1, 0, 1, no
79702732,  alexukmma1, 1, 0, 1, no
3085555202,  terzofuoco26, 1, 0, 1, no
441701161,  silvanamaucioni, 2, 0, 2, no
466509888,  pasqualeflight, 1, 0, 1, no
1143357973,  AllDoctor85, 1, 0, 1, no
442735679,  cristianobtweet, 2, 0, 2, no
4697560933,  LorenaIrcone, 5, 0, 5, no
105854469,  peppemotta86, 1, 0, 1, no
801177795409932289,  isabelrejna, 1, 0, 1, no
412408303,  ecekko, 1, 0, 1, no
523394825,  supermalaxx, 3, 0, 3, no
194511339,  Ste_Messina, 3, 0, 3, no
2828466457,  sspolverini, 1, 0, 1, no
1317088771,  alexpicchi73, 2, 0, 2, no
2994158927,  vicky_cat02, 1, 0, 1, no
4850789769,  NicolaTintori, 2, 0, 2, no
3846764800,  francesco_barri, 1, 0, 1, no
79282660,  teramotexas, 1, 0, 1, no
431741869,  nicozetti, 1, 0, 1, no
768065295084818432,  LuigiCesarini2, 2, 0, 2, no
417778429,  pasksak, 3, 0, 3, no
28182634,  Seta_rossa, 2, 0, 2, no
3558973643,  TeresaColozzi, 2, 0, 2, no
2543565519,  vrrach, 1, 0, 1, no
805565234970841089,  frost_34, 1, 0, 1, no
1525042693,  AgneseZ97, 1, 0, 1, no
798191160066002945,  veve_86_italy, 1, 0, 1, no
2276225552,  pigall71, 1, 0, 1, no
606147435,  delloneno, 4, 0, 4, no
384927860,  stefyorlando, 4, 0, 4, no
471397261,  giulopa, 1, 0, 1, no
3907780402,  mike_onehundred, 1, 0, 1, no
539835980,  elenaswartele, 1, 0, 1, no
736908928769007616,  chawar66, 1, 0, 1, no
775077834612154369,  enzoamoruso89, 1, 0, 1, no
886409983,  aidafrancomacar, 1, 0, 1, no
1575780570,  MalfiToto, 1, 0, 1, no
50690845,  hoppuspotamus, 1, 0, 1, no
1262943984,  ChiricoGiulia, 1, 0, 1, no
534863473,  mjp4liberty, 2, 0, 2, no
802047416,  ErikaContardi, 1, 0, 1, no
2174646856,  susanninalma, 1, 0, 1, no
2203683053,  raffaelevolpe80, 2, 0, 2, no
2726719697,  CerinoEmiliano, 2, 0, 2, no
472298643,  salvatoredanie4, 2, 0, 2, no
70937566,  manomon, 2, 0, 2, no
2210939675,  LivAlberto, 1, 0, 1, no
1316198996,  flavhar, 1, 0, 1, no
635268290,  Fsabatelli, 1, 0, 1, no
436029270,  spinoleo, 6, 0, 6, no
721805202211401730,  ZampaloniMoira, 3, 0, 3, no
449072743,  joiauk, 1, 0, 1, no
30160207,  alberto_rossini, 1, 0, 1, no
799956470,  virgiliomax, 1, 0, 1, no
50314830,  lalby, 4, 0, 4, no
931821571,  cirasella61, 2, 0, 2, no
404537108,  Sballo46, 2, 0, 2, no
396463100,  SimonelliAldo, 1, 0, 1, no
791434621925920768,  DenisScudieri, 1, 0, 1, no
541079589,  luciadistefano5, 1, 0, 1, no
772508718198120448,  Paola19672, 1, 0, 1, no
2524869982,  9fd6b178a9f0410, 1, 0, 1, no
2180958723,  PieralisiRicky, 3, 0, 3, no
3207864399,  LUIGICAPOGROSS_, 2, 0, 2, no
1966284062,  CeciVittorino, 2, 0, 2, no
451436044,  SimoneMoneti1, 1, 0, 1, no
2799652340,  Antoonever, 2, 0, 2, no
3046149161,  francangelo48, 1, 0, 1, no
555085723,  cicintrip, 2, 0, 2, no
2323632758,  Villa5stelle, 5, 0, 5, no
3247227967,  that_foggyday, 1, 0, 1, no
4897612589,  Giancar01875527, 1, 0, 1, no
1038210043,  cirricawa, 1, 0, 1, no
456523196,  Leo94b, 1, 0, 1, no
1585726832,  PippoTentenna, 2, 0, 2, no
893895823,  santiagolatino4, 1, 0, 1, no
4703628013,  Pierluigi5s, 1, 0, 1, no
94653849,  irv_a, 1, 0, 1, no
506364019,  MomoDelia, 2, 0, 2, no
568073045,  Tita2179, 3, 0, 3, no
395823148,  Mik_Scattarelli, 1, 0, 1, no
128844770,  GiulioStefani, 4, 0, 4, no
117225838,  CentristNet, 4, 0, 4, no
345037144,  Korimrikom, 6, 0, 6, no
704462391938052096,  GiannazzoSanto, 3, 0, 3, no
256717862,  bitoon77, 2, 0, 2, no
847527014,  MiletheFrog, 1, 0, 1, no
460529921,  AgostinoGrillo, 6, 0, 6, no
538578000,  marcellaforni2, 1, 0, 1, no
182773660,  AlessioParadisi, 2, 0, 2, no
778208193709301761,  alfiodesilva91, 1, 0, 1, no
712949762857762818,  disambigua49, 3, 0, 3, no
4019107157,  mary050373, 1, 0, 1, no
326116085,  LudoPaone, 2, 0, 2, no
2172872273,  paulthomas1020, 4, 0, 4, no
490663784,  MicheleMasella, 6, 0, 6, no
428212697,  LorenzoRighetti, 1, 0, 1, no
3228198179,  026f6562bd0a48a, 6, 0, 6, no
2392610875,  AbeleS96, 2, 0, 2, no
2871241720,  mariella063, 1, 0, 1, no
3146219384,  umami5th, 1, 0, 1, no
526726795,  SCarpanese, 3, 0, 3, no
922990920,  zampieripatti, 3, 0, 3, no
430892218,  muletti88m, 1, 0, 1, no
2263824353,  fchella55, 2, 0, 2, no
3334399623,  gueli_antonella, 1, 0, 1, no
1031522772,  CorderaMagda, 1, 0, 1, no
714176524535132161,  LaFrancisella, 1, 0, 1, no
92065265,  DamianoMaggi, 1, 0, 1, no
251575467,  rodolforizzo76, 1, 0, 1, no
499029069,  FrancescaCont20, 1, 0, 1, no
805561469232443394,  fiezzo27, 1, 0, 1, no
365394974,  antonellobr, 1, 0, 1, no
4095964695,  Roberto07427240, 1, 0, 1, no
3104176366,  IosellaTacci, 1, 0, 1, no
1035183542,  dreamertom10, 2, 0, 2, no
376535256,  Kiryan15, 2, 0, 2, no
749365494130601984,  mkm1rk0, 1, 0, 1, no
2169077983,  benserk75, 1, 0, 1, no
788551456865579009,  LauraMelotti3, 1, 0, 1, no
329273552,  GiorgioDiGiaco1, 1, 0, 1, no
437613465,  IlMarronz, 1, 0, 1, no
448317601,  rossymarinaro, 2, 0, 2, no
771147650,  max_sciacca, 2, 0, 2, no
2837229892,  gsuperba, 1, 0, 1, no
723807407261011969,  PaoloPassera6, 3, 0, 3, no
347163786,  10marlau70, 2, 0, 2, no
3803131221,  novellovittorio, 2, 0, 2, no
3093565820,  picciannamaria, 2, 0, 2, no
733202402338312192,  Flawear64, 1, 0, 1, no
786594969884778496,  RuggeroMaestro, 5, 0, 5, no
1248179430,  klaudioatzori, 2, 0, 2, no
765852936014626816,  AntonellaFavali, 5, 0, 5, no
1374411655,  Marie_Jasmine_U, 1, 0, 1, no
1111669807,  tanobarone2, 1, 0, 1, no
713430888386805760,  maurodealberei, 2, 0, 2, no
290526506,  addiritturadici, 2, 0, 2, no
154824095,  Rafelisi, 1, 0, 1, no
2418563325,  renzinorenna, 2, 0, 2, no
4515142407,  Rossana57032057, 2, 0, 2, no
398629721,  KeythFin, 1, 0, 1, no
372058331,  miki1086, 2, 0, 2, no
2981988957,  rog_ri, 1, 0, 1, no
46202228,  ilpiolo, 1, 0, 1, no
780507044470198272,  hsbraven, 1, 0, 1, no
477703040,  MRaffaelino, 1, 0, 1, no
1853413428,  FrancescaLater3, 1, 0, 1, no
3333323567,  fr_eerider, 1, 0, 1, no
1152213248,  pablodotato, 1, 0, 1, no
98204739,  gio_valvassori, 1, 0, 1, no
37776782,  DanyDM, 1, 0, 1, no
407124709,  Felletti55, 1, 0, 1, no
793934453974433793,  Ciccio97PA, 1, 0, 1, no
346163733,  rhio75, 6, 0, 6, no
2325819461,  apratelli61, 1, 0, 1, no
2381791600,  fgagliano13, 8, 0, 8, no
2535748479,  apolizzotto51, 1, 0, 1, no
128495900,  alfenzo, 1, 0, 1, no
788419059301937152,  vcracolici84, 1, 0, 1, no
2247031480,  achilleshybris, 2, 0, 2, no
747776250840780801,  bocchieribeppe, 1, 0, 1, no
1071497792,  marty__23, 1, 0, 1, no
475404387,  duofabrimusic, 1, 0, 1, no
1379345592,  giangiulio_carm, 1, 0, 1, no
1278949189,  LgTumolo, 1, 0, 1, no
4044878537,  luasat71, 1, 0, 1, no
2394970593,  daa5b93e9a104eb, 2, 0, 2, no
290884637,  Luca_Giacomelli, 1, 0, 1, no
2332346138,  mammolita72, 1, 0, 1, no
269019138,  cipo3282, 2, 0, 2, no
359308513,  simonaruggeri_, 1, 0, 1, no
1274890934,  SoniaDeLazzer, 1, 0, 1, no
1224992959,  stefano_biotto, 1, 0, 1, no
580880845,  Guybrush964, 1, 0, 1, no
989486672,  ritapinna7, 2, 0, 2, no
4142110199,  Davide94Bjj, 1, 0, 1, no
4908625900,  Elid78Elisa, 2, 0, 2, no
3351139683,  taituyeshi, 2, 0, 2, no
2604312407,  mariagraziabon, 1, 0, 1, no
732840775,  GianlucaCurti1, 5, 0, 5, no
3297574539,  RitaRitabosco2, 1, 0, 1, no
2853690197,  gcarpesh, 1, 0, 1, no
161164067,  silvialensi, 1, 0, 1, no
803931008227799040,  John_SunriseNo, 1, 0, 1, no
796194001,  GiovannaScialla, 1, 0, 1, no
560577301,  antoazzu, 1, 0, 1, no
2853895743,  bitontikr, 1, 0, 1, no
419019604,  M5SFrance, 3, 0, 3, no
3037223092,  pietrangelosan1, 1, 0, 1, no
15336354,  triplemax, 1, 0, 1, no
612027693,  GiuseppeBorzi2, 1, 0, 1, no
83557217,  pierodepascale, 1, 0, 1, no
320840015,  enzosen, 5, 0, 5, no
754220905413378048,  vitomalfa, 1, 0, 1, no
138349879,  nedz72, 1, 0, 1, no
2234348555,  crepasfigli2, 1, 0, 1, no
429226101,  BAIOCCOPAOLA, 3, 0, 3, no
256254309,  CAROLYNN1949, 2, 0, 2, no
1021693554,  alfredilullo, 1, 0, 1, no
2951057926,  daveesupremacy, 1, 0, 1, no
785165792270749698,  tiberiom211, 6, 0, 6, no
789003725394280448,  Pocha1997_, 2, 0, 2, no
759414686072901632,  angelatub73, 1, 0, 1, no
1464376202,  TizianaAste, 1, 0, 1, no
791602493469913093,  MRitaG65, 5, 0, 5, no
2501161878,  ludimatwitt, 1, 0, 1, no
540370998,  _cusano, 1, 0, 1, no
1248853178,  clickpazzia, 2, 0, 2, no
2813738574,  OnlyRealtruthie, 1, 0, 1, no
608217046,  bartalo71, 5, 0, 5, no
69307922,  cristinabari, 2, 0, 2, no
501003185,  GianfrancoSant3, 1, 0, 1, no
698085001380937729,  deboraderai, 1, 0, 1, no
748542289853751296,  ElisaSPoulain, 3, 0, 3, no
945386772,  KalimbaClub, 1, 0, 1, no
418688411,  esangian, 2, 0, 2, no
4300612829,  ludovica_acri, 6, 0, 6, no
2296207141,  Trismoon23, 4, 0, 4, no
2339948812,  AmicoCol, 1, 0, 1, no
736664723505086464,  KahlerSabrina, 4, 0, 4, no
4386239236,  DrLMI1, 3, 0, 3, no
790626445278212096,  fedegranella, 3, 0, 3, no
743185656051081217,  SalviusJuve, 1, 0, 1, no
2594958926,  millimcafe, 2, 0, 2, no
734345496,  Fmandri87, 2, 0, 2, no
245947109,  Wasp19__, 1, 0, 1, no
79991599,  nogarin, 1, 0, 1, no
463784862,  Bugs_mv, 1, 0, 1, no
35252397,  ginaswo, 2, 0, 2, no
4139076737,  MortgageAgents1, 3, 0, 3, no
879086671,  NJMadeline, 1, 0, 1, no
112582208,  EgoAnglus, 1, 0, 1, no
767194625329209345,  Gazzotti_F, 1, 0, 1, no
162691129,  jepsantamato, 1, 0, 1, no
320168319,  Mao_Ferla, 1, 0, 1, no
91993668,  CarloCosolo, 1, 0, 1, no
449940001,  Giu_lia_18, 1, 0, 1, no
324024931,  callmykikko, 2, 0, 2, no
231433929,  Baxysam, 3, 0, 3, no
707825864,  La_Nene10, 1, 0, 1, no
417275168,  ninfadora75, 3, 0, 3, no
758984403422810112,  SandrucciJacopo, 2, 0, 2, no
2359630247,  simoVANZ, 1, 0, 1, no
2338630951,  gioperarch, 2, 0, 2, no
55817524,  IlGualty, 2, 0, 2, no
191574580,  tanocanario, 3, 1, 2, no
804384381280382976,  Vince110272, 1, 0, 1, no
56757699,  ilmattia, 1, 0, 1, no
613350364,  GherardoLiguori, 1, 0, 1, no
322699816,  attilio24, 1, 0, 1, no
1334529307,  sserinlove, 2, 0, 2, no
2256679742,  Ferraresi_V, 1, 0, 1, no
50338513,  iMoliere, 2, 0, 2, no
737526030907232256,  francesco_fonti, 13, 0, 13, no
839626670,  str_le, 3, 0, 3, no
1167459253,  MarinoRausa, 4, 1, 3, no
574642927,  montellamonica, 14, 0, 14, no
868681170,  NickRemix, 1, 0, 1, no
86611813,  aliceverdino, 2, 0, 2, no
407380746,  fracocu, 6, 0, 6, no
796442684940427266,  Ginoberna55, 3, 0, 3, no
2745513875,  hoping2000, 1, 0, 1, no
2535998835,  DemoDirettaPart, 1, 0, 1, no
802212091709026305,  StellaFedra, 1, 0, 1, no
757860425451077632,  chiodino1938, 5, 0, 5, no
1260160800,  teresa_zotta, 9, 0, 9, no
787726419149352960,  FrancyBike65, 1, 0, 1, no
972579685,  melanie_rossi, 1, 0, 1, no
896261767,  ANTONIOCIMINEL1, 2, 0, 2, no
441213910,  bellucoantonio, 1, 0, 1, no
752975877517041669,  Nella70476696, 1, 0, 1, no
364323523,  MicaOrne, 1, 0, 1, no
28352472,  WineRoland, 1, 0, 1, no
806655240,  luca_biasioli, 2, 0, 2, no
1219276116,  StefanoPetro, 2, 0, 2, no
3015183569,  zed_xx, 1, 0, 1, no
740614837647093761,  Marnev56, 3, 0, 3, no
418518953,  MichelaJandolo, 1, 0, 1, no
3367527737,  LucaBen80, 3, 0, 3, no
1727305202,  mrphantom96, 1, 0, 1, no
84890964,  ernestolacanna, 3, 0, 3, no
967057728,  RBulgarelli1, 4, 0, 4, no
4866946060,  Serena34573349, 4, 0, 4, no
1479816176,  candidopao, 14, 0, 14, no
724325815756967937,  PaxetBonumLux, 2, 0, 2, no
3002785552,  ritfernov, 1, 0, 1, no
741520828504911872,  mau240958, 5, 0, 5, no
241991497,  Aldostreppa, 1, 0, 1, no
706900272,  Maxprimis, 2, 0, 2, no
220976355,  giancriMi, 4, 0, 4, no
763291960727760897,  LaCroix240816, 2, 0, 2, no
2307403408,  arjanedda, 1, 0, 1, no
369379110,  ninobarone01, 1, 0, 1, no
969923378,  am30969, 2, 0, 2, no
559559659,  enzorsini, 1, 0, 1, no
776714498795311104,  Cesare73803790, 5, 0, 5, no
2505630769,  halabama_man, 1, 0, 1, no
1302464240,  giovannipapa31, 3, 0, 3, no
1228087620,  toninter75, 6, 0, 6, no
4076297056,  Michela93772993, 1, 0, 1, no
776144281,  simonon77, 5, 0, 5, no
2932297229,  arceri_gerardo, 1, 0, 1, no
2226319458,  LadyRanja, 2, 0, 2, no
325094307,  RizMarcoBeccari, 1, 0, 1, no
54939844,  IvanNFG, 4, 0, 4, no
242958381,  letmebex, 1, 0, 1, no
471486462,  Gab78asr, 3, 0, 3, no
701359002496716800,  MassimoAllinoro, 5, 0, 5, no
897447138,  ProfiloBoemo, 2, 0, 2, no
1107229501,  fabricoli, 1, 0, 1, no
722387472848695296,  AntiJournalT, 2, 0, 2, no
1553893082,  MarcoMarcoran, 2, 0, 2, no
704614221192044544,  PanGianpiter, 10, 0, 10, no
556307020,  MauriziaFarinel, 1, 0, 1, no
761901618107387904,  AlFango1, 2, 0, 2, no
2219220328,  loluleda, 6, 0, 6, no
2584756455,  miamarylun, 2, 0, 2, no
529759031,  ritagoi, 2, 0, 2, no
1132209026,  lucagoaten, 1, 0, 1, no
3324316822,  sergio25071964, 1, 0, 1, no
2567098531,  lauraefrican, 1, 0, 1, no
1148897880,  ArotaderomaTito, 2, 0, 2, no
2355048536,  LibanoStefano, 2, 0, 2, no
793504466007973889,  Mariasa95935048, 5, 0, 5, no
802812190411681792,  marcellinus1974, 1, 0, 1, no
2613980914,  alegreg71, 2, 0, 2, no
3397077149,  SferrinoVito, 3, 0, 3, no
2273437220,  StopoLT, 2, 0, 2, no
532609504,  palmas62, 1, 0, 1, no
147501849,  robertaperlini, 1, 0, 1, no
228335333,  Moketoveto, 4, 0, 4, no
271879224,  gashaquietstorm, 1, 0, 1, no
951890166,  vincal1, 3, 0, 3, no
1319334121,  DifendiRoma, 1, 0, 1, no
1042815667,  Nino_Damiano, 1, 0, 1, no
759292043973758976,  DukaLuli, 2, 0, 2, no
2320511389,  Robertoera75, 1, 0, 1, no
1222637010,  Michele20590389, 1, 0, 1, no
465486423,  lucianobaldassa, 1, 0, 1, no
500574143,  gianluc54097412, 2, 0, 2, no
1088672947,  serenasantoro3, 12, 0, 12, no
4538649137,  eugeniomaba, 2, 0, 2, no
1039374985,  SergioLoddo2, 1, 0, 1, no
793217482316193792,  EugeniaFrances2, 5, 0, 5, no
497238693,  MauroBregoli, 1, 0, 1, no
1928371358,  nicolettadamare, 2, 0, 2, no
87370820,  AlexMariniTN, 4, 0, 4, no
1070923920,  AlexSpe75, 2, 0, 2, no
3338378788,  GiMarfi, 3, 0, 3, no
379706636,  Yle_TheWall, 6, 0, 6, no
449635271,  DePaolino, 1, 0, 1, no
1040122507,  maury2762, 3, 0, 3, no
701338375643594752,  Fanrizio21, 1, 0, 1, no
4200248956,  gioy21, 2, 0, 2, no
1491175380,  GaetanDiLena, 3, 0, 3, no
38103794,  giallo24, 3, 0, 3, no
1246270873,  raffaelepiemon2, 6, 0, 6, no
1379208858,  ortolanloris, 1, 0, 1, no
1336067024,  TranchinaFabio, 2, 0, 2, no
1298570959,  MaScaramella, 1, 0, 1, no
785530954920161280,  Rita_M57, 1, 0, 1, no
1420741524,  stefano_dart, 1, 0, 1, no
4797691731,  arcadiocataldo1, 3, 0, 3, no
715632223664398336,  AlexDL78, 1, 0, 1, no
3346612277,  AlbertoRicciar3, 1, 0, 1, no
3957207015,  marangellamart1, 1, 0, 1, no
396497515,  Stepieru, 8, 0, 8, no
472954931,  AndreaCorea1, 1, 0, 1, no
469103936,  m_vale78, 5, 0, 5, no
4076059463,  barbara22ema30, 1, 0, 1, no
456854642,  passetour, 1, 0, 1, no
2801571939,  DistabileG, 1, 0, 1, no
1116879944,  antoniocuomo20, 1, 0, 1, no
420445452,  wlasky1000, 6, 0, 6, no
1052916824,  Ateoman2009, 2, 0, 2, no
2417297936,  francocaradonio, 1, 0, 1, no
470301475,  MontanaWalter, 2, 0, 2, no
2377259598,  M5SVibor, 3, 0, 3, no
402085531,  neviods, 1, 0, 1, no
2351795462,  rosannaeliseo, 1, 0, 1, no
100530020,  gtaffelli, 2, 0, 2, no
21276839,  mdogbillionaire, 1, 0, 1, no
3406161766,  paolo_trobbiani, 2, 0, 2, no
884964986,  SerroniMarco, 1, 0, 1, no
2534372572,  FavoniGiorgio, 2, 0, 2, no
2344846407,  CiaoNando, 6, 1, 5, no
441253433,  marco10579, 3, 0, 3, no
740493001248673792,  jovannissimo, 3, 0, 3, no
754260182713204736,  ZenzeroAcido, 1, 0, 1, no
992696286,  a_ruzzante, 1, 0, 1, no
722758789036957696,  alessio071204, 1, 0, 1, no
3131554253,  cesarevassalli, 3, 0, 3, no
3144494615,  giulrioss, 7, 0, 7, no
2910869781,  pinorussobat, 1, 0, 1, no
389430038,  Gi8M, 5, 0, 5, no
1083204576,  raissa_iannacci, 1, 0, 1, no
181119521,  marck_77, 1, 0, 1, no
1251971718,  Mazarinabroglia, 2, 0, 2, no
733599179906240513,  SartoriGiovann3, 4, 0, 4, no
465389756,  cinco84, 2, 0, 2, no
3044045152,  gluca0, 1, 0, 1, no
575630130,  MimmoPetrella, 1, 0, 1, no
155093398,  iliesyle, 3, 0, 3, no
2910727479,  respectjungle, 2, 0, 2, no
2346974944,  SArcidiacon, 2, 0, 2, no
2512880848,  mimmomarga, 1, 0, 1, no
715883458359398400,  martacasuccio1, 1, 0, 1, no
1402740133,  ldicarlo1, 1, 0, 1, no
778671333853040642,  VincenzoAscanio, 3, 0, 3, no
532545386,  giuseppemormino, 1, 0, 1, no
774226398961631232,  gcamiciotti1, 1, 0, 1, no
741622785122930688,  Clara33517091, 6, 0, 6, no
390752714,  coar87, 1, 0, 1, no
4902430509,  nono_b_28, 2, 0, 2, no
1017977773,  chiaraturchi63, 1, 0, 1, no
1131283195,  ElleLuciotto, 1, 0, 1, no
1063725882,  palumbo_carlo, 4, 0, 4, no
2330094224,  LoDiChi, 2, 0, 2, no
4615130548,  Monicamelloni1, 4, 0, 4, no
3433894977,  mazzeoemanuele1, 3, 0, 3, no
708280503795851264,  e_scarpino, 2, 0, 2, no
2631193317,  SpecaDaniela, 1, 0, 1, no
387770884,  M5SROMA14, 7, 0, 7, no
1077077449,  M5SRoma7, 7, 0, 7, no
2234825179,  2MunicipioRoma, 7, 0, 7, no
1362048522,  M5SRomaIV, 7, 0, 7, no
2343427327,  M5SRomaVIII, 7, 0, 7, no
871504855,  M5SROMAVI, 7, 0, 7, no
903430776,  M5SRomaXII, 7, 0, 7, no
472928902,  M5SROMAX, 7, 0, 7, no
1088527944,  M5SROMAV, 7, 0, 7, no
1026985548,  marcello_devito, 8, 0, 8, no
20736494,  max1mo4you, 6, 0, 6, no
1122681396,  M5SRomaXV, 7, 0, 7, no
1346721164,  M5SRXI, 7, 0, 7, no
131292189,  M5SRoma, 7, 0, 7, no
607286270,  M5SRoma9, 7, 0, 7, no
946701314,  M5SRoma1, 7, 0, 7, no
2308628263,  M5SRoma13, 7, 0, 7, no
3695701275,  robertoedue, 1, 0, 1, no
234929591,  poeboston, 2, 0, 2, no
798213135803023360,  AlessandroConi6, 2, 0, 2, no
1316027886,  a_ultimo, 3, 0, 3, no
1225904144,  yallama1, 2, 0, 2, no
2382424494,  gepy61, 2, 0, 2, no
2466339133,  Alfa_Phi, 2, 0, 2, no
738108664033185792,  Roma66056163, 3, 0, 3, no
20446798,  giampaolo19, 1, 0, 1, no
2305637082,  adrysns916, 2, 0, 2, no
3790217597,  pierrotriste, 3, 0, 3, no
3833401401,  ZweiundDreiszig, 1, 0, 1, no
746936386754912256,  ciccio846, 4, 0, 4, no
129576770,  stefbianchi, 1, 0, 1, no
715634542363729920,  kemalerdem777, 3, 0, 3, no
4872044806,  MassimoAlibert2, 1, 0, 1, no
711066251,  csa1976, 3, 0, 3, no
404405791,  Juvecele, 1, 0, 1, no
476179115,  CiccioPace, 5, 0, 5, no
3387234539,  thomasulmers, 1, 0, 1, no
730372688003338240,  ritabrigidaM5S, 3, 0, 3, no
401324048,  ClaudioFratini, 3, 0, 3, no
740094487,  gioiaeodio, 1, 0, 1, no
134058065,  DotIngAleFroc, 1, 0, 1, no
59069716,  Micslama, 2, 0, 2, no
714814345100791808,  LisaMartoni2015, 4, 0, 4, no
4919384266,  luludisa1969, 5, 0, 5, no
792646804751970304,  Marco_Giorgilli, 2, 0, 2, no
1435611025,  The_Rain_Man, 2, 0, 2, no
764752555834474496,  Retwitto_stelle, 2, 0, 2, no
2157178129,  LilloSferio, 2, 0, 2, no
3404959493,  Oshakowski, 3, 0, 3, no
422646984,  EzioFederici, 1, 0, 1, no
784829184682106880,  DaniloAsr1979, 1, 0, 1, no
722164688340049920,  Wendyluglio, 1, 0, 1, no
122520593,  chiamatemistiv, 3, 0, 3, no
505733936,  emiliano_po, 3, 0, 3, no
2158629268,  paoloemilius, 1, 0, 1, no
2905060763,  tizakamario, 2, 0, 2, no
777501425576341504,  Roberto74365145, 1, 0, 1, no
368574158,  paolocolocci, 6, 0, 6, no
1266769243,  BattDe, 1, 0, 1, no
1086912564,  fortealfredo70, 2, 0, 2, no
3481510162,  MarcoMosc1, 5, 0, 5, no
604451498,  czstratocaster, 2, 0, 2, no
15943109,  emanuel3, 1, 0, 1, no
1322452531,  francoamatulli1, 2, 0, 2, no
3293224625,  Atreyu976, 1, 0, 1, no
3311604711,  perlacasa01, 1, 0, 1, no
564429315,  DavideDelprato, 1, 0, 1, no
107082839,  MaryDil, 1, 0, 1, no
787235942,  charl1853, 2, 0, 2, no
789980429155721217,  RParodirg1, 2, 0, 2, no
2849986283,  mariacr76934354, 1, 0, 1, no
291245199,  adigiamba, 5, 0, 5, no
4277803971,  marcellocustom1, 1, 0, 1, no
486664655,  paoloviancini, 2, 0, 2, no
184747714,  gregory_cocco, 5, 0, 5, no
513790402,  diStasioStefano, 1, 0, 1, no
132432431,  romacaput_mundi, 1, 0, 1, no
2304409155,  MMartelli6, 1, 0, 1, no
485148799,  sherasade1958, 2, 0, 2, no
2301498411,  ginocicchini, 1, 0, 1, no
774239929865998336,  giorgio21507586, 1, 0, 1, no
3131529981,  riccardomich, 6, 0, 6, no
4318412477,  ClaudiaFische, 5, 0, 5, no
2707579435,  frappapara, 1, 0, 1, no
2472444574,  GrandoRoberto, 2, 0, 2, no
4610380588,  ilenewinkler201, 4, 0, 4, no
2276807984,  infobixio, 1, 0, 1, no
359861181,  CarloCarlo199, 2, 0, 2, no
4608384377,  annarighi15, 4, 0, 4, no
1037401735,  oleksandr69, 1, 0, 1, no
1719352879,  giggiodelprete, 2, 0, 2, no
989571222,  ANTONIOZOPPELLO, 2, 0, 2, no
455042529,  Assuntina54, 4, 1, 3, no
472222755,  stefaniarain, 1, 0, 1, no
444613355,  ramon7856, 3, 0, 3, no
392332017,  IShehi, 1, 0, 1, no
4189113322,  ma_ki_max, 1, 0, 1, no
2842602671,  MargheChiti, 1, 0, 1, no
76906137,  MarcelloPorcasi, 6, 0, 6, no
2356613778,  ArturoForlano, 1, 0, 1, no
3939868781,  VIIcomandamento, 2, 0, 2, no
3435357142,  Juandoc2, 1, 0, 1, no
785379659466899456,  SaraWmenica, 3, 0, 3, no
1225470488,  marioazzolina, 1, 0, 1, no
800163036,  peppealoax, 3, 0, 3, no
377872873,  3filetti, 4, 1, 3, no
473046356,  Hanry12, 1, 0, 1, no
2243577362,  rob_arci, 1, 0, 1, no
1222653246,  pie13748, 13, 0, 13, no
1893283914,  ghisla99, 2, 0, 2, no
1876846094,  GrilliniArdea, 5, 0, 5, no
4775690980,  amoredemamma, 1, 0, 1, no
419823209,  Barbara19691, 1, 0, 1, no
2984820215,  CianoLeone, 5, 0, 5, no
392324691,  gianmaria2011, 6, 0, 6, no
794277942427844616,  Davebrignoli, 1, 0, 1, no
8620162,  apecar, 2, 0, 2, no
1100581142,  1957Elton, 1, 0, 1, no
703776920,  felicemarano, 3, 1, 2, no
3026638931,  DKiupp, 6, 0, 6, no
407187512,  AnninaLubbock, 1, 0, 1, no
796058021784879104,  carmelo96811844, 3, 0, 3, no
1002163952,  CondottiG, 1, 0, 1, no
1440629558,  nunziabonita, 3, 0, 3, no
359899396,  Ellibec, 1, 0, 1, no
2543645621,  maurodellanna, 1, 0, 1, no
4873134448,  guiderdone57, 1, 0, 1, no
382015339,  giufechi2003, 1, 0, 1, no
716719928028631040,  angfra1998, 1, 0, 1, no
3419625731,  Ben68011410, 3, 0, 3, no
3384524717,  nomoreviction, 1, 0, 1, no
2689925565,  rosalbacola50, 5, 0, 5, no
488533911,  FrancescoRizz22, 1, 0, 1, no
1321212242,  gengj78, 1, 0, 1, no
1487351570,  SpagnoloPaola, 3, 0, 3, no
1026241580,  ludesa30, 3, 0, 3, no
798216901071687680,  PistolaMauro1, 1, 0, 1, no
1713720703,  Nonno_Carlo, 2, 0, 2, no
3057522160,  FerrettoLorenzo, 1, 0, 1, no
1551364297,  alem4you, 1, 0, 1, no
700664229376847874,  pascal777rm, 2, 0, 2, no
459556967,  antonietta_giu, 1, 0, 1, no
364797484,  mikosemily, 7, 0, 7, no
4259508101,  MauroMoretti20, 4, 0, 4, no
1719318895,  CarloFiscalini1, 5, 0, 5, no
2847131057,  echopetra, 1, 0, 1, no
805179730110611457,  valenzia2202, 1, 0, 1, no
1244059747,  sancit71, 1, 0, 1, no
706793935180537857,  AMProbo, 3, 0, 3, no
251351863,  MarieFarret16, 1, 0, 1, no
774625071059050496,  Lazzaro1969, 1, 0, 1, no
517751958,  benlau99, 3, 0, 3, no
3236866227,  dangelofra1, 1, 0, 1, no
488618381,  Claudio_M5S, 4, 0, 4, no
723877334,  margheritini, 2, 0, 2, no
143590548,  FabbioSabatini, 1, 0, 1, no
2270253242,  CarmineC_, 3, 0, 3, no
2238091980,  Port1Di, 1, 0, 1, no
3372717964,  lilly29princess, 7, 0, 7, no
1077453158,  ziccla, 1, 0, 1, no
612314316,  afab69, 5, 0, 5, no
376307086,  iulius1980, 1, 0, 1, no
83904123,  MelToBeWilde, 3, 0, 3, no
454921223,  marco_tufo, 1, 0, 1, no
406165467,  FRAtiminoRI, 1, 0, 1, no
1099414640,  PaoloPaolor, 2, 0, 2, no
3147687143,  max_ostia, 1, 0, 1, no
1861601461,  Oblio62, 1, 0, 1, no
4622433142,  saraantonelli15, 4, 0, 4, no
3047948086,  DalfinoMarcello, 2, 0, 2, no
414554793,  AlePizzuti, 3, 0, 3, no
471151069,  photovale21, 1, 0, 1, no
2400697528,  ImIvano, 2, 0, 2, no
586539054,  deltavictor75, 1, 0, 1, no
430166728,  domenicopiro, 1, 0, 1, no
2361454653,  OfficinaCrima, 2, 0, 2, no
3394746226,  alexandercaper1, 2, 0, 2, no
266198278,  max_tir, 2, 0, 2, no
235831481,  Michelle_rv604, 6, 0, 6, no
483854366,  ElioDiBella, 4, 0, 4, no
164235748,  magara77, 2, 0, 2, no
988029930,  brunaperrini, 4, 0, 4, no
747491522413731840,  andrelapeste, 1, 0, 1, no
1369959745,  diegodettodedy, 1, 0, 1, no
507971362,  ita991, 1, 0, 1, no
742113352319705088,  antongiglio, 1, 0, 1, no
878518842,  MykyCorsari, 1, 0, 1, no
1938878952,  Romule10, 2, 0, 2, no
78392326,  ilbanale, 1, 0, 1, no
189880084,  ferruccio_p, 4, 0, 4, no
3151556691,  clodraiola, 1, 0, 1, no
577122304,  giodarcoonlus, 1, 0, 1, no
3172743856,  dionisimattia, 2, 0, 2, no
4863913085,  bici_live, 4, 0, 4, no
925999238,  jacopocitterio, 1, 0, 1, no
1228542182,  gingimela, 1, 0, 1, no
336555320,  didimanc, 1, 0, 1, no
759734861586325505,  alessandro41168, 1, 0, 1, no
216759861,  simonarocchi, 1, 0, 1, no
3136221652,  marcoluch, 3, 0, 3, no
4624659274,  margherita7799, 3, 0, 3, no
55220422,  anneriittac, 1, 0, 1, no
797567182666350594,  rita74angelini, 1, 0, 1, no
2337708335,  T1z1an0, 17, 0, 17, no
229160327,  marcoranieri72, 4, 0, 4, no
125962407,  a_elle, 2, 0, 2, no
121553628,  Danitosc, 1, 0, 1, no
783344169041485825,  CesarinoTassoni, 1, 0, 1, no
20802488,  veloroo, 2, 0, 2, no
3962676802,  mmspm1403, 2, 0, 2, no
2176226463,  Passa92W, 1, 0, 1, no
553959228,  AlbertoIlaria, 9, 0, 9, no
1053530935,  LorenzoZamburru, 1, 0, 1, no
178803896,  grimmo78, 1, 0, 1, no
501982093,  icouldbeDebbie, 1, 0, 1, no
202166644,  gcarrarm, 3, 1, 2, no
1288422541,  giulioriotta, 3, 0, 3, no
399366563,  Biziov69, 1, 0, 1, no
456782206,  dgsquare2, 1, 0, 1, no
426849929,  FBXII, 2, 0, 2, no
478124356,  ellepuntopi, 1, 0, 1, no
521674910,  wimjsi, 3, 0, 3, no
2810187580,  verocorniciaio, 2, 0, 2, no
54661587,  voiager33, 1, 0, 1, no
1039609963,  RAFFAELLAMILAN1, 1, 0, 1, no
3048022054,  picc_pic, 1, 0, 1, no
498306432,  Sarirana84, 1, 0, 1, no
574738634,  MANCU_LI_CANI, 1, 0, 1, no
1018057250,  CarlottaGrande1, 1, 0, 1, no
1104420319,  CarlaRusin, 7, 0, 7, no
264429396,  antodicarlo, 1, 0, 1, no
15968004,  walterfantauzzi, 1, 0, 1, no
1710490044,  luisannamesseri, 2, 0, 2, no
622755007,  alessandropaso, 1, 0, 1, no
2279333173,  orsomarrone, 5, 0, 5, no
800699105118810112,  Albani_Hills, 3, 0, 3, no
3169890556,  CardilliClaudia, 1, 0, 1, no
422607723,  SaraCanducci, 1, 0, 1, no
432779927,  maxcarlesimo, 5, 0, 5, no
292260257,  AgostiniValeria, 1, 0, 1, no
604690306,  soniamarghe, 1, 0, 1, no
4738484242,  tella_free, 1, 0, 1, no
387165791,  diannaftlea, 2, 0, 2, no
795410113544802304,  andrea_tropeano, 1, 0, 1, no
2803441027,  TinaDasti, 3, 0, 3, no
186593878,  ClotiOrny, 1, 0, 1, no
1168778490,  Flori92, 1, 0, 1, no
907919298,  angqwe, 1, 0, 1, no
702809833,  soloaivlis, 1, 0, 1, no
1377883285,  Angelo_Bruno89, 1, 0, 1, no
805884499032739844,  roxydimaggio, 2, 0, 2, no
2252373657,  Fba966, 1, 0, 1, no
1333771333,  wannabefritzl, 2, 0, 2, no
285009953,  gaetanodemare, 3, 0, 3, no
491288320,  Kekkazzolekappa, 2, 0, 2, no
801507896165093376,  Rickii70, 1, 0, 1, no
1259204922,  FabFilizzola, 1, 0, 1, no
3430718068,  urbanmirrors, 1, 0, 1, no
1420699964,  PazzoGabbiano, 1, 0, 1, no
772722230761578496,  angeloaaa86, 1, 0, 1, no
1894932806,  francy6510, 4, 0, 4, no
2481673542,  FrancediSabato, 1, 0, 1, no
14840162,  fitsnews, 1, 0, 1, no
754075116783435781,  RosannaCatalan7, 2, 0, 2, no
747000185977507840,  krolsandrine, 1, 0, 1, no
801326327395708928,  silashinafn, 1, 0, 1, no
1558070772,  Mic_DAlessio, 1, 0, 1, no
2262704766,  LuigiPezzulo73, 1, 0, 1, no
515611930,  MarinoDalia, 1, 0, 1, no
758282229487398912,  ocusfocus5, 1, 0, 1, no
387762782,  erasmodaroma, 9, 0, 9, no
397366465,  StontoGrazia, 4, 0, 4, no
2578134970,  enricomorg77, 4, 0, 4, no
4835104781,  MiCozzoli, 1, 0, 1, no
3130577031,  diarioromano, 4, 0, 4, no
1306999220,  RQuadrano, 1, 0, 1, no
316033868,  simonapedone1, 1, 0, 1, no
570076370,  BrunoBattaglia6, 1, 0, 1, no
912248084,  gian_3vi, 4, 0, 4, no
717651068759511044,  FabrizioRusso, 1, 0, 1, no
52352441,  santre1977, 5, 0, 5, no
2332474422,  Rafdec59, 1, 0, 1, no
555851815,  cristianopiccin, 1, 0, 1, no
1032345572,  rossellafaragli, 1, 0, 1, no
805875199707062272,  ZioBruto, 1, 0, 1, no
487099777,  Liloia3, 2, 0, 2, no
191473946,  VeryConde, 1, 0, 1, no
460297979,  duty62, 1, 0, 1, no
552944751,  Silvano_DB, 1, 0, 1, no
1001731381,  ascoliroberto, 1, 0, 1, no
358089042,  Lorenzaccio73, 1, 0, 1, no
2786098415,  domavo1, 1, 0, 1, no
492970032,  salvatorbruno, 3, 0, 3, no
397972599,  Marcokata, 1, 0, 1, no
803259533036519424,  saveMetroC, 1, 0, 1, no
787899548555440128,  NicolettaLosac2, 1, 0, 1, no
1624989181,  gabbroka, 12, 0, 12, no
196495188,  Coline80, 1, 0, 1, no
710844636160507906,  davidemaestri, 1, 0, 1, no
805820287384244224,  FabioDiRicco1, 1, 0, 1, no
161462044,  gnovelli, 4, 0, 4, no
190963245,  FidelisMaximus, 1, 0, 1, no
702273345472090113,  enzoroncelli, 2, 0, 2, no
104061714,  gatrbait, 1, 0, 1, no
121068845,  zac1967, 1, 0, 1, no
1899972746,  ml__75, 6, 0, 6, no
123374600,  MattiaArdizio, 1, 0, 1, no
586806065,  m_dellachiesa, 1, 0, 1, no
541650578,  gaetanoministru, 2, 0, 2, no
726765581375037441,  catepoggi, 1, 0, 1, no
65933264,  LucaCelli, 1, 0, 1, no
2644280985,  luisa_pieroni, 1, 0, 1, no
2319529177,  editoriale24, 2, 0, 2, no
555791920,  FabioPetrich, 2, 0, 2, no
3304830435,  romatristezza, 11, 0, 11, no
490422216,  i_danesi, 2, 0, 2, no
783064901275222017,  Simoneuno1, 1, 0, 1, no
1016052702,  EldaLeBras, 2, 0, 2, no
742503230828126208,  drow_it, 1, 0, 1, no
791279209,  gianluca_basso7, 1, 0, 1, no
84132807,  fran78rm, 3, 0, 3, no
2898244047,  love_simon8, 5, 0, 5, no
537442556,  VenturiMaurizio, 2, 0, 2, no
599497975,  AndreaCantoro8, 1, 0, 1, no
523251306,  michelecolucci3, 1, 0, 1, no
402911478,  manuelnigriello, 1, 0, 1, no
792636693367119872,  sandro_bassani, 2, 0, 2, no
804208006254755842,  Marco16324439, 1, 0, 1, no
1265172517,  Toni_ct_1, 1, 0, 1, no
981599204,  FabrizioPititto, 4, 0, 4, no
2227467541,  misbilancio, 1, 0, 1, no
540983116,  vizoslow, 1, 0, 1, no
3351944151,  cassisifrancy, 1, 0, 1, no
3456756437,  LucaColla3, 1, 0, 1, no
803511145021800448,  altablaif, 1, 0, 1, no
2679606969,  elena_mosti, 1, 0, 1, no
781635668195827716,  _francesco_1980, 1, 0, 1, no
147200306,  TonyPostak, 1, 0, 1, no
702629084099121153,  AVulpi1, 4, 0, 4, no
249859759,  CinqueNews, 1, 0, 1, no
769202373919117312,  DesTruesdale, 3, 0, 3, no
555956189,  ThomasSelyem, 1, 0, 1, no
2893190685,  Bbs10San, 1, 0, 1, no
536395566,  AngeloSturni, 4, 0, 4, no
4449971849,  vintes18, 1, 0, 1, no
282047688,  FabianaL_, 1, 0, 1, no
1210086031,  AssuntaBurro, 3, 0, 3, no
337624301,  XtizioX, 1, 0, 1, no
1726446366,  davidvallone1, 3, 0, 3, no
4850581731,  sesasaila5, 3, 0, 3, no
3093375483,  gianluca_sant, 2, 0, 2, no
855221910,  marilenasposato, 3, 0, 3, no
1317079993,  patopancha, 2, 0, 2, no
1040908952,  emiliano______, 2, 0, 2, no
337956523,  LucaNobili, 1, 0, 1, no
1286702522,  marez60, 1, 0, 1, no
147725370,  Euippa, 2, 0, 2, no
2473348917,  gidolo, 3, 1, 2, no
1628219264,  PPellizzieri, 3, 0, 3, no
708008057981247488,  dajeeeeeeeeee, 6, 0, 6, no
1550772164,  Cindycatura, 1, 0, 1, no
716259299,  sarainnocenti80, 1, 0, 1, no
471777128,  Luciano_Jethro, 1, 0, 1, no
2294569309,  Tittypolly, 1, 0, 1, no
40638218,  Rossana_Capo, 1, 0, 1, no
316634046,  CarmeloSardo, 1, 0, 1, no
3158016406,  borghi75, 6, 0, 6, no
2180726666,  realepatrizia2, 2, 0, 2, no
9564632,  Moscerina, 1, 0, 1, no
482924290,  francolai2, 2, 0, 2, no
839726317,  GiusTW, 4, 0, 4, no
3188590067,  AgrippineRomana, 2, 0, 2, no
4452315099,  MarisaConca, 3, 0, 3, no
367398011,  faustini_f, 1, 0, 1, no
739689246953443328,  sonianaldi, 1, 0, 1, no
4656294467,  lumacaperforza, 2, 0, 2, no
1221210116,  SNurchis, 1, 0, 1, no
437652304,  risolina70, 2, 0, 2, no
17201066,  Di_Elle, 1, 0, 1, no
491048774,  cicciosergio, 1, 0, 1, no
515657617,  dodouran, 2, 0, 2, no
443068722,  spucho_, 1, 0, 1, no
464217456,  gustamiblog, 7, 0, 7, no
757230229740019712,  tricheco23, 1, 0, 1, no
1615832094,  salvouno1, 1, 0, 1, no
211631890,  STATUSPANGEA, 4, 0, 4, no
408047823,  gabrielapelis, 1, 0, 1, no
554197569,  Dyno78C, 1, 0, 1, no
540531263,  GabryPery, 3, 0, 3, no
703879093,  GiampyRin, 1, 0, 1, no
2502313861,  LivioEvelina, 2, 0, 2, no
3065989288,  DukDaffe, 8, 0, 8, no
1386811099,  LeoCapasso80, 4, 0, 4, no
395980701,  FrancescoMuti, 1, 0, 1, no
1010758932,  63Jump, 3, 0, 3, no
4406327014,  barone_fidanza, 2, 0, 2, no
2893649607,  kramerlengo, 2, 0, 2, no
75996547,  My_ROMA, 1, 0, 1, no
3568308916,  dafirendaflames, 1, 0, 1, no
118727314,  verdecardamomo, 1, 0, 1, no
2504371264,  LuisaPelati, 3, 0, 3, no
890672678,  vittorio_campus, 3, 0, 3, no
174197510,  heinemotogiamma, 1, 0, 1, no
772876315909324801,  Gemmasarda59, 1, 0, 1, no
4548006215,  fabry6314, 1, 0, 1, no
4785550396,  mauriziebasta, 1, 0, 1, no
110180072,  fenix71ita, 1, 0, 1, no
705338935476674560,  SergioBrigatti2, 1, 0, 1, no
369175285,  dodici75, 1, 0, 1, no
317761058,  Romulus1951, 1, 0, 1, no
445485530,  maxpat72, 2, 0, 2, no
798187756761546752,  Maia35423726, 1, 0, 1, no
4294251033,  mattiadesso1, 1, 0, 1, no
2188769004,  thedok978, 1, 0, 1, no
575374344,  7didenari, 1, 0, 1, no
1045175822,  nicolamosele, 1, 0, 1, no
302054401,  marilensias, 1, 0, 1, no
982166486,  MLuizaBottolin, 1, 0, 1, no
2765385220,  RArnesano, 1, 0, 1, no
3311120861,  Soledad_0891, 2, 0, 2, no
700786170423353346,  mibi05, 4, 0, 4, no
637245026,  ClaudioMarsilio, 1, 0, 1, no
3732226162,  fedezucc, 1, 0, 1, no
2936690493,  borzagiov, 2, 0, 2, no
55893052,  spinosoo, 2, 0, 2, no
2488407674,  LaviKyvernitis, 1, 0, 1, no
484943965,  cuorepensante1, 1, 0, 1, no
1084397318,  IXgennaio1900, 1, 0, 1, no
425060148,  ineziessenziali, 1, 0, 1, no
1160757192,  albertoaugelli, 1, 0, 1, no
3037477287,  fontan_rose, 2, 0, 2, no
3094987240,  CelestinaAriano, 1, 0, 1, no
389490141,  TWImedmar, 2, 0, 2, no
488767725,  pretoriano75, 2, 0, 2, no
448872666,  BenassaiGioia, 3, 0, 3, no
2237033255,  26aprile, 3, 1, 2, no
224973785,  l_piacco, 1, 0, 1, no
51802390,  christiank79, 1, 0, 1, no
227438020,  AliciaDede, 1, 0, 1, no
847991659,  ANGELOPANZERA, 2, 0, 2, no
726281638821412865,  Pieroma64, 1, 0, 1, no
392046617,  peppesta, 2, 0, 2, no
740477506164297732,  john__pemberton, 2, 0, 2, no
997232677,  fabertwt, 1, 0, 1, no
337240318,  ginetorz, 2, 0, 2, no
1457535378,  scardinoCa, 2, 0, 2, no
803873999960817664,  ChiaraNari88, 1, 0, 1, no
741625059123601408,  AntonioLattanz9, 1, 0, 1, no
2195380902,  CTorSapienza, 3, 0, 3, no
1441381885,  romasociale, 1, 0, 1, no
736963801258549256,  ClorindaCerzino, 1, 0, 1, no
398319264,  AlfioSerafico, 2, 0, 2, no
887469692,  anatana69, 2, 0, 2, no
516722369,  pubcomm, 1, 0, 1, no
2509432657,  FabioFra81, 1, 0, 1, no
2844932132,  mirkogranci, 1, 0, 1, no
103809135,  miandefoe, 4, 0, 4, no
187206647,  Saiax, 1, 0, 1, no
1264115138,  maione_ma, 1, 0, 1, no
487937304,  cri_tofani, 2, 0, 2, no
15806786,  tdhitaly, 1, 0, 1, no
627306800,  VittorioLupi, 1, 0, 1, no
2270280739,  Toblin_, 1, 0, 1, no
3805232716,  DanielePerri969, 1, 0, 1, no
417624241,  daniloscalise, 1, 0, 1, no
3243326117,  quota33M, 1, 0, 1, no
131446695,  23piddu, 2, 0, 2, no
3101475160,  pietropaolo1967, 1, 0, 1, no
390622504,  PrimoMapelli, 1, 0, 1, no
2512945530,  osvaldoluci, 1, 0, 1, no
3001519506,  ethanrwilkinson, 1, 0, 1, no
255612179,  elibari64, 5, 0, 5, no
337250925,  AmedeoLevorato, 1, 0, 1, no
577410791,  emiliomassari, 1, 0, 1, no
585655442,  tinammen, 1, 0, 1, no
4076693128,  nosenzo_mauro, 5, 0, 5, no
3064021768,  notteblanca, 3, 0, 3, no
2592691565,  roland_agosta, 1, 0, 1, no
130113390,  Francymela, 3, 0, 3, no
323672484,  a_aurigemma, 1, 0, 1, no
2938609954,  ScapigliatiD, 1, 0, 1, no
1972968930,  arastet77, 1, 0, 1, no
2433420551,  Pascquino, 1, 0, 1, no
1894190204,  paolodeluca296, 1, 0, 1, no
19623421,  sel99, 4, 0, 4, no
539238012,  CoppiniGiuliano, 2, 0, 2, no
166094661,  fedetia, 2, 0, 2, no
2721276416,  lumandre1, 3, 0, 3, no
457775543,  bichosbradipo, 1, 0, 1, no
8356242,  FedericoLukkini, 5, 0, 5, no
1263019249,  MarcoPalumbo66, 2, 0, 2, no
712583139,  DalColGabriele, 1, 0, 1, no
3022778475,  vittoriamancin4, 1, 0, 1, no
8851612,  Principegentile, 1, 0, 1, no
4234014981,  Alessiotto71, 1, 0, 1, no
207169955,  Giuspa78, 6, 0, 6, no
1089742220,  danzica64, 1, 0, 1, no
174919256,  eddydsb, 1, 0, 1, no
729616747272245248,  riparinigiulia, 1, 0, 1, no
432566115,  abunabuana, 1, 0, 1, no
1161138678,  Marcoblacks76, 2, 0, 2, no
800264905,  ranocchietta44, 1, 0, 1, no
77825880,  virgigullo, 1, 0, 1, no
430161001,  conni3bis, 3, 0, 3, no
4784306960,  verdini_mario, 2, 0, 2, no
634881669,  bluelaskin, 1, 0, 1, no
2319141767,  Alicia_Smith19, 2, 0, 2, no
2780281767,  MarisolPix, 1, 0, 1, no
317628440,  muchodanger, 6, 0, 6, no
781531805245640704,  Enza83850952, 1, 0, 1, no
4804242813,  MImpossibile, 1, 0, 1, no
384272086,  s_farfarelli, 2, 0, 2, no
1023264421,  FelicettiKevin, 2, 0, 2, no
3428800613,  pasquale_elia2, 1, 0, 1, no
3949254442,  AleVecchi, 1, 0, 1, no
1875965089,  Begalino82, 3, 0, 3, no
397193378,  AlessandroBoxx, 1, 0, 1, no
416552940,  Nico_Lucc, 1, 0, 1, no
478752867,  Mick_64, 1, 0, 1, no
2843525403,  FdamelioD, 1, 0, 1, no
184000199,  fabioambrosi, 1, 0, 1, no
796268494589493248,  Piomele4, 1, 0, 1, no
586869426,  psetteseven, 1, 0, 1, no
520662652,  erne1976, 2, 0, 2, no
4808531415,  alessandrastan6, 1, 0, 1, no
869514487,  Popagni, 1, 0, 1, no
3005755821,  Imperiabruno, 1, 0, 1, no
2415932786,  Ginetto53, 1, 0, 1, no
3197941023,  MarcStir, 3, 0, 3, no
3119564260,  doStrudel, 3, 0, 3, no
4594827853,  gplai1957, 1, 0, 1, no
4706693655,  tonino62222127, 1, 0, 1, no
712535686751121409,  mathena1234567, 1, 0, 1, no
3109964067,  annelory84, 1, 0, 1, no
174574401,  fabri_ross, 4, 0, 4, no
1527948434,  amicidibeppeva, 1, 0, 1, no
2545572317,  7795b9ae93a3497, 2, 0, 2, no
446942856,  LucaMezzo, 7, 0, 7, no
720247033404203008,  peppe031955, 1, 0, 1, no
24608545,  Markus70, 1, 0, 1, no
550398209,  AlfDonatucci, 2, 0, 2, no
773215488,  Melchin10, 1, 0, 1, no
429313221,  RosannaStanco, 1, 0, 1, no
50232653,  fioranialex, 3, 0, 3, no
737756994854125568,  kiaretta1886, 1, 0, 1, no
543495055,  FrancoLaurie, 3, 0, 3, no
1022215518,  Giorgio_ciarni, 1, 0, 1, no
165161686,  sabrinaangelini, 1, 0, 1, no
114899241,  BenjaminBakouch, 1, 0, 1, no
444121705,  MicheleVigliot1, 1, 0, 1, no
1101543078,  dagostino01, 1, 0, 1, no
1299121968,  AndreaCoiaM5S, 1, 0, 1, no
846625280,  Diego_VegaRojas, 1, 0, 1, no
714148965,  Lucas121279, 1, 0, 1, no
187521367,  kitkatsmexw, 1, 0, 1, no
3020513836,  siamostufi81, 3, 0, 3, no
80130808,  FranciBonardi, 1, 0, 1, no
4612373962,  seb_vivien, 1, 0, 1, no
37664215,  Monicabart, 1, 0, 1, no
401552240,  MicheleCori, 1, 0, 1, no
2321443642,  simonegrillo86, 1, 0, 1, no
479653294,  paolofranci17, 2, 0, 2, no
4098206903,  ChrisKaramazov, 2, 0, 2, no
1435333154,  ugociro, 1, 0, 1, no
803262969064947712,  PileofPhone, 1, 0, 1, no
568078380,  ArmagideonTimes, 5, 0, 5, no
805750811557064705,  persico60, 1, 0, 1, no
2150559813,  ge_francesca, 2, 0, 2, no
4026982535,  MassimoSilla_, 1, 0, 1, no
2208843094,  AsteTiziana, 1, 0, 1, no
3186148157,  letizia2511, 1, 0, 1, no
450779740,  ShadeOfInsanity, 1, 0, 1, no
934308690,  Giuseppeamb, 1, 0, 1, no
3503667437,  Alice__175, 1, 0, 1, no
353552872,  BarbaraFerrini, 2, 0, 2, no
776157810061086722,  mal_erba, 1, 0, 1, no
2410129514,  Raffaele_12, 2, 0, 2, no
2191117734,  peer_paulsen, 1, 0, 1, no
3226405349,  CAlfano69, 2, 0, 2, no
1353938107,  geometrapiras, 1, 0, 1, no
2202371624,  Jefd573, 3, 0, 3, no
484881564,  IMalaguti, 3, 0, 3, no
1381449618,  tibiaeperone, 1, 0, 1, no
490667441,  gianlucadallost, 1, 0, 1, no
787703409969336320,  neko759, 3, 1, 2, no
421003837,  giaffa86, 1, 0, 1, no
738955727339986944,  Fiddledeedee01I, 2, 0, 2, no
4623838474,  blackshrimp00, 1, 0, 1, no
832113828,  Rosegalwines, 1, 0, 1, no
751904098987966464,  supershila81, 4, 0, 4, no
2945586671,  advoreloux, 1, 0, 1, no
2286684400,  Official_RdF, 1, 0, 1, no
36342469,  Lalimpi, 1, 0, 1, no
3234130441,  eliodevito80, 1, 0, 1, no
728969390163677185,  Angelo42303508, 4, 0, 4, no
428226738,  gattobagnato, 7, 0, 7, no
1166066197,  RenzulliGabri, 1, 0, 1, no
490623980,  antonio090761, 2, 0, 2, no
14308495,  SalBer, 1, 0, 1, no
410220846,  Astro211, 1, 0, 1, no
482809660,  avvmonaco, 1, 0, 1, no
337727921,  AlessioLT, 3, 0, 3, no
236829486,  elenavellutini, 1, 0, 1, no
708471552958795776,  Unifi1Onenation, 1, 0, 1, no
1103402550,  Katys_hug, 1, 0, 1, no
3077192037,  andreceandre, 1, 0, 1, no
211284738,  WWE_ILARIA, 1, 0, 1, no
1095726703,  blogesquilino, 1, 0, 1, no
587639074,  morfurio, 1, 0, 1, no
706940531495051264,  tabata7193, 1, 0, 1, no
564075796,  enrydamy, 1, 0, 1, no
2258116508,  MarioGringos, 1, 0, 1, no
2263144866,  delfratecesare, 2, 0, 2, no
1573630574,  alleluhia68, 1, 0, 1, no
266046192,  caramella2683, 1, 0, 1, no
1539197671,  DVYLAN91, 1, 0, 1, no
555754229,  crissyluna, 1, 0, 1, no
2383649104,  Giumas79, 1, 0, 1, no
2946199577,  MarinelloGiusy, 1, 0, 1, no
2502465806,  angela_amalia, 1, 0, 1, no
376169060,  Vix85gk, 1, 0, 1, no
760755097882198016,  massimo_fornari, 2, 0, 2, no
1890129044,  DarkmanUomonero, 2, 0, 2, no
452272820,  angytarquini, 2, 0, 2, no
500802902,  23Modica, 1, 0, 1, no
2379902109,  valereds79, 2, 0, 2, no
4418988976,  5Secondzofbaek, 6, 0, 6, no
4033900996,  xgxxlxx, 1, 0, 1, no
1707243738,  VMatteo75, 2, 0, 2, no
3345525249,  ChecchiFlaminia, 2, 0, 2, no
371278555,  Gaetano_LoTurco, 1, 0, 1, no
2955027305,  _ovunquesiaH, 1, 0, 1, no
2980874405,  dr_danielepagan, 1, 0, 1, no
531024722,  Iksander47, 1, 0, 1, no
711673577318309888,  DanielePetroce3, 1, 0, 1, no
472272055,  GiusyColonna, 1, 0, 1, no
431076305,  _indieliu, 1, 0, 1, no
1148898289,  emiliolamp, 3, 0, 3, no
3298233473,  dieghito990, 1, 0, 1, no
552132820,  leo_forleo, 1, 0, 1, no
146010269,  adrianss2001, 1, 0, 1, no
2550316518,  coccadanda, 1, 0, 1, no
56819028,  arioldo, 1, 0, 1, no
99556902,  nikita82roma, 6, 0, 6, no
802921215715405824,  BoggianiGerardo, 1, 0, 1, no
250670952,  lottandoidemoni, 1, 0, 1, no
2250138083,  seivitahaz, 1, 0, 1, no
791359414993358849,  familycosta721, 1, 0, 1, no
234454722,  Takemetomyidol_, 1, 0, 1, no
1222570518,  paola0071, 1, 0, 1, no
784783472468619264,  lavinia78720130, 1, 0, 1, no
1398381302,  palad_dee, 1, 0, 1, no
290604277,  ohmybjeber, 1, 0, 1, no
138825055,  Galdaron, 10, 0, 10, no
3400254046,  jovaxm, 1, 0, 1, no
164469196,  robysimo81, 1, 0, 1, no
14099501,  plucciola, 2, 0, 2, no
705686706406690816,  davidenadali, 1, 0, 1, no
861212444,  Mic_ort, 3, 0, 3, no
2277848232,  kerossa62, 1, 0, 1, no
515462112,  fvmaurizio77, 2, 0, 2, no
293977374,  AlexCCF93, 1, 0, 1, no
951757819,  sorce7, 1, 0, 1, no
231110601,  giovannizambito, 1, 0, 1, no
2921202064,  TommasoLanda, 2, 0, 2, no
798610056119980032,  ciops06, 1, 0, 1, no
2500916406,  Tarif_Welt24, 3, 0, 3, no
1382671670,  OrylarVinca, 2, 0, 2, no
797740375213568000,  SancioClaudio, 3, 0, 3, no
121177103,  clancn, 1, 0, 1, no
131183483,  valedileva, 2, 0, 2, no
2713708404,  previl96, 1, 0, 1, no
636652709,  jimmie_blair, 1, 0, 1, no
189811579,  lampuga, 1, 0, 1, no
1187349354,  GiuliaCoccoli, 1, 0, 1, no
377348117,  laurafabrizi, 1, 0, 1, no
1415041356,  RosariaToraldo, 1, 0, 1, no
789459828007723009,  BoldroCop, 1, 0, 1, no
472202396,  alessandrotiso1, 1, 0, 1, no
804278132966617088,  simone_lamarra, 2, 0, 2, no
396802776,  Simojuventus, 1, 0, 1, no
440663402,  AltieriRaffaele, 4, 0, 4, no
433609457,  cristianaprato, 1, 0, 1, no
232259622,  luidir47, 1, 0, 1, no
1263798854,  barbara_musella, 1, 0, 1, no
4105911004,  CannaDonato, 1, 0, 1, no
2744750367,  irenebonomo3112, 1, 0, 1, no
458324440,  marco371173, 2, 0, 2, no
940811316,  LorenzoRausa, 2, 0, 2, no
248611884,  FraniGrM, 1, 0, 1, no
17732518,  ormiga, 1, 0, 1, no
392655405,  Anton_Dekh, 1, 0, 1, no
733254501675728896,  Andrew_Pez, 1, 0, 1, no
745888524,  casalserugo5ste, 2, 0, 2, no
445284060,  silviapistone81, 1, 0, 1, no
2244584796,  AnnalisaAglioti, 2, 0, 2, no
629626485,  Aga_Tuxy, 2, 0, 2, no
2539645564,  TodiscoAmalia, 1, 0, 1, no
351221139,  clod_rich16, 1, 0, 1, no
501225684,  emi_bat, 1, 0, 1, no
966157914,  MaurizioMath, 1, 0, 1, no
402670015,  kikadit, 9, 0, 9, no
312175988,  schummy75, 1, 0, 1, no
502807296,  GiuseppeFormoso, 1, 0, 1, no
426777693,  noemicresh, 1, 0, 1, no
2764545717,  LuMia1208, 2, 0, 2, no
3353377672,  valentinarte8, 1, 0, 1, no
3404091532,  ThecocoRisto, 1, 0, 1, no
52552781,  Stepmorana, 2, 0, 2, no
216684324,  Scarla6, 1, 0, 1, no
3254557839,  BerserkuCrissi, 4, 0, 4, no
747706717656481792,  thecsergio, 1, 0, 1, no
1317075626,  rosariocorigli1, 2, 0, 2, no
717483009033768961,  Gianniveneri1, 1, 0, 1, no
2735526789,  UR_1977, 2, 0, 2, no
471163054,  waltermentre, 4, 0, 4, no
579221912,  SofiaVardaro, 1, 0, 1, no
420388790,  BrunoPuntura, 1, 0, 1, no
217432906,  Hum_Glass, 1, 0, 1, no
3466600696,  xAliAlix3, 1, 0, 1, no
1733129954,  pabloflip92, 3, 0, 3, no
2249697301,  CPregazzi, 1, 0, 1, no
742401891837968384,  BlgaethGaeth, 1, 0, 1, no
821921425,  frap1975, 2, 0, 2, no
876091626,  Lifurbi, 3, 0, 3, no
245758830,  BertaButtarazzi, 1, 0, 1, no
419660075,  aglajablunet, 1, 0, 1, no
4560243317,  JaaaneEyre, 3, 0, 3, no
134522688,  miotei, 1, 0, 1, no
56131320,  oliviertempora, 1, 0, 1, no
405435925,  Loris41086, 1, 0, 1, no
762696434093260800,  cicciama, 1, 0, 1, no
3355967475,  RinascitaVitaYT, 2, 0, 2, no
703032493558005760,  AnthonyPomilia, 1, 0, 1, no
1671778394,  Miss_Eveee, 1, 0, 1, no
4652707168,  salvomorettino, 2, 0, 2, no
300158013,  graziamacchiati, 1, 0, 1, no
585154533,  fellanavy, 2, 0, 2, no
4891650449,  Acquachiara09, 2, 0, 2, no
425125521,  KurtPzrLehr, 1, 0, 1, no
1148357390,  Jopalet, 1, 0, 1, no
1009860876,  antoninomas, 4, 0, 4, no
2878861445,  johnjohnlacca, 3, 0, 3, no
256717889,  oryoryok, 1, 0, 1, no
372030829,  fattocome, 1, 0, 1, no
499200257,  MariaLafratta, 3, 0, 3, no
939341838,  rossellabrunett, 1, 0, 1, no
735230765353598977,  AndreaFelline96, 3, 0, 3, no
2341748583,  massimi60826047, 1, 0, 1, no
203864243,  Ser_Nelkore, 1, 0, 1, no
1311669534,  PocappoPiopio, 1, 0, 1, no
2192498421,  mirco_foschi, 1, 0, 1, no
1568773796,  Herol_l, 1, 0, 1, no
449868302,  Antonangel59, 2, 0, 2, no
2751634019,  porconello, 2, 0, 2, no
808756406,  Skorpio10232405, 1, 0, 1, no
339200327,  ValeriaMeuti, 1, 0, 1, no
284220925,  gira_marco, 3, 0, 3, no
3298144097,  00e8b53f2687418, 1, 0, 1, no
2789455796,  ___Elisss___, 1, 0, 1, no
954821,  eamonn, 1, 0, 1, no
1220965501,  katy6382, 1, 0, 1, no
2757158998,  Michi00Michela, 1, 0, 1, no
62287662,  outsider63, 2, 0, 2, no
2324366672,  Ciruacchiotto, 2, 0, 2, no
805551453360234496,  MeForever_K, 1, 0, 1, no
3042805982,  DeDrant1275, 2, 0, 2, no
126524687,  LucasGiglioti, 1, 0, 1, no
4040817507,  Sharon64704996, 1, 0, 1, no
232191247,  cesareforti, 2, 0, 2, no
704238977,  sergiofabbri77, 2, 0, 2, no
794565592628035584,  paspiplus, 1, 0, 1, no
770990284159221761,  morenoiacobini, 1, 0, 1, no
1428656318,  syontai93, 1, 0, 1, no
4286762296,  misslilliehall, 1, 0, 1, no
758358681968869376,  jrlatte9, 1, 0, 1, no
4869719117,  Ela83X, 2, 0, 2, no
3405282700,  da47082db96d478, 1, 0, 1, no
247712433,  the_sintou, 3, 0, 3, no
712653089170395140,  TheDarkale_, 1, 0, 1, no
52575343,  picnic4b, 1, 0, 1, no
151917586,  EOspinaSr, 1, 0, 1, no
2775304420,  Rosignano5Stars, 2, 0, 2, no
26255191,  renovitali, 1, 0, 1, no
1273295426,  Fantoman75, 1, 0, 1, no
3049140719,  raffaelepigna11, 2, 0, 2, no
442319731,  sheriffdagreat, 1, 0, 1, no
539047267,  MuraZiv1, 1, 0, 1, no
418872542,  FulvioAugello, 1, 0, 1, no
3435520894,  MicheleAnime63, 1, 0, 1, no
2703557176,  barreca51, 3, 0, 3, no
1919511206,  FRANCES06710942, 1, 0, 1, no
36304268,  silviamobili, 1, 0, 1, no
1134464702,  anattostefano, 3, 0, 3, no
322163890,  KoenDenolf, 1, 0, 1, no
457733955,  Ruseno74, 2, 0, 2, no
431600605,  GwentaGil, 3, 0, 3, no
134858666,  dmatassino, 1, 0, 1, no
2890422803,  FranchinaFabio, 4, 0, 4, no
134671060,  stebell1974, 1, 0, 1, no
2776015188,  stappo23, 2, 0, 2, no
436660358,  SebaGiuffrida, 1, 0, 1, no
843207530,  gabriellagiarr, 2, 0, 2, no
251595754,  Sabrydoc, 1, 0, 1, no
1608719413,  Benjaminsmile_, 1, 0, 1, no
266764319,  GabrieleCerino, 1, 0, 1, no
635396890,  il_Rattocco, 1, 0, 1, no
1060911451,  mardoi31l, 1, 0, 1, no
3047490297,  MokyDeb, 8, 0, 8, no
2745589518,  bellucci129, 1, 0, 1, no
847121852,  M5SLazio, 1, 0, 1, no
788124079794577408,  crescini_fabio, 1, 0, 1, no
2731920166,  balducci78, 1, 0, 1, no
985398132,  emanuelamenicuc, 2, 0, 2, no
797144547415494661,  Roman_Warheart, 1, 0, 1, no
4632393442,  alexisUS1292, 2, 0, 2, no
329277011,  alliedelonge, 1, 0, 1, no
3134745514,  emmebi420, 1, 0, 1, no
79697729,  tranviadeseo, 1, 0, 1, no
3376387594,  1987Bianco, 1, 0, 1, no
323139288,  luiszert1, 1, 0, 1, no
145297386,  RosyVignati, 1, 0, 1, no
2522211712,  WaFF0Ls, 1, 0, 1, no
3237617343,  pcliers, 1, 0, 1, no
2948848851,  8a27d93b5ea04dc, 5, 0, 5, no
396705268,  VictorMotricala, 1, 0, 1, no
2904232168,  nuccioS59, 1, 0, 1, no
708715099935141888,  PuteadorCarlos, 1, 0, 1, no
777035492365709312,  Winner2016Trump, 6, 0, 6, no
747212738250809344,  luca1372, 1, 0, 1, no
22044633,  notmyname02, 1, 0, 1, no
480271048,  olivaflute, 1, 0, 1, no
500871116,  VendittiSimona, 2, 0, 2, no
2735054350,  virgyhome, 1, 0, 1, no
384744166,  lapunk5, 4, 1, 3, no
434226034,  AlexGobs, 1, 0, 1, no
708859255374405633,  MaxRaySpring, 1, 0, 1, no
3228944018,  ambionESC, 3, 0, 3, no
25595761,  jumlo, 1, 0, 1, no
471905877,  herbamaury, 1, 0, 1, no
1330126752,  mg_martello, 5, 1, 4, no
3381622366,  Barbara36180467, 2, 0, 2, no
2793032105,  vannic85, 1, 0, 1, no
3016841057,  GiorgiaMi92, 1, 0, 1, no
2319604766,  boemo83, 1, 0, 1, no
493303189,  GiusiCampanini, 3, 0, 3, no
2628180141,  pippo_togo, 2, 0, 2, no
1579555884,  RockSeppia, 1, 0, 1, no
60883194,  Lucadp79, 1, 0, 1, no
495299498,  Rossy_Toykova, 2, 0, 2, no
30817675,  tatore, 1, 0, 1, no
393338020,  CostanzaCecchin, 1, 0, 1, no
427274048,  19stefano78, 1, 0, 1, no
2327881259,  ClaudiaSc71, 1, 0, 1, no
3091751285,  orsetto_ale, 1, 0, 1, no
1020228091,  NegAdriana, 1, 0, 1, no
850166480,  thesecurityguy1, 1, 0, 1, no
415045443,  ChiarotMassimo, 3, 1, 2, no
276380022,  macneil54, 2, 0, 2, no
789419805002661888,  desi_enzo, 1, 0, 1, no
2312728101,  Loris69TS, 1, 0, 1, no
3383450651,  drunk__monk, 2, 0, 2, no
788570161800294406,  DarleneIacoviel, 1, 0, 1, no
464916901,  Mirko77F, 1, 0, 1, no
2922670673,  damadifuoco, 1, 0, 1, no
145382087,  ArigatoGozeiMas, 1, 0, 1, no
463958008,  Crm_Cll, 2, 0, 2, no
83933691,  shymon84, 2, 0, 2, no
1633295922,  micdan31, 1, 0, 1, no
498345515,  CripkeB, 1, 0, 1, no
2730162724,  CiattoMelissa, 1, 0, 1, no
313843015,  BlackJammer, 1, 0, 1, no
1378574263,  vestsempuguale, 1, 0, 1, no
2276618119,  Elis__abetta, 3, 0, 3, no
615532397,  UgoPerotti, 3, 0, 3, no
2174230349,  scotton_daniele, 1, 0, 1, no
426608038,  WMirigliano, 2, 0, 2, no
3763499301,  luisdett26, 1, 0, 1, no
589218993,  sitarg1927, 1, 0, 1, no
432427502,  cdio79, 2, 0, 2, no
586373819,  NovelloClaudio, 2, 0, 2, no
1137926508,  mgdaquila, 7, 0, 7, no
131506066,  antonESCU_bT95, 1, 0, 1, no
2955504839,  mariamartella2, 2, 0, 2, no
904604208,  nonsonorachele, 1, 0, 1, no
739907534518157312,  JacopoEsposito8, 1, 0, 1, no
4772785649,  GennaroCecca, 1, 0, 1, no
788932831,  fra_pastorello, 1, 0, 1, no
803474330277576704,  scuRAGGIata, 8, 0, 8, no
1543918664,  AgneseManuelli, 1, 0, 1, no
717037129042370561,  cristin92471120, 2, 0, 2, no
181950730,  marcopalombi72, 2, 0, 2, no
3318734877,  Banchi141, 1, 0, 1, no
728750584564690944,  SaladeTo, 8, 0, 8, no
446897324,  CavaniAlberto, 1, 0, 1, no
1926529471,  silvialoved1965, 1, 0, 1, no
136673570,  gaiacamossi, 1, 0, 1, no
52468851,  mauroev, 4, 0, 4, no
726164539025272832,  principatom5s, 1, 0, 1, no
1421295818,  michaelapuscar, 1, 0, 1, no
2794339455,  ADR19691, 1, 0, 1, no
2889447297,  ronganos, 1, 0, 1, no
455796667,  irma_palazzo, 1, 0, 1, no
474788900,  Riccardi_, 1, 0, 1, no
803319280225939457,  cyberse49333188, 1, 0, 1, no
735437220715335680,  annilongo, 1, 0, 1, no
174186680,  comunicale79, 1, 0, 1, no
2536730207,  cipcris, 1, 0, 1, no
752875557373808640,  Paolo58806047, 1, 0, 1, no
95019932,  racittadini, 1, 0, 1, no
1948011380,  walkerc2e, 1, 0, 1, no
446958662,  LucianoPizzelli, 1, 0, 1, no
1360090130,  GioCri_2002, 3, 0, 3, no
2176117600,  ceci_otto, 1, 0, 1, no
719080627757322240,  LoGnorante, 1, 0, 1, no
84664898,  fabio68m, 1, 0, 1, no
18939830,  cotrozzilivio, 2, 0, 2, no
345439766,  ilBignamix, 1, 0, 1, no
791951409688170497,  Roby7474, 1, 0, 1, no
3579815723,  PatriziaPalmit1, 2, 0, 2, no
772523313612591105,  fata5smorgana, 3, 1, 2, no
3025677400,  VandaLazzari65, 1, 0, 1, no
3619655957,  AlessAlongi, 2, 0, 2, no
55590913,  FrancescoHe, 1, 0, 1, no
2876969818,  Pablecito80, 1, 0, 1, no
422904136,  joyfar01, 2, 0, 2, no
173522276,  ilnotaro, 2, 0, 2, no
617598666,  annapanariello2, 1, 0, 1, no
264695144,  MarcoIlardi, 2, 0, 2, no
422414478,  GAssanti, 1, 0, 1, no
39460385,  SCOZCA, 1, 0, 1, no
106771056,  RitaGiuseppone, 2, 0, 2, no
1110311593,  itakus, 1, 0, 1, no
9940892,  fedemello, 11, 2, 9, no
621073071,  colettinadia, 2, 0, 2, no
753910937770418176,  UffiziGalleries, 1, 0, 1, no
198079470,  renzopessotto, 1, 0, 1, no
3982458934,  salomonx69, 4, 0, 4, no
4253242395,  _adaco_, 1, 0, 1, no
710713901663592448,  joeroggier, 1, 0, 1, no
444028791,  valencapuano, 1, 0, 1, no
729214200925532160,  charlieazzurro, 14, 0, 14, no
368885612,  annunziatamimmo, 2, 0, 2, no
1933271388,  MICHELEDURANTI1, 1, 0, 1, no
799323363634245632,  lucylig, 4, 0, 4, no
3901748193,  meridonare, 1, 0, 1, no
140014890,  kiarind, 1, 0, 1, no
46073660,  marziodimezza, 1, 0, 1, no
359202565,  brindisina98, 1, 0, 1, no
955582345,  valbutterfly2, 16, 2, 14, no
907601977,  marcoassante199, 2, 0, 2, no
2822999261,  vinesp57, 1, 0, 1, no
27473837,  deogo, 1, 0, 1, no
619015105,  plpetrillo, 1, 0, 1, no
318965193,  nicolapasa, 1, 0, 1, no
456335294,  EnricoLobina, 1, 0, 1, no
412453101,  antoniotesta_eu, 1, 0, 1, no
117432140,  GiuseppeDangelo, 1, 0, 1, no
233487608,  GioFranzese, 1, 0, 1, no
117110691,  novellatedesco, 2, 0, 2, no
159465016,  dagored3, 1, 0, 1, no
432554149,  Enzo_dErrico, 3, 0, 3, no
1617262098,  maurobiavati, 1, 0, 1, no
354900068,  ale74ru, 1, 0, 1, no
617691852,  MollleLing, 1, 0, 1, no
772827890954141696,  kekkascuola, 1, 0, 1, no
3227018709,  chissasemai, 1, 0, 1, no
4864139045,  francomartini14, 6, 0, 6, no
358122962,  MarcoCuoreazzur, 2, 0, 2, no
50262288,  framillegol, 1, 0, 1, no
587451886,  GuariniBg, 1, 0, 1, no
709105553423917058,  hihuim, 1, 0, 1, no
283450285,  olivarai, 2, 0, 2, no
432589047,  m4urinux, 2, 0, 2, no
4187641697,  Agataambro, 1, 0, 1, no
4912017454,  2Bravi, 1, 0, 1, no
741951647723737088,  la_rossa88, 2, 0, 2, no
988749812,  _gporcu, 2, 0, 2, no
437290507,  mattweetsa, 1, 0, 1, no
202946046,  msinistro, 3, 0, 3, no
1241472956,  70Angi, 2, 0, 2, no
174217550,  paololabruzzo, 1, 0, 1, no
741147210,  AdrianaBravi1, 1, 0, 1, no
3155293071,  manganellogiov1, 3, 0, 3, no
548544359,  Adesign249, 2, 0, 2, no
2796145285,  Stregatto9, 1, 0, 1, no
1623270990,  _ele94, 1, 0, 1, no
1638708829,  CeccaMilly, 1, 0, 1, no
773314313180315648,  grillotwittante, 1, 0, 1, no
729740396255916032,  Frances93139181, 1, 0, 1, no
2657124579,  angel9804, 2, 0, 2, no
2319326605,  CristianoTurato, 1, 0, 1, no
708386861,  fiorifio56, 1, 0, 1, no
2277815894,  CARLA24255338, 3, 0, 3, no
145284956,  EnzoSan69, 1, 0, 1, no
598974424,  SDino59, 9, 0, 9, no
1268204864,  MPingerna, 1, 0, 1, no
702952591,  RondelliM, 7, 0, 7, no
4544172989,  Fre1963Free, 3, 0, 3, no
2495987256,  SilvioGalantini, 1, 0, 1, no
413855425,  Setom74, 9, 0, 9, no
857730480,  gianmichelevann, 7, 0, 7, no
447043590,  andreaAocello, 2, 0, 2, no
10611402,  vincy75, 3, 0, 3, no
431694519,  steba1972, 1, 0, 1, no
736235688656576513,  dallashugg, 1, 0, 1, no
852754820,  DEBORAMASCI1, 1, 0, 1, no
624876269,  EugenioGnoffo, 1, 0, 1, no
23179771,  Gioborg, 1, 0, 1, no
776122110917902337,  claa1962, 1, 0, 1, no
421941338,  tonyy61, 2, 0, 2, no
799324496482172928,  michele656565, 2, 0, 2, no
520792250,  uno80939102, 1, 0, 1, no
436285908,  vintz_PA, 1, 0, 1, no
778634541661556736,  alexstera88, 1, 0, 1, no
801072087402221572,  Paolo72044338, 1, 0, 1, no
772800324675465216,  MauroGarrapa, 4, 0, 4, no
366235360,  LuisaMameli, 3, 0, 3, no
1538780774,  brunoueluccio, 1, 0, 1, no
448207683,  smack_iabile, 1, 0, 1, no
413943853,  jimi_78, 1, 0, 1, no
549935132,  Zianana66, 1, 0, 1, no
104492086,  annarchica, 1, 0, 1, no
418809718,  Giuly0013, 3, 0, 3, no
2688365054,  Gsolls1, 1, 0, 1, no
783405945791578112,  Ros_bis90, 1, 0, 1, no
4635942508,  Sonia_Nesli, 1, 0, 1, no
452351631,  gianluigidellac, 2, 0, 2, no
803260661308555264,  akramshaby, 1, 0, 1, no
804977898369249280,  Valenti81803546, 1, 0, 1, no
4181995061,  stefanosorice2, 3, 0, 3, no
430137287,  GabrieleGozzoli, 1, 0, 1, no
552244447,  FrancescoDIntr, 1, 0, 1, no
465053408,  Christinamc1983, 1, 0, 1, no
305833247,  mincatas, 1, 0, 1, no
613804971,  Giuls_Moonlight, 2, 0, 2, no
128688814,  varionews, 4, 0, 4, no
316552150,  EJurlaro, 1, 0, 1, no
2931731932,  fdfc16832a484b6, 1, 0, 1, no
513217439,  anaclems, 2, 0, 2, no
99916072,  GiuliaGibertoni, 2, 0, 2, no
2320420238,  walterscarcella, 2, 0, 2, no
2837446354,  ciairo, 2, 0, 2, no
220992786,  DeboraSprock, 2, 0, 2, no
769498283756642304,  MarcoAtta77, 1, 0, 1, no
444504781,  misterviaggio, 1, 0, 1, no
86546315,  GiuseppeC1957, 2, 0, 2, no
728560322752188416,  valeriafaseb, 1, 0, 1, no
412372084,  frankybaroni, 1, 0, 1, no
295635514,  Gaspare965, 1, 0, 1, no
844509133,  maxcantatore, 1, 0, 1, no
188136909,  Choroukenzo, 2, 0, 2, no
1014091514,  PsicologiaSapep, 1, 0, 1, no
173439628,  auliner, 1, 0, 1, no
2812583886,  gialloo1, 1, 0, 1, no
1477343594,  Numeratore, 1, 0, 1, no
372779253,  amaranto64, 1, 0, 1, no
1966660543,  MarCaSere, 1, 0, 1, no
1188911720,  Baba54daki, 1, 0, 1, no
946529088,  massimofiori2, 1, 0, 1, no
270821168,  ibrahimyasacan, 1, 0, 1, no
1015588921,  leandronevola, 2, 0, 2, no
438385480,  PatriziaTerzoni, 3, 0, 3, no
1151495287,  violadelpensie, 5, 0, 5, no
783276237351489536,  barbaralu66, 1, 0, 1, no
529367193,  willis7277, 1, 0, 1, no
294756310,  davide79torino, 1, 0, 1, no
889666248,  Exanuskronos69, 5, 0, 5, no
3056592447,  marghec3, 1, 0, 1, no
2963152966,  Edoardo__1996, 4, 0, 4, no
2242408249,  CotugnoCarmine, 2, 0, 2, no
426460313,  pettinaripaolo, 1, 0, 1, no
500184959,  iabez2000, 1, 0, 1, no
2560820463,  LDegani, 1, 0, 1, no
1122686647,  Julian__Grieco, 1, 0, 1, no
721722836226871296,  Vera787147631, 1, 0, 1, no
63978273,  enricoviaggi, 2, 0, 2, no
602831906,  vecienz79, 1, 0, 1, no
1006028442,  EEvienia, 1, 0, 1, no
781222259558088704,  medi03441569, 1, 0, 1, no
570257633,  rosarioluongo74, 1, 0, 1, no
185144870,  annamaria_84, 1, 0, 1, no
234372708,  Sterombi, 1, 0, 1, no
791193793051721728,  gloriamazzeo77, 2, 0, 2, no
1016109914,  fargi34, 4, 0, 4, no
390342010,  NeriSassi, 1, 0, 1, no
444768003,  dani_srcnl, 1, 0, 1, no
2808699178,  nosferatum2014, 1, 0, 1, no
200288284,  qdellarosa, 2, 0, 2, no
2592149692,  iv3sixcaio, 1, 0, 1, no
483118529,  CannataRoberto, 2, 0, 2, no
152427789,  vegacraps, 1, 0, 1, no
96313736,  evos67, 1, 0, 1, no
4871332221,  nonsonogrillino, 1, 0, 1, no
812867930,  WriterJazz, 2, 0, 2, no
989456214,  Cronix72, 1, 0, 1, no
946295724,  vinceleonetti, 1, 0, 1, no
946447663,  GiampaoloLizza, 5, 0, 5, no
776734605353291776,  aprandini27, 1, 0, 1, no
799531993973325824,  yaropolovase, 1, 0, 1, no
3087165969,  M5sMarigliano, 2, 0, 2, no
1387856863,  MichaelArmanno, 2, 0, 2, no
472780497,  SaimonScaard, 1, 0, 1, no
484219561,  oswi1172, 2, 0, 2, no
3054098656,  GianlucaFerri13, 2, 0, 2, no
585892339,  stefanobravione, 2, 0, 2, no
2752259173,  schlef1a, 1, 0, 1, no
791611407762685953,  AntonellaPengue, 1, 0, 1, no
389611714,  LMonfrecola, 1, 0, 1, no
611597594,  giovannasici7, 2, 0, 2, no
1355517703,  lostehuelche, 1, 0, 1, no
831875880,  ele_missus, 1, 0, 1, no
753958367610146817,  marcomala77, 1, 0, 1, no
803871029080838144,  Luigi_lops, 2, 0, 2, no
4472007209,  FicarraLaura_bi, 2, 0, 2, no
751806809434980353,  cicci78511, 1, 0, 1, no
124273634,  Giurgitte, 1, 0, 1, no
4813403782,  luigides_1, 1, 0, 1, no
2395909131,  MazzuAlessandro, 2, 0, 2, no
497382403,  walker_anto, 2, 0, 2, no
364961388,  Stekrano, 1, 0, 1, no
1137413112,  sicignano_f, 1, 0, 1, no
2981519823,  adrimelchio, 2, 0, 2, no
1160212783,  Gabbianella1Blu, 3, 0, 3, no
794294828775473152,  FabrizioPintori, 1, 0, 1, no
259733750,  Silve_7, 1, 0, 1, no
832668218,  Ale_Capasso, 1, 0, 1, no
48614561,  AlexNapoli, 2, 0, 2, no
770234596839612416,  fera_alfonso, 1, 0, 1, no
1256574842,  Robertoruggine, 5, 0, 5, no
818013072,  CuoreAlto, 1, 0, 1, no
802237433395945476,  Flavia_Consonni, 1, 0, 1, no
49261294,  AREASciencePark, 2, 0, 2, no
792216138361016320,  3dbone, 3, 0, 3, no
2352118818,  pietropruneri, 1, 0, 1, no
331537566,  Np_Italia, 2, 0, 2, no
803526977231712256,  umbdago, 3, 0, 3, no
755286164731490305,  Stefano54655309, 2, 0, 2, no
341431151,  max_triplete, 1, 0, 1, no
2321104375,  SandroScandolo, 1, 0, 1, no
780879437218840579,  Maria_B_arbieri, 1, 0, 1, no
363795552,  BalbiMariano, 5, 0, 5, no
3187555726,  metrana, 4, 0, 4, no
2470618681,  immaginario_IS, 1, 0, 1, no
751028107944026112,  marco152925941, 2, 0, 2, no
1257106364,  sara_pasquale, 1, 0, 1, no
90718713,  iamgiulia_8, 1, 0, 1, no
274811473,  CarlosVCiampi, 3, 0, 3, no
27877758,  gibutino, 1, 0, 1, no
1116999974,  vdliguori, 4, 0, 4, no
1080941533,  robertopetrucca, 1, 0, 1, no
708746809032761344,  mimmmomig, 1, 0, 1, no
2247466280,  AntonioBubbo, 1, 0, 1, no
800008614136188928,  franko_gina, 2, 0, 2, no
4558218203,  massimopenna39, 1, 0, 1, no
1650023988,  miktwit23, 2, 0, 2, no
380359585,  serragiovanna, 1, 0, 1, no
1036846736,  sbigotti_to, 1, 0, 1, no
1675839859,  luca_dinicola, 1, 0, 1, no
3438644819,  marasca2015, 1, 0, 1, no
1244012304,  salvatorebecca, 3, 0, 3, no
467736212,  gianlucapuglis2, 1, 0, 1, no
504652328,  salvoguida23, 1, 0, 1, no
397942497,  danirodia, 1, 0, 1, no
759145283716538368,  pasale87, 1, 0, 1, no
778668476332474372,  Ecincoestrellas, 1, 0, 1, no
340877741,  angelinolanzino, 1, 0, 1, no
406509882,  Enzo_Abbagnale, 1, 0, 1, no
1058676752,  FraAniello, 2, 0, 2, no
1190590579,  adrianaadry56, 3, 0, 3, no
131867712,  kronebigxv8, 1, 0, 1, no
539637351,  jax9386, 2, 0, 2, no
488627298,  EmmETabaccheria, 1, 0, 1, no
702827736516190208,  Andiap04, 22, 0, 22, no
2299277402,  mat_polve, 2, 0, 2, no
3101916429,  DiemmegDi, 1, 0, 1, no
481487529,  Sofistio, 1, 0, 1, no
885190620,  LuisaEtramar, 6, 0, 6, no
832613244,  massimo271, 2, 0, 2, no
540264278,  annamariagig, 5, 0, 5, no
374743672,  FMartinello, 4, 0, 4, no
388190082,  Antop77, 1, 0, 1, no
118756273,  fgraniglia, 3, 0, 3, no
718368584360140800,  FerruLuciano, 2, 0, 2, no
732580256,  doctor_el86, 1, 0, 1, no
1011051636,  _milicenzio, 1, 0, 1, no
126883491,  a1lessandro, 24, 3, 21, no
333358286,  pipudrio, 1, 0, 1, no
562730933,  RakelLombardi, 2, 0, 2, no
2155726458,  M5SOleggio, 3, 0, 3, no
390644069,  Orsodan, 1, 0, 1, no
4033699635,  Sabrina70442637, 2, 0, 2, no
704134053,  CCasanova61, 2, 0, 2, no
1138200559,  karloleonardi, 6, 0, 6, no
893601463,  lessio61, 1, 0, 1, no
1165463461,  FedericaSclano, 1, 0, 1, no
765519857941110784,  catia_caporali, 7, 0, 7, no
2330754668,  maurofontana74, 1, 0, 1, no
463840173,  nimlot61, 1, 0, 1, no
378591855,  GiovanniAlesi, 2, 0, 2, no
446163232,  francescobevac1, 1, 0, 1, no
1053093684,  GiuliaSarti86, 1, 0, 1, no
3031025781,  tama07081947, 2, 0, 2, no
366769522,  marcobilleci, 1, 0, 1, no
118000836,  marco_lucisani, 2, 0, 2, no
438542009,  borghialex, 1, 0, 1, no
980610223,  rache_tonelli, 1, 0, 1, no
366639902,  david_sarra, 1, 0, 1, no
258400230,  ilsilvio, 3, 0, 3, no
208527329,  Pigio73, 1, 0, 1, no
553046883,  presascart1977, 4, 0, 4, no
4765393854,  MonicaPassalac4, 2, 0, 2, no
3248724731,  crismborella, 3, 0, 3, no
255018823,  hesky76, 1, 0, 1, no
3243222784,  broby65, 8, 0, 8, no
802593581210988545,  Niktasck, 1, 0, 1, no
1097778030,  CesareDamiani, 1, 0, 1, no
3208222643,  gmagliar, 2, 0, 2, no
392733410,  AgiproNews, 1, 0, 1, no
740625579108630533,  marcoluxlux, 1, 0, 1, no
782501678461358080,  simonet1970, 3, 0, 3, no
368247272,  Bradfszayn, 1, 0, 1, no
3299007346,  antonioalimenta, 3, 0, 3, no
754062941306122240,  andreadm131195, 1, 0, 1, no
85557887,  Poly_09, 2, 0, 2, no
391287768,  SANDRIXROMA, 1, 0, 1, no
85352908,  paristoria, 1, 0, 1, no
2715196346,  terrycoensurya, 1, 0, 1, no
4874766939,  pulce9296, 1, 0, 1, no
102013327,  lindacarfa, 1, 0, 1, no
464726162,  NicolaCubeddu, 1, 0, 1, no
499533706,  MMacrelli, 4, 0, 4, no
4902884411,  AlbasWorld, 2, 0, 2, no
81804418,  RenatoZampieri, 2, 0, 2, no
753571887314239488,  gaetanaccio, 1, 0, 1, no
294194412,  AidaRoldo, 1, 0, 1, no
3030526046,  IFalchero, 1, 0, 1, no
471173883,  RosalbaGrillo, 1, 0, 1, no
3864556223,  edoardo_taranto, 1, 0, 1, no
2725221087,  fulviaps, 1, 0, 1, no
862753490,  Giovannagioia68, 1, 0, 1, no
1069130844,  lagobrun0, 1, 0, 1, no
711929302183493632,  _littletess, 1, 0, 1, no
4647149236,  Ciro39730697, 2, 0, 2, no
382203329,  jena650, 1, 0, 1, no
400015385,  _heyjade_, 1, 0, 1, no
114539972,  Lombard5stelle, 6, 0, 6, no
1333660242,  nickbebimoretti, 1, 0, 1, no
551299529,  peppino255, 2, 0, 2, no
419456103,  CarusoSimona, 1, 0, 1, no
3322494874,  maurizia_lopez, 2, 0, 2, no
1101918108,  PeP_Magic, 2, 0, 2, no
1060195976,  massimopiccardi, 1, 0, 1, no
768572212819402752,  ida9997, 1, 0, 1, no
747172498945474561,  calavice3, 1, 0, 1, no
758274506829987840,  Frank31820994, 2, 0, 2, no
460450308,  GIUSYMARTALO, 2, 0, 2, no
585871107,  raffaele_tucci, 2, 0, 2, no
79005597,  luc4ut, 4, 0, 4, no
1042462844,  FabSpedale, 1, 0, 1, no
2230102908,  marsili_alberto, 1, 0, 1, no
2896777635,  GaleanoRiccardo, 1, 0, 1, no
2253267231,  StefanoMontana4, 2, 0, 2, no
1609938302,  Fbenincasa75, 1, 0, 1, no
456141356,  MarcoBenarrivo, 1, 0, 1, no
456988512,  eleonorapavesi, 2, 0, 2, no
1225067388,  carmenzerotto1, 1, 0, 1, no
1665884389,  parrinello42, 1, 0, 1, no
1601716938,  Forlenza_Vito, 16, 0, 16, no
1942284877,  VitoCreamy, 1, 0, 1, no
766299046378102784,  Lisa97790208, 6, 0, 6, no
440718150,  RIngegnoli, 1, 0, 1, no
215735111,  SalvoRGB, 2, 0, 2, no
781572318090915844,  VincenzaChiefa, 1, 0, 1, no
45415143,  Pusillanime00, 1, 0, 1, no
3925347557,  maTi_Pelli, 1, 0, 1, no
2878237587,  ValePuligheddu, 1, 0, 1, no
1865508474,  moto58rola, 1, 0, 1, no
318959018,  RobdecaDe, 1, 0, 1, no
1268009264,  ManuPontis, 4, 0, 4, no
1261967018,  NotaroAnna, 2, 0, 2, no
431483569,  granatamilo, 1, 0, 1, no
800648842752315393,  amedeomuoio, 1, 0, 1, no
3351609791,  taniatyrossa, 1, 0, 1, no
482147117,  MattiaLiPuma, 1, 0, 1, no
2746995422,  mattiabgl, 1, 0, 1, no
399346824,  patriziadelross, 1, 0, 1, no
12752012,  wizardino, 1, 0, 1, no
2195622679,  Isa_Adinolfi, 2, 0, 2, no
1364546478,  toghni83, 1, 0, 1, no
1454869160,  fiorellabenci, 1, 0, 1, no
1537579003,  MusicShared95, 1, 0, 1, no
2561977803,  gradang75, 1, 0, 1, no
256596290,  Marsch23, 1, 0, 1, no
2834233443,  52Fabio52, 2, 0, 2, no
2332486730,  RIJEKApartments, 3, 0, 3, no
822057882,  TomsonResta, 2, 0, 2, no
303929988,  PaoloCaponetto, 1, 0, 1, no
95441446,  iseddin, 1, 0, 1, no
434817153,  salvass78, 1, 0, 1, no
784105165079085057,  fefelab85, 1, 0, 1, no
755690195622699008,  lorenzocelic, 1, 0, 1, no
415514079,  cosimobarra, 1, 0, 1, no
1565351414,  DemaRegina, 3, 0, 3, no
497315201,  cbcarlito, 1, 0, 1, no
2334780685,  rillo66, 8, 0, 8, no
563687087,  Clamass68, 1, 0, 1, no
1854517788,  AntoninoMigliet, 4, 0, 4, no
399455627,  ArmandoNapoleta, 1, 0, 1, no
779648076,  FChiarucci, 3, 0, 3, no
2887152821,  FaceGianni, 1, 0, 1, no
1338795409,  centercallsaler, 2, 0, 2, no
105100430,  claudiorisi, 2, 0, 2, no
1015984172,  JanRudolfWaclaw, 1, 0, 1, no
3233036369,  carfonte, 1, 0, 1, no
2219790670,  SveviMarco, 1, 0, 1, no
1370602922,  PedRuggero, 1, 0, 1, no
917106613,  CiancittoC, 1, 0, 1, no
1267263205,  LuigiGennara, 4, 0, 4, no
1179036590,  IserniaGianluca, 1, 0, 1, no
1424197706,  KiurloR, 2, 0, 2, no
631151428,  Pier_joe1927, 1, 0, 1, no
720978207437144064,  Marco210964, 1, 0, 1, no
1504483819,  CadyLeeRock, 4, 0, 4, no
816951644,  matteotisco, 1, 0, 1, no
528507835,  EmilianoBasei, 10, 0, 10, no
591871935,  MarioMascellino, 3, 0, 3, no
412445498,  GesuinoCardu, 2, 0, 2, no
3031016373,  martina_gxx, 1, 0, 1, no
365770924,  lfrankkk, 1, 0, 1, no
481567489,  SaraMarcozzi, 1, 0, 1, no
1250680993,  Francesmart, 1, 0, 1, no
852437864,  MatteoFossati74, 1, 0, 1, no
804062148137779201,  Tito11423960, 1, 0, 1, no
227431559,  antonjo_, 3, 0, 3, no
1462586190,  emilianoandreo, 1, 0, 1, no
51058089,  AntonioSabetta, 1, 0, 1, no
724012565467148288,  vertefjodorov20, 1, 0, 1, no
802243109291749376,  CoscienzaDiZelo, 1, 0, 1, no
260375532,  pinkyalby, 1, 0, 1, no
231141862,  mauriziomc, 1, 0, 1, no
65373148,  parapapu, 4, 0, 4, no
787800174328414208,  vincenzozappon, 3, 0, 3, no
471912361,  bafius73, 1, 0, 1, no
525285013,  AndreaMoriello, 1, 0, 1, no
3314778179,  m5sumbria, 1, 0, 1, no
2840126938,  roberpiu, 2, 0, 2, no
2339135738,  gabcecchini, 1, 0, 1, no
497119569,  SasaCaiazza, 1, 0, 1, no
717355882342981633,  BertucciGabrie2, 1, 0, 1, no
291643455,  Simone_Giamp, 1, 0, 1, no
1137078259,  marinellamantov, 1, 0, 1, no
495899677,  calimerando, 2, 0, 2, no
1017325987,  josef_oddo, 1, 0, 1, no
187280264,  MarioMicillo, 1, 0, 1, no
215602422,  Igor_76, 1, 0, 1, no
445648044,  MolinariDavide, 1, 0, 1, no
2199633606,  BrunoZito2, 2, 0, 2, no
2370221592,  jacberti, 2, 0, 2, no
2386238362,  LoskoPiero, 1, 0, 1, no
4445896233,  Silvano43689208, 3, 0, 3, no
1465483002,  marta_prova, 3, 0, 3, no
22059942,  Incerti, 3, 0, 3, no
718454532070645760,  TizianaDeChiar2, 1, 0, 1, no
2868975208,  massimopad, 1, 0, 1, no
75244473,  musicAndri, 1, 0, 1, no
778647667039690752,  IoVotoForse, 1, 0, 1, no
560540704,  AlicePrimofiore, 1, 0, 1, no
234371367,  Giuseppe988, 2, 0, 2, no
338277664,  fra_gentile, 1, 0, 1, no
29949938,  Fantalisa11, 1, 0, 1, no
2808612898,  alcmq, 1, 0, 1, no
3027663464,  tonimor52, 1, 0, 1, no
295458873,  StefanoTasquier, 3, 0, 3, no
2321252292,  MgmMele, 1, 0, 1, no
1034927581,  FraVegan, 1, 0, 1, no
553567662,  ce_orla, 4, 0, 4, no
974551627,  filomenacotti, 1, 0, 1, no
105890490,  mghignatti, 1, 0, 1, no
436153188,  sciancomat, 1, 0, 1, no
4743147495,  SSalvatore66, 1, 0, 1, no
296507003,  ErnyMilan9, 2, 0, 2, no
4083585255,  iannantuono_a, 1, 0, 1, no
743513444926787586,  Asuka_Kano_, 1, 0, 1, no
1026900505,  Aclyssia, 1, 0, 1, no
784055854236573696,  TupackLeo, 1, 0, 1, no
307260980,  giovannisal91, 5, 0, 5, no
307920458,  Strama_manchi, 2, 0, 2, no
460099696,  LuciaLazzeri77, 1, 0, 1, no
175044831,  analphabeta, 1, 0, 1, no
2753391711,  yabuki68, 3, 0, 3, no
2525740797,  AlfSen82, 1, 0, 1, no
751547228,  totobaby77, 1, 0, 1, no
3310846805,  gianluca_tufano, 1, 0, 1, no
427476449,  proffiforever, 1, 0, 1, no
3405492419,  Alfredo10395079, 1, 0, 1, no
764435675227774976,  salvo7358, 2, 0, 2, no
14410869,  pianozero, 1, 0, 1, no
834242162,  SattaStt, 1, 0, 1, no
2883152433,  idnorep, 2, 0, 2, no
1716718334,  lorenzo291078, 1, 0, 1, no
753174758087331840,  celario_paola, 1, 0, 1, no
2789363694,  mariagiardina5, 7, 0, 7, no
588208330,  AnnaIacomelli, 1, 0, 1, no
625856670,  MicheleVitale22, 1, 0, 1, no
2319505332,  carroneandrea, 6, 0, 6, no
747071486482055168,  CristinaLongin2, 1, 0, 1, no
435137464,  cretellam, 1, 0, 1, no
426918412,  Trixie2405, 3, 0, 3, no
465584625,  valegenn, 1, 0, 1, no
395525660,  BonciMarco, 1, 0, 1, no
1446911749,  mk_stefy, 1, 0, 1, no
2442172829,  LuckyGarofalo, 1, 0, 1, no
2501148630,  MarginInversi, 2, 0, 2, no
1014946904,  CammerCarolina, 3, 0, 3, no
718197754242142209,  chieco961, 1, 0, 1, no
1385272040,  moretto333, 3, 0, 3, no
328168761,  Alesss77, 3, 0, 3, no
2771382189,  OriginOfQueen, 1, 0, 1, no
495033529,  mariosboobs, 3, 0, 3, no
437630901,  Laura_McFly95, 2, 0, 2, no
70086035,  salstan123, 1, 0, 1, no
67286398,  phoebehw, 1, 0, 1, no
2676363277,  hadgebest, 1, 0, 1, no
717579320,  RobertoMontana8, 2, 0, 2, no
805035489371815936,  ToniniVioletta, 1, 0, 1, no
797738652499582977,  BarbaraThebress, 1, 0, 1, no
791361224252489728,  Butterf63421403, 2, 0, 2, no
1236652220,  AlessioGrottola, 2, 0, 2, no
4398733419,  costcri, 2, 0, 2, no
408406196,  BarileGiuseppe, 2, 0, 2, no
2591510034,  serenamia5, 1, 0, 1, no
536140387,  giannitinelli2, 1, 0, 1, no
726847158,  angelicozenone, 1, 0, 1, no
98813859,  SportsLitWriter, 1, 0, 1, no
158106087,  brutaleo, 2, 0, 2, no
2981820371,  Thecubepr, 1, 0, 1, no
1728704371,  MPorzioCatone5S, 1, 0, 1, no
3029974462,  nunziaargenzia1, 2, 0, 2, no
778703684054097920,  Pot_1981, 1, 0, 1, no
4069278623,  GiovanniMonca10, 2, 0, 2, no
774968109002358784,  Francydes95, 1, 0, 1, no
409291868,  GianniFabi, 1, 0, 1, no
1915390190,  PietroAusano, 1, 0, 1, no
841723272,  antonio_sannia, 1, 0, 1, no
2780234221,  MarcoZullo, 5, 0, 5, no
766208199917703168,  pa_gelsomino, 1, 0, 1, no
424087659,  alexandroscialo, 2, 0, 2, no
2957376141,  carmagnola67, 1, 0, 1, no
3026266861,  PorruRosa, 1, 0, 1, no
787663494183260161,  Christi61286849, 1, 0, 1, no
407878518,  Sal861, 4, 0, 4, no
1149376610,  Fer81P, 1, 0, 1, no
617171996,  cercinico, 1, 0, 1, no
3072562972,  AgataLiggieri, 1, 0, 1, no
1386423176,  AndreaVallascas, 3, 0, 3, no
1162767474,  vive0101, 1, 0, 1, no
113456813,  dogio81, 3, 0, 3, no
378157055,  AndreaDibi, 1, 0, 1, no
425643681,  3sfazzari, 1, 0, 1, no
2162905795,  riomare56, 2, 0, 2, no
97228214,  Andrea__Vitale, 1, 0, 1, no
2818986705,  unochepensa, 1, 0, 1, no
228321602,  ennio79, 2, 0, 2, no
711099043,  FortunatoGmail, 1, 0, 1, no
1047652207,  Anna161514, 2, 0, 2, no
1392316111,  Gia_mina, 1, 0, 1, no
746615602513612800,  michelamastr, 1, 0, 1, no
1029356240,  AngyAuroraTh, 1, 0, 1, no
3065729321,  darllngkeatonn, 1, 0, 1, no
742000041305505792,  afragola5stelle, 1, 0, 1, no
2745351881,  trilliblu17, 1, 0, 1, no
93440777,  doriano1950, 4, 0, 4, no
554319615,  RobertoDArrigo, 1, 0, 1, no
805509092689190912,  turiuk1801, 1, 0, 1, no
496843205,  AgroLanDesigner, 1, 0, 1, no
424092979,  ramarroart, 1, 0, 1, no
177504451,  AlpTungaGoktug, 1, 0, 1, no
375721518,  lancill86magnum, 1, 0, 1, no
961043671,  ErcSantsMon, 2, 0, 2, no
3024109528,  Tiziano06111983, 1, 0, 1, no
1416142333,  sylviaheat, 1, 0, 1, no
565519280,  Alessia_DAmico, 1, 0, 1, no
464850279,  MarcoFasano88, 1, 0, 1, no
417404028,  DixonJrdc, 1, 0, 1, no
469519349,  RamiAkremi, 1, 0, 1, no
861246444,  Paolo_Rosetti, 1, 0, 1, no
3234316363,  andpacca, 1, 0, 1, no
435026743,  GuaprovTron, 8, 3, 5, no
1134732668,  elenagluc, 4, 0, 4, no
319093216,  zuozo_, 1, 0, 1, no
2692705233,  BrunoDonatella, 1, 0, 1, no
1285313371,  Tototris, 1, 0, 1, no
997943606,  AngelaAngeliqu1, 3, 0, 3, no
582717492,  aluigi86, 1, 0, 1, no
47555976,  z_michel, 4, 0, 4, no
1462107829,  AscanioFerraro, 1, 0, 1, no
380838056,  JessicaDAltilia, 1, 0, 1, no
3231826833,  tweemelk, 1, 0, 1, no
477934480,  jourdan975, 1, 0, 1, no
2984387777,  DibiaseTafuri, 1, 0, 1, no
1072331106,  FrancBusinarolo, 2, 0, 2, no
719542156126498816,  PASQUALECOLICC6, 2, 0, 2, no
2179542069,  zoroinfbo, 1, 0, 1, no
2447136595,  Alina34334849, 1, 0, 1, no
3906755599,  ivanalealini, 15, 0, 15, no
341729250,  AntonioMarchi10, 1, 0, 1, no
40216987,  micck66, 3, 0, 3, no
1899976812,  WalterVerona, 3, 0, 3, no
1522918213,  CarloGibertoni, 1, 0, 1, no
635283342,  BestettiMassimo, 3, 0, 3, no
1043140386,  MBalderi, 1, 0, 1, no
965980400,  TittiDN, 1, 0, 1, no
382141768,  ginosaru, 1, 0, 1, no
3009523493,  fabgogna, 1, 0, 1, no
1460749387,  ZauliSara, 1, 0, 1, no
1398174300,  AntoLari1986, 2, 0, 2, no
3070122863,  alebsct, 1, 0, 1, no
3336497591,  piga_martina, 2, 0, 2, no
2611121314,  jessagnese, 1, 0, 1, no
3997300246,  mpastore181, 1, 0, 1, no
706977832,  sam2itta, 2, 0, 2, no
2356354474,  CorvinoDaniele, 1, 0, 1, no
3093644236,  alesdigennaro, 1, 0, 1, no
397902445,  musichetta_82, 2, 0, 2, no
194916610,  EleonoraLaura, 2, 0, 2, no
113707488,  alinoski, 1, 0, 1, no
4875918567,  eribertomazza, 1, 0, 1, no
400228971,  LovethehoneyB, 1, 0, 1, no
164255352,  Aquila6, 1, 0, 1, no
2277299122,  GinevrinoF, 1, 0, 1, no
797546504709881856,  massimogbonanno, 1, 0, 1, no
517367400,  MicheleFumarol1, 1, 0, 1, no
805621619381116928,  Ci_Siamo_Quasi, 6, 0, 6, no
204362369,  fanzfeng, 2, 0, 2, no
72653116,  chille82, 1, 0, 1, no
410796950,  thenc83, 2, 0, 2, no
492868812,  Stefy_61, 1, 0, 1, no
4093194160,  ilmasco, 1, 0, 1, no
1342378488,  Laura_hioops, 1, 0, 1, no
2864655706,  laurasatta67, 1, 0, 1, no
155175769,  limone86, 1, 0, 1, no
418301345,  SuperErmy, 7, 0, 7, no
3001315397,  dcortes217, 2, 0, 2, no
786291541560164353,  luciaarioli, 1, 0, 1, no
725267992490201089,  MirkoHashtag, 1, 0, 1, no
1735413050,  GiuVik, 1, 0, 1, no
370317402,  riccardolino97, 1, 0, 1, no
487350871,  Noodles_70, 3, 1, 2, no
497067598,  Zinno_Anto777, 1, 0, 1, no
3110991701,  nanni_antonio, 1, 0, 1, no
3233822843,  LCasuc, 2, 0, 2, no
893322829,  giuseppedibel11, 2, 0, 2, no
1444057844,  donatelladt, 2, 0, 2, no
424232469,  Mari_iuso, 1, 0, 1, no
115125066,  omarcip, 2, 0, 2, no
1259876935,  pierowatchdog, 1, 0, 1, no
739464739848327168,  aldocivello, 1, 0, 1, no
163973932,  GENOA69, 1, 0, 1, no
1140585595,  GiovaFalcone, 1, 0, 1, no
2358239955,  STuozzi, 1, 0, 1, no
713488995267776512,  leonardo_car_90, 1, 0, 1, no
2802565126,  SasyCuturi, 1, 0, 1, no
411587862,  Zimo1976, 1, 0, 1, no
1907788800,  GASPARETITONE92, 1, 0, 1, no
192277509,  gxausa, 4, 0, 4, no
404038986,  PaoloVaccarello, 1, 0, 1, no
701978031,  Tatmattat, 1, 0, 1, no
4076789541,  Nanasupergirls, 1, 0, 1, no
2534832186,  brinopuzzul, 1, 0, 1, no
728289066169606144,  respectRESPECTo, 4, 0, 4, no
49592235,  a_colonello, 1, 0, 1, no
1241512020,  EmilioCenturio, 1, 0, 1, no
524427275,  LeoBellucci68, 1, 0, 1, no
418532282,  Alessandro_mic, 1, 0, 1, no
19791924,  Matteo84, 1, 0, 1, no
768361830049775616,  NelloLombardo87, 1, 0, 1, no
4895277075,  zvezda_int, 1, 0, 1, no
445727059,  marcellomolina1, 4, 0, 4, no
96368478,  depot36, 1, 0, 1, no
784756576229978112,  sandrolindirix, 1, 0, 1, no
389329973,  FabioBramati, 2, 0, 2, no
401573417,  WiAnselmo, 1, 0, 1, no
1036785966,  LuciusEvil85, 1, 0, 1, no
2807355797,  DiBallista, 1, 0, 1, no
711937157234106369,  KorianLXX, 1, 0, 1, no
621945762,  GENNAR0ACANFORA, 5, 0, 5, no
734404005544251392,  politisonia9, 3, 0, 3, no
1008846302,  AlexMelicchio, 2, 0, 2, no
3151774115,  CardoneGaspare, 2, 0, 2, no
1576436762,  brook1285, 1, 0, 1, no
347879345,  itsmiry, 1, 0, 1, no
3564664455,  vittorio83101, 2, 0, 2, no
498746167,  Deviduan, 1, 0, 1, no
97512948,  michele1375, 1, 0, 1, no
1234070258,  LuigiTrib, 2, 0, 2, no
510441663,  LFestolai, 2, 0, 2, no
3079004361,  blackskies81, 1, 0, 1, no
2686763793,  antonio_podda, 1, 0, 1, no
208792626,  7Claus, 1, 0, 1, no
795170913759232000,  MassimoPiam, 3, 0, 3, no
796633775908200448,  bonacina_milvia, 1, 0, 1, no
1223938933,  IgnazioMarchett, 1, 0, 1, no
97654241,  ibadiagne1, 3, 0, 3, no
2860387389,  FabFaberrimo, 1, 0, 1, no
3669161052,  iOpPiXQ, 1, 0, 1, no
2407292225,  viaggioasudest, 4, 0, 4, no
960709286,  PSalutij, 2, 0, 2, no
272444320,  ziogio84, 1, 0, 1, no
193093990,  StefanoLimido, 7, 0, 7, no
401270818,  VoltoliniSergio, 1, 0, 1, no
424887657,  _mirylisa_, 1, 0, 1, no
546146776,  emma_montilla, 1, 0, 1, no
409401116,  jaureguicrushes, 1, 0, 1, no
488228389,  Alamroste, 1, 0, 1, no
1104800478,  antoninofiorel2, 1, 0, 1, no
2715490961,  giovannimiobor, 1, 0, 1, no
324937940,  LucaCialone, 1, 0, 1, no
471288163,  dbaldoli, 2, 0, 2, no
997961833,  Jikkol, 3, 0, 3, no
538352513,  justlikeaswan, 1, 0, 1, no
257600699,  danieleamadei1, 1, 0, 1, no
868842919,  motardknight, 2, 0, 2, no
4011769781,  AleCaimano95, 1, 0, 1, no
2230687067,  RenziValentino, 1, 0, 1, no
398777579,  Ferdinando_R, 1, 0, 1, no
789473196974235648,  figiovanibari, 1, 0, 1, no
2403109144,  amato_ea, 1, 0, 1, no
916122110,  Bala_mazeh, 1, 0, 1, no
418585940,  daniele_bungaro, 1, 0, 1, no
433157453,  daniele_delgiu, 2, 0, 2, no
1300336105,  carlo_rodini, 1, 0, 1, no
2490453968,  ITnewsAQ, 1, 0, 1, no
4593402796,  nadiagennaio, 1, 0, 1, no
70914477,  paolo_rainone, 1, 0, 1, no
1367554068,  MarcoCheck, 1, 0, 1, no
2189123792,  noviello_m, 1, 0, 1, no
4744364495,  sdp230170, 1, 0, 1, no
4897441318,  Peppe15850, 1, 0, 1, no
421940382,  morgante_ant, 1, 0, 1, no
854995166,  lucamerlo1961, 1, 0, 1, no
114541381,  FlavioParis, 1, 0, 1, no
1546601714,  FilippoCorbetta, 3, 0, 3, no
3601765336,  LallaAnedda, 1, 0, 1, no
386605670,  mmcastellana, 1, 0, 1, no
1007379228,  DaniCancellaro, 2, 0, 2, no
412371227,  AngieCalabria, 2, 0, 2, no
425154943,  sindacoascoli, 2, 0, 2, no
743901080,  RiccardoSerino, 1, 0, 1, no
4121762391,  OgnibeneAntoni0, 2, 0, 2, no
533298709,  ItsMsBeatrice, 4, 0, 4, no
236346513,  illetterati, 1, 0, 1, no
2223424171,  dileboss, 1, 0, 1, no
538979322,  Al3xI98O, 2, 0, 2, no
516425565,  alessan14409230, 1, 0, 1, no
2810483745,  salvodenaro969, 1, 0, 1, no
2972138392,  ZQuaglia, 1, 0, 1, no
3152326126,  mmoviedreamer, 2, 0, 2, no
2247033698,  nicomorreale, 1, 0, 1, no
1022297180,  seminavento, 1, 0, 1, no
55205815,  danibarison, 2, 0, 2, no
1086392940,  judyset, 2, 0, 2, no
2198055140,  esarpieri, 2, 0, 2, no
198237141,  CruthABhais, 2, 0, 2, no
3395698721,  possibileTO, 16, 0, 16, no
958385528,  berardi_berry, 1, 0, 1, no
1075851336,  mazzodirosa, 5, 0, 5, no
3304312095,  Cesenati, 1, 0, 1, no
2489783098,  InchesMarina, 1, 0, 1, no
3429792322,  Sinibaldo2, 2, 0, 2, no
832781346,  elleflo, 1, 0, 1, no
17623945,  gfailli, 1, 0, 1, no
2886188501,  sarah_fagnani, 1, 0, 1, no
2663879552,  gnofforosy, 1, 0, 1, no
923054467,  grosciarelli, 1, 0, 1, no
133657565,  callthewild, 2, 0, 2, no
361378092,  ele_MP, 1, 0, 1, no
1254914232,  Vaperonzolo, 1, 0, 1, no
403690384,  gghrrrr, 3, 0, 3, no
402200260,  ilariaeffe_, 6, 1, 5, no
612573173,  AntoniaFerri96, 1, 0, 1, no
247726328,  yes_political, 61, 0, 61, no
50773283,  quillyx, 7, 0, 7, no
787557789908492288,  KiraPossibile, 12, 0, 12, no
475922296,  lucatrent, 1, 0, 1, no
714376418055073793,  rosabiancage, 40, 0, 40, no
3394568602,  bria_daniela, 4, 0, 4, no
1300370167,  gmarcoc, 12, 0, 12, no
4237848425,  AstiPossibile, 12, 0, 12, no
3579613995,  CantoniAndrea3, 4, 0, 4, no
972656305,  graziellabonazz, 2, 0, 2, no
519587814,  claudiasuman, 1, 0, 1, no
415474316,  ChiaraBen1, 1, 0, 1, no
113092215,  robertodiloreto, 5, 0, 5, no
27076736,  Gianuario, 1, 0, 1, no
596242494,  GobbatoOmar, 1, 0, 1, no
4895171374,  maria_atza, 1, 0, 1, no
84114885,  Scisciolina, 1, 0, 1, no
103850600,  annadicosmo, 1, 0, 1, no
14743741,  federicabianchi, 1, 0, 1, no
336091189,  LucaBortot, 24, 0, 24, no
352286129,  CicoGiattini, 3, 0, 3, no
2358389201,  DavipasquaD, 1, 0, 1, no
587385901,  giuliana_63, 3, 0, 3, no
615369614,  sonosempregraz, 3, 0, 3, no
291299121,  AkanumaSaburo, 1, 0, 1, no
1927609350,  FAttiani, 1, 0, 1, no
993828108,  carmelo03355935, 1, 0, 1, no
710856118,  RealiAlice, 1, 0, 1, no
2493300512,  gui_sann, 15, 0, 15, no
1857916189,  Pablobrado, 2, 0, 2, no
340206383,  marge78s, 4, 1, 3, no
72123412,  longghost, 1, 0, 1, no
256448479,  valeriaderosa, 1, 0, 1, no
180519887,  cibe68, 5, 0, 5, no
2414965448,  FamaNelMondo, 1, 0, 1, no
714364362320912385,  Fullmonty_Ge, 12, 0, 12, no
504900046,  SaraSarita1978, 5, 0, 5, no
739555684379992064,  armando_ciraci, 1, 0, 1, no
486146467,  fra__alice, 10, 0, 10, no
285012814,  Dat4BIT, 1, 0, 1, no
322933929,  ellyesse, 21, 0, 21, no
54912548,  mattianocchi, 1, 0, 1, no
307312384,  sheispale, 1, 0, 1, no
549362239,  paolopedrollo, 2, 0, 2, no
765596923,  kappalvia, 1, 0, 1, no
537571703,  pola6565, 2, 0, 2, no
3906873494,  DocZocc, 1, 0, 1, no
765607412778893312,  MarcisRosa, 3, 0, 3, no
51752772,  stefanocatone, 65, 0, 65, no
993545408,  AvvAMaestri, 16, 1, 15, no
721992704,  CocchiaraA, 1, 0, 1, no
402821533,  Blunaturale, 22, 0, 22, no
802346387056848896,  Mattia_Piac, 1, 0, 1, no
2295054346,  Luisa_Zu, 1, 0, 1, no
2290581567,  martola_ba, 1, 0, 1, no
752109345333182464,  RobynH711, 1, 0, 1, no
400271467,  ziacoco_, 1, 0, 1, no
3145545058,  RomaPossibile, 6, 0, 6, no
87500470,  fepop, 3, 0, 3, no
791983374890070017,  FrancescoLabri5, 4, 0, 4, no
3381931395,  ElenaSeroni, 1, 0, 1, no
14203530,  alberto_e_fabio, 3, 0, 3, no
418164976,  rosario_deluca, 1, 0, 1, no
3676258635,  mainardi_c, 1, 0, 1, no
1017310213,  EmanuelaAmendo1, 45, 0, 45, no
555223117,  SerenaMatata, 1, 0, 1, no
219283583,  ennionicolucci, 1, 0, 1, no
297353414,  LeoBrattoli, 5, 0, 5, no
1040112655,  PescioA, 1, 0, 1, no
4296909862,  PossibileRimini, 2, 0, 2, no
343557294,  betascia, 7, 0, 7, no
107832131,  monicaborgonovo, 1, 0, 1, no
2357348337,  MarcoManJazz, 2, 0, 2, no
1660188204,  AlbaVallone, 2, 0, 2, no
1026285708,  antonacci_s, 1, 0, 1, no
218170928,  babethin, 1, 0, 1, no
745654987,  SandraQuellen, 4, 0, 4, no
2867411482,  ervalax, 2, 0, 2, no
744104941,  TamaraVitelli, 1, 0, 1, no
92093560,  Annansr, 1, 0, 1, no
322644117,  lamberto50, 1, 0, 1, no
227326545,  enricomariam42, 1, 0, 1, no
83905283,  EleonoraBellini, 5, 0, 5, no
570043126,  CHCEmsden, 1, 0, 1, no
2980651536,  Aleky88_, 1, 0, 1, no
908644910,  IndipenDancing, 3, 0, 3, no
3246308829,  GBertaiola, 5, 0, 5, no
272473332,  rupof, 4, 0, 4, no
4105925825,  SpettinatiPisa, 105, 0, 105, no
2778839548,  totibusc, 1, 0, 1, no
2471307470,  MariaGi45409317, 4, 0, 4, no
18074964,  riccardosusigan, 4, 0, 4, no
134043295,  springcornfield, 4, 0, 4, no
68464543,  _C1P8, 5, 0, 5, no
472149764,  lucapasto71, 5, 0, 5, no
3980123284,  ZaraPossibile, 9, 0, 9, no
2385387728,  thunder_Luna, 1, 0, 1, no
3141830668,  b6f85a4e93924c7, 5, 0, 5, no
368938633,  paologabri, 2, 0, 2, no
432659382,  fraturca, 1, 0, 1, no
995538919,  rossipaoloborg, 2, 0, 2, no
2452845047,  SernesiAnna, 2, 0, 2, no
829100496,  emanuele_delca, 1, 0, 1, no
514862063,  gmbadalucco, 8, 0, 8, no
1012718378,  otto_gerbotto, 7, 0, 7, no
3372564964,  Ann14256154, 1, 0, 1, no
1650257054,  LaStefi_P, 6, 0, 6, no
409780693,  beck2009, 1, 0, 1, no
2789716509,  36Antignani, 1, 0, 1, no
356979186,  morenaragone, 1, 0, 1, no
1388012268,  adrianadanielis, 1, 0, 1, no
228092863,  iparchia, 1, 0, 1, no
216722162,  robertobraibant, 4, 1, 3, no
1747593649,  sseruenah, 1, 0, 1, no
455091874,  EnzoSpano, 10, 0, 10, no
2788775085,  LiviDaniela, 1, 0, 1, no
2745073989,  fabiolabernar12, 1, 0, 1, no
2258720305,  frances1724, 1, 0, 1, no
553489727,  Pikkkets, 4, 0, 4, no
379606499,  pachir1, 1, 0, 1, no
2586934926,  grrsarafe, 1, 0, 1, no
864298688,  my_fugaro, 1, 0, 1, no
2438113823,  da_angelini, 1, 0, 1, no
61253013,  valelelli, 3, 0, 3, no
3345399412,  lorenzmetr, 1, 0, 1, no
2245662505,  pdeffe, 18, 0, 18, no
1228301834,  FrancoMusiani, 2, 0, 2, no
969981643,  ES1670, 1, 0, 1, no
449929150,  Zziagenio78, 1, 0, 1, no
736738094,  dakota_rain1986, 1, 0, 1, no
413452932,  chiccotassi, 33, 0, 33, no
396708812,  Samuelpk88, 4, 0, 4, no
1153870734,  pucciopucci, 4, 0, 4, no
2467854313,  CrippaCristiano, 1, 0, 1, no
2942489579,  robespierre1102, 1, 0, 1, no
2505069530,  azarb56, 1, 0, 1, no
2365629604,  Itapop3, 1, 0, 1, no
711840434922905601,  wberor, 1, 0, 1, no
4754588073,  PatrizioRossi68, 1, 0, 1, no
299591494,  aurelionoto, 2, 0, 2, no
716296157501251584,  11Anna33, 2, 0, 2, no
2859584915,  ElisabettaLapa, 6, 0, 6, no
2256825849,  RCavalleris, 1, 0, 1, no
28311464,  newyorker01, 4, 0, 4, no
483921025,  stefanotenenti, 1, 0, 1, no
963357198,  solosamp52, 1, 0, 1, no
952525316,  sgiangra69, 4, 0, 4, no
868495848,  FerminaTardiola, 1, 0, 1, no
314704846,  Valeriadionisi, 1, 0, 1, no
1371364542,  GiorgioCassiani, 1, 0, 1, no
374492014,  edo_cavalieri, 4, 0, 4, no
556279234,  ValeJim78, 1, 0, 1, no
195570374,  ManuelNegri1, 1, 0, 1, no
423764654,  Manuelitas3, 1, 0, 1, no
765272653,  marco_piotti, 1, 0, 1, no
368251893,  PopperPro, 1, 0, 1, no
328728398,  FrCarrozza, 4, 0, 4, no
315206080,  MassimoBorin, 1, 0, 1, no
1901726846,  acollocola, 3, 0, 3, no
1162777183,  MAcquisto, 1, 0, 1, no
2180838160,  ir8lotus, 14, 1, 13, no
498950135,  DaBraveSquirrel, 1, 0, 1, no
424953319,  luca74alba, 1, 0, 1, no
548339636,  Gerardo6481, 1, 0, 1, no
1338533124,  bgassistenza, 1, 0, 1, no
759087906698952705,  salvolacquisto, 1, 0, 1, no
1056261745,  cadore31, 1, 0, 1, no
753897017479458816,  Re_Sambuco, 5, 0, 5, no
354437152,  romugio, 1, 0, 1, no
546883200,  Orsito57, 3, 0, 3, no
146990130,  Bisont19, 1, 0, 1, no
4904886465,  FrancescomerloI, 3, 0, 3, no
573026318,  MicheleOkuto79, 1, 0, 1, no
434245648,  jg88london, 1, 0, 1, no
4204846048,  Sima_luse, 1, 0, 1, no
734978406,  martascelto, 1, 0, 1, no
417987965,  cintamtam, 4, 0, 4, no
616006828,  DjProfC, 1, 0, 1, no
467800902,  M6Massimiliano, 1, 0, 1, no
3155599023,  Ser_Otonin, 1, 0, 1, no
170662528,  Roby1893, 2, 0, 2, no
55290343,  Cirillo71, 3, 0, 3, no
2341857585,  mixmichy, 2, 0, 2, no
2948819674,  PSgces, 3, 0, 3, no
2707696839,  giagc1, 1, 0, 1, no
465494905,  Ale_Il_Cica, 2, 0, 2, no
325434933,  lajeje13, 3, 0, 3, no
993658128,  holdenboerina, 4, 0, 4, no
585007734,  ErmenautaE, 1, 0, 1, no
524960159,  lucapontani1, 1, 0, 1, no
453913656,  StefBadi, 1, 0, 1, no
2820137385,  chiauzza, 1, 0, 1, no
708633075190775808,  lucia_speciale, 1, 0, 1, no
731917270369357824,  alessandra_fata, 4, 0, 4, no
2825937448,  GiankarlinoP, 2, 0, 2, no
701001362688057344,  ChiccaC5, 1, 0, 1, no
2752633492,  ftoscano45, 2, 0, 2, no
3124892121,  vivo8001, 1, 0, 1, no
201383425,  ilMalf, 1, 0, 1, no
3861211695,  NicolettaAnton6, 2, 0, 2, no
1960996136,  Boukols, 1, 0, 1, no
94096311,  silariucci, 3, 0, 3, no
4909961751,  ritabiabi, 2, 0, 2, no
222031257,  mamalu01, 1, 0, 1, no
484111651,  PietroPinna77, 2, 0, 2, no
484710448,  tedbeebundy, 4, 0, 4, no
49400917,  Daniele_Brundu, 2, 0, 2, no
296556636,  Megistone90, 1, 0, 1, no
371984063,  CorradoDeMori_, 2, 0, 2, no
2723526534,  consuldati, 4, 0, 4, no
534158772,  AllanKafka, 1, 0, 1, no
1464772885,  VenetoPossibile, 1, 0, 1, no
898362882,  pasolinisel, 1, 0, 1, no
354192905,  andreferto, 2, 0, 2, no
267649803,  LuigiGrimaldi19, 2, 0, 2, no
2508822164,  elifiniguerra, 1, 0, 1, no
1456957934,  donbicenzo, 1, 0, 1, no
52887994,  signro, 1, 0, 1, no
2528310757,  max75arvat, 2, 0, 2, no
1697331835,  salvo092z105, 2, 0, 2, no
1363738694,  nicgconti, 1, 0, 1, no
252472868,  delotwitt, 3, 0, 3, no
407777608,  GPGiampi, 18, 0, 18, no
3907053811,  marco_sberla, 3, 0, 3, no
475785102,  MariaLuisaCamma, 1, 0, 1, no
86396588,  manutrentasan, 1, 0, 1, no
795413094306578432,  fra_calia, 5, 0, 5, no
743476400447959040,  MaraSpagn, 1, 0, 1, no
50755916,  Pelagatti, 1, 0, 1, no
114332714,  DinoGiarrusso, 1, 0, 1, no
4023777869,  natonel1965, 1, 0, 1, no
2604413069,  framaio82, 4, 0, 4, no
724908158813102080,  sicuruslan, 1, 0, 1, no
1063187516,  AngeloFrezzotti, 1, 0, 1, no
3674593815,  PossibileFR, 1, 0, 1, no
144924917,  Chicca7066, 1, 0, 1, no
95655966,  simod87, 2, 0, 2, no
1643202524,  enzastroscio, 1, 0, 1, no
2242134295,  RaskolnikovGio, 1, 0, 1, no
703690480333279232,  ardit_bardho, 1, 0, 1, no
2360067140,  Nubulina, 1, 0, 1, no
136243366,  LucaGaveglia, 3, 0, 3, no
438382792,  dinataled, 2, 0, 2, no
2318726325,  GiuseppeSarao, 1, 0, 1, no
2912674654,  mberguer369, 1, 0, 1, no
465870411,  FranziskanerC, 3, 0, 3, no
404289086,  ilmichelaccio, 1, 0, 1, no
99547552,  saria_mba, 1, 0, 1, no
1601049578,  IsabellaMessa, 1, 0, 1, no
2401546563,  iris_emg, 1, 0, 1, no
267278702,  lasceltadisofie, 1, 0, 1, no
840408042,  ChristianConte_, 1, 0, 1, no
746108643792257025,  OpenGDB, 2, 0, 2, no
1367959076,  markinob, 2, 0, 2, no
488774565,  EulaliaGrillo, 4, 0, 4, no
316376052,  alessandracatsi, 1, 0, 1, no
3197562329,  FerroSte, 4, 0, 4, no
2318623488,  speleogasp, 1, 0, 1, no
1360232630,  europaviva21, 1, 0, 1, no
462974581,  fborsotti, 4, 0, 4, no
496882326,  GrazianoValobon, 2, 0, 2, no
559360022,  NenziTre, 1, 0, 1, no
840139694,  dario_benetti, 2, 0, 2, no
2495046013,  61206bff2fe44a1, 1, 0, 1, no
505731055,  arantza0909, 1, 0, 1, no
1311315589,  vascogeminiani, 2, 0, 2, no
2194346187,  francioni81, 1, 0, 1, no
1239185874,  peppinaines, 4, 0, 4, no
2183118052,  lindamaria61, 1, 0, 1, no
738895631897530368,  bringbacksardon, 1, 0, 1, no
342663113,  SusannaPellis, 1, 0, 1, no
8672302,  ElisAceto, 6, 0, 6, no
1063095882,  Ninnige, 1, 0, 1, no
367768283,  anna_navarra, 1, 0, 1, no
723065022,  pomponellacassa, 2, 0, 2, no
489421757,  EFurbini, 1, 0, 1, no
617476851,  angelacasciaro, 1, 0, 1, no
701318641,  chiamaago, 1, 0, 1, no
376435133,  VFocarini, 4, 0, 4, no
548527501,  hiddenyears, 1, 0, 1, no
482157683,  salvatorecalda2, 3, 0, 3, no
278558220,  rob_salentino, 10, 0, 10, no
2267498320,  Morandini44P, 1, 0, 1, no
34666215,  Mister_Mustard_, 10, 0, 10, no
957115429,  GiuliaVB7, 2, 0, 2, no
3297004216,  fcaruso77, 1, 0, 1, no
383392161,  DepaulisLidia, 2, 0, 2, no
41102501,  massimobolzoni, 1, 0, 1, no
33197952,  danikina, 1, 0, 1, no
751709328495828992,  ChiaraNic2000, 2, 0, 2, no
1004351580,  mare_egeo, 1, 0, 1, no
877284637,  esynedd, 1, 0, 1, no
543775709,  BarbanoD, 1, 0, 1, no
405498866,  MoriThinkgreen, 3, 0, 3, no
10305682,  Ennio_Ammatuna, 1, 0, 1, no
16718357,  ilfrance, 4, 0, 4, no
1546075458,  ClaraApi, 2, 0, 2, no
1422707112,  vdisalvo61, 1, 0, 1, no
599317794,  iato4347, 1, 0, 1, no
82389388,  glr_69, 11, 0, 11, no
361097511,  61scacorte, 1, 0, 1, no
1094672911,  rossellabea, 2, 0, 2, no
391505537,  AleQuinto1, 1, 0, 1, no
447059765,  anita_lombardi, 1, 0, 1, no
2765465397,  AgostaClaudia, 1, 0, 1, no
985260338,  GiuseppeB3, 1, 0, 1, no
115821691,  EmanueleVitale8, 1, 0, 1, no
1392414307,  LStregatta, 1, 0, 1, no
3728578817,  comp1111, 4, 0, 4, no
1958726070,  MCaua87, 5, 1, 4, no
916889676,  ameranieri, 1, 0, 1, no
3398794235,  PossibileTN, 2, 0, 2, no
3919762222,  gina_longobardi, 1, 0, 1, no
398846237,  babavigano, 1, 0, 1, no
53025983,  mauro_ciociari, 3, 0, 3, no
96736190,  AleFry93, 1, 0, 1, no
362697385,  carocchia_gm, 1, 0, 1, no
2361311542,  mimmoporcaro, 1, 0, 1, no
1111825675,  SbaragliaE, 1, 0, 1, no
2173408514,  matilderossi14, 4, 0, 4, no
97636338,  NazzaroGioia, 1, 0, 1, no
1093674200,  Fragile_ivy, 2, 0, 2, no
390370399,  rita_larita, 2, 0, 2, no
250615118,  baronebarolo, 1, 0, 1, no
708604566414168064,  LeoCusseau, 3, 0, 3, no
430921472,  giorgiobrusa, 1, 0, 1, no
99360043,  GiuseppeMilano, 13, 0, 13, no
323712890,  eireenM, 3, 0, 3, no
421987528,  PaolaGattini1, 2, 0, 2, no
1603537111,  LuccaPossibile, 16, 0, 16, no
597546745,  RobertoOmodei, 2, 0, 2, no
507858408,  mrnlla, 1, 0, 1, no
1528013437,  is0bzr, 6, 0, 6, no
455732838,  giannioriporap, 1, 0, 1, no
1238563154,  nocciola68, 2, 0, 2, no
159428186,  Luisi_36, 1, 0, 1, no
262300343,  CAPTAlNERD, 1, 0, 1, no
181907487,  Piero8211, 3, 0, 3, no
1374627000,  ProssimaPR, 3, 0, 3, no
439907099,  FabSciarratta, 7, 0, 7, no
3143038229,  IpocritaUtopia, 1, 0, 1, no
404232151,  selmabellomo, 5, 0, 5, no
326225431,  francescagibs, 1, 0, 1, no
989780574,  concettagentili, 1, 0, 1, no
2260532036,  gemmapontini, 1, 0, 1, no
82301254,  sonia_star, 1, 0, 1, no
119442405,  MacKlavious, 2, 0, 2, no
407864601,  MasFerrario, 1, 0, 1, no
5660552,  venetianspring, 1, 0, 1, no
518822244,  Melissa_Di_Sano, 1, 0, 1, no
561198013,  pasto_ema, 1, 0, 1, no
16120863,  sinigagl, 9, 0, 9, no
401222371,  SLiberatori, 1, 0, 1, no
620409243,  Giraffa50, 1, 0, 1, no
2219307076,  simotumiotto, 1, 0, 1, no
2902660673,  fabfor53, 1, 0, 1, no
123943257,  fabioiov, 5, 0, 5, no
345413548,  cateferri, 3, 0, 3, no
798264883062206469,  sunneversets100, 3, 1, 2, no
4244506073,  paperallarancia, 1, 0, 1, no
56959678,  Alyssa_77, 1, 0, 1, no
36112151,  eenrico, 8, 0, 8, no
406612713,  SSnaporaz, 1, 0, 1, no
3946857573,  115_marinax, 1, 0, 1, no
485841893,  Speziale11, 5, 0, 5, no
1292233951,  DomenicoSetola, 1, 0, 1, no
4062849807,  ChRiStIaN1987_, 3, 1, 2, no
782203229375438848,  pigna1897, 2, 0, 2, no
1086423912,  klarakic, 2, 0, 2, no
504625929,  FranzFoti, 16, 0, 16, no
600493716,  GianvaM, 1, 0, 1, no
3241670374,  MiraPossibile, 8, 0, 8, no
889554902,  domenicoditell1, 1, 0, 1, no
406074969,  RVilonna, 4, 0, 4, no
393298498,  LaSgarella, 1, 0, 1, no
486764261,  pliniocaocche, 4, 0, 4, no
2269224186,  MarcoAmbra, 1, 0, 1, no
14257328,  Giuseppe_Conte, 2, 0, 2, no
781097255793295361,  APPASSIONAT, 1, 0, 1, no
416602053,  tiramagda, 1, 0, 1, no
61769061,  robboos, 2, 0, 2, no
2268022753,  MariaGraziaLaGr, 1, 0, 1, no
1736856739,  elstitico, 1, 0, 1, no
248600291,  Varrons, 1, 0, 1, no
502040368,  map_pina, 2, 0, 2, no
133661112,  Fabioder, 2, 0, 2, no
421986520,  DavAstolfiGreen, 1, 0, 1, no
14146095,  doonie, 1, 0, 1, no
1416334759,  xsara91x, 1, 0, 1, no
3312600789,  Sarabraghira, 1, 0, 1, no
463819571,  AdriPantera111, 1, 0, 1, no
422900035,  CeciliaDelFreo, 1, 0, 1, no
580072300,  robi_wan_kenoby, 1, 0, 1, no
2735436460,  LeyvaFrancesco, 2, 0, 2, no
70074473,  gaietti, 1, 0, 1, no
3037069073,  giordano_bindi, 1, 0, 1, no
29241203,  ludojona, 1, 0, 1, no
39827736,  entropia2009, 3, 0, 3, no
329655105,  tinellissima, 1, 0, 1, no
904225238,  MascheriniM, 1, 0, 1, no
407827638,  mariadp59, 2, 0, 2, no
2153540972,  jesixcivati, 1, 0, 1, no
96323735,  aliossandro, 1, 0, 1, no
470527296,  MrSkoglio, 1, 0, 1, no
241521416,  fdrctnzz, 1, 0, 1, no
90597064,  Giaimeddu, 7, 0, 7, no
4705737143,  claudiagri89, 2, 0, 2, no
22604022,  AkiFzero, 1, 0, 1, no
101783889,  phr23, 2, 0, 2, no
135640839,  ElfoBruno, 4, 0, 4, no
522636610,  FrankSlade5, 1, 0, 1, no
805150779929722880,  Benedet35791130, 2, 0, 2, no
256888973,  marcocacchioli, 3, 0, 3, no
269723753,  politikavi, 3, 0, 3, no
1362895116,  BaMantiero, 1, 0, 1, no
264429967,  incontestabile, 1, 0, 1, no
96236264,  irpannocchia, 20, 0, 20, no
434743018,  emerge67, 2, 0, 2, no
1657867358,  carusopascoski_, 2, 0, 2, no
258294816,  Frantz75, 7, 1, 6, no
466809596,  Riccardo_Carpa, 1, 0, 1, no
2851657444,  valentina_mulas, 1, 0, 1, no
82319300,  LotarSan, 1, 0, 1, no
1519470108,  Namalo97, 1, 0, 1, no
108061631,  aliciasbb, 3, 0, 3, no
1209302970,  m_decaria, 1, 0, 1, no
389388850,  danny_mancini, 1, 0, 1, no
289844002,  elisapunto, 1, 0, 1, no
2992059808,  Pa_Gug, 1, 0, 1, no
363854578,  AntoPalombi, 2, 0, 2, no
573306944,  ClaudioBocci2, 1, 0, 1, no
3614129489,  napolipossibile, 8, 0, 8, no
259068501,  mariush79, 1, 0, 1, no
708875522,  MicheleSpinella, 2, 0, 2, no
1115796702,  RobySpedicato, 1, 0, 1, no
3301082218,  possibileav, 1, 0, 1, no
2820415427,  Filcafree, 6, 2, 4, no
2660717879,  drya_fly, 2, 0, 2, no
703178296255643648,  Fuori_conTROLL, 1, 0, 1, no
722256877,  dsabbadini, 1, 0, 1, no
3300827655,  AllegraElisa, 1, 0, 1, no
177321655,  mininightingale, 1, 0, 1, no
84030207,  CalzeBucate, 1, 0, 1, no
2357919636,  Trekker1978, 1, 0, 1, no
2291495448,  TizianaNov, 3, 0, 3, no
344890156,  Amanauzzi, 1, 0, 1, no
1929792140,  CastelloPoss, 1, 0, 1, no
3784366697,  chiara_scott_gb, 1, 0, 1, no
124114948,  bure74, 1, 0, 1, no
720938640302600193,  semabluposs, 1, 0, 1, no
1460831760,  brianzapercivat, 1, 0, 1, no
1278796585,  catiacan61, 2, 0, 2, no
1357999944,  MacchiaFilomena, 1, 0, 1, no
363766849,  ulisse470, 1, 0, 1, no
429291540,  zeghes, 1, 0, 1, no
2347407895,  silvanag56, 1, 0, 1, no
304406977,  ida_bauer_, 2, 0, 2, no
763785605713199105,  costituzionesp, 19, 2, 17, no
83427420,  Tobolo73, 1, 0, 1, no
106768331,  watmour, 1, 0, 1, no
1561360807,  DanieleLorenze2, 1, 0, 1, no
205654050,  daniele_varotto, 1, 0, 1, no
2795360609,  WBKimmoto, 1, 0, 1, no
726085176,  piedipalmati, 1, 0, 1, no
722410225161125888,  msgaiafalanga, 1, 0, 1, no
225920702,  Signorina_Wonka, 1, 0, 1, no
927321409,  MapOfMe, 1, 0, 1, no
3375685769,  ffranci9, 1, 0, 1, no
142239687,  robertoambro, 2, 0, 2, no
481109998,  elelua, 1, 0, 1, no
426106037,  pamelarossilli, 1, 0, 1, no
31499492,  caniodica, 2, 0, 2, no
3306815747,  hannalena17m, 1, 0, 1, no
55549791,  JMonicaHD, 8, 3, 5, no
448070647,  aPIcult, 3, 0, 3, no
450911836,  betty_castelli, 1, 0, 1, no
155305005,  DonPippoUnico, 1, 0, 1, no
212885237,  robgar80, 3, 0, 3, no
762423451,  Prospmusicali, 3, 0, 3, no
3006171915,  JulesValmont, 1, 0, 1, no
1926128882,  fabrilapa, 1, 0, 1, no
569069021,  RaffRoma, 1, 0, 1, no
123064822,  seiya80, 1, 0, 1, no
326414232,  giulia_pagano, 2, 0, 2, no
432551402,  AndreaBiacca, 2, 0, 2, no
3120931079,  pierpietroalfo1, 1, 0, 1, no
579840890,  laziadiKant1, 1, 0, 1, no
425050042,  vuricc, 1, 0, 1, no
265363157,  seiosonoio, 1, 0, 1, no
2610078162,  AnnaMaat, 1, 0, 1, no
634331572,  LuigiPiazza1985, 2, 0, 2, no
1295655181,  Splenetico, 1, 0, 1, no
2248731075,  catespero81, 1, 0, 1, no
449786912,  yakob38, 1, 0, 1, no
32848844,  AB00L, 2, 0, 2, no
12921092,  broogo, 1, 0, 1, no
1202469937,  BaldoniPa, 3, 1, 2, no
2661672875,  nicofabricatore, 1, 0, 1, no
47096857,  Henrybah, 1, 0, 1, no
17250886,  mess_one, 1, 0, 1, no
302495838,  ElisaPolli, 1, 0, 1, no
431681063,  evrachiarucci, 2, 0, 2, no
983202188,  pTribaudino, 1, 0, 1, no
1176617984,  Katia_Spano, 1, 0, 1, no
373834391,  IvanGualandri, 1, 0, 1, no
995163235,  EMoggi, 1, 0, 1, no
291617943,  alex1967_italy, 2, 0, 2, no
74193544,  giorgi0_, 1, 0, 1, no
82194916,  r_coluccio, 3, 0, 3, no
847326918,  santotnas, 2, 0, 2, no
778622611144183808,  benedettauglian, 1, 0, 1, no
9214802,  antronella, 1, 0, 1, no
898446354,  cpneglia, 1, 0, 1, no
3826528468,  forteetaigue, 1, 0, 1, no
212760937,  viseph, 1, 0, 1, no
86612717,  eccezion_ale, 1, 0, 1, no
754820684036145153,  greic0c0c0, 1, 0, 1, no
70116825,  monicarodigari, 1, 0, 1, no
1314715572,  antodoctor66, 1, 0, 1, no
4886097705,  PossibileMilano, 2, 0, 2, no
91175866,  Piciulina3, 1, 0, 1, no
491461632,  LelezX, 3, 0, 3, no
2603702354,  ValerioBonfrate, 1, 0, 1, no
488684786,  NestSilvia, 1, 0, 1, no
1031302704,  FenixVince, 1, 0, 1, no
212870758,  Sfigataavita, 1, 0, 1, no
249131360,  splendenzo, 4, 0, 4, no
1022117018,  ApprodoSicuro, 2, 0, 2, no
2193942701,  CheMagdalena, 1, 0, 1, no
147469640,  GabrieleAdani, 2, 0, 2, no
633077662,  8papere, 1, 0, 1, no
75746749,  lescatterbraine, 1, 0, 1, no
843502922,  ListaLuciano, 1, 0, 1, no
244180943,  michele0904, 2, 0, 2, no
133790890,  ilpost, 1, 0, 1, no
1123481,  Cafeponci, 1, 0, 1, no
2869658737,  fery1378, 1, 0, 1, no
128495447,  SentaScusiProf, 1, 0, 1, no
24145590,  pierpaolodcanto, 3, 0, 3, no
469756701,  Admancinelli, 1, 0, 1, no
554483491,  dodo_nicolai, 1, 0, 1, no
524355966,  alessandro2412, 1, 0, 1, no
88072055,  filecc, 4, 0, 4, no
100462127,  dreaminhogwarts, 1, 0, 1, no
3801646635,  zsuperfrengo, 3, 1, 2, no
801687648448479232,  katyatk6, 1, 0, 1, no
542697215,  ClaudiaDIppolit, 2, 0, 2, no
1648735543,  regaale58, 2, 0, 2, no
473355517,  PeppeCuzzola, 1, 0, 1, no
312249402,  Celest1982, 1, 0, 1, no
2413871801,  massidesimo, 1, 0, 1, no
61140194,  oet1978, 1, 0, 1, no
392828316,  verobellin, 1, 0, 1, no
2180032739,  cheluzza, 1, 0, 1, no
1627693741,  Eemanfredi, 1, 0, 1, no
450945586,  AGiorgy, 1, 0, 1, no
18250015,  canemajico, 3, 0, 3, no
770272591814750208,  Non_proprioSana, 2, 0, 2, no
22417397,  quimichela, 1, 0, 1, no
831166219,  VitaMarko83, 1, 0, 1, no
995703769,  SimoBalzani, 1, 0, 1, no
186737365,  aledipa1990, 1, 0, 1, no
16132761,  flyingb, 1, 0, 1, no
1165545368,  BarberisFa, 1, 0, 1, no
140866381,  esalu57, 1, 0, 1, no
425332035,  MeryPavoni, 1, 0, 1, no
739547121095966720,  BuzzDeKemp, 2, 0, 2, no
37005475,  iervil, 1, 0, 1, no
479894019,  falkendoc, 1, 0, 1, no
720935684010336257,  andrea_lavolpe, 1, 0, 1, no
1073824771,  MonicaMonicaxx, 1, 0, 1, no
1459664820,  isa_nigro, 1, 0, 1, no
207738727,  hernancrisci, 1, 0, 1, no
1362881412,  LeonardusKook, 3, 1, 2, no
496628286,  fiammetta75, 1, 0, 1, no
464538447,  oliofucktory, 5, 2, 3, no
409172119,  proietta, 1, 0, 1, no
2726780518,  framichelon, 1, 0, 1, no
499651865,  Arciclaudio, 1, 0, 1, no
797043217766223873,  ComitatoRomaNO, 1, 0, 1, no
532233305,  mirkoconlak, 1, 0, 1, no
1729080907,  Riccardo_1979, 1, 0, 1, no
288192300,  FantAlessio, 1, 0, 1, no
1160032458,  MariPiredda, 2, 0, 2, no
2227099600,  1968Neri, 1, 0, 1, no
462507663,  GiDiFenza, 2, 0, 2, no
287674459,  federica_dL, 1, 0, 1, no
155329181,  a_Pis4niello, 1, 0, 1, no
3664116256,  ColibriRavenna, 7, 0, 7, no
1048503306,  chiara_nardo, 2, 0, 2, no
150185600,  faberandfaber, 2, 0, 2, no
4361587528,  LaiLaivalentina, 2, 0, 2, no
43082547,  dancherous, 1, 0, 1, no
447158871,  grazianocama, 1, 0, 1, no
552619515,  Saporidielisa, 1, 0, 1, no
475064906,  cristinacipria1, 1, 0, 1, no
371443264,  MatildeGianesin, 1, 0, 1, no
810866180,  andremaggio, 1, 0, 1, no
134419764,  mina359, 1, 0, 1, no
2919375467,  lemmeleo, 2, 0, 2, no
2426870045,  GruppoPiva, 1, 0, 1, no
140759025,  fillofillofillo, 1, 0, 1, no
4865623204,  MarcoPepi79, 1, 0, 1, no
374775777,  emilioferrucci, 1, 0, 1, no
282267783,  realgiugallo, 2, 0, 2, no
540269865,  PmBartolotta, 1, 0, 1, no
729430742787338240,  Tinas_17, 1, 0, 1, no
3217788777,  a02ed0c2e0df4b4, 1, 0, 1, no
1006160659,  DadoSgr, 3, 0, 3, no
539465072,  jfmoriche, 1, 0, 1, no
402627400,  MassimoGenini, 2, 0, 2, no
170747792,  ivanvadori, 4, 0, 4, no
150291895,  kiakube, 2, 0, 2, no
17398391,  roccorossitto, 1, 0, 1, no
2183205763,  ValeriaNatalizi, 1, 0, 1, no
417751713,  SALVATOREVITAL3, 1, 0, 1, no
418968176,  sa_valas, 2, 0, 2, no
513312094,  cukigio, 3, 0, 3, no
2361970348,  FMarchu, 1, 0, 1, no
274494468,  LaChessina, 4, 0, 4, no
1242178308,  StefanoGarello1, 1, 0, 1, no
482995387,  EMeglioli, 1, 0, 1, no
14931302,  framusa, 1, 0, 1, no
2856994017,  TiaMarks, 1, 0, 1, no
1169662310,  z4erre, 1, 0, 1, no
1917266941,  orlando_salvati, 1, 0, 1, no
461410400,  EttoreAnselmo, 1, 0, 1, no
432674051,  MicheleFenzl, 1, 0, 1, no
133641226,  gabrieletorr, 3, 0, 3, no
42399072,  dierema82, 2, 0, 2, no
1060611614,  paoladec72, 1, 0, 1, no
492588231,  cillinant, 1, 0, 1, no
2200279033,  GiacomoSantrevi, 1, 0, 1, no
199275935,  France_91, 1, 0, 1, no
398565982,  MimmoSanto17, 1, 0, 1, no
430130897,  seposto, 3, 0, 3, no
507591568,  maxtalini, 1, 0, 1, no
195433093,  michelemerluzzi, 1, 0, 1, no
185999770,  Gio_Signorini, 1, 0, 1, no
146037020,  omerovitali, 1, 0, 1, no
269253670,  alegavax, 1, 0, 1, no
196495709,  robertofabbrini, 1, 0, 1, no
3310877290,  VolpiPvolpi99, 3, 1, 2, no
288918417,  _DaviDX, 1, 0, 1, no
2275678571,  waitSoloGodot, 1, 0, 1, no
759648125019680768,  Alagon1964, 1, 0, 1, no
729967134311337984,  MicSogari, 1, 0, 1, no
1017149450,  FedericoSala6, 1, 0, 1, no
137387338,  deetnick, 1, 0, 1, no
598550153,  FABIOLAFr85, 1, 0, 1, no
52538651,  Menoccina, 1, 0, 1, no
2247061773,  IArtioli, 1, 0, 1, no
30309333,  UntitledOne, 1, 0, 1, no
35216252,  DarioDolce, 1, 0, 1, no
2271850251,  estrafata, 1, 0, 1, no
571543756,  aliceferrari12, 1, 0, 1, no
1370084306,  GianlucaRaffi, 1, 0, 1, no
491337323,  MenDavideAto, 1, 0, 1, no
2559969658,  Giulizzi3, 1, 0, 1, no
297374938,  FrancescaBF, 1, 0, 1, no
244510499,  ImNoritaka, 1, 0, 1, no
2240743859,  Sancho979, 1, 0, 1, no
472306174,  Gabriele_gabgas, 1, 0, 1, no
4842404398,  latteepeperoni, 1, 0, 1, no
3890198715,  lusalvemini, 1, 0, 1, no
36461066,  MayhemH, 1, 0, 1, no
857873809,  andreabarolini, 2, 0, 2, no
1482938376,  luca_miotti, 1, 0, 1, no
335997914,  emalabro, 1, 0, 1, no
773630350308286464,  blablale, 1, 0, 1, no
1117451029,  frncsclgt, 1, 0, 1, no
2815017419,  MarcoVi18, 1, 0, 1, no
29489829,  bettamarangoni, 1, 0, 1, no
217833162,  P3nny_, 1, 0, 1, no
275702246,  taipatk, 1, 0, 1, no
261231185,  gnaidi, 1, 0, 1, no
339855032,  LuanaGala, 1, 0, 1, no
186976135,  Vin_themusicdoc, 2, 0, 2, no
281977782,  pimboc, 2, 0, 2, no
36954868,  elfodavide, 1, 0, 1, no
1330103137,  LidiaCar28, 1, 0, 1, no
1017154668,  gilupada, 1, 0, 1, no
1417782745,  em_brandolini, 1, 0, 1, no
3171055223,  filtcgilcatania, 1, 0, 1, no
1633482697,  EnzoFo87, 1, 0, 1, no
21268052,  Nadif, 1, 0, 1, no
2225350735,  SFlaviafs, 1, 0, 1, no
603521508,  Route__24, 1, 0, 1, no
506364886,  orbun5, 2, 0, 2, no
2399218862,  consolefirmin, 2, 0, 2, no
748616061474512896,  ceciolin, 1, 0, 1, no
264047932,  Luca_Preziosi, 1, 0, 1, no
22170921,  Consuelo_Motta, 1, 0, 1, no
22345073,  LadySbatSnow, 2, 0, 2, no
14376973,  michele_menard, 7, 2, 5, no
337559945,  vallycolombari, 6, 0, 6, no
582518710,  amicarellaeligi, 1, 0, 1, no
1074654600,  AntonioMagno13, 2, 0, 2, no
751264609,  DeMarchiAlice, 1, 0, 1, no
1638112500,  GonzellettoEMM, 1, 0, 1, no
445808056,  flaviabianchi6, 2, 0, 2, no
2644885920,  FiomMilano, 1, 0, 1, no
355819031,  AlocciRoberto, 1, 0, 1, no
781964484244074496,  LeoDelloIacono, 1, 0, 1, no
2070321,  gustomela, 3, 0, 3, no
266134679,  alessio_pagani, 1, 0, 1, no
2934024047,  cfa34f865e3d4a7, 1, 0, 1, no
1155231451,  agnese_70, 1, 0, 1, no
3298515478,  ea85vr, 1, 0, 1, no
498096650,  s3nt1, 2, 0, 2, no
3727937895,  sartozza, 1, 0, 1, no
1658550259,  Giusgood, 1, 0, 1, no
1015246008,  CerutiGino, 1, 0, 1, no
133657058,  r_u_f_f_, 1, 0, 1, no
2785721938,  fabbriclau, 4, 0, 4, no
2933615739,  Subcomandante8, 1, 0, 1, no
735382877639184384,  AMarcoBottone, 1, 0, 1, no
971574992,  MarthaPisa, 1, 0, 1, no
226607706,  Kimicohippy, 1, 0, 1, no
237336622,  pasy75, 1, 0, 1, no
554361688,  Laura6976, 1, 0, 1, no
414430905,  Pierdupon, 1, 0, 1, no
711234545576714241,  rootofarrow, 1, 0, 1, no
956094938,  spirritta, 1, 0, 1, no
1166904667,  rebeccabruno97, 1, 0, 1, no
497892219,  VirgiSigno, 1, 0, 1, no
3438688090,  LOPPEI2, 1, 0, 1, no
575350675,  cacioman, 1, 0, 1, no
2988179457,  PPirajno, 1, 0, 1, no
251167680,  annaBusca, 2, 0, 2, no
2576165373,  DRossecco, 1, 0, 1, no
107537459,  mondeban, 2, 0, 2, no
61174500,  robbienico, 1, 0, 1, no
2357747324,  tubal2002, 1, 0, 1, no
2185641244,  francesco20uri, 1, 0, 1, no
43758048,  laBalza, 1, 0, 1, no
483014874,  GabMorra, 1, 0, 1, no
2915743943,  matt_stefanelli, 1, 0, 1, no
1948845974,  Catia_twit, 1, 0, 1, no
423452651,  Aimo52Antonio, 1, 0, 1, no
531353736,  Brisamistral, 2, 0, 2, no
800059142434070528,  MofidGhunaim, 1, 0, 1, no
403071809,  max_mans, 1, 0, 1, no
56184462,  pierluigi1972, 1, 0, 1, no
1394750035,  MarcoBaggioli, 2, 0, 2, no
2878208153,  zabusa6, 2, 0, 2, no
503583739,  Simo_Gera, 1, 0, 1, no
1383804116,  FraFuganti, 4, 0, 4, no
186472351,  martinlor, 3, 0, 3, no
791728633,  bearsayshello, 1, 0, 1, no
1441922222,  m4alfoy, 1, 0, 1, no
1248424860,  LindaP_9, 2, 0, 2, no
2277923293,  savinastiz, 1, 0, 1, no
705386674096832514,  possibileFi, 23, 0, 23, no
1077110833,  massimilianimrc, 1, 0, 1, no
866082667,  GioDallAvo, 2, 0, 2, no
2542694957,  biancamirka, 1, 0, 1, no
1271173591,  TassBurrfoot, 4, 0, 4, no
394004577,  concettaconsoli, 1, 0, 1, no
431868464,  dibolo70, 2, 0, 2, no
1211979302,  anirgigi, 1, 0, 1, no
513544196,  lamortevito, 1, 0, 1, no
436632575,  AlbertoCameroni, 3, 0, 3, no
42472392,  SamDiamante, 1, 0, 1, no
442988779,  PiaCovre, 2, 0, 2, no
39705114,  metapapero, 1, 0, 1, no
2768984488,  Ipocontro, 1, 0, 1, no
858461498,  PatriziaFaro, 1, 0, 1, no
710484705561464833,  Hombre_2_0, 1, 0, 1, no
3378635435,  lorislazzarini, 1, 0, 1, no
48652450,  Stade84, 1, 0, 1, no
40205144,  mariziller, 1, 0, 1, no
472813329,  fafo149, 5, 0, 5, no
89745601,  antoniobrunetto, 1, 0, 1, no
1449811436,  antonellabagnai, 1, 0, 1, no
1060584918,  virginiataffuri, 1, 0, 1, no
482565463,  maximo965, 1, 0, 1, no
121189666,  TitusPetronius, 1, 0, 1, no
259667046,  egaio90, 1, 0, 1, no
3238919583,  didiacca, 1, 0, 1, no
2841219569,  fragmentship, 1, 0, 1, no
554333061,  Gere_Luca, 13, 0, 13, no
805551382132649988,  Alesitta77, 1, 0, 1, no
2232059383,  WestKimi, 1, 0, 1, no
199226452,  AlbertoPrina, 2, 0, 2, no
149271071,  Dark_tex, 1, 0, 1, no
475910427,  universosordo, 1, 0, 1, no
3096441706,  FilippoPiron, 4, 0, 4, no
30840771,  fvalieri58, 1, 0, 1, no
724334180935589888,  cinziasinisi1, 1, 0, 1, no
533179045,  AndreaTroiani13, 1, 0, 1, no
2509807266,  TravisBickleJK, 1, 0, 1, no
382817123,  claudialopedote, 2, 0, 2, no
3576591082,  bellaciaoRE, 4, 0, 4, no
1054911576,  soniap1975, 9, 2, 7, no
46755068,  iltwitdimarco, 1, 0, 1, no
385304137,  matteoventurin1, 1, 0, 1, no
3404366332,  LudovisiGiovan1, 1, 0, 1, no
81871800,  claudiodinapoli, 1, 0, 1, no
3992833575,  EnricoCattaneo6, 1, 0, 1, no
1316490913,  emmeguidi, 1, 0, 1, no
3037134647,  dimarby, 1, 0, 1, no
228052591,  melenabig, 1, 0, 1, no
14570884,  rsta, 1, 0, 1, no
299642449,  ddaloisi, 1, 0, 1, no
423421424,  Boris_Grushenko, 1, 0, 1, no
254032141,  mausassi, 1, 0, 1, no
512116327,  lisetta1986, 3, 0, 3, no
65791929,  MrMegu, 1, 0, 1, no
118770273,  gresleri, 2, 0, 2, no
1459455080,  StefanoLonati1, 2, 0, 2, no
593590410,  lele_lombardi, 1, 0, 1, no
945762720,  lapicci72, 1, 0, 1, no
4817602365,  rossana_corti, 1, 0, 1, no
2951309483,  NonSonoMicaBond, 1, 0, 1, no
438507165,  FulvioIchestre, 1, 0, 1, no
35060058,  ferris60, 1, 0, 1, no
801060646699855872,  ilSindacalista_, 1, 0, 1, no
254710766,  AnnaTChe, 1, 0, 1, no
405239257,  dcolarossi76, 1, 0, 1, no
3006726093,  angelog42925331, 1, 0, 1, no
2320612201,  DecayedBoson, 1, 0, 1, no
1298482453,  lmfiameni, 1, 0, 1, no
794689116277526528,  valsteff, 1, 0, 1, no
55819049,  ilbaku, 3, 0, 3, no
1092054787,  belladelli960, 1, 0, 1, no
793705615914856448,  HamaKitama, 5, 1, 4, no
908765210,  CanaliNatalia, 1, 0, 1, no
594859010,  bepimobile, 1, 0, 1, no
3913210511,  miranda_cossu, 1, 0, 1, no
772962268157968384,  possibile_ra, 3, 0, 3, no
1002800005,  emiliovellandi, 2, 0, 2, no
192235112,  bipuntoemme, 1, 0, 1, no
22643979,  gelofred, 1, 0, 1, no
1897525356,  LapiDaria2, 1, 0, 1, no
747245468,  tizianacampodon, 2, 0, 2, no
494453703,  giovmitra, 1, 0, 1, no
2479080795,  vetusmanga, 1, 0, 1, no
313172472,  sewingprincess1, 1, 0, 1, no
850998049,  GillesRegoli, 1, 0, 1, no
1536559470,  maurizi01238636, 1, 0, 1, no
2899564629,  CanalMartino, 1, 0, 1, no
762310425249771521,  cervignano_no, 3, 0, 3, no
266642198,  stefanorlandini, 1, 0, 1, no
578838113,  AntonelloMolin1, 8, 0, 8, no
264153613,  gpcossu, 8, 0, 8, no
750193133871325184,  LauraLaciccia18, 1, 0, 1, no
15342585,  simopg71, 1, 0, 1, no
480740992,  francescosimmar, 4, 0, 4, no
969030108,  RobiGent_7, 1, 0, 1, no
1073472072,  mariateresam66, 1, 0, 1, no
196345013,  TheRomeoAntonio, 1, 0, 1, no
220607993,  FraMilione, 1, 0, 1, no
3954296663,  Mycroft74, 1, 0, 1, no
593101773,  CronacheLucane, 1, 0, 1, no
333297861,  giorgio1706, 1, 0, 1, no
149217394,  rosmerypelle, 1, 0, 1, no
391039251,  C_Cirigliano, 1, 0, 1, no
101220634,  Johnnyutah74200, 1, 0, 1, no
435297353,  mikycollarile, 4, 0, 4, no
934575858,  MikiMagri, 1, 0, 1, no
434071914,  mlimuli, 2, 0, 2, no
461227143,  GLComandini, 1, 0, 1, no
385356024,  millytucci, 1, 0, 1, no
2183716922,  AngeloDeianaTW, 1, 0, 1, no
455840858,  IJennydorica, 3, 1, 2, no
51198800,  itsdede, 4, 0, 4, no
852990302,  mariobianco20, 1, 0, 1, no
2760351771,  dario_rigobello, 1, 0, 1, no
786304612420714496,  SoniaPoliti2, 1, 0, 1, no
4899231777,  leone9849, 6, 0, 6, no
396991861,  magyc95, 1, 0, 1, no
2370357600,  Leonardo_Bel, 1, 0, 1, no
802217884760023040,  luchin45325470, 1, 0, 1, no
785492607493369856,  fanta_rachel, 1, 0, 1, no
811414452,  mara_mucci, 1, 0, 1, no
330962609,  marcellalogli, 1, 0, 1, no
101030849,  nicomarti0, 1, 0, 1, no
292250600,  EnricoCapiozzo, 1, 0, 1, no
594041298,  MCFerradini, 1, 0, 1, no
2787787988,  ProgrammaFuturo, 3, 0, 3, no
312242186,  alebiafora, 1, 0, 1, no
397187753,  LucaPalestra, 1, 0, 1, no
22484478,  mmguru, 1, 0, 1, no
778939382707458048,  Roma_Semplice, 1, 0, 1, no
575347900,  tizianamedici, 3, 1, 2, no
252565001,  MarcoAlici, 3, 1, 2, no
2677397216,  osd_it, 1, 0, 1, no
337394074,  marianda70, 1, 0, 1, no
775639896841195520,  roma_roc, 1, 0, 1, no
774661708396781570,  ninefix, 1, 0, 1, no
1213604838,  MaxApi, 1, 0, 1, no
16362643,  ascoscia, 1, 0, 1, no
1887395294,  GrazianoGian, 1, 0, 1, no
411432358,  aleCattaneo79, 2, 0, 2, no
414972626,  futuroitaliano, 1, 0, 1, no
1056094116,  RoccoTodero, 5, 0, 5, no
2612551,  chermaz, 1, 0, 1, no
14979671,  la_franci, 1, 0, 1, no
5676402,  vincos, 2, 0, 2, no
425426261,  ayumartini45, 1, 0, 1, no
514848412,  luigibille1, 1, 0, 1, no
444240837,  lavander55, 1, 0, 1, no
435367434,  TarylorMartin4, 1, 0, 1, no
476339196,  sety0pra, 1, 0, 1, no
22127498,  Donzelli, 1, 0, 1, no
444241960,  ReeseAndrews6, 1, 0, 1, no
433578599,  SmithDavid5612, 1, 0, 1, no
616466190,  xeniaperan, 1, 0, 1, no
391531110,  birraesalsicce, 1, 0, 1, no
2485008400,  SoSglySolid, 1, 0, 1, no
82119861,  manuelgentile75, 1, 0, 1, no
1175934182,  bracconiere67, 2, 0, 2, no
62364690,  poffare, 1, 0, 1, no
10934032,  comunitazione, 1, 0, 1, no
196945505,  boa82, 2, 0, 2, no
618277233,  loremada81, 1, 0, 1, no
112981049,  RattoGiustina, 4, 0, 4, no
1048083020,  CarraraDante, 3, 1, 2, no
3326012500,  pitwalk1, 16, 1, 15, no
298164175,  MarinaVoudouri, 5, 1, 4, no
2800841139,  mlatini6, 3, 1, 2, no
1317310818,  salvo_tranchida, 3, 1, 2, no
405745496,  francesco92m, 1, 0, 1, no
799985228789977088,  ludoorsmocdi191, 1, 0, 1, no
450726242,  conteduca48, 1, 0, 1, no
209300173,  QdSinistra, 2, 0, 2, no
2501654327,  RobertoViccaro, 4, 0, 4, no
621968725,  m_angella14, 1, 0, 1, no
947689230,  JackySimoncelli, 2, 0, 2, no
4332140086,  Ladysilvia7, 3, 1, 2, no
491156990,  rubbish79, 4, 1, 3, no
3843650115,  MichidelPra, 10, 1, 9, no
4012526097,  mdelpra1, 7, 1, 6, no
801884847790817285,  2c7b54de31354cc, 3, 1, 2, no
4897518861,  masgiord, 4, 1, 3, no
376861483,  arcobalenoceano, 3, 1, 2, no
2319559369,  furibonda44, 3, 0, 3, no
181684989,  babbuzzi75, 7, 2, 5, no
436189641,  marione6363, 5, 2, 3, no
159985010,  MaNuElaJUVE34, 5, 1, 4, no
1276256071,  DOcchini, 3, 1, 2, no
796409487213133829,  LaliradiVico, 4, 0, 4, no
2261631554,  Sto_con_Putin, 1, 0, 1, no
895909506,  SognoStupendo, 1, 0, 1, no
2371698337,  giorgiaef, 8, 0, 8, no
2567121758,  ITnewsPV, 3, 0, 3, no
467536279,  stefanovaresi, 2, 0, 2, no
3610762348,  tagadala7, 4, 0, 4, no
485044249,  temisaba95, 3, 0, 3, no
1178812555,  Zarathustra_8, 1, 0, 1, no
1886161784,  SenatoRagazzi, 2, 0, 2, no
1073842549,  chango_75, 3, 1, 2, no
96303460,  bezzigiacomo, 2, 0, 2, no
562063761,  islamlie2, 15, 0, 15, no
169387991,  magdicristiano, 2, 0, 2, no
2797939824,  DrTytty, 3, 0, 3, no
574808723,  FScamuzzi, 1, 0, 1, no
2984732475,  Gennibi2015, 9, 0, 9, no
3107819271,  leliofranceschi, 3, 0, 3, no
2933315099,  ornella_zito, 9, 1, 8, no
462069435,  CatoneGiampiero, 4, 0, 4, no
800412781899956224,  mariatangredi1, 2, 0, 2, no
807625544,  KrisBrasilZumba, 1, 0, 1, no
418173864,  PanuccioAndrea, 2, 0, 2, no
841665998,  roberta_ru, 2, 0, 2, no
63674368,  MatteoSeraceni, 1, 0, 1, no
77540948,  quigleyp, 2, 0, 2, no
2879539541,  FranCast755, 1, 0, 1, no
518391983,  fatagnomo, 1, 0, 1, no
381439267,  FabioGulotta, 1, 0, 1, no
3377577663,  RotaCostantino, 2, 0, 2, no
3345106587,  CapitanArbano, 1, 0, 1, no
3429131512,  napolicalciovid, 1, 0, 1, no
73854874,  wallflower_85, 2, 0, 2, no
626753423,  MSDivytoski, 3, 0, 3, no
720332902320467968,  Valeria196550, 2, 0, 2, no
386065714,  MattiAnti, 1, 0, 1, no
3803802809,  boerianrhapsody, 1, 0, 1, no
239002248,  M5Savellino, 1, 0, 1, no
1010781937,  IngVarob, 4, 0, 4, no
796375652165357568,  Naiandiv, 1, 0, 1, no
2157198452,  AliceTerenzola, 3, 0, 3, no
718399714325094400,  maestraless, 4, 0, 4, no
1451532528,  giumilis, 2, 0, 2, no
1482201595,  FightTheStroke, 1, 0, 1, no
85820733,  Mario_Rossano, 1, 0, 1, no
415665457,  rita3ferr, 1, 0, 1, no
799999773818363905,  SamFoxBot, 1, 0, 1, no
356497258,  dominicipi, 1, 0, 1, no
558031406,  LiPerni, 2, 0, 2, no
796638809580589056,  FRCastellini, 1, 0, 1, no
58845374,  fabriziogallo, 1, 0, 1, no
323951434,  AndreaBoeris, 3, 0, 3, no
58719148,  nellocats, 3, 0, 3, no
2517639023,  francescostep84, 6, 0, 6, no
3066014739,  Luc4b, 1, 0, 1, no
45410367,  otellopinata, 1, 0, 1, no
45301618,  supermariobos, 2, 0, 2, no
476782210,  andrea_pelosi, 1, 0, 1, no
2895724737,  senecafilosof0, 1, 0, 1, no
328701052,  FBuonora, 1, 0, 1, no
51166909,  bitolgius, 1, 0, 1, no
476811892,  robynud1, 7, 0, 7, no
156729839,  comilara, 1, 0, 1, no
785072491563810816,  SICILIASTUPEND1, 2, 0, 2, no
728277306570067968,  MarinaBerrino, 1, 0, 1, no
98947753,  ligureapuano, 1, 0, 1, no
1227177884,  primo_lato, 8, 0, 8, no
2548045884,  UglAvellino, 11, 0, 11, no
3078100444,  UglMetalm, 17, 0, 17, no
2619985539,  sandro4911, 1, 0, 1, no
1040251176,  GiovannidiBiton, 1, 0, 1, no
2383565354,  AliceSavelli, 1, 0, 1, no
1252330836,  14Bisconti, 2, 0, 2, no
261757783,  uglfoggia, 6, 0, 6, no
527886495,  Alca147, 7, 0, 7, no
38340760,  ladydiedgar, 2, 0, 2, no
799574075291140101,  AndreaR93873022, 1, 0, 1, no
139339339,  maxmagri, 2, 0, 2, no
2236419782,  RubinoPino1, 1, 0, 1, no
401704325,  a_melchionno, 11, 0, 11, no
537051193,  UglSicilia, 1, 0, 1, no
759886508220309505,  ciroBorrelli75, 2, 0, 2, no
3230539624,  pasqualegianga1, 1, 0, 1, no
111410606,  AcquavivaAngelo, 3, 0, 3, no
431859432,  Ilario1964, 1, 0, 1, no
1606595466,  santodubito, 3, 1, 2, no
2978458125,  luisaclarissa, 1, 0, 1, no
68984285,  mauryhappy, 1, 0, 1, no
872452502,  cittadinanzaatt, 2, 0, 2, no
985076126,  StCarnevale, 1, 0, 1, no
2412990049,  MrValesan, 1, 0, 1, no
432264645,  alba_ins, 2, 0, 2, no
110990122,  200664, 1, 0, 1, no
1416548016,  Darioeyes, 1, 0, 1, no
1610203530,  antoschiAv, 1, 0, 1, no
2617636336,  asinorosso76, 1, 0, 1, no
1605405253,  gp_fiore, 5, 0, 5, no
10774862,  gpcerri, 1, 0, 1, no
2370772835,  MassimoPaolucc6, 1, 0, 1, no
784138144870457344,  MariantoniaMic3, 1, 0, 1, no
401492287,  GiannoloLuca, 1, 0, 1, no
408546766,  G1Abate, 2, 0, 2, no
253639943,  sbrando72, 1, 0, 1, no
417392878,  MdGOfficial, 1, 0, 1, no
636390373,  Domenicotammar2, 1, 0, 1, no
2906705362,  annaconte81, 1, 0, 1, no
3322751109,  BComuGlobal, 1, 0, 1, no
1475312670,  Riscattoazzurro, 1, 0, 1, no
4136435007,  roccomaz, 1, 0, 1, no
3772927402,  massa_critica_, 1, 0, 1, no
20021712,  BLACKFLAGchi, 1, 0, 1, no
2592480058,  dosmesdoscinc, 1, 0, 1, no
3159339067,  ilTestMagazine, 1, 0, 1, no
526589536,  PLinItalia, 1, 0, 1, no
1132405543,  ale_clem, 1, 0, 1, no
469747259,  simopax82, 1, 0, 1, no
1056109082,  mamauro1, 1, 0, 1, no
837370934,  giuseppegrassi9, 32, 0, 32, no
4556208021,  TranchiFanchi, 1, 0, 1, no
138364373,  loposeper, 42, 0, 42, no
776357522,  EgonMichelle, 10, 0, 10, no
2171916782,  runninglo, 1, 0, 1, no
94594903,  malucy2, 60, 0, 60, no
2396676379,  Silvio22410511, 30, 0, 30, no
432329081,  rosalbapereira1, 4, 0, 4, no
613567201,  BritIann007, 2, 0, 2, no
1160616948,  danitwix, 1, 0, 1, no
720266765650014208,  cecco170, 21, 0, 21, no
4229963363,  MarkoLemma, 42, 0, 42, no
497906852,  Alexpi69, 4, 0, 4, no
2902589133,  bepper875, 1, 0, 1, no
471369382,  coscenzioso6, 13, 0, 13, no
194766923,  aledam87, 2, 0, 2, no
2385369457,  elettra1970, 1, 0, 1, no
422962166,  ASSO1M, 1, 0, 1, no
3277940725,  09058659313m07, 1, 0, 1, no
71545876,  superantos, 1, 0, 1, no
422646193,  marioseby57, 13, 0, 13, no
799195890749730816,  vicentacarla3, 2, 0, 2, no
463864783,  FabioM63, 1, 0, 1, no
4924737299,  GiorgiaTartagl1, 1, 0, 1, no
1175672102,  miclosweb, 1, 0, 1, no
532577856,  giovannacaluri, 4, 0, 4, no
2183863684,  giusiary, 4, 0, 4, no
29063880,  dbdebs, 1, 0, 1, no
3233336236,  pippuzzo5stelle, 34, 0, 34, no
319846232,  posterit, 7, 0, 7, no
2772740636,  resistenzam5s, 31, 0, 31, no
502195501,  albertoGroff, 2, 0, 2, no
446616638,  AlessandraLeon8, 1, 0, 1, no
781201656532926464,  giulianopluto, 3, 0, 3, no
4927619332,  megven7, 1, 0, 1, no
694875836411990016,  LouisCelestino, 1, 0, 1, no
1235353459,  dbasezz, 3, 0, 3, no
1004504533,  harrodugo, 1, 0, 1, no
2281118124,  MoralistaDelCax, 1, 0, 1, no
3145332994,  emilybronte85, 1, 0, 1, no
2870658190,  GBognandi, 2, 0, 2, no
2942486068,  VitulloDv, 4, 0, 4, no
291417844,  djtaglierino, 1, 0, 1, no
247775090,  nennaornella, 4, 0, 4, no
3011065835,  Mov5StelleNoto, 1, 0, 1, no
2289452816,  renatomarotta, 1, 0, 1, no
802824517219479553,  Grazia19688377, 1, 0, 1, no
526478079,  aldobini, 1, 0, 1, no
733032143530696704,  lorri744, 2, 0, 2, no
203827028,  mrbitlinus, 5, 0, 5, no
290093767,  N36volpe1973, 45, 0, 45, no
4787676166,  antonellab67, 3, 0, 3, no
761928076397834240,  Angelodimichel4, 1, 0, 1, no
461839912,  PasqualeRea1, 1, 0, 1, no
425067394,  lauraserloni, 1, 0, 1, no
1346566790,  RobertoAllegret, 38, 0, 38, no
415440185,  LucaBrivio73, 2, 0, 2, no
3304637962,  lauraantonell19, 1, 0, 1, no
2755069611,  gianlucacapell2, 2, 0, 2, no
404283215,  FabioFedericiF, 1, 0, 1, no
446307797,  biagioscol, 2, 0, 2, no
2726832817,  maumizi, 1, 0, 1, no
4895893847,  veryfabryyuri, 2, 0, 2, no
1968997549,  giovanniborci, 1, 0, 1, no
706392027278217216,  francesca_quatt, 1, 0, 1, no
1458889328,  LauraKiss15, 2, 0, 2, no
410077670,  FrannicoC, 1, 0, 1, no
1409045616,  manlio_greco, 1, 0, 1, no
205638223,  acquamarina62, 3, 0, 3, no
2179309175,  sorce52, 2, 0, 2, no
562968203,  loredanaceruso, 1, 0, 1, no
415129119,  orchidea62009, 1, 0, 1, no
35000018,  dbussetti, 3, 0, 3, no
2353554590,  cadamuro_gino, 2, 0, 2, no
736168858898337792,  robygamba70, 1, 0, 1, no
2303315316,  Fabioleon777, 2, 0, 2, no
1415231497,  Alexein222, 1, 0, 1, no
64002024,  AlpineCairn, 1, 0, 1, no
499676949,  andreatheblando, 2, 0, 2, no
398603525,  Emanuela_Corda, 1, 0, 1, no
966502022,  salape2, 8, 0, 8, no
1639836846,  o_franco_aleman, 1, 0, 1, no
3357277319,  peac4love, 1, 0, 1, no
401546671,  verodilo, 1, 0, 1, no
39976483,  areaizzo, 12, 0, 12, no
2729690231,  PatriziaProbo, 1, 0, 1, no
734115846495305728,  francescotruck, 1, 0, 1, no
866432192,  Salvatoreilpira, 4, 0, 4, no
86336577,  for_michina, 1, 0, 1, no
787922343784046592,  DomenicoSimini, 4, 0, 4, no
3919219541,  lancianews, 1, 0, 1, no
732125961412612097,  dariokuno, 2, 0, 2, no
2219448182,  PasqualeCarola, 7, 0, 7, no
706060041254780928,  Egaleonis, 2, 0, 2, no
801560814696144896,  AndreaFraNchin0, 1, 0, 1, no
2850141704,  playeronline1, 1, 0, 1, no
289806001,  carlosdebo, 1, 0, 1, no
408780630,  tedescogennaro, 1, 0, 1, no
3026776164,  ardarcangelo_d, 1, 0, 1, no
998895174,  exprofcasapens, 1, 0, 1, no
3834882442,  casillo_alfonso, 1, 0, 1, no
20939436,  mostquiet, 1, 0, 1, no
2525039696,  concett95520392, 15, 0, 15, no
1264018218,  francescomila18, 16, 0, 16, no
2959917485,  ornellamarzilli, 68, 0, 68, no
796381889326153729,  Giovann35203596, 3, 0, 3, no
2506958514,  EnricoMatteazzi, 2, 0, 2, no
1120383019,  Beppe__Grillo, 1, 0, 1, no
18280831,  papiriki, 1, 0, 1, no
2328858254,  PaoloQuera, 2, 0, 2, no
3143144909,  Beppetonini, 3, 0, 3, no
3370650735,  fuldapa, 4, 0, 4, no
1024365672,  GiovanniPigio, 1, 0, 1, no
552976390,  GianlucaTC, 3, 0, 3, no
2892226235,  66comiNotti, 1, 0, 1, no
802601571427225600,  gianpiero_246, 1, 0, 1, no
3261069747,  DessiSelvaggia, 2, 0, 2, no
93197485,  massimoneri90, 26, 0, 26, no
385704361,  ermesgirotto, 1, 0, 1, no
1848967950,  GerardoPergamo1, 6, 0, 6, no
951593118,  PierDomenicoSal, 4, 0, 4, no
703318645,  rfalco49, 8, 0, 8, no
802580873753350144,  leastmgdr, 1, 0, 1, no
300083934,  giovannicroce1, 4, 0, 4, no
2780485292,  AxelOffic, 2, 0, 2, no
860296220,  bonanno_massimo, 1, 0, 1, no
1100294395,  crisenza_paola, 1, 0, 1, no
1144953769,  gianniskipper, 8, 0, 8, no
359493082,  ermannobombelli, 1, 0, 1, no
1015819494,  RenatoNarcisi, 20, 0, 20, no
3700266675,  osma_rido, 2, 0, 2, no
2361488227,  M2013smMaria, 2, 0, 2, no
791360681815728129,  paolocar12, 5, 0, 5, no
802211792764207105,  mr_gatti61, 1, 0, 1, no
801843258183786496,  scafettafabio, 1, 0, 1, no
55509918,  paspro2, 1, 0, 1, no
1352301782,  drfrancocapuani, 27, 0, 27, no
2156562691,  PalmiscianoL, 3, 0, 3, no
1365084235,  crimaxim, 1, 0, 1, no
2342539890,  patriziabaldi1, 1, 0, 1, no
531265189,  EmmaMorbini, 1, 0, 1, no
400602706,  DiegoVinciguerr, 1, 0, 1, no
1566318876,  MasstevMusic, 1, 0, 1, no
1418841108,  vespiri, 3, 0, 3, no
769256675719180288,  Salvato40840541, 3, 0, 3, no
284683090,  naripac, 5, 0, 5, no
1265550168,  GiuseppeCrow, 4, 0, 4, no
2858795351,  jocker1975, 1, 0, 1, no
501599823,  giorgio84605180, 1, 0, 1, no
400393067,  MM_Ambrogi, 3, 0, 3, no
841387776,  DiegoForoni, 1, 0, 1, no
799000131483770880,  Xandarmm, 1, 0, 1, no
94788246,  Alien1it, 14, 0, 14, no
802587183186116608,  marcojesolo46, 1, 0, 1, no
712212243757322241,  Frankhox, 3, 0, 3, no
331093272,  walter1711, 1, 0, 1, no
2336391177,  luisastar63_lu, 2, 0, 2, no
2494327693,  MarcoValliM5S, 4, 0, 4, no
1023802202,  1950Cristiano, 2, 0, 2, no
148545440,  rciafardone, 1, 0, 1, no
88019719,  Adriano_Sora, 3, 0, 3, no
786871131114528769,  greentaak, 2, 0, 2, no
2310271175,  GmNunzio, 2, 0, 2, no
2784347102,  io05296397, 1, 0, 1, no
1420323073,  GiuliaPozzuoli, 4, 0, 4, no
396864162,  Pavel_Ferrari, 1, 0, 1, no
3231787383,  guerino1988, 3, 0, 3, no
594773318,  ZainebMornagui, 1, 0, 1, no
1089513403,  MarioGregu, 30, 0, 30, no
196508522,  Italianamente, 2, 0, 2, no
99885525,  Dreyfus72, 1, 0, 1, no
622270454,  udeaugustinis, 1, 0, 1, no
2318181395,  pier_grecchi, 1, 0, 1, no
2899280399,  ThornXYZ, 1, 0, 1, no
1941112045,  pastore72149760, 2, 0, 2, no
1045531866,  umberto772, 2, 0, 2, no
1229782501,  ALESarch, 1, 0, 1, no
197937732,  gillezfred, 3, 0, 3, no
3303556480,  pastore_arturo, 2, 0, 2, no
781439771017109504,  SilvanaForlini, 1, 0, 1, no
483729331,  MarcelloBBB, 1, 0, 1, no
421017807,  MicheleMileto, 2, 0, 2, no
966297074,  MarriPaolo, 6, 0, 6, no
14638233,  Africanasoul, 4, 0, 4, no
2799326845,  campanedda51, 1, 0, 1, no
170660330,  OrtegaJordi, 1, 0, 1, no
539721796,  NormanDeArmond, 2, 0, 2, no
1563877585,  Cometa1963, 7, 0, 7, no
1434758118,  GtMerrywife, 1, 0, 1, no
393689013,  catribe, 1, 0, 1, no
3034201259,  Franco3falbo, 19, 0, 19, no
742029008146210816,  anniballe_d, 1, 0, 1, no
1076294167,  990910MBI, 1, 0, 1, no
1109873544,  maurocnt, 1, 0, 1, no
409998602,  lucioriccetti, 1, 0, 1, no
447413010,  odlat, 1, 0, 1, no
423578767,  paololocascio1, 3, 0, 3, no
1167113408,  carmelo_1970, 4, 0, 4, no
573881279,  5simo_simo3, 1, 0, 1, no
62383022,  lucacolantonio, 1, 0, 1, no
204078845,  Marco_J_Ferrari, 1, 0, 1, no
706524248106524673,  steorun, 1, 0, 1, no
170423526,  FlorisSerra, 3, 0, 3, no
1692143298,  MikyAloisio, 2, 0, 2, no
4383940095,  sasaks_s, 1, 0, 1, no
2833896585,  alangio22, 2, 0, 2, no
2151049389,  rivi_davide, 1, 0, 1, no
380183508,  carlorinaldi1, 1, 0, 1, no
869445680,  FconteC, 1, 0, 1, no
801464592836755456,  crepaldi_1024, 1, 0, 1, no
3155492620,  gianfrancogian5, 2, 0, 2, no
952393700,  LaPoliticaChe, 1, 0, 1, no
119127143,  epico69, 1, 0, 1, no
383632630,  Folpo66, 1, 0, 1, no
1077797754,  flavio_fantino, 1, 0, 1, no
3134015573,  Balilla17, 1, 0, 1, no
1061062754,  internaz1, 1, 0, 1, no
787673845738115077,  girgenticristin, 1, 0, 1, no
1146192529,  giovannasarto10, 1, 0, 1, no
397512732,  PinelliPier, 5, 0, 5, no
607368233,  aluca1970, 1, 0, 1, no
1147430462,  LetoPompilio, 1, 0, 1, no
290724470,  chiesa_stefano, 1, 0, 1, no
970849686,  StefanoPallavic, 2, 0, 2, no
1036863938,  SalvatorePazzol, 1, 0, 1, no
2587790685,  linov00, 1, 0, 1, no
2356202642,  ALeCause, 1, 0, 1, no
2256809326,  francesconi70, 2, 0, 2, no
802363365771378688,  moipoxyhyd1973, 1, 0, 1, no
2426116776,  doripacca, 1, 0, 1, no
31521666,  paolodriussi, 2, 0, 2, no
886686836,  AntonioMaterdom, 4, 0, 4, no
2992825821,  sandrodeambrog1, 1, 0, 1, no
792627890395418624,  AngyCatarinella, 2, 0, 2, no
783767997018177536,  AngelaCasu2, 1, 0, 1, no
3170257623,  roberta8111, 1, 0, 1, no
1143193639,  lorenzociccaron, 1, 0, 1, no
2283924266,  giovannizzo2, 1, 0, 1, no
428476147,  nicola_corona, 2, 0, 2, no
780699672276905984,  AuroraSpurio, 1, 0, 1, no
595338478,  cilie79, 1, 0, 1, no
3377889609,  PreduRuju, 1, 0, 1, no
1513495909,  DinardoRaffaele, 1, 0, 1, no
297971382,  doraespo, 3, 0, 3, no
2366121870,  AnbigAngy, 2, 0, 2, no
319307045,  RivafiRita, 1, 0, 1, no
516890828,  mancinifabio1, 3, 0, 3, no
194144770,  itfaari, 1, 0, 1, no
739443565198204928,  MarcantonioCl, 1, 0, 1, no
726083054,  SoloTrePi, 2, 0, 2, no
1384371824,  CIRODESANTO1, 1, 0, 1, no
697968492050522112,  Oriana34177611, 1, 0, 1, no
3135640856,  ae972, 2, 0, 2, no
405837281,  lodifab, 1, 0, 1, no
791208910623506432,  gionickleo, 3, 0, 3, no
110278009,  stefanoforgione, 1, 0, 1, no
904798681,  saveJACKo, 1, 0, 1, no
1852012634,  HALTEREGO28, 1, 0, 1, no
231118677,  MIKISCO, 19, 0, 19, no
721766411937411072,  DamianoPignate1, 1, 0, 1, no
22616851,  panzarotto, 1, 0, 1, no
779544980012556288,  jokermax71, 1, 0, 1, no
3986857846,  geomfrancodifa1, 2, 0, 2, no
2184761907,  Fadda14, 3, 0, 3, no
1146148506,  RobertoDimaggio, 2, 0, 2, no
470081458,  camezza72, 2, 0, 2, no
733566498,  GorrasiLino, 1, 0, 1, no
1070413645,  giosimo74, 1, 0, 1, no
1054666776,  fulkat2, 1, 0, 1, no
1039501538,  ernesto_diana, 2, 0, 2, no
348502260,  loryianni, 2, 0, 2, no
566136857,  stefanocasalec, 1, 0, 1, no
420624994,  claudiodipas, 7, 0, 7, no
415047353,  euka1gianni, 1, 0, 1, no
4251258976,  camandrea80, 1, 0, 1, no
232132456,  atamau77, 2, 0, 2, no
61816119,  terryvale, 1, 0, 1, no
478601909,  Fiffo78, 1, 0, 1, no
4186870516,  Manodivento, 2, 0, 2, no
3079657612,  DLF_Paris16, 1, 0, 1, no
449865440,  carlodeleo, 1, 0, 1, no
478520272,  marcellomastice, 3, 0, 3, no
787276746819330048,  mario65523797, 1, 0, 1, no
29851314,  reroll, 2, 0, 2, no
791577594227458048,  Francescoarm71, 1, 0, 1, no
752727902559625216,  rosario231206, 2, 0, 2, no
715125585,  ToppiCom, 1, 0, 1, no
345384153,  safilippelli, 1, 0, 1, no
1853678790,  FragoleMature, 9, 0, 9, no
2223123756,  Poto86, 1, 0, 1, no
87893299,  GrippoAlex, 1, 0, 1, no
2348278097,  candyenne22, 1, 0, 1, no
64275595,  VictySight, 2, 0, 2, no
416586096,  ollagfra, 1, 0, 1, no
1916736956,  serramanuela5, 7, 0, 7, no
34572076,  familyhousemag, 1, 0, 1, no
442906173,  Cleopatra3300, 1, 0, 1, no
375255136,  IvanoLandi, 1, 0, 1, no
964698278,  ORESTEFERRO, 1, 0, 1, no
176053884,  monteur_tv, 1, 0, 1, no
747863299555995650,  pattobaratto, 4, 0, 4, no
3065938786,  NotiziarioDN, 1, 0, 1, no
1109984041,  gianlucameconi, 1, 0, 1, no
3303758080,  Ozbahh, 1, 0, 1, no
800810400983883776,  francescoburra7, 4, 0, 4, no
1219904792,  ilpartigiano, 1, 0, 1, no
822067778,  PaoloFruttero, 2, 0, 2, no
396417613,  danimiele1, 1, 0, 1, no
735060410215346176,  dimar_dimarzo, 3, 0, 3, no
1166428405,  vittoriavitali1, 3, 0, 3, no
117064713,  Chiaruttini, 1, 0, 1, no
92236282,  donatellapavone, 1, 0, 1, no
4355382796,  1m_mario, 1, 0, 1, no
782258395382423556,  alberto_andria, 2, 0, 2, no
803629689856229376,  754_339, 2, 0, 2, no
401703102,  GMendix, 1, 0, 1, no
3268499779,  MatRan15, 1, 0, 1, no
318440967,  johnnycev, 1, 0, 1, no
201691601,  Didimighi, 1, 0, 1, no
810395744,  romani_1976, 3, 0, 3, no
3937311809,  PattiLu76, 2, 0, 2, no
1001745906,  patriziaf59, 1, 0, 1, no
2987511106,  lotusdiego1, 1, 0, 1, no
459248135,  Isor53, 1, 0, 1, no
178155347,  MartinaColas, 1, 0, 1, no
483028649,  LauraIavarone, 1, 0, 1, no
3320495819,  PalermoTurismo, 1, 0, 1, no
186388096,  fraguarino, 3, 0, 3, no
96198967,  Sp4rd4, 1, 0, 1, no
852569226,  albass58, 1, 0, 1, no
1913784829,  GrGabris, 1, 0, 1, no
4216964932,  biobba20155, 1, 0, 1, no
2474046728,  aggielli, 3, 0, 3, no
90124895,  pippoj, 7, 0, 7, no
1230788334,  linndamas, 1, 0, 1, no
3117872572,  RitaVaccaro8, 2, 0, 2, no
330529365,  FrancyPetra, 1, 0, 1, no
992834858,  caterinafrazzet, 1, 0, 1, no
1286873820,  86pac, 1, 0, 1, no
2329159892,  DeFabbris, 1, 0, 1, no
4128961174,  Manubiasin, 1, 0, 1, no
19422447,  tamburrano, 6, 0, 6, no
424966108,  antonivalentino, 1, 0, 1, no
182586235,  marcobinotto, 1, 0, 1, no
3252980355,  BenMariemben, 1, 0, 1, no
2385584221,  ChryAllegra, 1, 0, 1, no
768448873048178689,  Yves_Florence, 1, 0, 1, no
3412398478,  dennibellomo, 1, 0, 1, no
738828239599226880,  patrizia_maffei, 1, 0, 1, no
38027529,  gabs_catalano, 4, 0, 4, no
1314338900,  MrWhite57734166, 1, 0, 1, no
2664104673,  AprodiProdi, 1, 0, 1, no
993551622,  mine090966, 1, 0, 1, no
3480858933,  Perikle181, 1, 0, 1, no
752973843422208003,  cangiovan65, 1, 0, 1, no
9568772,  g_bertoncello, 2, 0, 2, no
1262690820,  fumatanera56, 2, 0, 2, no
1069078807,  orsibruno, 1, 0, 1, no
94690071,  ABCletta, 1, 0, 1, no
781222767807070208,  mecuccia, 1, 0, 1, no
956180245,  monikventu, 1, 0, 1, no
503124705,  MAXBEAUTYFULL, 4, 0, 4, no
429140220,  BarattoMattia, 1, 0, 1, no
555469454,  ivan0305, 1, 0, 1, no
390912718,  Dnl84le, 1, 0, 1, no
2452231707,  GRosadiroma82, 11, 0, 11, no
2432954326,  DiTonydifresco, 1, 0, 1, no
143178638,  alfbrunow, 1, 0, 1, no
2220089080,  pietroa67, 1, 0, 1, no
3388830129,  f03685f00e3e499, 2, 0, 2, no
428192006,  namepaolo, 2, 0, 2, no
2243103750,  vergugnos, 6, 0, 6, no
99390218,  acesarini, 1, 0, 1, no
940072826,  mrt3074, 1, 0, 1, no
2442175797,  maurizio79rs, 2, 0, 2, no
506236862,  NandoCipollino, 1, 0, 1, no
398607885,  lucavilla75, 1, 0, 1, no
223405753,  raimondolu, 2, 0, 2, no
794235436935892992,  emmalinn75, 1, 0, 1, no
573749510,  antonmax67, 1, 0, 1, no
2783636812,  grgfrln91, 1, 0, 1, no
1875113508,  sebendinelli, 1, 0, 1, no
2917517319,  1f23c698eaf74bd, 1, 0, 1, no
759768288381382656,  Tosca16613733, 1, 0, 1, no
255747388,  Praticante85, 1, 0, 1, no
762981306586324992,  DepauRita, 1, 0, 1, no
2924632104,  flapanteriore, 1, 0, 1, no
2475118937,  thomas__mcclain, 1, 0, 1, no
768385300355743744,  salvatorevalle8, 1, 0, 1, no
1220690641,  AndreaBelvedere, 1, 0, 1, no
513424484,  apidicecco, 4, 0, 4, no
782209691787071488,  20033101_150, 1, 0, 1, no
509703882,  merlinoatwork, 1, 0, 1, no
2463483414,  RinnovabiliBiz, 1, 0, 1, no
3088893988,  Lia61877161, 1, 0, 1, no
17018967,  NormalBooking, 1, 0, 1, no
1570059619,  LelioPetiva, 1, 0, 1, no
589899714,  FRANCESCOBURRA1, 13, 0, 13, no
395887529,  aakashOgleby, 1, 0, 1, no
1192340953,  PBitti, 1, 0, 1, no
403038998,  DeTursi, 1, 0, 1, no
60705171,  renatopasini, 1, 0, 1, no
1230108756,  PPiergi, 1, 0, 1, no
1277947736,  francescoviti64, 1, 0, 1, no
706835606232555520,  giacomogc270968, 1, 0, 1, no
602897043,  FVonThurn, 1, 0, 1, no
375106694,  stefanoguarni, 1, 0, 1, no
299660754,  fampillo, 1, 0, 1, no
3225202246,  MichelaCarota, 1, 0, 1, no
2902748278,  Sikulo72, 2, 0, 2, no
805821153554169860,  sculacciatope, 1, 0, 1, no
11055732,  aubreymcfato, 1, 0, 1, no
2994392625,  maddoxx55, 1, 0, 1, no
318940473,  NicolaMacr, 1, 0, 1, no
2361032367,  ottaviani192, 1, 0, 1, no
481416521,  Arpa__net, 15, 0, 15, no
417271851,  chiccazzo, 1, 0, 1, no
795263769261772800,  michele00110, 2, 0, 2, no
4611996742,  Elisabettafabbr, 3, 0, 3, no
1389377954,  CristianoDemart, 1, 0, 1, no
4882021971,  MignanoRoberta, 1, 0, 1, no
710355800,  AlessandroDP21, 1, 0, 1, no
718376903099432961,  MimmoSgura1, 1, 0, 1, no
770249747252781056,  cascella_matteo, 1, 0, 1, no
804979919788933120,  Seby5779, 2, 0, 2, no
1007997080,  akab50, 4, 0, 4, no
1201957429,  dario25091962, 5, 0, 5, no
1079112506,  MrsJuliette93, 1, 0, 1, no
804195631493509120,  Teresa86564986, 3, 0, 3, no
763430495514423296,  kisimaio, 1, 0, 1, no
478976747,  lafedeibibetti, 1, 0, 1, no
108592050,  giamaga, 3, 0, 3, no
784331797496631296,  cosimocalabres5, 7, 0, 7, no
772349570,  MBuccarella, 1, 0, 1, no
397162844,  Tonigno82, 2, 0, 2, no
1234864148,  TommasoWom7, 1, 0, 1, no
2351835684,  gbadteach, 2, 0, 2, no
740586516049735680,  claudio_zamb, 1, 0, 1, no
437627701,  edoagnese, 1, 0, 1, no
731917588247220227,  immaginemozion1, 1, 0, 1, no
725686916918722560,  andrea5stelle87, 1, 0, 1, no
1219163587,  Pulguiteam, 3, 0, 3, no
4593533705,  carmelo_vicario, 1, 0, 1, no
3054957747,  donato_alfiniti, 1, 0, 1, no
2177094569,  ScottoMa, 1, 0, 1, no
107246102,  paolo7891, 1, 0, 1, no
1220896010,  alessan32814990, 6, 0, 6, no
171040838,  robertaestop, 1, 0, 1, no
1259480484,  vecevending, 1, 0, 1, no
2855057866,  mgdicapua, 1, 0, 1, no
577928462,  filippo_maini, 1, 0, 1, no
1048508089,  paolopaolo57, 1, 0, 1, no
980985488,  tercamma, 2, 0, 2, no
2184456353,  BeppeChiappini, 1, 0, 1, no
1122635904,  cmuzzetto, 3, 0, 3, no
2387298926,  caterinacorda1, 1, 0, 1, no
4110680129,  TroiaGiulio, 1, 0, 1, no
4240911946,  Genzicipo, 2, 0, 2, no
55403948,  lucaRiggio, 1, 0, 1, no
525636772,  antoniovinci8, 5, 0, 5, no
631851653,  BabisSpanos, 1, 0, 1, no
408580036,  giankurt, 4, 0, 4, no
304005346,  CoachDade, 1, 0, 1, no
1612919144,  MarcoDarth, 5, 0, 5, no
1219454078,  BruscaSalvatore, 1, 0, 1, no
880754108,  FiumeMarinella, 1, 0, 1, no
800493184363024384,  Michael55024366, 1, 0, 1, no
103596196,  ilmengo, 2, 0, 2, no
391919014,  mikiarny, 1, 0, 1, no
52185645,  massivale, 1, 0, 1, no
2414797352,  pompili43106623, 2, 0, 2, no
120272449,  giusypop, 1, 0, 1, no
2729099096,  teodorogerico, 1, 0, 1, no
554296369,  rickycam78, 1, 0, 1, no
404550647,  gilengil59, 1, 0, 1, no
973576950,  acornacchione1, 1, 0, 1, no
449850313,  PolAlberto, 6, 0, 6, no
457937702,  marer62, 1, 0, 1, no
921591691,  AntnioSenes, 6, 0, 6, no
1035666272,  MattiaFiammengh, 1, 0, 1, no
337869423,  MarinaCeccarel, 1, 0, 1, no
2740845106,  fabriziofabri14, 1, 0, 1, no
1394592542,  giuseppes1967, 1, 0, 1, no
343370530,  leonardocava, 11, 0, 11, no
742616018636406784,  Sabrizav, 1, 0, 1, no
432148641,  calosibilla, 1, 0, 1, no
942042836,  djZioJoe, 1, 0, 1, no
1227817225,  FalconeMf, 1, 0, 1, no
2894418435,  BrunoBSAT, 2, 0, 2, no
359908699,  aquila1962, 1, 0, 1, no
2895742594,  IreneDx1, 1, 0, 1, no
1273161506,  laura151168, 1, 0, 1, no
803322305610940417,  filippo_saggi, 4, 0, 4, no
213408314,  Fa_Pe, 1, 0, 1, no
791374453926166529,  twittemyx, 2, 0, 2, no
2168865698,  achab_1966, 1, 0, 1, no
1225205178,  gianlucagreco74, 1, 0, 1, no
397245294,  gianlucarizzo46, 3, 0, 3, no
177726923,  PokeChubby, 1, 0, 1, no
2186988510,  annaVattucci, 1, 0, 1, no
90902777,  Vagnerd_7, 1, 0, 1, no
500915160,  Terian_Dimmi, 2, 0, 2, no
144557195,  sOoNicola, 1, 0, 1, no
456936722,  condorr72, 2, 0, 2, no
101194334,  Pier_Cannito, 2, 0, 2, no
784116405981544451,  PatriziaBorghi2, 2, 0, 2, no
1849342003,  CarmeloRicupero, 2, 0, 2, no
949767170,  GiustinoAndria, 1, 0, 1, no
1157792384,  scarcozzo, 1, 0, 1, no
258006600,  junkiebba, 1, 0, 1, no
800836660682440705,  FrancescoDeFr17, 1, 0, 1, no
465518198,  StefyBijoux1, 1, 0, 1, no
2385752304,  LenxCamera, 13, 0, 13, no
1380718032,  Digio36, 13, 0, 13, no
2421023606,  Renemargot1, 2, 0, 2, no
1004973133,  Parigino2, 1, 0, 1, no
2708544953,  Paapois, 3, 0, 3, no
729064394567651330,  Frances45444278, 3, 0, 3, no
2361236242,  vincemes70, 1, 0, 1, no
1395049230,  danielariely, 1, 0, 1, no
1351750926,  MonellaSerrenti, 1, 0, 1, no
2402803553,  alessan75956809, 1, 0, 1, no
66783709,  43gabriele, 1, 0, 1, no
1143419132,  musalinoo, 1, 0, 1, no
2948729416,  sissyandtony, 1, 0, 1, no
2504881172,  giotto_62, 3, 0, 3, no
523314125,  daber85, 1, 0, 1, no
432684012,  EmiliaLoscalzo, 1, 0, 1, no
767936783237644292,  ejaculations, 1, 0, 1, no
709985365206106112,  em_bov, 4, 0, 4, no
2910734045,  edilefranchini, 1, 0, 1, no
3014138272,  d1b9e9059f2c493, 1, 0, 1, no
4193789127,  dott_busa, 1, 0, 1, no
3295652280,  afradoc, 1, 0, 1, no
2264476401,  GsalvaSCARFO, 4, 0, 4, no
1113905276,  OreginaMeteo, 3, 0, 3, no
394095897,  ElenaPannyLane, 2, 0, 2, no
970255340,  SantarlasciMaur, 4, 0, 4, no
2688397197,  favapippo, 1, 0, 1, no
2956501541,  BuonaiutoG, 2, 0, 2, no
458445168,  santinimaura, 1, 0, 1, no
3480199816,  Ale_scandone, 1, 0, 1, no
3661485195,  Rituzza60gmail1, 1, 0, 1, no
453964141,  RoberCacchi, 3, 0, 3, no
4105846605,  Fernand58357945, 4, 0, 4, no
451652033,  Alex7Liberti, 1, 0, 1, no
557128044,  Nembomario, 1, 0, 1, no
793610243922071553,  TWezycki, 1, 0, 1, no
2376911012,  M5S_Albairate, 1, 0, 1, no
1456848812,  brucer58, 1, 0, 1, no
757283763797778432,  mariolo16084562, 1, 0, 1, no
429174475,  ascalavido, 1, 0, 1, no
773959279,  LayonNiki, 1, 0, 1, no
3427533177,  rosy_genduso, 1, 0, 1, no
433553500,  frikfrak46, 1, 0, 1, no
447846362,  marcomiccoli1, 3, 0, 3, no
1428729751,  tiavulone, 1, 0, 1, no
3407782672,  Adele35111364, 1, 0, 1, no
222375064,  ilcorriereblog, 2, 0, 2, no
1173006894,  emanueleo73, 1, 0, 1, no
413151078,  MarioZPunterco, 1, 0, 1, no
1698574146,  gladiatore987, 2, 0, 2, no
1621614835,  TommasinAndrea, 1, 0, 1, no
192118395,  baldix2, 3, 0, 3, no
3349971568,  cirascafur, 1, 0, 1, no
418657078,  Nino_Effe, 1, 0, 1, no
2176107184,  Max46Oldmax, 1, 0, 1, no
387511056,  FrancescoSicil1, 1, 0, 1, no
501809742,  raffaelesarnell, 1, 0, 1, no
622317402,  EmmaPrencipe, 1, 0, 1, no
930579210,  mariarosaconca1, 1, 0, 1, no
515171492,  luigibreak, 1, 0, 1, no
251638195,  IURONE, 2, 0, 2, no
488821140,  stefano_mitello, 1, 0, 1, no
785953647188447232,  jelideflow, 1, 0, 1, no
4208849560,  Giusepp31129863, 1, 0, 1, no
265456866,  pacal1973, 1, 0, 1, no
4643004927,  MatteoLeprini, 1, 0, 1, no
1723277772,  antonellabye, 1, 0, 1, no
105277013,  TheSuburbsGuy, 1, 0, 1, no
1370364667,  fulvio_libero, 1, 0, 1, no
546701313,  taita74, 1, 0, 1, no
1102199018,  giuliovodola, 1, 0, 1, no
1457469680,  dani_vallekano, 1, 0, 1, no
2184911833,  biancoelena4, 1, 0, 1, no
1289667200,  Miramaremara, 3, 0, 3, no
764414759261315072,  ApiCelline, 1, 0, 1, no
1314661519,  TiNilde, 1, 0, 1, no
1933565744,  luigimalindi, 1, 0, 1, no
354844811,  Mau_rigno, 1, 0, 1, no
805714518294806528,  sandra_vescovi, 1, 0, 1, no
791735680732913664,  Re_di_Hokuto, 1, 0, 1, no
4699430514,  malumsmile_, 1, 0, 1, no
2383635908,  claudiofastell1, 1, 0, 1, no
915704730,  s_venco, 3, 0, 3, no
3270094128,  backtoWaterloo, 1, 0, 1, no
543291999,  nardomi62, 1, 0, 1, no
2474193206,  SuperChataigne, 2, 0, 2, no
3073086526,  salvecla, 1, 0, 1, no
223748747,  agnosticIT, 1, 0, 1, no
752238344118083584,  Dalila_Verardi, 1, 0, 1, no
872251675,  sbspena, 1, 0, 1, no
3232147305,  bogliascom5s, 1, 0, 1, no
1283820974,  massimo_1955, 1, 0, 1, no
279422631,  sharpbeauty, 1, 0, 1, no
789955010331369472,  ellymcape, 1, 0, 1, no
127595699,  francescavallo, 1, 0, 1, no
2735547946,  contynium73, 1, 0, 1, no
797563370,  mariabevilacqu2, 1, 0, 1, no
378159279,  ianadru, 1, 0, 1, no
489195928,  miccantarella, 1, 0, 1, no
502865342,  leolozito, 1, 0, 1, no
49612888,  AndreasTT, 1, 0, 1, no
47946596,  stringbeanjean0, 1, 0, 1, no
765240828,  LMudadu, 1, 0, 1, no
4899802323,  franca672, 1, 0, 1, no
806057771468734464,  otreblic, 1, 0, 1, no
392730397,  Skardosa, 1, 0, 1, no
2359996649,  Fo11Maini, 1, 0, 1, no
3031058761,  tonio9191, 1, 0, 1, no
722161837383540736,  LovableCaro, 1, 0, 1, no
2324857372,  danymo54, 1, 0, 1, no
366135277,  4gattiaroma, 1, 0, 1, no
430599289,  TurkoYeah, 1, 0, 1, no
513184347,  Bono1952, 1, 0, 1, no
426958299,  Salvo7676, 2, 0, 2, no
484220471,  Gio_Cecchinato, 1, 0, 1, no
4632995241,  AndreaStimilli, 1, 0, 1, no
2359157445,  giacchetti2000, 1, 0, 1, no
267966135,  NatalinaFarano, 1, 0, 1, no
803312587362496518,  Diego_Modenini, 1, 0, 1, no
4768174949,  ujonathan70, 1, 0, 1, no
4124138679,  GerBa73, 1, 0, 1, no
210389532,  mysteven66, 1, 0, 1, no
400904268,  PINUCCI0, 4, 0, 4, no
369179336,  diegoscognamigl, 2, 0, 2, no
1368850908,  FMCastaldo, 9, 0, 9, no
758299566093500416,  Miskokovac, 2, 0, 2, no
782264091389857792,  frrslv, 1, 0, 1, no
756143225165840388,  Alessan97411423, 1, 0, 1, no
804000933994786816,  Bellunum, 1, 0, 1, no
802932138601484288,  pietropolara, 2, 0, 2, no
4105723264,  maopasquinelli, 2, 0, 2, no
1386409051,  simoneb57, 1, 0, 1, no
1108513123,  Duke_LetoII, 1, 0, 1, no
3301844175,  _alberto_bosco_, 1, 0, 1, no
2418898621,  cristin62471285, 1, 0, 1, no
3004063252,  MelloniManuele, 1, 0, 1, no
1114383950,  pasqualesanto11, 1, 0, 1, no
3156492300,  Antony28776432, 1, 0, 1, no
2738783405,  mauro_ebe, 1, 0, 1, no
729776809575907329,  borgo_grazia, 1, 0, 1, no
135932493,  DjMorsan, 1, 0, 1, no
382304436,  uomodipace, 1, 0, 1, no
599219874,  GILAS60, 4, 0, 4, no
73420263,  micverde, 3, 0, 3, no
629274064,  kekkolett, 1, 0, 1, no
471975571,  marlon1340, 1, 0, 1, no
773533953521311744,  JonathanKrist77, 2, 0, 2, no
377374276,  camelvino, 3, 0, 3, no
3385590159,  777s777s, 2, 0, 2, no
2169507597,  BrosioG, 1, 0, 1, no
148723959,  Turi1982, 1, 0, 1, no
1515980365,  domi732013, 3, 0, 3, no
2557144432,  PietroRubini, 1, 0, 1, no
475578901,  fabrirusso68, 1, 0, 1, no
489735587,  LorenzoMalevolt, 1, 0, 1, no
791943046396940288,  AngelaPanella65, 2, 0, 2, no
397554898,  DomenicaVerrico, 1, 0, 1, no
3135198681,  pratesi_s, 1, 0, 1, no
3336603742,  AndreaVerza15, 1, 0, 1, no
703606661412474887,  StaniMesisca, 1, 0, 1, no
448750282,  adlucc, 1, 0, 1, no
1082407140,  Teach8686, 1, 0, 1, no
2614227554,  vuoisaperedi, 10, 0, 10, no
760387692958015488,  SIMONA14084790, 3, 0, 3, no
2837988653,  SilvyRossini, 1, 0, 1, no
710521199584006144,  ilacqua_franco, 4, 0, 4, no
475577032,  ceratiandrea, 3, 0, 3, no
353666078,  conte_maria, 2, 0, 2, no
3069465819,  aleandrozeccas1, 1, 0, 1, no
361809583,  LorettaPasta, 1, 0, 1, no
48066008,  bacao, 1, 0, 1, no
2245355560,  AngeloPolly, 1, 0, 1, no
625802529,  Gospodimilostiv, 4, 0, 4, no
2860048756,  ageloj26, 1, 0, 1, no
81296978,  lujatube, 1, 0, 1, no
139831560,  Max_Ragusa, 1, 0, 1, no
487463041,  RossanaDonati, 1, 0, 1, no
1039599080,  Cimabue_, 1, 0, 1, no
4164602849,  ArmenioMaria57, 1, 0, 1, no
762337563025760257,  chiesarena3, 3, 0, 3, no
116685125,  almascien, 3, 0, 3, no
2183161219,  moviradiotwitt, 3, 0, 3, no
3084210021,  AielliRiccardo, 1, 0, 1, no
778938594622894080,  roby1761, 1, 0, 1, no
372760787,  giughost, 1, 0, 1, no
1437581690,  enzagianna, 1, 0, 1, no
396513566,  muffatoandrea, 1, 0, 1, no
793909945351700481,  cloman849, 1, 0, 1, no
157131465,  Argo16, 1, 0, 1, no
33039034,  cod4anto, 1, 0, 1, no
991309093,  CristinaRulfi, 1, 0, 1, no
375709660,  Loredanarossone, 2, 0, 2, no
198832735,  AlessioLoGaglio, 1, 0, 1, no
330490956,  franco4574, 1, 0, 1, no
745659215881076736,  IlariaAndreucc1, 1, 0, 1, no
254076311,  Quortshirts, 2, 0, 2, no
801505964633554944,  MatteoGabucci12, 1, 0, 1, no
2262944341,  rosalella_, 1, 0, 1, no
418048339,  andrevr46, 3, 0, 3, no
124132193,  ninodiberardino, 1, 0, 1, no
705820717556834304,  Frances55205713, 2, 0, 2, no
473128255,  steoscali, 1, 0, 1, no
378014511,  campipaolo, 3, 0, 3, no
1262709276,  francescosapia3, 2, 0, 2, no
544424960,  nesrinkiziltepe, 2, 0, 2, no
221786542,  MassimoBugani, 1, 0, 1, no
4863973245,  AntonioPerrel12, 1, 0, 1, no
791658298521055232,  Silvio01239757, 1, 0, 1, no
785240677466644482,  onlypipa, 1, 0, 1, no
505924362,  ElyDen1, 1, 0, 1, no
72777391,  space_lord_mofo, 1, 0, 1, no
428423623,  IOLANDADOCIMO, 1, 0, 1, no
2359562326,  Enr1coVallarola, 2, 0, 2, no
794500668027445248,  matteongnt71, 1, 0, 1, no
2786973323,  BroggiElisa, 1, 0, 1, no
804261576761081860,  LinguaFraFranca, 1, 0, 1, no
3535552281,  guidosky38, 1, 0, 1, no
5593172,  saneirot, 1, 0, 1, no
411849829,  holealienonvolo, 1, 0, 1, no
2896487589,  traverso1234, 3, 0, 3, no
2748826143,  MirtaMirmilla, 3, 0, 3, no
707281602351648769,  albertom5storo, 2, 0, 2, no
541659611,  dangul81, 2, 0, 2, no
2332191414,  Franckorlando69, 1, 0, 1, no
15144611,  gianlucasassi, 3, 0, 3, no
609167584,  niclapodesta, 2, 0, 2, no
265348883,  AronBoele, 1, 0, 1, no
237392330,  marco11985, 20, 0, 20, no
4898162783,  tiffano1983, 4, 0, 4, no
374499857,  TheLordSeth, 2, 0, 2, no
421302747,  GiancarloRizzo, 2, 0, 2, no
3053205142,  MicheleVincigu8, 1, 0, 1, no
770519510138941440,  ciuef, 1, 0, 1, no
2223169266,  DonJoseLaSida, 3, 0, 3, no
205888140,  mr_kaizen, 1, 0, 1, no
802218277372039168,  ElBona67, 1, 0, 1, no
260683267,  sordacchione, 1, 0, 1, no
1943352259,  Danaesse, 2, 0, 2, no
800240133974855680,  ComeCazzoTePare, 1, 0, 1, no
1278210284,  Ale_C_Carrozzo, 1, 0, 1, no
761449763296477184,  GiuseppeAdaglio, 1, 0, 1, no
417094749,  titanokid, 4, 0, 4, no
703020132,  ia08773, 1, 0, 1, no
1225018712,  pierlu_73, 2, 0, 2, no
703019927,  FrancescoVlad, 1, 0, 1, no
3715386076,  pica_emanuele, 1, 0, 1, no
1201564051,  CinquiniC, 1, 0, 1, no
1142989243,  Fr2174, 1, 0, 1, no
800743787068735488,  Vet_RMaffey, 3, 0, 3, no
2389413932,  Megalommatis, 1, 0, 1, no
1588631677,  sghiso79, 1, 0, 1, no
801542736222572544,  jurycesar1, 1, 0, 1, no
2508021147,  Toniapatty, 1, 0, 1, no
2546713458,  EDYDIBONITO, 3, 0, 3, no
2277860888,  GiusGiuliani, 1, 0, 1, no
425276399,  MapleRedFire, 1, 0, 1, no
1355401399,  LUCIANOPANGALLO, 1, 0, 1, no
253135962,  MarcoBrollo, 1, 0, 1, no
236523500,  FrancescaBudano, 1, 0, 1, no
36307715,  ilSarty, 1, 0, 1, no
2709338195,  AVannello, 1, 0, 1, no
716598542572396544,  Luana22939585, 1, 0, 1, no
793933362582978561,  EnzoD84, 1, 0, 1, no
914564990,  GabrieleBatoni, 2, 0, 2, no
800707848191647744,  beautifulboat, 1, 0, 1, no
423281726,  bobocraxi, 2, 0, 2, no
472404545,  paoloemb, 1, 0, 1, no
700733903372492800,  bennypll, 1, 0, 1, no
529790138,  pgborgini, 1, 0, 1, no
272961989,  Pierber2011, 1, 0, 1, no
2376774356,  sidney08507633, 1, 0, 1, no
305830378,  DanielePiazza2, 1, 0, 1, no
498975787,  Fox74ita, 1, 0, 1, no
625969647,  MayerNorbert, 1, 0, 1, no
892687952,  GiorgioDeCagna, 1, 0, 1, no
1618737265,  89londoner, 1, 0, 1, no
255085427,  iFulvo, 1, 0, 1, no
1395987182,  xgianc, 1, 0, 1, no
380371435,  lorelay_868, 1, 0, 1, no
313401706,  Mirko1971m, 1, 0, 1, no
591598115,  prosperi_andrea, 3, 0, 3, no
3222530686,  ZardoElisa, 1, 0, 1, no
789845752910647296,  63Pegh, 1, 0, 1, no
958529605,  roberto251960, 1, 0, 1, no
1300769053,  1959martina1111, 1, 0, 1, no
516238138,  leliozeta, 3, 0, 3, no
440207914,  Atenaide_Arpone, 2, 0, 2, no
785405593330802688,  Daniela46309541, 2, 0, 2, no
58159094,  JackMariner, 1, 0, 1, no
217634365,  IcqusIxoye, 1, 0, 1, no
792133535024967680,  Angelo51250826, 1, 0, 1, no
796123967853654020,  MaternityVictor, 1, 0, 1, no
2971880133,  giovannidipiaz1, 1, 0, 1, no
1035009296,  47_nunzio, 1, 0, 1, no
2809802006,  Miky796, 1, 0, 1, no
1114722992,  Paxpartout, 2, 0, 2, no
729253554196713472,  RaffaeleViscone, 1, 0, 1, no
791946392981745666,  DiariPolitici, 1, 0, 1, no
52773121,  Geromedia, 1, 0, 1, no
797186498911203328,  giodaez, 1, 0, 1, no
716631504,  SuteraAngela, 4, 0, 4, no
574403169,  rosalb64, 1, 0, 1, no
419084673,  Alesciamano, 1, 0, 1, no
582111037,  Michele4mento, 1, 0, 1, no
497263437,  natachaartdecor, 1, 0, 1, no
2293711096,  Angelopaxia, 1, 0, 1, no
1140566040,  vivianalomonaco, 1, 0, 1, no
1548457902,  M5S_Veneto, 1, 0, 1, no
140116780,  _WinstonWolf, 1, 0, 1, no
1322244361,  Giulucantoni, 1, 0, 1, no
383311383,  LFlorimonte, 1, 0, 1, no
802878612521226240,  adricanarelli, 1, 0, 1, no
2472041283,  SianoAngelo, 1, 0, 1, no
488369670,  nicolacioffo1, 3, 0, 3, no
791356702977323008,  LisantiLuca, 1, 0, 1, no
144128481,  pickwick80, 1, 0, 1, no
732678450,  giocle1, 1, 0, 1, no
408676382,  fioro78, 1, 0, 1, no
2273421414,  SCHIAVONEAMALIA, 1, 0, 1, no
703295272265367552,  neviolino75, 2, 0, 2, no
2207978535,  MarinellaNap, 1, 0, 1, no
576369057,  massimo15691, 1, 0, 1, no
754718657880678400,  maximilianthegr, 2, 0, 2, no
1857194689,  ilmietitore85, 3, 0, 3, no
296179562,  Andrea3_t, 2, 0, 2, no
4032603616,  sim1ste, 1, 0, 1, no
4076933254,  mauriziomadaro1, 2, 0, 2, no
784679732034080768,  Mik21132626, 1, 0, 1, no
571914703,  gygi77, 1, 0, 1, no
1314728936,  NicolaMorra63, 2, 0, 2, no
3065216445,  Dr____Nash, 1, 0, 1, no
801396324428038144,  statesereni, 1, 0, 1, no
2798763527,  daniea_daniela, 2, 0, 2, no
169042404,  ClaudioVING, 1, 0, 1, no
728850746871971840,  mika0275109112, 1, 0, 1, no
143576761,  mekengi, 1, 0, 1, no
763349615458578433,  f166cbda35e34f7, 1, 0, 1, no
58478445,  fraff1, 1, 0, 1, no
538300806,  stefanolisci, 1, 0, 1, no
2179447205,  ghito49, 1, 0, 1, no
47969711,  gabriella_roux, 3, 0, 3, no
1464976362,  Pedro_Maria88, 1, 0, 1, no
1477131018,  fabrimoon, 2, 0, 2, no
803648232144433152,  Mariate93357083, 1, 0, 1, no
1627601215,  FrancoDiGiammar, 1, 0, 1, no
124236178,  GianlucaVacca, 7, 0, 7, no
1142647476,  robiflash61, 2, 0, 2, no
541988677,  claudiosimeoni, 2, 0, 2, no
788744375249633284,  nonnabrigitta, 2, 0, 2, no
526213147,  maurybonazzi, 2, 0, 2, no
3434287768,  Buio99, 1, 0, 1, no
182113694,  francyguff, 1, 0, 1, no
2331775274,  antonino3531967, 1, 0, 1, no
2978361604,  emacat3, 1, 0, 1, no
3075282753,  ArgieriEllen, 2, 0, 2, no
795324018178093056,  VikiVitt60, 1, 0, 1, no
159412548,  MaxCaramazza, 1, 0, 1, no
1092248448,  TCaldarella, 1, 0, 1, no
1236535783,  giacomo_carso, 1, 0, 1, no
3321758853,  nella125830, 1, 0, 1, no
229884867,  EliGiova74, 2, 0, 2, no
39018914,  belacivetta, 1, 0, 1, no
1555166234,  c_cangiano, 1, 0, 1, no
558110892,  IvanoRipani, 1, 0, 1, no
2320504019,  giando1962, 1, 0, 1, no
804119991524225024,  satiricamento, 1, 0, 1, no
425391665,  Braluc81, 1, 0, 1, no
1412775048,  paperopoli2003, 1, 0, 1, no
2219545025,  missioni0, 2, 0, 2, no
3126534947,  CeliLid, 1, 0, 1, no
621383690,  NapoGi17, 1, 0, 1, no
277015964,  Caru88, 2, 0, 2, no
449717780,  MariaDFonti, 4, 0, 4, no
1862886032,  enzoromanovr, 1, 0, 1, no
1861652984,  EugenioVerdinel, 2, 0, 2, no
3295023377,  salviccio60, 1, 0, 1, no
3410355807,  LorisBergamini, 2, 0, 2, no
2178130104,  pepgatto, 2, 0, 2, no
747583665056718848,  sperandiomario1, 3, 0, 3, no
79287190,  Scardreamer, 1, 0, 1, no
180005622,  Antonio180760, 1, 0, 1, no
315687815,  LuisBelvedere, 1, 0, 1, no
798202174190866432,  bruno76533638, 3, 0, 3, no
772770225670459392,  recchiabellisa1, 1, 0, 1, no
2414683945,  Sergiodp69, 2, 0, 2, no
804497097869393920,  GianpietroFagg2, 1, 0, 1, no
800421412682874882,  Riccardo0972, 2, 0, 2, no
2169042164,  AglDall, 1, 0, 1, no
902519029,  ilbonzaturatti7, 1, 0, 1, no
922906549,  FabioMaritano, 1, 0, 1, no
3433975120,  FF28_11, 1, 0, 1, no
741570412895739904,  rivoli111, 1, 0, 1, no
2974399810,  AntoSoraggi, 1, 0, 1, no
181684018,  renatodelledonn, 1, 0, 1, no
1662108194,  KnzKunz, 8, 0, 8, no
2720575342,  CrBarbarini, 1, 0, 1, no
234291821,  miriagenga, 2, 0, 2, no
256627292,  MickyNardella, 1, 0, 1, no
3940078893,  morgan_lelii, 1, 0, 1, no
702804571656167428,  antfasan, 1, 0, 1, no
2680186468,  rosadamato634, 1, 0, 1, no
4845019959,  feelzena, 1, 0, 1, no
222436482,  ToscanAntiqua, 1, 0, 1, no
3064716183,  AthelstBeard, 1, 0, 1, no
2969699331,  ravera_fernando, 1, 0, 1, no
429910422,  LelloChiarello, 1, 0, 1, no
149054148,  zazzetto, 2, 0, 2, no
171690967,  G_net75, 2, 0, 2, no
360485722,  Vanganel, 2, 0, 2, no
200661860,  RubinoMauro, 1, 0, 1, no
2733575715,  mr_1516, 1, 0, 1, no
3182766357,  Domenic32826810, 1, 0, 1, no
441233690,  giannicocozza, 2, 0, 2, no
711589458529882113,  gennysiervo, 2, 0, 2, no
71031958,  Bailardo, 2, 0, 2, no
3233888700,  TommyCinisello, 2, 0, 2, no
2830095710,  safarandola, 2, 0, 2, no
16145985,  Giorgiolaporta, 1, 0, 1, no
799265737202405376,  brossdjtop, 2, 0, 2, no
3130683383,  umbimilot, 1, 0, 1, no
802606702805876736,  robertinakkk, 1, 0, 1, no
236350643,  renataortolani, 1, 0, 1, no
163103141,  andreserant, 1, 0, 1, no
913545247,  fraccomoda, 2, 0, 2, no
2512542022,  ABombardino, 1, 0, 1, no
23920614,  Gasinfo, 1, 0, 1, no
1367962406,  argonauuta, 1, 0, 1, no
35176190,  journeyman2009, 1, 0, 1, no
781955788130684928,  Silva900000, 1, 0, 1, no
347122369,  NickSloth, 1, 0, 1, no
335331575,  gabry969, 1, 0, 1, no
412601910,  maxcolt64, 3, 0, 3, no
506221043,  GiovanniTamburi, 3, 0, 3, no
2376808347,  StranoAlex, 1, 0, 1, no
425682891,  FMoscarella, 1, 0, 1, no
756230260971012096,  EleonoraMeloni7, 1, 0, 1, no
762341424310411265,  armerino72, 1, 0, 1, no
420255846,  AntonioFlorio3, 1, 0, 1, no
354780310,  PinoSica, 1, 0, 1, no
2942129068,  Luciana81715565, 1, 0, 1, no
2188026987,  DarioCirillo8, 1, 0, 1, no
3547995913,  mesho2244551, 1, 0, 1, no
804245492959952896,  robertavivi21, 1, 0, 1, no
421052754,  matteog82, 1, 0, 1, no
738067590212378624,  giulioscavonge1, 1, 0, 1, no
609406199,  luca_danese, 1, 0, 1, no
880434931,  ferrettideluca, 1, 0, 1, no
2880024419,  lazzareschideb1, 1, 0, 1, no
1458010693,  HuckFra, 2, 0, 2, no
2266309267,  DepalmasM, 4, 0, 4, no
4170375988,  EnricaGrassi75, 3, 0, 3, no
132833937,  alescan86, 1, 0, 1, no
172278444,  i_essio, 1, 0, 1, no
1154188134,  Alice1Salvatore, 1, 0, 1, no
409819035,  AimeAlessandro, 2, 0, 2, no
456664059,  snulfo, 1, 0, 1, no
442615473,  Max_Ruffoni, 1, 0, 1, no
1280950585,  MoloroseT, 4, 0, 4, no
363629679,  VeroRPederzani7, 1, 0, 1, no
221066689,  cinci04, 1, 0, 1, no
3918540497,  giuseppe2125, 1, 0, 1, no
801323798716968960,  Miriam91332749, 1, 0, 1, no
398542406,  Finez27, 1, 0, 1, no
495275440,  Alberto__San, 1, 0, 1, no
402658881,  ema_astolfi, 1, 0, 1, no
704071958951022592,  Massimi28477096, 1, 0, 1, no
2763812068,  peppe_trapani, 3, 0, 3, no
1037212327,  antoninodurzo, 1, 0, 1, no
415473030,  CostantinoNr1, 1, 0, 1, no
800721722123034624,  prestera_arta, 1, 0, 1, no
882495276,  rcentaz, 1, 0, 1, no
28571384,  blueskyinmind, 1, 0, 1, no
390665502,  martino_marco, 1, 0, 1, no
801388615175700480,  pastaesuriaca, 1, 0, 1, no
141258073,  tartavilma, 1, 0, 1, no
791224292918919169,  redegliscacchi, 1, 0, 1, no
460933532,  albagamba72, 1, 0, 1, no
3130803092,  7804Simo, 1, 0, 1, no
3243124235,  ForesiMarco, 1, 0, 1, no
717762449886355456,  Domenic15675431, 2, 0, 2, no
1077066470,  tapisiglav, 1, 0, 1, no
432704179,  CorradinStefano, 1, 0, 1, no
761697672789098496,  obsoleto___, 1, 0, 1, no
4507733613,  LupinSettimo, 1, 0, 1, no
3065784040,  smoothgirl10, 1, 0, 1, no
185794895,  alessandro_972, 4, 0, 4, no
2979884158,  CondinaIt, 2, 0, 2, no
772075962938908672,  paganoantonio59, 1, 0, 1, no
803119207256883200,  Alessandro7111, 3, 0, 3, no
497797578,  PaolaTavernaM5S, 1, 0, 1, no
527584702,  ellechianti, 1, 0, 1, no
62003557,  vitocrimi, 1, 0, 1, no
801016452455219200,  MoreferarumClan, 1, 0, 1, no
33914149,  smothc, 1, 0, 1, no
4358295022,  PietroManca7, 1, 0, 1, no
2949224753,  bepitosin58, 1, 0, 1, no
483145404,  marchese413, 1, 0, 1, no
480251724,  DegaMau, 1, 0, 1, no
4196781983,  GiuseppeSilvag2, 1, 0, 1, no
785540780568014849,  SergioGuido8, 1, 0, 1, no
353115688,  paolo_buda, 1, 0, 1, no
1157677256,  lollo94Lfgl, 1, 0, 1, no
1431408690,  LauraVlasic, 2, 0, 2, no
1474111062,  cirosellini, 1, 0, 1, no
89407105,  amxstudio, 1, 0, 1, no
766261457881337856,  Db00201_, 2, 0, 2, no
612470382,  ilCriticante, 1, 0, 1, no
754774133796433920,  maistrak70, 1, 0, 1, no
549205128,  bernardi94c, 1, 0, 1, no
2824584058,  Kaio1987, 1, 0, 1, no
506003067,  Zebra73Curci, 1, 0, 1, no
328916356,  StefanoLuzi, 1, 0, 1, no
738811488,  BargiggiaFranco, 1, 0, 1, no
4853428299,  amanojayana, 3, 0, 3, no
710085412577026048,  Carmelo2980, 1, 0, 1, no
773134022369275904,  renato_battisti, 2, 0, 2, no
426978385,  MastrodonatoR, 3, 0, 3, no
1031049613,  Ross23Stefano, 1, 0, 1, no
792422546813620228,  Rossell69382168, 1, 0, 1, no
4441012180,  Massimo22213339, 1, 0, 1, no
2989954665,  FabrizioNoli, 1, 0, 1, no
396831702,  PeddRaam, 1, 0, 1, no
784721199838457856,  NewForEverybody, 1, 0, 1, no
276230660,  wenceslao71, 1, 0, 1, no
411696442,  biancalaura70, 1, 0, 1, no
534057893,  micheleprincip1, 2, 0, 2, no
585475210,  Barbi58C, 4, 0, 4, no
1282619952,  peppe76giuseppe, 1, 0, 1, no
275993167,  darkshad0w, 1, 0, 1, no
3064476580,  davidetiro82, 4, 0, 4, no
4174051582,  monipo71, 1, 0, 1, no
3064862597,  abarone_barone, 1, 0, 1, no
771761141295026177,  s4Xswb0Pv5fmonS, 1, 0, 1, no
994012712,  AngeloScavone, 1, 0, 1, no
2879187077,  giovannipetruc9, 1, 0, 1, no
29190332,  caldozza, 1, 0, 1, no
477639684,  Danielem5s, 1, 0, 1, no
704976168525668352,  JTeesdale1, 1, 0, 1, no
17836555,  mummygirl, 3, 0, 3, no
383563779,  poviapaola, 1, 0, 1, no
2719953051,  sabribellucci, 1, 0, 1, no
3187495264,  marce67e, 1, 0, 1, no
1305316945,  FraAndreozzi, 2, 0, 2, no
291683439,  Frexitrump, 1, 0, 1, no
724687182653480960,  MalataDi, 2, 0, 2, no
1360108453,  rhysgrinstead, 1, 0, 1, no
47696186,  joliemaman, 1, 0, 1, no
798740533,  virgy_bieber15, 2, 0, 2, no
1419002360,  JonasMartelli, 1, 0, 1, no
1010705413,  JuanyGar63, 1, 0, 1, no
448332490,  Lluisgarciacala, 1, 0, 1, no
149141687,  Andy__80, 1, 0, 1, no
3303076979,  BlackLilium87, 1, 0, 1, no
1882934695,  dreihochneun, 1, 0, 1, no
741972779499720704,  maxpalax80, 1, 0, 1, no
580692065,  ElenaIncarnato, 2, 0, 2, no
802833038220677120,  _simonad, 1, 0, 1, no
437480927,  GiuDayLorDie, 1, 0, 1, no
367592425,  CICCIOSF, 1, 0, 1, no
1548525307,  efsi2365, 1, 0, 1, no
27302295,  derossimichele, 1, 0, 1, no
753591304886579200,  sacchetti_paola, 1, 0, 1, no
2272299786,  Freedom_4_GB, 1, 0, 1, no
2716880374,  sabrinaomar8, 1, 0, 1, no
4794808410,  tanino756, 4, 0, 4, no
805706453608701953,  PietroMorielli, 1, 0, 1, no
2900973699,  Martinodissiden, 1, 0, 1, no
365420803,  new__luca93, 2, 0, 2, no
1448085942,  EufraboEugenio, 1, 0, 1, no
588424885,  gargano5stelle, 2, 0, 2, no
785397787995303936,  mastro9610, 1, 0, 1, no
1491291140,  Magi88Alex, 1, 0, 1, no
254508514,  EmmeCity, 1, 0, 1, no
564628722,  dariodedi, 1, 0, 1, no
15098906,  darkfender, 1, 0, 1, no
4427347264,  xbiebsvoice, 1, 0, 1, no
978547374,  GiusyTartamella, 1, 0, 1, no
302506591,  consuelo_lopez, 2, 0, 2, no
2330261468,  sfnlcd, 2, 0, 2, no
480451727,  kriofed, 1, 0, 1, no
393383204,  Cecetto_, 1, 0, 1, no
2945843549,  Bisca68Lucio, 1, 0, 1, no
1035351402,  f_bertaglia, 1, 0, 1, no
470824201,  Geraldina56, 1, 0, 1, no
1026730362,  DanielPaun23, 1, 0, 1, no
2215711553,  berry15465, 1, 0, 1, no
2937411783,  Sony91S, 2, 0, 2, no
760571713553858560,  MardyTC, 1, 0, 1, no
469248451,  Fausto1311, 1, 0, 1, no
161060415,  IngritDauti, 1, 0, 1, no
21039204,  joeypurple, 1, 0, 1, no
361378885,  jonsindreu, 1, 0, 1, no
367785617,  GBordieri, 1, 0, 1, no
185810059,  IvanLeoDomine, 1, 0, 1, no
407817837,  LatinaGaia, 2, 0, 2, no
2733212308,  EricYesyev, 1, 0, 1, no
4824182254,  atodotrapo, 1, 0, 1, no
335246224,  luca_surace, 1, 0, 1, no
124651309,  normacarballo, 1, 0, 1, no
135922191,  susveray28, 1, 0, 1, no
101053662,  marcigliano, 1, 0, 1, no
485569820,  SemeriaMarco, 3, 1, 2, no
4881041223,  Trix69Luisma, 1, 0, 1, no
536285838,  CRoggiero, 1, 0, 1, no
1351595492,  jeffs_araujo35, 1, 0, 1, no
2472367403,  TirelliMirella, 1, 0, 1, no
2272851296,  M5Sestero, 1, 0, 1, no
564217156,  lucman60, 1, 0, 1, no
1607062016,  InfoDalParlam5S, 1, 0, 1, no
385007356,  Zenoborean, 1, 0, 1, no
81867518,  Resistance2_0, 1, 0, 1, no
770995119185076224,  margheazzurra74, 2, 0, 2, no
62270930,  frankaguido, 1, 0, 1, no
502201170,  acab2372, 1, 0, 1, no
4853162061,  michelatommaso2, 1, 0, 1, no
100795724,  david_ld, 1, 0, 1, no
224799449,  k0r3nd, 1, 0, 1, no
397943480,  AnnaGiacovazzo, 1, 0, 1, no
285144362,  rentaquill, 1, 0, 1, no
805731798512795648,  crozzoli_andrea, 1, 0, 1, no
720349689808293888,  GiovanniGiuber1, 1, 0, 1, no
1052614238,  gabcillo, 1, 0, 1, no
1091488650,  PozzifPozzi, 2, 0, 2, no
792334186057170944,  Emanuela310770, 1, 0, 1, no
3400136117,  RenatoMilanesi, 1, 0, 1, no
1564068662,  alisiaderi, 2, 0, 2, no
4824901653,  leogiubila, 9, 0, 9, no
866491718,  giancarmine4, 1, 0, 1, no
363618910,  marellamitica, 1, 0, 1, no
84534810,  _DiLeZ_, 1, 0, 1, no
1274322852,  UmbVass, 1, 0, 1, no
469694002,  agroasx, 1, 0, 1, no
591009919,  ciunciullai, 3, 0, 3, no
2980871206,  MassaRomano, 3, 0, 3, no
194270726,  aequano, 1, 0, 1, no
4004573717,  M5SArezzo, 1, 0, 1, no
143805886,  GianlucaGodani, 1, 0, 1, no
1159625930,  ClaudioPiuri, 1, 0, 1, no
446495082,  francescomusell, 1, 0, 1, no
1665392198,  giudici60, 1, 0, 1, no
4738694260,  snarkbubble, 1, 0, 1, no
1011390390,  alessandrogiro5, 2, 0, 2, no
2882381601,  LorenzoSarmi13, 1, 0, 1, no
237448162,  ElisabettaBoop, 1, 0, 1, no
430697740,  Bissi99, 1, 0, 1, no
476866628,  pipposcifo1, 2, 0, 2, no
210876091,  soniabouzas, 1, 0, 1, no
1004883073,  danieledem75, 1, 0, 1, no
1900091946,  Anto70Croce, 1, 0, 1, no
770748061,  IlGio85, 1, 0, 1, no
2906329295,  magnanimarco8, 1, 0, 1, no
2383408304,  lauralamaletto1, 1, 0, 1, no
165968066,  _MHofmeister, 1, 0, 1, no
803358237441527809,  SeveTheRino, 1, 0, 1, no
802858978988457984,  Raptor_2024, 1, 0, 1, no
104129726,  VanessaEffect, 1, 0, 1, no
1275867079,  gabrielmarin82, 1, 0, 1, no
2613431981,  lucacardarelli5, 1, 0, 1, no
801916664426205185,  mockasmagazine, 1, 0, 1, no
976823918,  micheledelgobbo, 1, 0, 1, no
2582843789,  79Carrozza, 1, 0, 1, no
3395736707,  pina_mancarella, 2, 0, 2, no
918459463,  maxsabatini5, 1, 0, 1, no
1217871432,  liviobordone, 1, 0, 1, no
4461419740,  cleziano72, 1, 0, 1, no
1008697176,  ivanozecchino, 1, 0, 1, no
157801847,  ayelenoliva, 1, 0, 1, no
1884357642,  M5SBellinzago, 1, 0, 1, no
3172387397,  DavideMardegan, 1, 0, 1, no
705968575,  locvnguyen1, 1, 0, 1, no
2574236356,  Valina_slide, 1, 0, 1, no
413972552,  antartleo, 1, 0, 1, no
714921875789504513,  madalina_solo, 1, 0, 1, no
2294223179,  lumo82, 1, 0, 1, no
1729631174,  rossi_2016, 1, 0, 1, no
4134176566,  Dick_Berts, 1, 0, 1, no
722460614858260480,  silvano1149, 1, 0, 1, no
471057183,  peterofgoos, 2, 0, 2, no
716688712579489792,  ChuckLN1, 1, 0, 1, no
2878110759,  FranFratt7, 1, 0, 1, no
1142397870,  lavocedelcarro, 1, 0, 1, no
802878390357426176,  CharryMayles06, 1, 0, 1, no
3457666769,  lucylla73, 1, 0, 1, no
402887931,  phillipmicallef, 1, 0, 1, no
2281953847,  CDHVDS, 1, 0, 1, no
212496035,  marcello57, 1, 0, 1, no
2519063076,  tammywalt61, 1, 0, 1, no
3152403305,  petti97, 1, 0, 1, no
2361814984,  lanicoseio, 4, 0, 4, no
3037264439,  carlomascia8111, 1, 0, 1, no
461026785,  attilabian, 1, 0, 1, no
741721091723415552,  RobertoTonell11, 1, 0, 1, no
802487031121244160,  gelmas1, 1, 0, 1, no
93462521,  polkiev, 1, 0, 1, no
2540241518,  BucetiPaola, 1, 0, 1, no
4817816537,  mirkosansone98, 1, 0, 1, no
471491176,  LucaMorass, 2, 0, 2, no
23785829,  gianlucazandini, 2, 0, 2, no
405467369,  ChristianCangia, 1, 0, 1, no
486411760,  BeatriceSavasta, 1, 0, 1, no
905847060,  MaclukAir, 4, 0, 4, no
398987806,  giummy67, 3, 0, 3, no
1039713476,  iarsetiem, 1, 0, 1, no
548515058,  udei194, 1, 0, 1, no
2242921584,  enzobuk1967, 1, 0, 1, no
4685894052,  LaStrega1974, 1, 0, 1, no
160255385,  MarcelloFoa, 1, 0, 1, no
442665187,  giovannatosi, 1, 0, 1, no
189555728,  LourdesTrenado, 1, 0, 1, no
4827701787,  salvomatarazzo, 1, 0, 1, no
291202396,  RealLosky, 1, 0, 1, no
792271702117982208,  GloriaDoneda, 1, 0, 1, no
521484394,  SilviaS71, 4, 0, 4, no
44611280,  VincenzoSorus, 2, 0, 2, no
2704713284,  lorenzo_calisti, 1, 0, 1, no
790650964004970496,  luciatara30, 3, 0, 3, no
409526553,  AlexGalazzi, 1, 0, 1, no
204471980,  edemo1500, 2, 0, 2, no
561268870,  HankSantarelli, 1, 0, 1, no
499780097,  DanieleVitturi, 1, 0, 1, no
841600790,  Disincanto_, 1, 0, 1, no
409370677,  CatiaS5, 1, 0, 1, no
60006673,  jaraparilla, 1, 0, 1, no
805376249468252161,  ChrisDringoli, 1, 0, 1, no
2263688823,  vitoleri, 1, 0, 1, no
2508141822,  elisina1986, 1, 0, 1, no
847540710,  SimoneAllegrini, 1, 0, 1, no
31666323,  MadonnaDP, 1, 0, 1, no
479804548,  patrytorto, 2, 0, 2, no
279130207,  agazzotto, 10, 0, 10, no
440145254,  MagicNaples1926, 1, 0, 1, no
710436342,  aldobagnialdo, 1, 0, 1, no
545965916,  SavinoPetilli, 1, 0, 1, no
90998435,  NapoliCalcioNET, 1, 0, 1, no
3244880728,  anonye2222, 1, 0, 1, no
800058792197193728,  fiammyp74, 2, 0, 2, no
1848105750,  Linus74Angelini, 1, 0, 1, no
105074240,  bollino79, 3, 0, 3, no
611802120,  PeppeProvenza, 1, 0, 1, no
314828018,  monograficotwit, 2, 0, 2, no
3247971833,  EnricoCelio, 1, 0, 1, no
805580926868717569,  GuglielmoMohi, 1, 0, 1, no
325423122,  julia_panna, 1, 0, 1, no
493564644,  sigilama66, 1, 0, 1, no
357402742,  marco22882, 1, 0, 1, no
2401210895,  AlgeriElena, 1, 0, 1, no
348125702,  florylulucia, 1, 0, 1, no
923766392,  AntilioA, 1, 0, 1, no
4199852639,  angelaaversa1, 1, 0, 1, no
1203781273,  sofiapieffe, 1, 0, 1, no
4030584351,  Fabiopica6, 1, 0, 1, no
29503204,  rloci, 1, 0, 1, no
3050030399,  fiorenzoriciop1, 1, 0, 1, no
585014645,  BesVog, 1, 0, 1, no
710404894826631169,  EguhlLort, 1, 0, 1, no
708415869513293825,  bsavage82, 1, 0, 1, no
738003923508826112,  Jennyunonove, 1, 0, 1, no
2195327711,  IntProcurement, 1, 0, 1, no
315262547,  Sas_Dalt, 1, 0, 1, no
716290497325694981,  MRicciardetto, 2, 0, 2, no
3093330052,  xnelsonrhx, 1, 0, 1, no
128518508,  yuubou600, 1, 0, 1, no
2327645726,  PappaletteraF, 1, 0, 1, no
3836329043,  max691926, 1, 0, 1, no
993717192,  KertushaIsmail, 1, 0, 1, no
232330384,  Ultimaoasi, 1, 0, 1, no
453012493,  carlosarracino, 1, 0, 1, no
729704055107391489,  minobottiglieri, 1, 0, 1, no
426270966,  Ale_B_88_FCIM, 1, 0, 1, no
314040976,  VariniMassimo, 1, 0, 1, no
493140640,  dalessandroM5S, 1, 0, 1, no
27413507,  fakeedbutler, 1, 0, 1, no
803762368761073665,  edofalso, 1, 0, 1, no
460200408,  LUCIOCIOTOLA, 1, 0, 1, no
225982309,  faidr, 1, 0, 1, no
796494022265147392,  Truth_Liberty_, 2, 0, 2, no
4884950417,  steuc2, 1, 0, 1, no
3228023541,  AngeloSgueglia2, 2, 0, 2, no
739493617,  schillsandrea, 1, 0, 1, no
4192067253,  franca_carletti, 2, 0, 2, no
428094539,  oldmay, 1, 0, 1, no
297315402,  Andreap971, 1, 0, 1, no
2920160650,  lucillacsl1, 1, 0, 1, no
179088440,  pepeponte88, 2, 0, 2, no
1257906091,  polzellanico1, 3, 0, 3, no
59805168,  ECantoni, 1, 0, 1, no
434851422,  EffeFevola, 2, 0, 2, no
272591058,  GiusyBarbatonyc, 1, 0, 1, no
386224912,  Filidiste, 1, 0, 1, no
96207679,  fABri_LT, 1, 0, 1, no
405642966,  pierpaolozzz, 1, 0, 1, no
4570414113,  rosicam101, 1, 0, 1, no
149842922,  guidolavoe, 1, 0, 1, no
740631932086652928,  roblag90, 1, 0, 1, no
3863196447,  Rosariozazza, 1, 0, 1, no
790917295279337472,  beafiore97, 1, 0, 1, no
398230105,  MynheerPeeper, 1, 0, 1, no
3307092292,  Jollarn, 1, 0, 1, no
274214893,  newsholo, 1, 0, 1, no
83893155,  PatrickParis88, 1, 0, 1, no
1275874194,  RavalCorvino, 2, 0, 2, no
708680401796132864,  lcnamato71, 1, 0, 1, no
260398745,  ElissaGodoy, 1, 0, 1, no
341641915,  malatestafabriz, 1, 0, 1, no
382945665,  MrSalamoSays, 1, 0, 1, no
301515439,  JonScotBurns, 1, 0, 1, no
77299913,  DonDraperClone, 2, 0, 2, no
2891332109,  stefanellistef1, 2, 0, 2, no
2558319999,  jank20669, 1, 0, 1, no
2211444264,  ElPapu1023, 1, 0, 1, no
4911378279,  jorgeomar1958, 1, 0, 1, no
2325435205,  LuigiNoveli, 1, 0, 1, no
1619846047,  Andrea74_aho, 1, 0, 1, no
1474865598,  MdeSaintMichel, 1, 0, 1, no
2676887991,  paolobassi166, 1, 0, 1, no
430216359,  francescocarre1, 1, 0, 1, no
470352642,  ACazzar, 2, 0, 2, no
305258223,  paolomarek17, 1, 0, 1, no
338471527,  bassalti, 1, 0, 1, no
196484069,  SaimonTx, 1, 0, 1, no
1216798586,  SolloFrancesco, 1, 0, 1, no
839406008,  deugenioe, 2, 0, 2, no
2455064133,  isitara61, 1, 0, 1, no
177812997,  CurtMills, 1, 0, 1, no
943315728,  mirco_magri, 1, 0, 1, no
439524666,  MarcoVuolo, 1, 0, 1, no
265478136,  PhilipBertrand, 1, 0, 1, no
1596356294,  seria_paolo, 1, 0, 1, no
1897406329,  samantarivello, 1, 0, 1, no
3333400919,  BianchiM4rco, 1, 0, 1, no
805423479474573312,  therealdinz, 1, 0, 1, no
1470498758,  AleCromOfficial, 1, 0, 1, no
369974934,  MauroMeloni89, 1, 0, 1, no
805553850128224256,  tronkyhallo, 1, 0, 1, no
228426881,  GreenMonsterah, 1, 0, 1, no
243425394,  LuigiPizzimenti, 1, 0, 1, no
285801295,  peppeanastasio, 1, 0, 1, no
1960745941,  z_a_v_m, 1, 0, 1, no
1446790993,  francescamel2, 2, 0, 2, no
761326142834040832,  alefantasy2016, 1, 0, 1, no
20635695,  DavideIppolito, 1, 0, 1, no
373228693,  franko_twt, 1, 0, 1, no
351901876,  SilvOz, 3, 0, 3, no
3425603783,  balole67, 1, 0, 1, no
4474334841,  giofa63, 1, 0, 1, no
2911603197,  IlPresidente84, 1, 0, 1, no
804379944,  ferdinandodisan, 1, 0, 1, no
721340174781804544,  mdionne7237231, 1, 0, 1, no
2767843313,  costellodaniel1, 1, 0, 1, no
918565273,  04102009_, 1, 0, 1, no
705758030508507141,  625bbd1b73e74c5, 1, 0, 1, no
80008326,  marco2288, 1, 0, 1, no
1145194201,  getiton6, 2, 0, 2, no
910304714,  dbddany, 1, 0, 1, no
803315900304723968,  zuswar, 1, 0, 1, no
2244403339,  Drammis1, 1, 0, 1, no
1356311990,  RossellaPG, 1, 0, 1, no
802207699664535552,  paola_iaboni, 2, 0, 2, no
2467750806,  EmanueleForlano, 1, 0, 1, no
151400061,  Mimmoto, 4, 0, 4, no
210182258,  Emanuelepetrali, 1, 0, 1, no
1598763572,  UK_Right, 1, 0, 1, no
1157798953,  karmafeliz, 1, 0, 1, no
245480277,  cicciopedace, 1, 0, 1, no
469519219,  ALBERTO_1977_, 1, 0, 1, no
1336235796,  denver72201328, 2, 0, 2, no
53137137,  polly_puff, 1, 0, 1, no
153436041,  ninignaregina, 1, 0, 1, no
1225736772,  LolaGanzarolli, 1, 0, 1, no
424538812,  TexasDollar, 1, 0, 1, no
4873533245,  simon_p82, 1, 0, 1, no
500090809,  fabiovigolo, 1, 0, 1, no
476883328,  dellorcopino, 1, 0, 1, no
2970098309,  AndreaZedda78, 1, 0, 1, no
981259128,  marcochio94, 1, 0, 1, no
740595177128071168,  pinoBosco2, 1, 0, 1, no
424953085,  PeppePorzio22, 1, 0, 1, no
186108238,  giulianodellape, 2, 0, 2, no
3264537088,  anagacom, 1, 0, 1, no
803695642778464257,  Adriana5999, 1, 0, 1, no
1218705558,  GiovanniScarpa_, 1, 0, 1, no
750024055990910976,  Bluethirty1, 1, 0, 1, no
2589868045,  cursin54, 4, 0, 4, no
418506913,  mauro_perri, 1, 0, 1, no
213771291,  mialberti, 1, 0, 1, no
19408759,  M5Sviareggio, 1, 0, 1, no
2530931419,  83Antonietta, 1, 0, 1, no
1283427912,  redrosso2, 1, 0, 1, no
1194659419,  cri49763971, 1, 0, 1, no
2973163389,  joppi1980, 3, 0, 3, no
353660487,  Pepnano, 1, 0, 1, no
327536757,  aleprincipi, 2, 0, 2, no
1037285754,  fabcostantini, 1, 0, 1, no
768299806888386560,  droneventure1, 4, 0, 4, no
1162106042,  sabbatex, 3, 0, 3, no
368920797,  SMaurizi, 1, 0, 1, no
2733966208,  1234Giles, 1, 0, 1, no
923883992,  pirronenunzio, 1, 0, 1, no
264637878,  ghibbli, 1, 0, 1, no
80307651,  nikusvitrani, 1, 0, 1, no
1145355552,  ciotola80, 3, 0, 3, no
3121152852,  ridocate, 1, 0, 1, no
386046711,  mister_spaik, 1, 0, 1, no
722534157512011778,  Claudio_Rallo, 1, 0, 1, no
413205249,  sre_la, 1, 0, 1, no
535516497,  DeRosaIolanda, 1, 0, 1, no
29907028,  Charles_Grillo, 1, 0, 1, no
745691882,  Giamma971, 1, 0, 1, no
2753394142,  M5sM5spi, 2, 0, 2, no
797775638358847489,  ivanlazz1, 1, 0, 1, no
497246384,  rino19711, 1, 0, 1, no
740748164,  propellente, 1, 0, 1, no
2182885554,  FaustoLerda, 1, 0, 1, no
485814780,  elenafabio, 1, 0, 1, no
745212254111469568,  FraTeo83, 1, 0, 1, no
754953683385851904,  AntonioMontres1, 1, 0, 1, no
2545660573,  CyrilGiraud79, 1, 0, 1, no
2762654597,  pn5stelle, 2, 0, 2, no
1103245380,  gabrielelivieri, 2, 0, 2, no
804806665040175104,  Stefano_Santese, 1, 0, 1, no
1534732470,  HK__49_3, 1, 0, 1, no
1061897502,  arronaquaudrt, 1, 0, 1, no
475722471,  RScarfato, 1, 0, 1, no
111599680,  dramaloveitalia, 1, 0, 1, no
392588429,  marialuisadurs1, 1, 0, 1, no
412501366,  Ariannadodero, 1, 0, 1, no
460917858,  elena_zagni, 1, 0, 1, no
797918697595793408,  Zagorkurac, 1, 0, 1, no
305795673,  tinatabo, 1, 0, 1, no
3124621439,  MarcoGalanteM5S, 2, 0, 2, no
738285320760885248,  haydude0, 1, 0, 1, no
2565509048,  GianlucaBozzett, 2, 0, 2, no
320676094,  PeperitaChili, 1, 0, 1, no
777421732219129856,  AndreaFerraroNa, 1, 0, 1, no
4049039237,  andrea_cottons, 1, 0, 1, no
96523135,  aleen77, 1, 0, 1, no
1015904244,  CiacchiR, 1, 0, 1, no
1284268466,  Francesco1311, 2, 0, 2, no
574630639,  FFoxylion, 1, 0, 1, no
3710949677,  gilmour681, 2, 0, 2, no
803377573711478784,  dariomarino19, 1, 0, 1, no
470188127,  NicoleScarlato, 1, 0, 1, no
104861617,  Sanremomeetup, 1, 0, 1, no
152035250,  dusvaleo, 3, 0, 3, no
588278416,  Sanremo5stelle, 1, 0, 1, no
450037663,  SilviaFarci, 1, 0, 1, no
81297458,  criboc, 1, 0, 1, no
1671704071,  EMocellini, 1, 0, 1, no
365003757,  TizianaGeraci, 1, 0, 1, no
3496115361,  mancini_gaetano, 1, 0, 1, no
380918320,  EliElisabetta, 1, 0, 1, no
3641175736,  MCandeliere, 1, 0, 1, no
1221361957,  ComandanteRico, 1, 0, 1, no
455843920,  luigib4, 1, 0, 1, no
2799598061,  EraTuttoScritto, 1, 0, 1, no
217072021,  soozikins, 1, 0, 1, no
4819490909,  EdoardoMazzant1, 1, 0, 1, no
2659593264,  Stella_Dio2, 1, 0, 1, no
202768204,  lorysem, 1, 0, 1, no
2548434750,  bartiol, 1, 0, 1, no
430566450,  MicheleGhiani, 1, 0, 1, no
3842509876,  berenicebskll, 1, 0, 1, no
26054461,  elisascipioni, 2, 0, 2, no
372196035,  EMIDEMA, 1, 0, 1, no
778599415007150080,  stebartols, 2, 0, 2, no
17583317,  FZucchi, 1, 0, 1, no
797549147628904448,  anilius24, 1, 0, 1, no
1235315634,  MassimoGiaquin1, 1, 0, 1, no
220179342,  EdgarMP96, 1, 0, 1, no
179503167,  S_Rabinal, 1, 0, 1, no
82092954,  starrysky4MJ, 1, 0, 1, no
1330940196,  StefanoMonk, 1, 0, 1, no
527518785,  GianniPGiov, 1, 0, 1, no
1349179320,  rofesti, 1, 0, 1, no
709304761628139520,  lacarognaofwend, 1, 0, 1, no
1030603327,  pescatore9, 2, 0, 2, no
2236122296,  beinasco5stelle, 1, 0, 1, no
591041659,  truth_bho_truth, 1, 0, 1, no
77455596,  laauraestrada, 1, 0, 1, no
3056591183,  MarianneHilte, 1, 0, 1, no
370283122,  inezvanderbijl, 1, 0, 1, no
454676270,  teo_7474, 1, 0, 1, no
822343399,  FabioPavia1, 1, 0, 1, no
466678175,  videoUP_, 1, 0, 1, no
354680601,  fedelink7, 1, 0, 1, no
709378917241589760,  GaetanoLeonard3, 1, 0, 1, no
255037440,  cileland, 3, 0, 3, no
210916152,  federico_capone, 1, 0, 1, no
416351352,  FABIOVCA, 3, 0, 3, no
755080499605999616,  AngeloColonna8, 1, 0, 1, no
2290224324,  MaxGarg1962, 1, 0, 1, no
1191099788,  parvizphoto, 1, 0, 1, no
341951128,  MBasciu, 1, 0, 1, no
496009313,  leslie5691, 2, 0, 2, no
433669797,  il_vins, 1, 0, 1, no
103265981,  carlomartinello, 1, 0, 1, no
425469249,  mcsacco, 1, 0, 1, no
1084256905,  VRobiri, 1, 0, 1, no
288246866,  Il_basilisco, 2, 0, 2, no
1286047106,  Teonoe31, 1, 0, 1, no
788699015609192448,  ricucci2016, 2, 0, 2, no
186058332,  giovanniscalaca, 1, 0, 1, no
518439847,  francyperrone92, 1, 0, 1, no
745349348,  brunodallavalle, 1, 0, 1, no
459256707,  DarioF72, 1, 0, 1, no
421817125,  gam1957, 1, 0, 1, no
1009192315,  Frmartin60, 1, 0, 1, no
448826586,  cassius429, 1, 0, 1, no
54880025,  VelhoEstilo, 1, 0, 1, no
2876375319,  diegoimbriani, 1, 0, 1, no
22612494,  Polliandre, 1, 0, 1, no
576371613,  PrancoLeoz93, 1, 0, 1, no
159775615,  paoloroma2010, 1, 0, 1, no
116204007,  marcepautassi, 1, 0, 1, no
769588195977723904,  carlocavallar0, 1, 0, 1, no
1011978120,  alcarbo2, 1, 0, 1, no
67879486,  CaptHaddock83, 1, 0, 1, no
728955175369621505,  Quirina_Cantini, 1, 0, 1, no
816969265,  Dandreolet, 1, 0, 1, no
746785459,  NicolaSABATELLI, 1, 0, 1, no
2904482489,  medori_jr, 1, 0, 1, no
3862422675,  rams236, 1, 0, 1, no
1111052448,  jalatom, 1, 0, 1, no
805575661083643904,  PieroBarzanti, 1, 0, 1, no
2752920977,  WindyLFC5, 1, 0, 1, no
22122033,  jvasili, 1, 0, 1, no
41611616,  GiovanniTambu, 1, 0, 1, no
3119387615,  EVRORENAISSANCE, 1, 0, 1, no
89938366,  fabiobottino, 1, 0, 1, no
770163040172015616,  antonellanovie2, 2, 0, 2, no
707900718208970752,  stevizam, 1, 0, 1, no
702110167320698884,  FilipsAndrea, 1, 0, 1, no
322362334,  Peppe_D_11, 1, 0, 1, no
116842247,  emirmontoya, 2, 0, 2, no
557871804,  agostinodalio, 1, 0, 1, no
719563341115584512,  itsmenphis, 1, 0, 1, no
1252985322,  Danielysuchepa, 1, 0, 1, no
458580695,  jjaxshin, 1, 0, 1, no
1011173563,  00frenky00, 1, 0, 1, no
3058950893,  nikopuffa, 2, 0, 2, no
1079977711,  mattiafresi, 1, 0, 1, no
777814211636461568,  stefcosta26, 1, 0, 1, no
2931926547,  DeniseGandi, 1, 0, 1, no
715849387906310146,  Mar_Tre60, 1, 0, 1, no
361280438,  controilpotere, 1, 0, 1, no
2152673555,  BiudyB, 2, 0, 2, no
378053594,  mariameloni, 1, 0, 1, no
804189439228596224,  opesurga1984, 1, 0, 1, no
196229406,  Viagem_Italia, 1, 0, 1, no
378833661,  GiannaMangia, 1, 0, 1, no
805450038990217216,  natorerenato, 1, 0, 1, no
2285463353,  noismeker2, 1, 0, 1, no
1280967290,  AntoDiLu, 1, 0, 1, no
2592925431,  Moby7122013, 1, 0, 1, no
471559066,  joeyDeMarco12, 1, 0, 1, no
3233255813,  FreddragonZen, 1, 0, 1, no
580825596,  superseba_juve, 1, 0, 1, no
259128394,  TarkokAj, 1, 0, 1, no
469639681,  Pabatt, 1, 0, 1, no
3353369697,  alexkid11301157, 1, 0, 1, no
358111700,  NunziaCerroneMD, 2, 0, 2, no
102398509,  lovon32, 1, 0, 1, no
94103025,  gbenciolini, 1, 0, 1, no
992601505,  IuriSassetti, 1, 0, 1, no
3781248801,  vale_bellettini, 1, 0, 1, no
2636971536,  realStaiti, 1, 0, 1, no
21303464,  alykhansatchu, 1, 0, 1, no
764884779590451200,  Pietro01164944, 1, 0, 1, no
736331226496258050,  draventhecrow11, 1, 0, 1, no
405107680,  annascotto1, 1, 0, 1, no
459397842,  minaventura, 1, 0, 1, no
826878486,  SebastianiGuido, 1, 0, 1, no
4873507006,  Tyranosaure2, 1, 0, 1, no
20609404,  smarcopoulos, 1, 0, 1, no
705007777106804736,  salvotesta1978, 1, 0, 1, no
508562002,  Tamara_s_f_t, 1, 0, 1, no
246038998,  paulfuckinhell, 4, 0, 4, no
431168185,  danyrizza, 1, 0, 1, no
1955313932,  2000Stile, 2, 0, 2, no
482858620,  Stefano9259, 1, 0, 1, no
257859835,  a_zzurra, 2, 0, 2, no
2412665353,  mimmolacorazza, 1, 0, 1, no
1234449386,  refrefref22, 1, 0, 1, no
483297165,  ninopirri, 4, 0, 4, no
2347645222,  mllmrc84, 1, 0, 1, no
3081210317,  DurazzoC, 1, 0, 1, no
190696281,  donato_m, 1, 0, 1, no
4838631045,  MicheleLaRosa6, 1, 0, 1, no
800331406656217088,  rosario_cascio, 1, 0, 1, no
2162042326,  SalvatoreImper9, 1, 0, 1, no
3050191671,  12345Gennarino, 1, 0, 1, no
603634400,  fernandotornese, 1, 0, 1, no
1306718947,  15998667, 2, 0, 2, no
1548994123,  DeserioDe, 1, 0, 1, no
199444190,  Erminiog, 1, 0, 1, no
328750567,  ManuCorradini, 1, 0, 1, no
417294081,  MariaRTatullo, 1, 0, 1, no
2998520939,  Miki59Michele, 1, 0, 1, no
576568612,  MarioBraga6, 1, 0, 1, no
2419034826,  Claudia15861818, 1, 0, 1, no
2478737879,  MassimoMoggio, 2, 0, 2, no
462918342,  StefaTOno, 1, 0, 1, no
220330731,  Francopozza, 2, 0, 2, no
271477889,  aculnaig80, 1, 0, 1, no
2401317738,  Fu_s_er, 1, 0, 1, no
2610078732,  5stelletoscana, 1, 0, 1, no
2336674700,  RedMCristina, 1, 0, 1, no
3144219153,  Dino21808709, 1, 0, 1, no
4696278104,  diffancesco41, 1, 0, 1, no
3370370428,  MaxGiachetto, 1, 0, 1, no
419006507,  frans381, 1, 0, 1, no
4847345513,  antonellapepe_, 1, 0, 1, no
518856916,  Orrudamiano, 3, 0, 3, no
261879481,  simonaansani, 1, 0, 1, no
2480462256,  pizzi1974, 1, 0, 1, no
3841950443,  alvise68, 1, 0, 1, no
4885991987,  RovitiKatia, 1, 0, 1, no
789782675292815364,  PontederaM5S, 4, 0, 4, no
422085981,  federicci1, 1, 0, 1, no
969698706,  BorsatoGiuliano, 1, 0, 1, no
701270809,  konstantinosc12, 1, 0, 1, no
4580895461,  papalia_fabio, 1, 0, 1, no
2944718859,  MeccMichele, 1, 0, 1, no
2801714098,  mastracc56, 1, 0, 1, no
1039453975,  buciass, 1, 0, 1, no
1032573726,  MocelliGiovanni, 1, 0, 1, no
791632456784936960,  _Occhialissimi_, 1, 0, 1, no
3973068471,  TeoKardec, 1, 0, 1, no
97249537,  mobilethumb, 1, 0, 1, no
946546771,  extrahomnes, 1, 0, 1, no
1405256342,  GMarini0680, 1, 0, 1, no
2288431546,  vincenzinacarbo, 2, 0, 2, no
2905455231,  galliotello49, 1, 0, 1, no
1509825860,  baffone5stelle, 1, 0, 1, no
755915551910879236,  Luigi18119325, 2, 0, 2, no
3124933529,  toninoacquario, 2, 0, 2, no
709491817633472512,  XILOXATO, 1, 0, 1, no
470261387,  ferrini_nicola, 1, 0, 1, no
1264410564,  onAir74, 1, 0, 1, no
744620207365328897,  soffiodi_luce, 1, 0, 1, no
722824948482375680,  Gloriabianco201, 3, 0, 3, no
3482551995,  LaviniaBon1986, 3, 0, 3, no
1279924916,  lucianagarbugli, 2, 0, 2, no
2181217378,  66_mush, 1, 0, 1, no
4889189339,  LaCasaDelPonte, 1, 0, 1, no
1085580902,  FGiona, 1, 0, 1, no
759376363434471424,  Philippe55623, 1, 0, 1, no
424123129,  gancitano66, 1, 0, 1, no
213603186,  MatteoMeo, 2, 0, 2, no
3826564636,  swm175, 1, 0, 1, no
423785351,  MarinaRitzla, 1, 0, 1, no
4907545497,  Mandrogna, 1, 0, 1, no
313740683,  francescomioli, 1, 0, 1, no
129748089,  ririmazz, 1, 0, 1, no
755359,  marcobg, 1, 0, 1, no
220997167,  theparxman, 1, 0, 1, no
788384602960297984,  ArtilesDana, 1, 0, 1, no
1283090984,  AveryChasten, 1, 0, 1, no
182038243,  aer974, 1, 0, 1, no
786897273678598144,  emiliopapeete, 1, 0, 1, no
2888255921,  domenip, 1, 0, 1, no
246791045,  gae_pp, 1, 0, 1, no
234954139,  nunziodb, 1, 0, 1, no
2402307408,  pepmaio, 1, 0, 1, no
747461500546220032,  SaschaMazzini, 3, 0, 3, no
801338550671331329,  LucaPicariello3, 1, 0, 1, no
485608060,  AnBalestra, 1, 0, 1, no
791076407036215296,  MaicLebon, 2, 0, 2, no
1275120396,  GIORGIOFERLANTI, 1, 0, 1, no
703893580503511040,  Ciccio19662004, 1, 0, 1, no
4351104375,  Iz2Nzu, 1, 0, 1, no
452338676,  SandroTeodori, 1, 0, 1, no
633866067,  iacon3, 1, 0, 1, no
577082208,  antoine965, 1, 0, 1, no
938878644,  perticaraluca, 1, 0, 1, no
303267275,  irri65, 1, 0, 1, no
406857025,  ContuPaolo, 1, 0, 1, no
1502210575,  LandoriPaolo, 2, 0, 2, no
2882367318,  cianflone_luca, 1, 0, 1, no
470996274,  GiuseppeSpider, 1, 0, 1, no
974439270,  ale_milanes, 1, 0, 1, no
771886311062007808,  stelledellasera, 1, 0, 1, no
794271096543580160,  innopol65, 1, 0, 1, no
500882938,  Lantidiplomatic, 2, 0, 2, no
3477759437,  stephnapoli1, 1, 0, 1, no
2279159738,  nikoskanellopou, 1, 0, 1, no
611777238,  RobertoFantoni1, 7, 0, 7, no
695998919059361793,  GianniMurania, 1, 0, 1, no
743204949606174722,  chiaraenazauro, 1, 0, 1, no
2849577231,  AnnalisaCast, 2, 0, 2, no
808852884,  ninogiordi, 1, 0, 1, no
608366393,  lorenzogenchi1, 1, 0, 1, no
759827175360962560,  GiovannaGiovin2, 1, 0, 1, no
2446847762,  fugardiroberto, 1, 0, 1, no
788670895665610752,  FilippoAntonio9, 1, 0, 1, no
1650796159,  ulisse0001, 1, 0, 1, no
516743613,  IvyRoncon, 1, 0, 1, no
49639316,  umbertosulla, 1, 0, 1, no
3205107655,  AssuntinaMo67, 1, 0, 1, no
4769336596,  _ilpaolino, 1, 0, 1, no
555960810,  FBattel, 1, 0, 1, no
376101198,  giucav1964, 1, 0, 1, no
2879350949,  salvatorescog10, 1, 0, 1, no
515850471,  27lucale, 1, 0, 1, no
2919549233,  artemisia133, 1, 0, 1, no
1067613672,  DiscannoGia, 1, 0, 1, no
735004009296232448,  annaadriana108, 1, 0, 1, no
518803927,  da_ni2005, 1, 0, 1, no
2871351407,  MazzaraFluo, 1, 0, 1, no
618540945,  RobertoMerlino1, 1, 0, 1, no
423032766,  GiuseppeLimoli, 1, 0, 1, no
774757874304253953,  Formicaio1, 1, 0, 1, no
719608945418092544,  Giovacresce59, 1, 0, 1, no
419959672,  ALEADRIANI, 1, 0, 1, no
420078767,  sandruccio72, 1, 0, 1, no
3062283743,  PirroElisa, 1, 0, 1, no
4875964570,  efficienzaener1, 1, 0, 1, no
2363421477,  balmirra75, 1, 0, 1, no
4568121035,  RSpadafina, 1, 0, 1, no
880993466,  claudiorossi919, 1, 0, 1, no
217419880,  Gepe64, 1, 0, 1, no
837437688,  giomanuele1, 2, 0, 2, no
792682371673980928,  ArmandoVesuvio, 1, 0, 1, no
533252389,  FedericaChecchi, 1, 0, 1, no
848808390,  LorenzoMorlini, 1, 0, 1, no
701036352897474561,  turinic18891, 1, 0, 1, no
280959875,  vitalbaandrea, 2, 0, 2, no
577362844,  aghe74, 1, 0, 1, no
910266067,  EmilianusD, 5, 0, 5, no
787973235417686016,  Bobragosta, 2, 0, 2, no
2780166346,  MirellaTany, 1, 0, 1, no
753748221315473408,  serenafantini00, 1, 0, 1, no
1565597845,  nerone81, 1, 0, 1, no
302652032,  simuno23, 1, 0, 1, no
421184161,  AugustoCantelmi, 1, 0, 1, no
497175650,  ap_elle, 1, 0, 1, no
813738259,  fulviomartuscie, 1, 0, 1, no
2993943651,  giammauro95, 1, 0, 1, no
541523662,  rico74roma, 1, 0, 1, no
130616191,  PGatling, 1, 0, 1, no
56646271,  nonnageca, 1, 0, 1, no
2782537521,  AntonellaAte, 2, 0, 2, no
3028492330,  BarbaraMateraUe, 3, 0, 3, no
249220275,  guarinofrancesc, 1, 0, 1, no
493543780,  giovacalcagni, 1, 0, 1, no
2380603569,  BaiuncoM, 1, 0, 1, no
2464175796,  francoforesi11, 1, 0, 1, no
485205700,  l_serino, 1, 0, 1, no
279668112,  MauriBassa, 1, 0, 1, no
799758427308388352,  valentina_italy, 1, 0, 1, no
710018592494981120,  dnamarateacont1, 1, 0, 1, no
75994558,  marcocampione, 2, 0, 2, no
137030093,  guarinom, 1, 0, 1, no
1957352750,  alfonsodiiorio, 2, 0, 2, no
3071096152,  magianchi, 3, 0, 3, no
951586740,  GfBernazzani, 1, 0, 1, no
2412371535,  ChiesaRoch59, 1, 0, 1, no
390236998,  ciocca2003, 3, 0, 3, no
4235527991,  andymanca62, 1, 0, 1, no
798690218,  alessiofigoli, 1, 0, 1, no
1851677838,  Neo_atterre, 1, 0, 1, no
593495537,  Cogfil, 1, 0, 1, no
1148831466,  SERGIOFS1, 1, 0, 1, no
385413672,  umbertocrabbia, 2, 0, 2, no
267438204,  19francys79, 1, 0, 1, no
4877535244,  RosyMennell, 1, 0, 1, no
4016361339,  rmariact, 6, 0, 6, no
48274346,  francyst, 2, 0, 2, no
2441705471,  e_devita84, 1, 0, 1, no
264320070,  stefanomgr, 1, 0, 1, no
3326829687,  MeandMyself1968, 1, 0, 1, no
4229348392,  erguerrieri, 1, 0, 1, no
293096194,  CamilloRedaelli, 1, 0, 1, no
712625582723502080,  indignaziosRM, 3, 0, 3, no
4901807531,  lauradalfollo1, 3, 0, 3, no
471221488,  valentinoorfeo, 1, 0, 1, no
1095548834,  FILOTICOA, 1, 0, 1, no
752043232264085505,  ceinoc1, 1, 0, 1, no
410047799,  Cly2460, 7, 0, 7, no
51289966,  tizianaguerrucc, 10, 0, 10, no
500230476,  pontmaxx, 3, 0, 3, no
3041331885,  piccolorex79, 1, 0, 1, no
140966820,  Enriko82, 1, 0, 1, no
2587763006,  AngelaApostoli, 2, 0, 2, no
386810205,  RM_marco01, 2, 0, 2, no
4016845217,  lucasagran, 4, 0, 4, no
828880422,  SanNuvola, 1, 0, 1, no
1114525730,  marilenacarrisi, 1, 0, 1, no
744160048352497664,  giamilli, 1, 0, 1, no
2845934806,  aleffemartini, 1, 0, 1, no
517496971,  kettolandia, 1, 0, 1, no
378671125,  TeaCastiglione, 1, 0, 1, no
2921386997,  Valanakin, 1, 0, 1, no
3447717202,  bernypuffa, 2, 0, 2, no
790456782263054336,  ladyemmacucc, 1, 0, 1, no
3100181957,  Massimi20143712, 1, 0, 1, no
526919768,  __DaniOK, 1, 0, 1, no
3054053176,  piropepi, 1, 0, 1, no
767125761308389376,  _agostino2003_, 1, 0, 1, no
1891638931,  canny_99, 1, 0, 1, no
2353389346,  car_mirko, 2, 0, 2, no
3367928763,  Naruto4316, 1, 0, 1, no
1441836270,  admirehar, 1, 0, 1, no
757654248519860225,  INeedBenji, 1, 0, 1, no
3609848506,  federicasimeol1, 1, 0, 1, no
4174159642,  mary_dreamers, 1, 0, 1, no
705779961290948608,  rosafilannino, 1, 0, 1, no
4740052216,  youtubeitaliati, 2, 0, 2, no
550416702,  radio_zek, 1, 0, 1, no
769485711712083968,  set_wingedtrash, 1, 0, 1, no
797886760940355584,  francyj333, 1, 0, 1, no
760132107666587648,  sasycatauro, 1, 0, 1, no
4834898891,  Blasteem_mtc, 2, 0, 2, no
337122176,  MatteoPelusi, 1, 0, 1, no
1630346022,  benjishappiness, 1, 0, 1, no
1938400746,  FadelliGiulia, 1, 0, 1, no
418215630,  ValeBise, 1, 0, 1, no
4726516035,  _giusy_16, 1, 0, 1, no
764668857382477824,  AbateMarika02, 2, 0, 2, no
3087142229,  druvkzain, 2, 0, 2, no
2954741927,  Ariana_372, 1, 0, 1, no
2585077275,  Ale13ssia14, 2, 0, 2, no
2888355995,  16a00e51a0bd460, 1, 0, 1, no
2892417849,  jessica_masucci, 1, 0, 1, no
712690061616291840,  MayasDandN, 1, 0, 1, no
2922689037,  Lodomyalways, 1, 0, 1, no
3099809855,  fr_enr7que305, 1, 0, 1, no
405618183,  93ANDERVSON, 1, 0, 1, no
2823742011,  ManuelaConsolo, 1, 0, 1, no
177396194,  Thetoyboy86, 1, 0, 1, no
1715570095,  studiozambon, 1, 0, 1, no
756521237438926848,  ale26borre, 1, 0, 1, no
2949027568,  giada_tini, 1, 0, 1, no
3289979162,  Checkwsel, 1, 0, 1, no
787382344202260480,  giusisgu, 1, 0, 1, no
4791467655,  decarlihug_, 1, 0, 1, no
845764760,  erikapace1d, 2, 0, 2, no
1586357036,  GiadabL, 1, 0, 1, no
705762730410708992,  claires_11, 1, 0, 1, no
3804790043,  c4363d3b8ca0441, 1, 0, 1, no
786284020988579840,  lu_130516, 1, 0, 1, no
1620333764,  Enzuccio831, 1, 0, 1, no
754283001341763584,  Alessia___27, 2, 0, 2, no
3334699492,  piccolasasha99, 1, 0, 1, no
8486912,  funnyg, 1, 0, 1, no
2671150011,  gcapodacqua79, 1, 0, 1, no
746721628843819008,  mattebiselover, 1, 0, 1, no
4300561103,  AleMonzi05, 1, 0, 1, no
757853744851660800,  giulypuffarossi, 1, 0, 1, no
2494334149,  geracitano_rob, 3, 0, 3, no
1002437894,  frAnnyhs, 1, 0, 1, no
874278259,  Daniele_AL_, 2, 0, 2, no
712994593269219329,  elenamerlino01, 1, 0, 1, no
1927758452,  PayneHoran16, 1, 0, 1, no
587783553,  RobertaNapo_, 1, 0, 1, no
221131476,  anexplodedview, 2, 0, 2, no
2747678938,  agraziosi69, 1, 0, 1, no
2754859972,  chiany_meme17, 1, 0, 1, no
3520510275,  d3arfra, 1, 0, 1, no
773850968844795904,  _Syria_Mascolo_, 1, 0, 1, no
3716663013,  twilight_laura, 1, 0, 1, no
569197950,  MontanaroCiro, 1, 0, 1, no
1005878934,  gabrielebusso, 1, 0, 1, no
2758116250,  stefanocavagnol, 3, 0, 3, no
2508291052,  CavalliOttavio, 1, 0, 1, no
39608445,  Genefab, 3, 0, 3, no
481857687,  Donatello39, 1, 0, 1, no
90493962,  carlettab, 3, 0, 3, no
2569588048,  aguazzotto, 3, 0, 3, no
800652730058477568,  piani_lorenzo, 1, 0, 1, no
1535003959,  liberaeforte, 2, 0, 2, no
1080966086,  denisheaven, 1, 0, 1, no
703657320874647552,  Whitestorm01, 1, 0, 1, no
729339188,  clinicaben, 1, 0, 1, no
2301271656,  way2learnitalia, 1, 0, 1, no
421885466,  RobMordenti, 1, 0, 1, no
1170252949,  lori_vullo, 1, 0, 1, no
552156917,  DanyCaon, 1, 0, 1, no
1103968124,  FaustinaLovesK3, 1, 0, 1, no
2282228803,  LeoGarnet1, 1, 0, 1, no
1378946276,  s3rpe, 1, 0, 1, no
2802425242,  jagermeistaaahh, 1, 0, 1, no
426112597,  carcke, 1, 0, 1, no
377522292,  gaetanogi, 4, 0, 4, no
800073124402204672,  uovo_bluff, 1, 0, 1, no
2743416479,  domedele, 1, 0, 1, no
2869346830,  Lelleri, 1, 0, 1, no
877900650,  EstManuel, 1, 0, 1, no
747035862626668544,  CossoAnna, 3, 1, 2, no
140392732,  cukke, 1, 0, 1, no
772092626107457536,  ElioElio2709, 2, 0, 2, no
797536939280834560,  n0rdmerda, 1, 0, 1, no
510494062,  DomyLocos, 1, 0, 1, no
1053123146,  ali12345658, 1, 0, 1, no
388739839,  Lemillemila, 2, 0, 2, no
8017142,  davide_vernizzi, 2, 0, 2, no
405917731,  ClaudioPasqua, 1, 0, 1, no
1872270133,  Zoo3Dprinting, 1, 0, 1, no
1595499780,  Cami_Grandi, 1, 0, 1, no
2911136777,  __martinaa99__, 1, 0, 1, no
1107227606,  CGianoglio, 1, 0, 1, no
3067877405,  anitaemma20, 1, 0, 1, no
3250680004,  Albertobfc, 1, 0, 1, no
1216009520,  magnomiche, 3, 0, 3, no
363304621,  antoniovis1, 1, 0, 1, no
1345951099,  brugiova, 1, 0, 1, no
394085064,  S_Lor75, 1, 0, 1, no
1296276722,  GiantGiaimo, 1, 0, 1, no
1183376743,  dinapoliroberto, 1, 0, 1, no
1492293990,  boialadra, 1, 0, 1, no
85083790,  deusadapaz, 1, 0, 1, no
3147522502,  famila76, 1, 0, 1, no
299606922,  telepavia, 1, 0, 1, no
235204181,  FiammettaDV, 1, 0, 1, no
566888485,  FilippoFacci1, 4, 0, 4, no
2851118121,  FaraoneValent, 1, 0, 1, no
522078771,  cjmimun, 1, 0, 1, no
903853592,  PasqualeCiaccia, 9, 0, 9, no
729765344278122497,  Matteo_Maspero, 1, 0, 1, no
306318181,  Fara1_, 4, 0, 4, no
709125831512231936,  GabriellaSplen1, 1, 0, 1, no
1086500294,  StefanoGallus, 1, 0, 1, no
111990324,  frapla, 1, 0, 1, no
3067517889,  GiuseppinaMannu, 1, 0, 1, no
790857103544049664,  niccoeffe1, 1, 0, 1, no
247343955,  gfreeforever, 1, 0, 1, no
230170195,  Vale_Eva, 3, 0, 3, no
2868803500,  ClemensMarella, 2, 0, 2, no
3049978111,  gfraccastoro, 1, 0, 1, no
427734966,  bangandblame82, 1, 0, 1, no
1052521086,  CdegDe, 1, 0, 1, no
728905817194418176,  mazzaramau, 1, 0, 1, no
1104743840,  lazuddasa, 1, 0, 1, no
515332055,  casalex26, 1, 0, 1, no
42392050,  lucapennati, 3, 0, 3, no
75563024,  gbongiorno300, 1, 0, 1, no
286756094,  npanda96, 1, 0, 1, no
960086424,  capitandaddy, 1, 0, 1, no
566326933,  KarlPar78, 2, 0, 2, no
332864857,  GeppiC, 1, 0, 1, no
747907860777041920,  IoredanaSelce, 1, 0, 1, no
1852353606,  tourist_77, 1, 0, 1, no
2412895226,  simonabuonaiut1, 1, 0, 1, no
729615752752447490,  AltrenativaGo, 1, 0, 1, no
738731784859455488,  GraziosiAdriano, 1, 0, 1, no
103232978,  rosannalamalfa, 1, 0, 1, no
3992320834,  FigPesaroUrbino, 1, 0, 1, no
4551716415,  FIGiovaniFano, 1, 0, 1, no
4738062017,  SConfidenziale, 2, 0, 2, no
626096538,  GretasenzaGarbo, 1, 0, 1, no
130240930,  andpellegrino, 3, 1, 2, no
800329779710808064,  IvanBunin_, 1, 0, 1, no
2982653979,  guadavitt, 1, 0, 1, no
497279830,  ldigiov, 1, 0, 1, no
713107266552139776,  designer_italy, 1, 0, 1, no
231036993,  mondobalneare, 1, 0, 1, no
792183529442516992,  scopofobico, 1, 0, 1, no
851768600,  tommasocastoldi, 1, 0, 1, no
254154874,  MarcelloConc, 2, 0, 2, no
529261734,  DomeDellaValle, 1, 0, 1, no
257490569,  valemy77, 1, 0, 1, no
96228101,  GhostdogRunner, 1, 0, 1, no
1229384556,  d_ercolani, 1, 0, 1, no
618868174,  ZuccaOscar, 1, 0, 1, no
1813344996,  pgiusy135, 1, 0, 1, no
1637888420,  PietroJoser, 1, 0, 1, no
772125245796970496,  liviozeta67, 5, 1, 4, no
1876984472,  antonellodz, 1, 0, 1, no
706434058016976896,  donald_love40, 1, 0, 1, no
2614353244,  ccgc_claudio, 1, 0, 1, no
94183480,  Renatambu, 2, 0, 2, no
902483371,  elenafutura_, 2, 0, 2, no
995160108,  ficsal, 1, 0, 1, no
1189154994,  Nico__Ber, 1, 0, 1, no
3075547941,  AlessCasano, 2, 0, 2, no
730081615804796928,  6difirenzese, 1, 0, 1, no
474822588,  sruz1977, 1, 0, 1, no
461292685,  gierre1984, 1, 0, 1, no
70728608,  Aldighieri, 1, 0, 1, no
705356388,  2STRONZ4U, 1, 0, 1, no
3154358021,  luca_siligato, 1, 0, 1, no
3840572321,  Heddymordicus, 1, 0, 1, no
286264929,  alfredo1883, 2, 0, 2, no
702171804417323011,  AN_EURTORRINO, 2, 0, 2, no
1100813652,  CrcXmGA, 2, 0, 2, no
803582666411048960,  rossellaberti1, 1, 0, 1, no
4147056975,  An_AzNazionale, 2, 0, 2, no
515310308,  FOrsomarso, 2, 0, 2, no
732559986778374144,  airone333, 1, 0, 1, no
729339570182066177,  peeyonkou, 1, 0, 1, no
2731631416,  BarbaraDamelia, 2, 0, 2, no
415083378,  EmanueleSalvo, 1, 0, 1, no
226511693,  otuscops, 2, 0, 2, no
302648075,  SiMancinelli, 1, 0, 1, no
2292329137,  DartSirius, 2, 0, 2, no
724723402968276992,  Co94819547Costa, 1, 0, 1, no
879974216,  francoisengo, 2, 0, 2, no
212962983,  marconati1971, 2, 0, 2, no
28793945,  MassimoBozza, 1, 0, 1, no
564876371,  giuliaciapparon, 2, 0, 2, no
826642668,  LiaStaropoli, 1, 0, 1, no
798109389928431616,  domenic_moretta, 1, 0, 1, no
3994936216,  dangipiro, 1, 0, 1, no
503847121,  pinotocco, 1, 0, 1, no
2289671119,  mirazef, 1, 0, 1, no
4805442333,  Giovannetti_E, 2, 0, 2, no
3193843480,  POPEisPOP, 1, 0, 1, no
62004025,  callimaco74, 7, 0, 7, no
161765309,  antobel73, 1, 0, 1, no
1106034919,  Amghelo, 1, 0, 1, no
2321245704,  marinopst, 1, 0, 1, no
2185783204,  Sarottola_, 14, 0, 14, no
8733352,  seaan, 1, 0, 1, no
16698143,  daniloausiello, 1, 0, 1, no
709809875002507266,  silvana_toni, 6, 0, 6, no
34616768,  egostino, 2, 0, 2, no
795345196665946113,  arabo_fenice, 2, 0, 2, no
558377336,  alegab77, 1, 0, 1, no
168123547,  iNebux, 1, 0, 1, no
3884255603,  soarez1611, 1, 0, 1, no
4530088653,  ales_carr, 1, 0, 1, no
402881758,  cdellaciana, 2, 0, 2, no
272463673,  ortensiotomaino, 1, 0, 1, no
3425468613,  GraziaRegina, 1, 0, 1, no
1360084927,  paolanegr, 1, 0, 1, no
557549753,  sil_toff, 1, 0, 1, no
3050446159,  LMossal, 1, 0, 1, no
362049613,  albanselmi, 1, 0, 1, no
1336847760,  cironoja, 1, 0, 1, no
282268099,  Lory_novabbe, 1, 0, 1, no
2152793202,  hounnickname, 1, 0, 1, no
425360041,  mauroconsolo, 1, 0, 1, no
1389693396,  FabioAnastasia, 2, 0, 2, no
4068347902,  squit1993, 1, 0, 1, no
1734368941,  annanastibella, 1, 0, 1, no
368886611,  Ginger_UgoQZ, 1, 0, 1, no
1467331304,  g92005957, 1, 0, 1, no
279935305,  raffaele1947, 1, 0, 1, no
384851495,  StefanoCisale, 1, 0, 1, no
1846097041,  cristinatassin1, 1, 0, 1, no
957079213,  emiliocaggiano, 1, 0, 1, no
155687352,  tonipute, 1, 0, 1, no
598416940,  MauroMaraschin1, 1, 0, 1, no
361503963,  Fabio_Munafo, 1, 0, 1, no
466809826,  bortolotti52, 1, 0, 1, no
36469575,  _GianLuca_, 2, 0, 2, no
2450182814,  Andreina_Ulissi, 1, 0, 1, no
3369328163,  d492bc175717491, 1, 0, 1, no
1098619812,  DegrassiG, 2, 0, 2, no
2787707316,  GioveGino, 3, 0, 3, no
4909784507,  MarziaDall, 1, 0, 1, no
3959313952,  PiacenzaCgil, 1, 0, 1, no
290174323,  ilBizza, 1, 0, 1, no
891569430,  CiroManigrasso, 3, 0, 3, no
2884046195,  silvian352, 2, 0, 2, no
781443342798381056,  DemXilNo, 3, 0, 3, no
390139303,  ArciNazionale, 4, 0, 4, no
218995078,  jkanzir, 1, 0, 1, no
1215945505,  mauroloconsolo, 1, 0, 1, no
1122457656,  DCambi, 1, 0, 1, no
400825181,  leonardomellon1, 1, 0, 1, no
1242095941,  cavallaromari, 1, 0, 1, no
70695596,  faberlaser, 1, 0, 1, no
2188896114,  Sara_Beatrix, 1, 0, 1, no
884174870,  PRCAsti, 1, 0, 1, no
799916451134132225,  ROBERDAN38, 1, 0, 1, no
3053325887,  CgilImola, 2, 0, 2, no
1241582108,  CgilFerrara, 1, 0, 1, no
1377069744,  maurizzi_mau, 2, 0, 2, no
485594129,  CGILParma, 3, 0, 3, no
553752390,  mirto_bassoli, 4, 1, 3, no
272887017,  chiaraorgantini, 1, 0, 1, no
477713777,  maggiore71, 1, 0, 1, no
232575488,  cigna69, 1, 0, 1, no
2464540421,  Cricrimilano, 1, 0, 1, no
507378569,  giacmoraGiacomo, 2, 0, 2, no
140378824,  alevacca, 1, 0, 1, no
344620401,  chiaracance, 1, 0, 1, no
261804112,  luvarras, 2, 0, 2, no
1632804410,  NewsExpoMi2015, 1, 0, 1, no
531461308,  LucaFer76, 1, 0, 1, no
200866509,  scarabellimauro, 1, 0, 1, no
3005974641,  vincenzoconsol2, 1, 0, 1, no
1522966285,  Minam54, 1, 0, 1, no
1180049252,  AndreaBozio, 1, 0, 1, no
621953244,  TaguidaSan, 1, 0, 1, no
201876604,  gianlucamancini, 1, 0, 1, no
1696330177,  MuccioliniG, 3, 0, 3, no
561476720,  LpBlanc, 1, 0, 1, no
3342101075,  Prima_In, 1, 0, 1, no
593681019,  graziarossi4, 1, 0, 1, no
4213069258,  ciotolina2004, 1, 0, 1, no
487899058,  santangelo_s, 2, 0, 2, no
596551434,  alesansoni, 1, 0, 1, no
582189209,  Erato2dot0, 1, 0, 1, no
4839799744,  francesca__m88, 1, 0, 1, no
1033618758,  angelo_bri, 1, 0, 1, no
567115810,  Marcello_FRB, 1, 0, 1, no
761965418395336704,  cavarra32, 1, 0, 1, no
757373697741185024,  LucaForti11, 1, 0, 1, no
340215261,  RenatKuenzi, 1, 0, 1, no
284487337,  democracy_intl, 1, 0, 1, no
2244603493,  people2power, 1, 0, 1, no
1346996612,  darioconte66, 3, 1, 2, no
385897719,  cesarebrogi1, 2, 0, 2, no
1441673010,  mad_astronaut, 1, 0, 1, no
712308565541855234,  Luce_Roma, 7, 0, 7, no
80690245,  medeoTL, 6, 1, 5, no
61435918,  FredianoFinucci, 2, 0, 2, no
2346535719,  lo_sparviero, 1, 0, 1, no
226995153,  FrancescaNevis, 2, 0, 2, no
770604000676835328,  B_R_1977, 1, 0, 1, no
1447030830,  gabrielemarch10, 3, 0, 3, no
2489675953,  Fra_Cass94, 3, 1, 2, no
123018601,  carlinohugo, 3, 1, 2, no
72541442,  KarenNahum, 1, 0, 1, no
617158024,  Iilwlng, 1, 0, 1, no
615845701,  R68Shaun, 1, 0, 1, no
2478094665,  corinamariex7, 1, 0, 1, no
1039580413,  zenazena67, 1, 0, 1, no
1498494175,  uuhumax, 2, 0, 2, no
1146101496,  alealexse, 2, 0, 2, no
905577096,  iostoconCOMI, 1, 0, 1, no
1487727384,  newsfrae, 2, 0, 2, no
961108988,  calrogiBG, 2, 0, 2, no
1598493312,  trullinet, 2, 0, 2, no
102114992,  paciolina, 1, 0, 1, no
199790331,  andrea091967, 1, 0, 1, no
448754383,  brunomeduri, 1, 0, 1, no
601316915,  bagnolina, 1, 0, 1, no
174978820,  rosannarizzi, 1, 0, 1, no
2955233225,  ALisimberti, 1, 0, 1, no
1397960005,  _girando, 1, 0, 1, no
712638482569625600,  Ninoc12, 8, 1, 7, no
14170643,  Vaccaro_G, 1, 0, 1, no
157917956,  PietroGalati, 1, 0, 1, no
433232662,  sabrinamassaro, 1, 0, 1, no
99807484,  felicebalsamo, 1, 0, 1, no
227412044,  GINOANTONACCI, 2, 0, 2, no
103823672,  PGDL, 1, 0, 1, no
751595845,  Aomidn6019, 3, 0, 3, no
330327779,  Luer_1o4, 1, 0, 1, no
3093857141,  noscaricoamare, 1, 0, 1, no
1610183600,  Betazoide, 3, 0, 3, no
3291544978,  danielecorrao66, 1, 0, 1, no
2163607505,  darioshaula, 1, 0, 1, no
394562705,  GiacomoZanna, 1, 0, 1, no
2970293500,  53_lone, 1, 0, 1, no
1089705342,  ManigrassoG, 1, 0, 1, no
391946870,  rossellinaohara, 1, 0, 1, no
406472403,  MaurizioMichele, 1, 0, 1, no
45861942,  LucaSucci, 1, 0, 1, no
415750859,  ccclacar, 1, 0, 1, no
415039798,  alcibiade68, 1, 0, 1, no
4698860869,  SydraKleps, 1, 0, 1, no
313813349,  CosimoMicelli, 1, 0, 1, no
4156848515,  Mariang61340356, 3, 1, 2, no
1538750090,  KompagnaTeresa, 1, 0, 1, no
3126643192,  george_walker68, 1, 0, 1, no
2766402312,  ConzaEmilio, 1, 0, 1, no
3117680235,  loreto_lu, 1, 0, 1, no
46346704,  g4l1l30, 1, 0, 1, no
3189709065,  PaesArchLetizia, 1, 0, 1, no
472013122,  francometta, 1, 0, 1, no
456713204,  atoiitoa, 2, 0, 2, no
801365046597132289,  AnzhelikaTyur, 1, 0, 1, no
394014388,  MariaApossamai, 2, 0, 2, no
450846026,  ivanapittella, 2, 0, 2, no
1747178024,  cla217, 2, 0, 2, no
441556239,  konomoronao, 1, 0, 1, no
291729417,  GMilanese, 1, 0, 1, no
1460529026,  maryuanna79, 1, 0, 1, no
2157207460,  ZeroGaia, 1, 0, 1, no
4872878914,  VMG_volpe, 1, 0, 1, no
244546028,  saromica, 1, 0, 1, no
193642197,  maurobertoTO, 1, 0, 1, no
398134246,  lumi_eventos, 2, 0, 2, no
199087253,  Siralexsantese, 1, 0, 1, no
479551600,  Mariaritamara, 1, 0, 1, no
479713128,  bertani_sandra, 1, 0, 1, no
53059344,  ferdilarizza, 1, 0, 1, no
738135001347153924,  Antovi171, 1, 0, 1, no
3190082914,  decimomeridio67, 2, 0, 2, no
1007124930,  annamattii, 1, 0, 1, no
406856918,  GiusMAZZINI, 2, 0, 2, no
3828401872,  LTByronoriginal, 2, 0, 2, no
869801606,  Imprimaturedito, 3, 0, 3, no
793591515796934657,  yperdiving, 1, 0, 1, no
409817475,  claudiachelli, 2, 0, 2, no
978708510,  ombraeffe, 1, 0, 1, no
379022377,  EnzoCalabr, 1, 0, 1, no
1034710201,  LaFemministica, 1, 0, 1, no
387056404,  StoglJr, 1, 0, 1, no
781133589245198336,  LeonardoDanaro, 1, 0, 1, no
1340154259,  Marria13Maria, 1, 0, 1, no
771759671401181184,  ilmaltesediprat, 1, 0, 1, no
389974442,  stornaiolo, 1, 0, 1, no
2537281228,  donatellapolign, 1, 0, 1, no
2728490969,  mariagraziapet6, 1, 0, 1, no
564794492,  occhiverdiii, 1, 0, 1, no
2940913042,  ACiabocco, 1, 0, 1, no
2372271426,  Lamary4ever, 1, 0, 1, no
555195153,  FrancescaCiura, 1, 0, 1, no
1315046245,  TuriFilippo, 2, 0, 2, no
1090448503,  farfallarrubia, 2, 0, 2, no
1134644042,  Andrput, 4, 0, 4, no
801838832102547456,  Palato_Beato, 1, 0, 1, no
340928644,  LeoAbascia, 1, 0, 1, no
519318638,  torepaola, 3, 0, 3, no
524284548,  AldoCannoletta, 1, 0, 1, no
1196316816,  SerraVitaliano, 1, 0, 1, no
3307979603,  Deb44848748, 5, 0, 5, no
2532904492,  gianni_liviano, 1, 0, 1, no
546646837,  AdaElmini, 4, 0, 4, no
469826948,  ElisaGalletto, 3, 0, 3, no
782497924232142849,  gnometta84, 1, 0, 1, no
1300968402,  gm_marilena, 1, 0, 1, no
306997738,  LeenaMey, 1, 0, 1, no
273360215,  IsabellaBolo, 1, 0, 1, no
397556913,  vincenzopompeo, 2, 0, 2, no
1236246583,  giomasmic, 1, 0, 1, no
4209276022,  SimoneBottalico, 1, 0, 1, no
328022080,  LibertyAnna, 2, 0, 2, no
798813634432372736,  SostieneCafo, 1, 0, 1, no
724617007379931137,  86valentieg, 1, 0, 1, no
780816250066743297,  TSN_49, 1, 0, 1, no
799879122126336000,  talalaxinaggal, 1, 0, 1, no
800746715133284352,  Evucka65, 1, 0, 1, no
3246905050,  andreacapo1977, 1, 0, 1, no
1014034080,  GloriaNegramaro, 1, 0, 1, no
1606661,  beppecolonna, 1, 0, 1, no
1491103976,  Eikpard, 1, 0, 1, no
527179601,  paolarogora, 1, 0, 1, no
491417328,  umbertodott, 1, 0, 1, no
309083041,  gabri1903, 2, 0, 2, no
56460480,  vikingo2300, 1, 0, 1, no
291605081,  Nicholaus_it, 1, 0, 1, no
277951072,  CarloneMario, 1, 0, 1, no
443594304,  richimattei, 1, 0, 1, no
771429034504880128,  botteguccia16, 1, 0, 1, no
3259953670,  lucani2019, 1, 0, 1, no
252185251,  ilGuaro, 1, 0, 1, no
2327790560,  AnnamSignorile, 1, 0, 1, no
406126168,  MarellaRuta, 1, 0, 1, no
96104745,  santosalfi, 1, 0, 1, no
8709042,  Uncino, 1, 0, 1, no
3030336508,  GuareschiMarzia, 1, 0, 1, no
2206875744,  ClodiaTaras, 1, 0, 1, no
133076985,  nikbolik, 1, 0, 1, no
421273974,  albgiuseppe1, 1, 0, 1, no
534231650,  gidasarn, 1, 0, 1, no
1559842459,  no_tap, 1, 0, 1, no
1311830046,  PattyAshepit, 1, 0, 1, no
1731664436,  Basilicatamigl, 1, 0, 1, no
522445957,  ParcoGargano, 2, 0, 2, no
778503955,  danielecorradi7, 1, 0, 1, no
98188333,  D_Cassatella, 1, 0, 1, no
1198293565,  PEPPELICATA72, 6, 0, 6, no
765979700808286208,  guyfawkes2_0, 1, 0, 1, no
1178473466,  oldares, 1, 0, 1, no
316972451,  NicolaDiMare, 3, 0, 3, no
805199157627654144,  musicamare1, 1, 0, 1, no
143755904,  tittipati, 1, 0, 1, no
4069067369,  DeadzoneIrwing, 2, 0, 2, no
784980281266765824,  PhiBee7, 1, 0, 1, no
1246122157,  donatocassano1, 2, 0, 2, no
1229409494,  pepilottame, 2, 0, 2, no
105902569,  numshub, 1, 0, 1, no
2312306342,  AzioneCivileTV, 1, 0, 1, no
794231200269434880,  Vito10091960, 2, 0, 2, no
1533314910,  Emilioluccarell, 1, 0, 1, no
796796303103639553,  mariagrazia1154, 1, 0, 1, no
394641871,  malbensi, 1, 0, 1, no
407082246,  flaviosqu, 1, 0, 1, no
3241562675,  RicciatoM, 1, 0, 1, no
59872650,  Uvaozio, 1, 0, 1, no
2971867924,  cappellifranco, 2, 0, 2, no
787723562010435584,  ingfragomeni, 1, 0, 1, no
800315432569749504,  tizietta69, 1, 0, 1, no
784727821990105088,  antonio91486165, 1, 0, 1, no
14082257,  greatpinkflower, 1, 0, 1, no
408620732,  diego_mancino, 3, 0, 3, no
560156137,  geomaicol, 2, 0, 2, no
449922265,  roccomartorana, 1, 0, 1, no
4319356877,  utolupi, 1, 0, 1, no
279018654,  giemmess, 1, 0, 1, no
1385518470,  SqualoGG, 2, 0, 2, no
2525968290,  adriobonomi, 1, 0, 1, no
517974089,  NapoliRaf, 2, 0, 2, no
1176954972,  NMangiacotti, 1, 0, 1, no
2919730121,  giovannibuono78, 1, 0, 1, no
4244938137,  aureolo2015, 1, 0, 1, no
1339442802,  AnnaCurci2, 1, 0, 1, no
1026513577,  Magari_Mori, 1, 0, 1, no
2346832778,  GabrieleEliaCsm, 1, 0, 1, no
1423857721,  FedericoBauMici, 2, 0, 2, no
132129411,  lelemubble, 1, 0, 1, no
884658194,  DavideLeonardi1, 1, 0, 1, no
2464385681,  Nicoladesilla, 1, 0, 1, no
47756372,  mgmaglie, 1, 0, 1, no
734805955985182720,  GrandeRufus, 1, 0, 1, no
334820496,  ibrbi, 1, 0, 1, no
796492542212767744,  SandroEramo, 1, 0, 1, no
789044728604061696,  FootwBall, 1, 0, 1, no
135862050,  IoSonoGianni, 1, 0, 1, no
1399140884,  domenicocuzzi, 1, 0, 1, no
472783137,  Giu_Gigliotti, 1, 0, 1, no
528642432,  nakys69, 2, 0, 2, no
805604343437291520,  giesepsoni1989, 1, 0, 1, no
703341653042601985,  Dubitoso, 2, 0, 2, no
1427377284,  ingiroxilmond0, 1, 0, 1, no
600483745,  LucianaPatrizia, 1, 0, 1, no
292271013,  PBonfigli, 1, 0, 1, no
1039127888,  stortora71, 1, 0, 1, no
385864055,  iwishtoberain, 2, 0, 2, no
2851502757,  massbini48, 1, 0, 1, no
297936044,  cagnuol, 2, 0, 2, no
3143527192,  figiovanimodena, 1, 0, 1, no
3065026630,  Pomp_c, 1, 0, 1, no
2306080108,  amcalexcap, 2, 0, 2, no
510685928,  ulba60, 1, 0, 1, no
397573326,  MarioScelzo1, 2, 0, 2, no
3384830219,  piccioni77, 1, 0, 1, no
2848115296,  Giustinianorex, 1, 0, 1, no
4243840054,  angela_iuliano, 1, 0, 1, no
2367112236,  olivozilio, 1, 0, 1, no
3259523579,  elisalalisa81, 1, 0, 1, no
138130394,  Tenkojak, 1, 0, 1, no
250667812,  bifedelomo, 1, 0, 1, no
3154530838,  giuli_valle, 3, 0, 3, no
480364996,  maurisa9, 1, 0, 1, no
708930840,  Massimodalcerro, 3, 0, 3, no
139743146,  mauriziozingoni, 1, 0, 1, no
1041890317,  Arman11Stefano, 1, 0, 1, no
395502958,  Marco_IlBudda, 1, 0, 1, no
463765364,  ClaudiaMancina, 1, 0, 1, no
781879938832068609,  AlbertiF81, 1, 0, 1, no
3353515834,  DanielaLongo25, 1, 0, 1, no
2609374654,  palumbo_emilio, 1, 0, 1, no
540763968,  Dischivolanti, 1, 0, 1, no
372777532,  giorgiozanchini, 1, 0, 1, no
96959346,  fguglieri, 1, 0, 1, no
600355032,  MarioBottosso, 1, 0, 1, no
2314569539,  maurizippo, 1, 0, 1, no
2262678820,  LoZerbino, 1, 0, 1, no
343895398,  MassimoBordin, 1, 0, 1, no
2221607530,  claudiocaruso77, 1, 0, 1, no
622808643,  luca_manz, 1, 0, 1, no
112764192,  stefaniamore65, 1, 0, 1, no
342206151,  Marco5Francia, 1, 0, 1, no
143852894,  SimoneBertu, 1, 0, 1, no
73057018,  cratete, 1, 0, 1, no
491634712,  annavigato, 1, 0, 1, no
4111041477,  annacastingtv12, 2, 0, 2, no
122695396,  lbrazzoli, 1, 0, 1, no
1384398409,  zf1964, 1, 0, 1, no
2230570336,  LenziniSonia, 1, 0, 1, no
3352855515,  bigiobigino, 1, 0, 1, no
455176265,  FrancoGgf, 1, 0, 1, no
66499939,  monterozunino, 1, 0, 1, no
518136723,  ciprycanovi, 1, 0, 1, no
490701564,  zeuxilverPA, 2, 0, 2, no
4832445695,  GRestaneo, 1, 0, 1, no
60866593,  adepatri, 1, 0, 1, no
793361599230861312,  DarioCorinto, 1, 0, 1, no
876503191,  AnnaFedele001, 1, 0, 1, no
1245745776,  marcellogorda, 2, 0, 2, no
1043151836,  alfredina7, 1, 0, 1, no
4605549200,  MatthewHrenak, 1, 0, 1, no
181206968,  alpibiancheit, 1, 0, 1, no
53198326,  carbonedg, 1, 0, 1, no
2335113854,  cecchirina, 2, 0, 2, no
203699702,  vitocontardo, 1, 0, 1, no
3279653075,  Gennaro68630820, 2, 0, 2, no
3336362219,  WLAPALERMO, 1, 0, 1, no
4827614413,  LaCla74, 1, 0, 1, no
776436951322943488,  pistillofilome1, 2, 0, 2, no
143900324,  peterzana, 1, 0, 1, no
1036825519,  leo_ster, 1, 0, 1, no
499807931,  gio_pellizzeri, 1, 0, 1, no
756552513483046912,  daniela_musina, 1, 0, 1, no
4156164196,  Piodaceto, 1, 0, 1, no
556033944,  dilcinico, 1, 0, 1, no
365514359,  Francemazza, 1, 0, 1, no
81829188,  gian_dal, 1, 0, 1, no
1037365346,  ComesIgnacio, 1, 0, 1, no
71005866,  frabiagiotti, 1, 0, 1, no
2322403651,  capojack67, 1, 0, 1, no
446607792,  LocatelliSte, 1, 0, 1, no
803947078590361601,  powergp2, 2, 0, 2, no
2582802381,  tizianateodosio, 1, 0, 1, no
498017973,  BoreaPaolo, 1, 0, 1, no
66473460,  Reddo_it, 1, 0, 1, no
10912362,  warkoholic, 1, 0, 1, no
349304660,  Olshany, 1, 0, 1, no
388341126,  GiuseppePasin, 1, 0, 1, no
3431444549,  TEnjeux, 1, 0, 1, no
269534239,  GMT_90, 1, 0, 1, no
1218997844,  Camille_fm, 1, 0, 1, no
39966411,  lucamoriconi, 2, 0, 2, no
346068070,  MarisaPancrazia, 1, 0, 1, no
2191180106,  Toremon50, 1, 0, 1, no
400663563,  dile_diletta, 1, 0, 1, no
71360623,  sirLac, 1, 0, 1, no
406130029,  carprato72, 1, 0, 1, no
382463247,  MarioRiccardiJr, 1, 0, 1, no
3479422576,  MikT18, 2, 0, 2, no
425880617,  andrea_natoli, 1, 0, 1, no
50574247,  gerrox, 1, 0, 1, no
365042365,  Mancuso_Mario, 1, 0, 1, no
1653121038,  NunzioParaggio, 1, 0, 1, no
546214663,  luccy8, 1, 0, 1, no
2541629306,  SabrinaGBernard, 1, 0, 1, no
405538337,  gigliolacaridi, 1, 0, 1, no
900175562,  VSerasin, 1, 0, 1, no
1341730716,  GiuliettaVanni, 2, 0, 2, no
191491710,  Sasycascone, 1, 0, 1, no
404650482,  alesmaffei, 1, 0, 1, no
167613639,  Filoreba, 1, 0, 1, no
760831854987583489,  ComitatoNOlomb, 1, 0, 1, no
803945815546925056,  ModaCfina, 2, 0, 2, no
2565231604,  MariaritaPolic1, 1, 0, 1, no
744169355806646276,  czritz80, 1, 0, 1, no
2986015264,  clama0912, 1, 0, 1, no
3053190841,  MrJean0, 1, 0, 1, no
55046674,  StephenDog, 1, 0, 1, no
4839452781,  PHJams, 1, 0, 1, no
745953463339737089,  sheep_floyd, 1, 0, 1, no
484617036,  kataroc, 1, 0, 1, no
2360804453,  gabriellacino, 2, 0, 2, no
2536585871,  Fabio_Cala, 2, 0, 2, no
506321342,  CorradiniLidia, 1, 0, 1, no
784082079877308417,  larawines, 2, 0, 2, no
106548241,  MarioFurore, 2, 0, 2, no
2978182583,  avanpostit, 2, 0, 2, no
3424014040,  48b59ce8215f418, 1, 0, 1, no
4236725416,  MaurizioCasu1, 1, 0, 1, no
121500784,  Viviana_cdl, 1, 0, 1, no
4080263177,  CosimocsS, 1, 0, 1, no
64025076,  roscura, 1, 0, 1, no
2282549490,  grecben, 1, 0, 1, no
844437781,  SaraBianchiHp, 1, 0, 1, no
428341973,  AngeloZaza, 1, 0, 1, no
1267171424,  Eposmail, 3, 0, 3, no
1585539301,  _platia, 1, 0, 1, no
891059384,  Dwalingen, 1, 0, 1, no
2585808948,  oude_lap, 1, 0, 1, no
786172092827914240,  adrianacacciop4, 3, 0, 3, no
753584798187257856,  gmrcmrg, 1, 0, 1, no
58211648,  AstioCiarlatani, 2, 0, 2, no
2394836599,  al_vicentini, 2, 0, 2, no
464076139,  SandraCasini, 1, 0, 1, no
376691595,  PaoloCaminiti1, 3, 0, 3, no
367231920,  anastasiamadam, 1, 0, 1, no
489243124,  gabrigiaci, 1, 0, 1, no
704446219079303169,  gmslongo, 7, 0, 7, no
2326687558,  Logyc0, 2, 0, 2, no
3053146135,  kurston__childs, 1, 0, 1, no
2359470090,  Muz_Riccardo, 1, 0, 1, no
2443995940,  dyam0n, 2, 0, 2, no
18899481,  wawos, 1, 0, 1, no
52738973,  sam71it, 2, 0, 2, no
4396381822,  Cloes86, 1, 0, 1, no
112266583,  ChiaraMaria1, 1, 0, 1, no
2223643491,  ctognoni69, 3, 1, 2, no
827285665,  raffidecar, 1, 0, 1, no
1247496404,  francacec, 2, 0, 2, no
3065888662,  slmplylovebook, 1, 0, 1, no
3053073007,  DamnImHands0m, 1, 0, 1, no
3298383251,  paravanie, 2, 0, 2, no
431517647,  CasanovaGabri, 1, 0, 1, no
558012025,  Aprile5404, 1, 0, 1, no
1355065410,  elviraqelly, 1, 0, 1, no
3363741953,  clacam52, 2, 0, 2, no
95899146,  alemichetti, 1, 0, 1, no
434839311,  antonioleotti1, 1, 0, 1, no
4830038927,  MariadelGaudio3, 1, 0, 1, no
453357659,  GianmarioNardi, 2, 0, 2, no
911236676,  JacopoFranchi87, 1, 0, 1, no
22604733,  gpiroddi, 1, 0, 1, no
702219779,  delfyn0, 3, 0, 3, no
148323458,  Toscanoirrivere, 1, 0, 1, no
15167463,  andrea_ciulu, 1, 0, 1, no
33464175,  escapista, 1, 0, 1, no
3881560054,  OrnellaGianni, 2, 0, 2, no
1069299457,  LauraArtt, 2, 0, 2, no
147669550,  stedubla, 2, 0, 2, no
2884205577,  marco_minari, 1, 0, 1, no
752617567,  FabrizioRho, 1, 0, 1, no
2394173556,  Vincenza81, 3, 0, 3, no
18483428,  giuseppecarlino, 3, 0, 3, no
3287666158,  ritabianco27750, 1, 0, 1, no
273466314,  hermzec, 1, 0, 1, no
1015915699,  prevoyancemusic, 1, 0, 1, no
485940959,  StefaniaRibaldi, 1, 0, 1, no
302157714,  emilio_longhi, 1, 0, 1, no
225535128,  ACTavecchio, 1, 0, 1, no
367192807,  PeterCiaccio1, 1, 0, 1, no
44423232,  Minimaki, 2, 0, 2, no
2562811728,  fillese, 1, 0, 1, no
779998996509102080,  Jovamd, 2, 0, 2, no
17674830,  Luigi57, 4, 0, 4, no
721639933199433728,  FDC_64, 1, 0, 1, no
460064675,  epizeusi, 1, 0, 1, no
391247874,  scaradozzis, 1, 0, 1, no
485629253,  GiamFalasca, 1, 0, 1, no
1657179714,  AngeloInfoposta, 1, 0, 1, no
3344737672,  MichelVietto, 1, 0, 1, no
427374134,  GennaroIaccari1, 1, 0, 1, no
2980810769,  KainaPi, 1, 0, 1, no
108700808,  nialltalk, 1, 0, 1, no
416890492,  Spinmads, 1, 0, 1, no
2611246133,  LeoPampana, 1, 0, 1, no
3601983563,  travellerino, 2, 0, 2, no
19358428,  Fondano, 1, 0, 1, no
630177246,  NCenti, 1, 0, 1, no
753715333173747712,  Martinaitaliana, 1, 0, 1, no
2317453454,  DanielP26616851, 1, 0, 1, no
483957067,  IperDave, 1, 0, 1, no
204858193,  totofalzo, 2, 0, 2, no
2844869322,  DreamescapePs, 2, 0, 2, no
44903309,  funkyoulow, 2, 0, 2, no
111141801,  lucameoli, 2, 0, 2, no
484771907,  lucianocapone, 6, 0, 6, no
111544472,  ziopippi, 1, 0, 1, no
27406951,  anto_giordano, 2, 0, 2, no
1007509333,  CongiuRita, 1, 0, 1, no
485060948,  RobertoSeri, 1, 0, 1, no
2414699069,  m_spagna, 1, 0, 1, no
469539285,  daffi15, 1, 0, 1, no
2492501665,  NoJobFactor, 1, 0, 1, no
2893850735,  me_musu, 1, 0, 1, no
1067991134,  FranciscoBaston, 6, 2, 4, no
237526834,  baronePino, 2, 0, 2, no
752768895031934977,  moraxestate, 2, 0, 2, no
3230638600,  leti1848, 1, 0, 1, no
748991771812724736,  Raffael52726274, 1, 0, 1, no
562058865,  marco_fabre, 1, 0, 1, no
437419192,  BadMoney1, 2, 0, 2, no
2986498385,  Dario44614299, 1, 0, 1, no
2439123325,  Strabicofilm, 2, 0, 2, no
3027511292,  guendalinazucc1, 1, 0, 1, no
492880987,  monika_gei, 2, 0, 2, no
460440475,  lucabelv, 1, 0, 1, no
416362189,  centrocopieplus, 1, 0, 1, no
430019208,  NataliaAugias, 1, 0, 1, no
742426208,  333Ludo, 1, 0, 1, no
615223,  antolo, 1, 0, 1, no
542549596,  ElisaFratangeli, 1, 0, 1, no
429881927,  PinballWizard69, 2, 0, 2, no
2385396421,  AngeParisi, 7, 0, 7, no
741454154355335169,  Bracle_Bracelet, 1, 0, 1, no
37512469,  sturli, 2, 0, 2, no
1269285138,  DanieleRuscetta, 4, 0, 4, no
500566096,  paolorm63, 1, 0, 1, no
1364490824,  FrancescSaba, 1, 0, 1, no
999870901,  LAgliottone, 1, 0, 1, no
1239893269,  Lorenzo_Lorenz_, 1, 0, 1, no
1062650718,  stenepoti, 1, 0, 1, no
2617478164,  liber13daniele, 1, 0, 1, no
29463669,  thomasfabbri, 2, 0, 2, no
1091619451,  Aldo_Marino1, 3, 0, 3, no
1242040304,  favaditopo, 1, 0, 1, no
487534247,  oberdan20, 1, 0, 1, no
746418917481000960,  coridastadio, 1, 0, 1, no
478036830,  bibbi77, 1, 0, 1, no
374549108,  PeppeLanzo, 1, 0, 1, no
2524395151,  Matteo_6alli, 1, 0, 1, no
359240143,  _lessimon, 1, 0, 1, no
222628269,  carlofavaretti, 1, 0, 1, no
314192197,  Giuseppe975, 1, 0, 1, no
1111564699,  FlorenzoDoino, 1, 0, 1, no
48768732,  ledep, 2, 0, 2, no
855282331,  federicod1vita, 1, 0, 1, no
2819021613,  RobVicaretti, 1, 0, 1, no
263086848,  daniel1981_, 1, 0, 1, no
348321186,  31clelia, 1, 0, 1, no
2831182421,  PrimianoCaputo, 1, 0, 1, no
40419167,  enricabelli, 1, 0, 1, no
712194014376755204,  libericittadin1, 1, 0, 1, no
953923741,  RGagnor, 1, 0, 1, no
795028576903069697,  MenteAspra, 2, 0, 2, no
398609310,  DalilaDiGioia, 1, 0, 1, no
190400882,  willyroutard64, 1, 0, 1, no
504631659,  FrancescoCoccoT, 5, 1, 4, no
455285487,  raggiovioletto, 1, 0, 1, no
759071073447075840,  LaerteGrimani, 1, 0, 1, no
411401928,  isacatalano, 1, 0, 1, no
2319480523,  ducci_elena, 1, 0, 1, no
838370179,  Marcellovalent_, 1, 0, 1, no
520827419,  Bibosechi, 2, 0, 2, no
352421269,  lolloriva, 1, 0, 1, no
2407044221,  _Francesco21_, 1, 0, 1, no
2751098044,  0e5090f3add24cf, 1, 0, 1, no
3722853495,  c_forestier, 2, 0, 2, no
119896656,  h10pippuz, 1, 0, 1, no
581617316,  PelosiSimone, 2, 0, 2, no
132241120,  Talbame, 1, 0, 1, no
2758461707,  fernalon165, 1, 0, 1, no
914628558,  RaMaurizio, 1, 0, 1, no
302570062,  lincedibeozia, 1, 0, 1, no
201501452,  MU329ParcosudMI, 1, 0, 1, no
153086571,  PietroGFloris, 1, 0, 1, no
16237091,  SilviaBorrelli, 1, 0, 1, no
385522939,  PlazaBologna, 1, 0, 1, no
425366243,  GBeaujeu, 2, 0, 2, no
779073210,  gregoriorapis, 1, 0, 1, no
374392352,  gegeste, 1, 0, 1, no
1283872520,  NellyEnne, 1, 0, 1, no
214034070,  AndreaBettio, 1, 0, 1, no
4827279141,  nicociccio80, 2, 0, 2, no
401330392,  Gibimassidda, 1, 0, 1, no
539785618,  Aledebe87, 1, 0, 1, no
9796912,  p4r0d5, 1, 0, 1, no
611760872,  MattiaAliani, 1, 0, 1, no
224652345,  gushand77, 1, 0, 1, no
708385115,  LfLuisafernando, 1, 0, 1, no
747214833083285504,  gabiotakmay1, 1, 0, 1, no
1381419367,  mt_par, 1, 0, 1, no
1333927363,  arnapiero, 1, 0, 1, no
352869389,  palumbo_enzo, 1, 0, 1, no
586625915,  MarinoPaltani, 1, 0, 1, no
2749292998,  ebarbieri311, 1, 0, 1, no
2799227808,  niyscha38, 1, 0, 1, no
185378398,  Banimalu, 1, 0, 1, no
68799306,  clem1960, 1, 0, 1, no
632083173,  mterrych, 1, 0, 1, no
4698044293,  imbiancaturaon1, 1, 0, 1, no
289878978,  rod1164, 1, 0, 1, no
2831385909,  EMemelli, 1, 0, 1, no
326016690,  MarBingham, 1, 0, 1, no
2240925978,  jhvefer, 2, 0, 2, no
1874120773,  INCNews, 1, 0, 1, no
3347326925,  AntoMorly, 1, 0, 1, no
3012027837,  AfgilM, 1, 0, 1, no
27352002,  GarGamer89, 1, 0, 1, no
726913921186185217,  theartofinter, 1, 0, 1, no
632427322,  Ostrega_, 1, 0, 1, no
721371014697992192,  mellegrino981, 2, 0, 2, no
573406649,  Meg_Fra, 2, 0, 2, no
137785529,  LCasiraghi, 1, 0, 1, no
2875309297,  Clamaialove, 1, 0, 1, no
2904847577,  JulioCesare12, 1, 0, 1, no
291596806,  SerenaGori, 1, 0, 1, no
595317798,  gginopino, 1, 0, 1, no
1190936910,  robert_mang, 1, 0, 1, no
1568383296,  gerardo_americo, 2, 0, 2, no
463775932,  justgiuli, 1, 0, 1, no
225718519,  very_1988, 1, 0, 1, no
3077774103,  cristallisale, 3, 0, 3, no
768519104353427458,  claudiodiegotom, 1, 0, 1, no
471302156,  CamonitaNatale, 1, 0, 1, no
475142274,  Gioanfuso, 1, 0, 1, no
293016987,  ErcoleSpizzirri, 1, 0, 1, no
418505620,  dessoandre, 1, 0, 1, no
446106924,  Erre94, 2, 0, 2, no
1417869506,  federicasalvi3, 3, 0, 3, no
169326263,  Mondo245, 1, 0, 1, no
516736949,  vairoemiliomari, 1, 0, 1, no
482915224,  yule1957, 1, 0, 1, no
1420698048,  StephenStrano, 1, 0, 1, no
211194021,  daktales, 2, 0, 2, no
22179579,  arturosalerni, 1, 0, 1, no
1513695745,  adimaio47, 1, 0, 1, no
786538326438227968,  gaggeroemilia53, 2, 0, 2, no
22752409,  effeciemme, 2, 0, 2, no
1424029538,  Kelben_78, 2, 0, 2, no
2760719741,  cotina125, 1, 0, 1, no
3228057418,  corpippo1167, 1, 0, 1, no
4744844236,  LinoDimar, 1, 0, 1, no
461895249,  andreabobi, 2, 0, 2, no
759460766273695744,  mercvinugl, 2, 0, 2, no
3340971070,  UglEugenio, 2, 0, 2, no
466690162,  GScacciavill, 1, 0, 1, no
2392904948,  UGLLazio, 1, 0, 1, no
365511674,  GiardinoVito, 2, 0, 2, no
3138893175,  DDaucelli, 1, 0, 1, no
2677043751,  brunaroda_roda, 3, 0, 3, no
2571683155,  Segr_Costruz_CE, 1, 0, 1, no
754020946399420416,  amedeo_gismondi, 1, 0, 1, no
1088783053,  giannimus, 1, 0, 1, no
487681909,  Almerico62, 1, 0, 1, no
1079703907,  Alefrank73, 1, 0, 1, no
2889104050,  annacardamone80, 1, 0, 1, no
2291548278,  lorelui_fede, 1, 0, 1, no
421336323,  LeongitoEduardo, 2, 0, 2, no
176168558,  salvo_ferrauto, 1, 0, 1, no
289324170,  antoniodelcorso, 1, 0, 1, no
1557730285,  GiuseppeACM81, 1, 0, 1, no
714179021110714370,  lu19lucia, 4, 1, 3, no
1921210748,  gibiffella, 12, 5, 7, no
3066008697,  jeitoapp, 2, 0, 2, no
3154570593,  AngelaChinca, 1, 0, 1, no
757757642,  MicheleArcange7, 1, 0, 1, no
1071052908,  marcogallon84, 2, 0, 2, no
746703984,  therealtomtom1, 1, 0, 1, no
4882567287,  micettanera51, 7, 0, 7, no
340148698,  AlbanoAntonio, 1, 0, 1, no
2364035995,  spazioconsumato, 6, 0, 6, no
126344012,  CODICIassconsum, 6, 0, 6, no
546285344,  ItEsposito, 10, 0, 10, no
826764168,  isa_gianni, 2, 0, 2, no
336716592,  EdoardoRosina, 1, 0, 1, no
16222806,  massimo_russo, 1, 0, 1, no
531296288,  MafaldaraS, 2, 0, 2, no
364241357,  PeppeGoool, 1, 0, 1, no
473042699,  gracivaleria, 1, 0, 1, no
2811584671,  ghiotto68, 3, 0, 3, no
475930507,  FM_Emmegi, 1, 0, 1, no
519800270,  PTorchi, 2, 0, 2, no
4689813482,  appia_day, 9, 0, 9, no
789553715766300673,  minuzzo3, 2, 0, 2, no
27636080,  manzolf, 1, 0, 1, no
116450737,  pradhaus, 1, 0, 1, no
2359198747,  juanne78, 1, 0, 1, no
2894480764,  adiafora_, 1, 0, 1, no
2849661244,  keenaroma, 1, 0, 1, no
713001212535246848,  adrydeedee, 6, 0, 6, no
4200779861,  StefanoDeAnge16, 3, 0, 3, no
1462996453,  dad082, 2, 0, 2, no
146185718,  carletto1973, 1, 0, 1, no
744497332637548544,  ArbitElegan, 1, 0, 1, no
545522033,  Popopozau, 4, 0, 4, no
163866571,  SamCacciolo, 1, 0, 1, no
1039724564,  chiara_cecco, 1, 0, 1, no
2746542772,  tambojosef, 1, 0, 1, no
330260849,  Rob_Rondinelli, 3, 0, 3, no
492555590,  silvialeonzi, 2, 0, 2, no
494909390,  cristinascappa, 1, 0, 1, no
1510018086,  flaminiasabate1, 1, 0, 1, no
1332450144,  DePaoletto81, 3, 0, 3, no
254707653,  blend974, 1, 0, 1, no
776040035049152512,  KingscrossArts, 4, 0, 4, no
1011745790,  MicheleDesogus, 1, 0, 1, no
14127198,  Clutcher, 1, 0, 1, no
100327059,  sergiofarina, 2, 0, 2, no
802515513729568772,  alex_sukrat, 1, 0, 1, no
1270670695,  loreleo1, 1, 0, 1, no
433612192,  bubajenny, 2, 0, 2, no
163896252,  iltorodilascaux, 1, 0, 1, no
2822701804,  CicloMamaa70, 1, 0, 1, no
3059740810,  vale_bmb_, 1, 0, 1, no
313390906,  MatteoLanzafame, 1, 0, 1, no
256956548,  wikiale, 1, 0, 1, no
475922139,  gianlucanitti, 1, 0, 1, no
3128854252,  felicesgambati6, 1, 0, 1, no
1289425303,  _sil93_, 1, 0, 1, no
1632907651,  fr40452375, 1, 0, 1, no
610333042,  CorradoMoretti, 1, 0, 1, no
810571969,  MatteoCollacchi, 1, 0, 1, no
212402248,  ArtMarius2, 2, 0, 2, no
796340446221963264,  Manux1981, 1, 0, 1, no
2902746298,  SarettaAsR79, 2, 0, 2, no
2361486773,  ArthurMrNewton, 1, 0, 1, no
307531468,  MartaGiannini, 1, 0, 1, no
210760071,  Eib63, 1, 0, 1, no
2526806834,  Sabinella81, 1, 0, 1, no
2729815985,  tambotto1, 1, 0, 1, no
223926395,  fedebarba1, 2, 0, 2, no
401465326,  MarcoRosso3, 1, 0, 1, no
445403898,  MR_Hurricane76, 1, 0, 1, no
510681191,  NinaAcocella, 1, 0, 1, no
886667504,  andreapolelli, 1, 0, 1, no
758670892251672576,  vice_questore, 1, 0, 1, no
379169704,  dexgio, 5, 0, 5, no
1192428948,  gelsomina68, 1, 0, 1, no
1531677930,  AntoVampi, 3, 0, 3, no
2576729006,  carlo_fusi, 1, 0, 1, no
593111769,  ILmirtese, 1, 0, 1, no
422798757,  CacciottiMarco, 1, 0, 1, no
435199410,  seaofrome, 1, 0, 1, no
3080630010,  robybarbieri82, 1, 0, 1, no
479724026,  patriziav62, 1, 0, 1, no
2345274633,  GliubichLaStefy, 1, 0, 1, no
1280563567,  BeatriceGulino, 1, 0, 1, no
453444597,  ElenaPro1, 1, 0, 1, no
462226444,  morenophilips, 1, 0, 1, no
434232469,  FedericaTonolin, 1, 0, 1, no
2997506451,  antonio19523, 1, 0, 1, no
424385301,  valentinasovier, 1, 0, 1, no
2247685331,  Elenaguglielmo1, 1, 0, 1, no
1070780718,  elicrisa25, 2, 0, 2, no
34196694,  cottytorino, 1, 0, 1, no
19604974,  and_mic, 1, 0, 1, no
454463805,  AndreaAscolese, 1, 0, 1, no
539050403,  SilCap78, 1, 0, 1, no
2644978389,  andreasarti64, 5, 0, 5, no
471018832,  mlongo63, 1, 0, 1, no
511271721,  Polidorox, 1, 0, 1, no
342905172,  lallachic, 1, 0, 1, no
2430631222,  Lucressio, 1, 0, 1, no
542852191,  CrisPalazzini, 1, 0, 1, no
1249983906,  mapivi63, 1, 0, 1, no
432886301,  le7Grace, 3, 0, 3, no
1414866230,  emilianobarbo78, 3, 0, 3, no
2198396045,  BovoGb, 1, 0, 1, no
760915205064892416,  ivanacuscito72, 1, 0, 1, no
19590970,  AssiduoLettore, 1, 0, 1, no
419772240,  marisveva, 1, 0, 1, no
256508868,  pin_klo, 2, 0, 2, no
2360811240,  Mirkomik88, 1, 0, 1, no
442690376,  superss74, 1, 0, 1, no
195097613,  mrborn2lose, 1, 0, 1, no
1650097483,  DNesli91, 1, 0, 1, no
147280554,  alchemistyc, 2, 0, 2, no
2604763780,  donafreedom, 1, 0, 1, no
358671300,  MilMass, 1, 0, 1, no
619178676,  DrABernetti, 4, 0, 4, no
796287659106832384,  bettachoo, 2, 0, 2, no
87962698,  LeonardoCaffo, 1, 0, 1, no
471402866,  lucagent, 1, 0, 1, no
288656733,  whiteblusky, 1, 0, 1, no
1146459277,  superkelly74, 1, 0, 1, no
367712119,  erpo_mata, 1, 0, 1, no
22641010,  Ra_11, 1, 0, 1, no
4747752975,  nmasini75, 1, 0, 1, no
1316230242,  RiccardoRocca92, 1, 0, 1, no
292865253,  Luca_Masala, 1, 0, 1, no
441743492,  arcoincielo, 1, 0, 1, no
4893365613,  ladaniMilolli, 1, 0, 1, no
533305986,  LucaPentrella, 3, 0, 3, no
60882004,  GROSSYGROSSY, 1, 0, 1, no
611063655,  ScrittureRai, 1, 0, 1, no
1518621589,  fabiocavataio, 2, 0, 2, no
2294254286,  Ale_Muzi, 1, 0, 1, no
23049915,  mbeccantini, 1, 0, 1, no
4023291459,  patriccia66, 2, 0, 2, no
1018058756,  IoGeorgiaLepore, 1, 0, 1, no
2973415361,  giovanna_bellu, 1, 0, 1, no
746331587428638720,  odal_marek, 1, 0, 1, no
420538798,  francescoallori, 1, 0, 1, no
548471081,  albertariccardi, 4, 0, 4, no
461932634,  CultureRoma, 1, 0, 1, no
710519954,  EmilianaEmpa24, 1, 0, 1, no
458721979,  anmur2604, 2, 0, 2, no
384304658,  leob1one, 1, 0, 1, no
47896750,  THNK_different, 1, 0, 1, no
18163631,  gabcuc, 1, 0, 1, no
715521782787280896,  518576c22ce2411, 1, 0, 1, no
2982433636,  VIVINSTRADA, 2, 0, 2, no
1037851609,  MaxDG63, 4, 0, 4, no
147943641,  pavlov_813, 1, 0, 1, no
16948721,  vincenzo_brana, 1, 0, 1, no
1278858271,  Ri_Ghetto, 1, 0, 1, no
1043191939,  Alestu96, 1, 0, 1, no
335451671,  DenisePezzoli, 1, 0, 1, no
370705320,  7TonyStark7, 1, 0, 1, no
978186865,  LMalanotteno, 2, 0, 2, no
556447537,  bloom014, 1, 0, 1, no
203197985,  TeoFerra, 1, 0, 1, no
1200638798,  1000FSDanny, 1, 0, 1, no
4172244862,  Elisa18125672, 2, 0, 2, no
55551432,  RomaSette, 1, 0, 1, no
484958212,  MonicaCillario, 1, 0, 1, no
386501517,  Lolicchia, 1, 0, 1, no
12918562,  telaio, 2, 0, 2, no
368485266,  OmarAburgeiba, 1, 0, 1, no
17306340,  Marspezia, 1, 0, 1, no
552720518,  frapapas, 3, 0, 3, no
1930280630,  bettaserafini, 1, 0, 1, no
146477952,  TychoBrahe29, 1, 0, 1, no
752871654070575104,  Marina73116437, 1, 0, 1, no
1126184292,  claugasb, 1, 0, 1, no
299163354,  Laimawen, 1, 0, 1, no
3121197057,  phoenix_fabio, 1, 0, 1, no
581933637,  chicchese, 1, 0, 1, no
296318811,  LavaBarocca, 1, 0, 1, no
491302624,  Tasc_abile, 2, 0, 2, no
767397722857021442,  SStiletti, 1, 0, 1, no
800049301443506176,  Cris19112016, 4, 0, 4, no
16537991,  alexiarojas, 1, 0, 1, no
3599907255,  angheran70, 1, 0, 1, no
3215882349,  b_linardi, 1, 0, 1, no
2822232480,  neveintasca, 1, 0, 1, no
541741004,  Frra_Roma, 2, 0, 2, no
2936864140,  giandesan1, 3, 0, 3, no
3425678355,  callmejorjor, 3, 0, 3, no
3226534781,  steugo77, 1, 0, 1, no
3334909204,  RBascoccia, 1, 0, 1, no
702175480905076736,  Mako76_, 2, 0, 2, no
247856797,  Silvia_D_A, 1, 0, 1, no
205210776,  lady_xanax, 1, 0, 1, no
407898601,  targeno, 11, 0, 11, no
491173848,  marcofratta, 1, 0, 1, no
490798068,  Frbarberini, 1, 0, 1, no
753725376036237314,  Fabrizi59139932, 1, 0, 1, no
144490047,  masaless, 1, 0, 1, no
747315391,  CalzolariG, 1, 0, 1, no
716208405459902464,  santited93, 2, 0, 2, no
553844061,  loretocapaldi, 1, 0, 1, no
497349209,  DOC_83_, 1, 0, 1, no
398090760,  giulyJules, 1, 0, 1, no
2393674071,  tonimercuri, 1, 0, 1, no
307999300,  la_gatti, 1, 0, 1, no
2347274438,  ilRottamatore, 2, 0, 2, no
989147641,  ManekiStra, 1, 0, 1, no
296733937,  EnricoStefano, 1, 0, 1, no
13282462,  sampietrino, 2, 0, 2, no
10059372,  bastet, 2, 0, 2, no
715785486,  KillerWhaleDE, 1, 0, 1, no
4551451042,  ERicrescita, 1, 0, 1, no
2767883764,  goblin380, 4, 0, 4, no
413430844,  ValerioCurcio, 1, 0, 1, no
1684468244,  AglioVestito, 2, 0, 2, no
1323216032,  mauro_bazzani, 1, 0, 1, no
1288257872,  snorristorluson, 3, 0, 3, no
1650047688,  ElgaBaviera, 1, 0, 1, no
796996456561442816,  tatina8909, 2, 0, 2, no
565784508,  MercurioPsi, 6, 0, 6, no
795987761622827008,  CittaMetroRoma, 1, 0, 1, no
36801345,  vgibertini, 1, 0, 1, no
2761842103,  RFontebuoni, 1, 0, 1, no
1585424048,  urbiker, 1, 0, 1, no
484168007,  TrabuccoGiorgio, 1, 0, 1, no
2936087235,  scerbopierre, 1, 0, 1, no
1722590094,  EmaMenichetti, 1, 0, 1, no
54913840,  AleCima, 1, 0, 1, no
2393684735,  nazgul_mikk983, 1, 0, 1, no
2878068448,  valesecisei, 1, 0, 1, no
1161059923,  Brunissimo2007, 1, 0, 1, no
229848654,  AleRBW, 1, 0, 1, no
4655664915,  FrSocialista, 1, 0, 1, no
195427066,  claudiodalpiaz, 1, 0, 1, no
703622291746398208,  JDeLaCouronne, 2, 0, 2, no
492474319,  JantasOO, 2, 0, 2, no
719098026434945025,  VivMilano, 1, 0, 1, no
23735287,  massi_tm, 1, 0, 1, no
309064441,  LogikSEO, 1, 0, 1, no
192850838,  AlanTheCrow, 2, 0, 2, no
3386953695,  martaleonardi63, 1, 0, 1, no
3960264747,  OsservatriceRM, 1, 0, 1, no
317858250,  AdoFRANZO, 1, 0, 1, no
1098132554,  AccAccoglienza, 1, 0, 1, no
2363796541,  listamarchini, 1, 0, 1, no
264674074,  78alexb, 3, 0, 3, no
156780554,  mr_pac, 1, 0, 1, no
382657928,  andrearomeod, 12, 0, 12, no
244530269,  giochini, 1, 0, 1, no
1093056480,  DesyNieves, 1, 0, 1, no
1681033327,  PdP_Cipo, 1, 0, 1, no
158139361,  ranierioffice, 1, 0, 1, no
428369864,  asrandrea82, 1, 0, 1, no
1227823358,  RInfascelli, 1, 0, 1, no
362353528,  MartaCoccoluto, 2, 0, 2, no
1225690944,  OpusPaulicium, 1, 0, 1, no
84030659,  SignoraAquilone, 1, 0, 1, no
821577050,  elinssen, 1, 0, 1, no
43339170,  Fgranese, 1, 0, 1, no
396857578,  Il_Reca, 3, 0, 3, no
3795663855,  Val_Gentili, 1, 0, 1, no
68460492,  aledardes, 1, 0, 1, no
14115225,  francesca_defeo, 1, 0, 1, no
1210858525,  TCampomori, 1, 0, 1, no
476743488,  patriziabiagin1, 1, 0, 1, no
803412473420402688,  bamalighmo1970, 1, 0, 1, no
525268787,  reporterfreelen, 1, 0, 1, no
569218257,  MichaelMurphyKO, 1, 0, 1, no
802996331426054145,  tzaridojdig1981, 1, 0, 1, no
54203549,  nicolerimbaud, 1, 0, 1, no
1704187662,  stellina_66, 1, 0, 1, no
3069593560,  24zampe, 1, 0, 1, no
486786904,  dasivo, 1, 0, 1, no
2634426862,  roximom56, 1, 0, 1, no
457391007,  tombac77, 1, 0, 1, no
1061331960,  sildavbarman, 1, 0, 1, no
4212260849,  Ever_Let_Me_Go, 4, 0, 4, no
1170199861,  AnniBoros, 2, 0, 2, no
1219654200,  silviapinci, 5, 0, 5, no
1277525125,  fedegregs, 1, 0, 1, no
380788364,  Voca92, 1, 0, 1, no
170455300,  Loislane6576, 4, 0, 4, no
444510706,  claudiorizza1, 2, 0, 2, no
434184878,  brutigan, 1, 0, 1, no
1288497643,  Matteo_Munno, 1, 0, 1, no
479005527,  CeratoIvana, 1, 0, 1, no
2876453600,  _AntonioMartone, 1, 0, 1, no
706051793843843072,  stregattaccio, 1, 0, 1, no
795382845413920769,  ParoleStampate, 1, 0, 1, no
799582147392798720,  LibriPer, 1, 0, 1, no
785143654805598208,  scrivolandia_st, 1, 0, 1, no
768422036758794240,  scrivolandia, 1, 0, 1, no
798180093520740352,  lamusicafa, 1, 0, 1, no
795413849381998592,  notturnoselvag1, 1, 0, 1, no
799579655808446464,  NelmioD, 1, 0, 1, no
3879275914,  Michel_7104, 1, 0, 1, no
1175066310,  LicyaVari, 1, 0, 1, no
2369493982,  Daniele80Londra, 1, 0, 1, no
901807579,  PauloRoberto5F, 1, 0, 1, no
2390872007,  nevalbarlas, 1, 0, 1, no
421863300,  fperuginipz, 1, 0, 1, no
478979804,  nanogelato, 6, 0, 6, no
594767012,  davideferrocom, 1, 0, 1, no
2583974283,  Mecmao, 1, 0, 1, no
3868881574,  nanapiza1, 1, 0, 1, no
1231193545,  Ranici91, 1, 0, 1, no
410038651,  Piestef1941, 2, 0, 2, no
110769331,  giuliaviolante, 1, 0, 1, no
390955003,  maurafrasca, 2, 0, 2, no
4502259255,  GangemiLaura, 1, 0, 1, no
780154819,  BrunoMossa, 1, 0, 1, no
2946220173,  divitocinema, 2, 0, 2, no
51772481,  lu_garg, 1, 0, 1, no
747307420276264960,  Cmfrtan, 5, 0, 5, no
1351938944,  Wanderlust_94, 1, 0, 1, no
235318725,  Carla_Canale_74, 1, 0, 1, no
2874870303,  neurosergio, 1, 0, 1, no
92749046,  davidecancarini, 1, 0, 1, no
4019514868,  sisterofnight85, 1, 0, 1, no
1979545116,  giorgioborghett, 1, 0, 1, no
80875024,  kyraitaly, 2, 0, 2, no
333960904,  fedeskier, 1, 0, 1, no
2397805103,  Vojka5, 1, 0, 1, no
2804052821,  liboni83, 11, 0, 11, no
574709708,  volpini_laura, 1, 0, 1, no
2821779182,  8MaryLeaf, 1, 0, 1, no
50950136,  m4nzi, 1, 0, 1, no
78592366,  iCeccio, 1, 0, 1, no
3296247557,  Scudierino, 1, 0, 1, no
708535368,  bubafra, 2, 0, 2, no
2563027047,  rivegauche_s, 1, 0, 1, no
409559794,  1964l, 1, 0, 1, no
472000716,  Nucci76, 1, 0, 1, no
366107110,  ELENACICCOZZI, 3, 0, 3, no
486511597,  topoteppa, 2, 0, 2, no
44651391,  MelaFerrentino, 3, 0, 3, no
2866107063,  penylouma1305, 1, 0, 1, no
2606143812,  ziamaruska, 1, 0, 1, no
397585905,  Myrti_C, 2, 0, 2, no
1611207038,  UomoPiuSemplice, 1, 0, 1, no
986768443,  regkrieger, 1, 0, 1, no
72825411,  enrico1964, 1, 0, 1, no
1163993796,  FaBenTO69, 2, 0, 2, no
1315150957,  goldenrabbit53, 1, 0, 1, no
1120123548,  Mrstoscani, 1, 0, 1, no
32166623,  Vitellozzo, 1, 0, 1, no
4403034262,  uponmyshoulders, 1, 0, 1, no
784079483301134337,  oliodipalma, 1, 0, 1, no
436855201,  LeoMangiavacchi, 1, 0, 1, no
416638388,  28gradi, 1, 0, 1, no
805544853132165120,  Ilpapero88, 2, 0, 2, no
1219027387,  lorela70, 1, 0, 1, no
3307289301,  Giulibuww, 1, 0, 1, no
372877605,  CORRYAZ, 2, 0, 2, no
147234729,  eleverni, 1, 0, 1, no
1075073228,  IngegnerSEO, 3, 0, 3, no
2391740046,  ErBibbitaro, 1, 0, 1, no
52858066,  gr_andyx, 1, 0, 1, no
340408011,  Vipdeldivano, 4, 0, 4, no
155856263,  AntonellaRan, 2, 0, 2, no
400732379,  elenagpolidori, 1, 0, 1, no
737923249070346240,  SuicideSquiddi, 1, 0, 1, no
1229455004,  vichelaloss, 1, 0, 1, no
442214344,  claudio_spadoni, 1, 0, 1, no
385994748,  hip108092, 1, 0, 1, no
165051584,  _diana87, 1, 0, 1, no
1276107571,  ariannalucci27, 1, 0, 1, no
46355863,  Guytano__, 1, 0, 1, no
3043696354,  BrunoContiFA7, 1, 0, 1, no
332840780,  aledicicco, 1, 0, 1, no
1601206675,  non9906, 1, 0, 1, no
55053428,  Seljess, 1, 0, 1, no
239754039,  fire4wd, 1, 0, 1, no
456648155,  GioBeninato, 1, 0, 1, no
2342862611,  stefaniaes76, 1, 0, 1, no
3296663865,  Josepaddeu, 1, 0, 1, no
494383010,  Zorba4Zorba, 1, 0, 1, no
20224538,  antoporfido, 1, 0, 1, no
249321169,  InFondoAllAnima, 1, 0, 1, no
483965262,  ArmidaDebora, 2, 0, 2, no
318331245,  ilteino, 2, 0, 2, no
418689046,  vmvinicio, 1, 0, 1, no
495045767,  holly0776, 2, 0, 2, no
582126359,  roxbassblues, 1, 0, 1, no
629669385,  nadertheking, 1, 0, 1, no
147310639,  shugarplum_90, 1, 0, 1, no
3141185441,  FlorianaMissori, 1, 0, 1, no
381971890,  CinziaTwi, 3, 0, 3, no
4416532660,  ph_dimauro, 1, 0, 1, no
786470725200842752,  Pierpao09900229, 1, 0, 1, no
783020214,  GiadaFFowler, 1, 0, 1, no
2182149856,  ClaudioNonna, 1, 0, 1, no
1175684660,  scarsciotti, 1, 0, 1, no
424529280,  MrGaet, 8, 0, 8, no
337258972,  RomeoColosseo, 1, 0, 1, no
439253059,  deustronzio, 1, 0, 1, no
412605774,  RosariaDApollo, 1, 0, 1, no
179034462,  vitomaxbucci, 1, 0, 1, no
3420517433,  K365Gianni, 1, 0, 1, no
2393974623,  monnalisaselfie, 1, 0, 1, no
116408795,  NCLetterario, 1, 0, 1, no
2243027792,  chieleon, 1, 0, 1, no
50594245,  Markinux, 1, 0, 1, no
358384589,  DChiomento, 1, 0, 1, no
52023775,  TorinoClick, 1, 0, 1, no
473772424,  Cittalia, 3, 1, 2, no
599483247,  FurfaroL, 1, 0, 1, no
370377630,  barbaragraffino, 1, 0, 1, no
68648501,  ViceM25, 1, 0, 1, no
433176274,  albertobarberis, 1, 0, 1, no
468370504,  ccuitorino, 1, 0, 1, no
1345373785,  lorusso_stefano, 1, 0, 1, no
512512014,  CoachMalvezzi, 2, 0, 2, no
420265631,  MarcoLavatar, 1, 0, 1, no
2451161791,  siclavoro, 1, 0, 1, no
798842956757102592,  ONGpiemonte, 1, 0, 1, no
3247867120,  stefano_manara, 1, 0, 1, no
52667653,  paolatealdi, 1, 0, 1, no
2228899537,  SistemaTorino, 1, 0, 1, no
4276681817,  ScuolaCotto, 1, 0, 1, no
3802234997,  enr_gav, 1, 0, 1, no
460996641,  GMP_WORLD, 1, 0, 1, no
1459703156,  meco_mix, 4, 0, 4, no
564370558,  massicaporale72, 1, 0, 1, no
796659204518006784,  rachelrachela80, 1, 0, 1, no
2243798055,  malasosta, 5, 0, 5, no
3307875581,  Matchagio7, 1, 0, 1, no
4544963296,  il_seccatore, 2, 0, 2, no
468780268,  federicoorta, 1, 0, 1, no
949175203,  fogliettachiara, 1, 0, 1, no
532957642,  Yes4To, 2, 0, 2, no
797369295881859072,  alessandro212m, 1, 0, 1, no
1411441638,  soantony23, 1, 0, 1, no
3320634071,  _ClaMarchisio_, 2, 0, 2, no
1196515682,  pmulassano, 1, 0, 1, no
1573345388,  marcogiuppone, 1, 0, 1, no
2506747965,  anzalotto, 1, 0, 1, no
779643582064066562,  andrea_viazzo, 1, 0, 1, no
414744686,  retronebbia, 2, 0, 2, no
4202809396,  muoversincitta, 1, 0, 1, no
801754,  suzukimaruti, 2, 0, 2, no
406323002,  pluto_03, 1, 0, 1, no
96229605,  gns2000, 1, 0, 1, no
2818840629,  GM_EuropaOvini, 1, 0, 1, no
393415845,  Lepricauno, 1, 0, 1, no
425649719,  GianmarcoFraska, 2, 0, 2, no
141936740,  SAPcagliari, 2, 0, 2, no
2931672725,  ibraMirkovic75, 1, 0, 1, no
2918245289,  DemonteMario, 1, 0, 1, no
3389000429,  Sergiosotgiase1, 3, 0, 3, no
547822404,  Adriano_Palozzi, 2, 0, 2, no
42389560,  AlexLucianoMayT, 1, 0, 1, no
784829417168207873,  Duffy_1958, 2, 0, 2, no
478305030,  loverdegianluca, 3, 0, 3, no
125975139,  Rubiyat, 1, 0, 1, no
274835694,  fineas10, 1, 0, 1, no
2207158497,  nicolalageder, 1, 0, 1, no
2472132872,  salvato14164980, 2, 0, 2, no
3081436118,  cirano148, 1, 0, 1, no
1964814212,  enrygattoj12, 1, 0, 1, no
65371363,  lullabywoman, 1, 0, 1, no
825815605,  AndreaGavarone, 1, 0, 1, no
801332237966987267,  isskoblilina, 1, 0, 1, no
351495967,  InfoNewsNapoli, 2, 0, 2, no
972423649,  valeortuz, 1, 0, 1, no
462101728,  DioIt, 1, 0, 1, no
4020636137,  AleVerrelli, 2, 0, 2, no
450778886,  rekimko, 1, 0, 1, no
781921091510005760,  CernoIlSupremo, 2, 0, 2, no
891007872,  CircoloTurati, 2, 0, 2, no
581310185,  SottileFabrizio, 3, 0, 3, no
6521502,  alexerra, 1, 0, 1, no
1278745771,  ossetto, 1, 0, 1, no
2284024161,  MolestoIl, 3, 0, 3, no
570163803,  monicaciaburro, 1, 0, 1, no
804632834501644289,  nataraja1991, 2, 0, 2, no
471742666,  VittorioVerusio, 2, 0, 2, no
71193744,  antonellamadeo, 2, 0, 2, no
433046582,  cultnsea, 1, 0, 1, no
1719583506,  lorimarti11, 2, 0, 2, no
1097394962,  Bara__22, 1, 0, 1, no
803386240489951232,  macn231, 1, 0, 1, no
406123480,  SergioNegroni, 1, 0, 1, no
371924509,  fabriziodist, 1, 0, 1, no
186372865,  Pescatore84, 1, 0, 1, no
570992674,  Gm15karla, 2, 0, 2, no
103232480,  enricogandolfi, 1, 0, 1, no
376145130,  assessore74, 2, 0, 2, no
514509122,  BorgMatteo, 1, 0, 1, no
96804648,  carmeloassenza, 1, 0, 1, no
391955295,  marco_gitto, 1, 0, 1, no
480438966,  LucaZaccari, 1, 0, 1, no
3855807508,  Cowboy201274, 1, 0, 1, no
878685505,  Giorgio_Assenza, 1, 0, 1, no
709503618,  MattewSchianti, 1, 0, 1, no
184348439,  entity_lm, 1, 0, 1, no
4076357332,  Nicola969703171, 1, 0, 1, no
993853790,  girmorr, 1, 0, 1, no
283507160,  GBonannodiL, 1, 0, 1, no
179871513,  italiadeidolori, 1, 0, 1, no
197355796,  vincenzomaran, 1, 0, 1, no
1427710298,  MartelliFrance, 4, 1, 3, no
113362743,  MaurizioIndaco, 2, 0, 2, no
2771777799,  CheteFregaTene, 1, 0, 1, no
603082591,  MicheleRampini, 1, 0, 1, no
2907681609,  fotoroma900, 1, 0, 1, no
3295578989,  LeneLepre, 1, 0, 1, no
731474165019119616,  thelma6317, 1, 0, 1, no
4876405329,  CbradiCristina, 1, 0, 1, no
1259891971,  MicheleBolgan, 1, 0, 1, no
190527996,  CristianoZatta, 1, 0, 1, no
425782220,  briciola00, 1, 0, 1, no
396404127,  thedriver66, 1, 0, 1, no
782340109,  gattogeremia, 1, 0, 1, no
721885819020173312,  panarinacalkig3, 1, 0, 1, no
54598696,  immagimario, 1, 0, 1, no
216643207,  Annadrx00, 2, 0, 2, no
142711432,  SimonVannini, 1, 0, 1, no
908138683,  FedericaCrepald, 1, 0, 1, no
388860597,  usai_marco, 1, 0, 1, no
483941482,  araldogiustizia, 1, 0, 1, no
354208096,  kar_el1955, 1, 0, 1, no
717323707535007744,  mimmo6666, 1, 0, 1, no
785434989576028160,  davinc242, 2, 0, 2, no
2956859205,  bacchetta55, 1, 0, 1, no
3221398883,  paolacommisso95, 1, 0, 1, no
538513540,  kartizer, 1, 0, 1, no
2211212309,  JanLaMantia, 1, 0, 1, no
793504775757238272,  Leonard15187807, 1, 0, 1, no
791001688584949764,  Vesuvio1957, 1, 0, 1, no
112769437,  Marianna2ooo, 1, 0, 1, no
407701503,  PressOfficeAREA, 2, 0, 2, no
206294638,  rezeff, 1, 0, 1, no
194223032,  seracri, 1, 0, 1, no
201761137,  iguanadan, 1, 0, 1, no
4031130172,  paolonedomenico, 1, 0, 1, no
783048133416783872,  marziaisenough1, 1, 0, 1, no
1358783606,  moira_sal, 1, 0, 1, no
1062774396,  bomberpiro, 1, 0, 1, no
1645529942,  graziano_79, 1, 0, 1, no
410601235,  FedericoLuongo1, 1, 0, 1, no
741533495227453440,  enricomancini11, 1, 0, 1, no
1271871373,  AlaskaSpines, 1, 0, 1, no
354370350,  fridrik73, 1, 0, 1, no
1189938984,  s_picen, 1, 0, 1, no
706567951428808704,  peppemasciari, 1, 0, 1, no
4764185375,  sneri1955, 1, 0, 1, no
602610308,  giu10peppe, 1, 0, 1, no
1195189627,  ahmatte_gri, 1, 0, 1, no
1289295079,  armandoperugini, 1, 0, 1, no
1301064319,  RizzoGigirz58, 7, 0, 7, no
3121689787,  LSonnj, 1, 0, 1, no
785355513152307200,  giorgio9089, 1, 0, 1, no
1545817196,  matildesjt, 1, 0, 1, no
494228967,  ciccioladelia, 1, 0, 1, no
2318406154,  carisvanghetti, 1, 0, 1, no
2817956454,  dicducfacfer18, 1, 0, 1, no
3048084708,  maddyfe, 1, 0, 1, no
2360788878,  ModoloCristina, 1, 0, 1, no
192210063,  LOSTINFICTIONUK, 10, 0, 10, no
14707379,  Carlofonda, 1, 0, 1, no
2749100742,  Nemyl1, 2, 0, 2, no
549221508,  acquaketa, 1, 0, 1, no
1090076990,  CamagheCat, 3, 0, 3, no
14650984,  marcozennaro, 1, 0, 1, no
776439709488803840,  Luigi103, 1, 0, 1, no
96192049,  flape82, 1, 0, 1, no
121691763,  leopardo14, 1, 0, 1, no
764290269361664000,  Luca42296334, 3, 0, 3, no
1867118582,  Marcoviniciodv, 5, 0, 5, no
1053575598,  Mariaro37744920, 1, 0, 1, no
60867782,  catnext, 1, 0, 1, no
2615327307,  Ferdina56463521, 1, 0, 1, no
988846506,  SilvioSaronno, 1, 0, 1, no
362202952,  AltamuraL, 1, 0, 1, no
1073514842,  liciniodimichel, 1, 0, 1, no
792758228895555584,  ansca68, 1, 0, 1, no
42671353,  ant_castaldo, 1, 0, 1, no
525770039,  unasolanima, 3, 0, 3, no
96964634,  marcoc1961, 3, 0, 3, no
2850884786,  simow1979, 7, 0, 7, no
2959921857,  mp_1972, 1, 0, 1, no
4743869176,  rollcage76, 2, 0, 2, no
272450967,  fabriGT, 2, 0, 2, no
719095505352007680,  stefano3030, 2, 0, 2, no
851310290,  LorenzoIlGiusta, 1, 0, 1, no
1183658797,  mauriliomondora, 1, 0, 1, no
458623597,  AMiracco, 1, 0, 1, no
714705252721762305,  Aldo52399586, 1, 0, 1, no
781214331748937728,  danyeydany1965, 1, 0, 1, no
2387729639,  deflamon, 1, 0, 1, no
754075999852191744,  RealVicoN, 1, 0, 1, no
803748942139760640,  stregaalyce, 4, 0, 4, no
3000836386,  David4ctl, 1, 0, 1, no
427211091,  Igor_Bermani, 1, 0, 1, no
29166185,  TheNexusV, 1, 0, 1, no
2399785188,  IrenePicarelli, 1, 0, 1, no
1171869331,  ElenaAndrea70, 1, 0, 1, no
793055656450355200,  Midwest38202040, 1, 0, 1, no
802252165595140096,  laiminsbackpri1, 1, 0, 1, no
1966745136,  waitingforthebp, 1, 0, 1, no
734962813,  ritamontanucci1, 1, 0, 1, no
618836329,  barba_emme, 1, 0, 1, no
245568963,  caliaesemenza, 1, 0, 1, no
1116457932,  DonnePolitica, 1, 0, 1, no
799549995204612096,  PaoloFreehog, 1, 0, 1, no
3311671889,  iopersempre74, 1, 0, 1, no
870556159,  salvopatane13, 1, 0, 1, no
3056430743,  AntonioSignor10, 1, 0, 1, no
4764391455,  acquarius102, 1, 0, 1, no
2430696135,  LinaVadal, 1, 0, 1, no
701748712339587072,  MichaelaAnselm1, 1, 0, 1, no
2248929082,  f_amato, 1, 0, 1, no
464857095,  GrazianoTortore, 1, 0, 1, no
603863493,  Frigo78, 1, 0, 1, no
49758744,  Soren13, 1, 0, 1, no
774973893060726785,  Salvatorecappe8, 1, 0, 1, no
4044724023,  cincischiati, 1, 0, 1, no
748630604778971136,  dellacquamarsa, 1, 0, 1, no
195455137,  MauroGiulivi, 2, 0, 2, no
850035295,  GiuffreMauro, 1, 0, 1, no
2539380734,  kira6677, 1, 0, 1, no
2852677474,  m5s_taranto, 2, 0, 2, no
3241702065,  pe_peps1987, 1, 0, 1, no
1913671255,  AdrianaCioci, 1, 0, 1, no
55251007,  saverioraimondo, 1, 0, 1, no
4858753947,  utahfoodfreedom, 1, 0, 1, no
212592062,  Dissenzo_, 1, 0, 1, no
485563568,  Toni184184, 1, 0, 1, no
1131103262,  MicheleArturo, 1, 0, 1, no
217087919,  robertoabate, 1, 0, 1, no
2887407797,  broggiglaucoj, 1, 0, 1, no
2397659735,  laricgiu, 1, 0, 1, no
2355545718,  GiuseppeABuono, 1, 0, 1, no
412637230,  LorenzPass, 1, 0, 1, no
2915966008,  MikiMinnielli, 1, 0, 1, no
706983565838385152,  giambacapitanio, 1, 0, 1, no
791439786,  DePalmaFra, 1, 0, 1, no
800412885880946688,  ConcettaMarino7, 1, 0, 1, no
554978317,  inespiludu, 1, 0, 1, no
2724223470,  WebSvelato, 2, 0, 2, no
2899382939,  Iu7Bqc, 1, 0, 1, no
50065323,  AlyLuz7, 1, 0, 1, no
448767335,  altadentro, 1, 0, 1, no
588219817,  Spaky01, 1, 0, 1, no
680173,  suafigositudine, 1, 0, 1, no
458405242,  nusspot, 1, 0, 1, no
1098895478,  thefoolishrebel, 1, 0, 1, no
1642691952,  dcentomini, 1, 0, 1, no
66792123,  Chiba87, 1, 0, 1, no
909925344,  AleMt78, 1, 0, 1, no
1479883909,  faint461, 1, 0, 1, no
712743044345364482,  kudrat_goraya, 1, 0, 1, no
192268572,  mirkoprocopio, 1, 0, 1, no
486889483,  pat_chiarello, 1, 0, 1, no
757228686777122816,  Leonardi140467, 1, 0, 1, no
3955231894,  sergiovalerioa3, 1, 0, 1, no
335888922,  simona51simona, 1, 0, 1, no
74880368,  ipsedixitennius, 1, 0, 1, no
93192980,  mirticaos, 1, 0, 1, no
1010789078,  rosapulejo, 1, 0, 1, no
359889602,  vongiap, 1, 0, 1, no
600073468,  umbertomoneta, 1, 0, 1, no
197420592,  padronadimilano, 1, 0, 1, no
892944115,  MichelePirolli, 1, 0, 1, no
379657067,  cla040681, 1, 0, 1, no
482313676,  gabrigi7, 1, 0, 1, no
1847905999,  NowakixHiro, 7, 0, 7, no
4121407583,  AvvGraziaDiBari, 1, 0, 1, no
2865919767,  tdepietto, 1, 0, 1, no
302244679,  vic2664, 1, 0, 1, no
2276998618,  PPaolomad, 2, 0, 2, no
2948537999,  MottyDi, 1, 0, 1, no
823062060,  Maximo0790, 2, 0, 2, no
1467197706,  MariaTrozzi7, 1, 0, 1, no
1218962124,  pamela1br, 1, 0, 1, no
76902417,  max_blue, 1, 0, 1, no
912548130,  migliore_il, 1, 0, 1, no
246882785,  Ro_Tom, 1, 0, 1, no
1196845802,  Luca_Berretta, 3, 0, 3, no
723010411063349248,  Mimi56063872, 7, 0, 7, no
790153438491471872,  Ciresinimarghe2, 2, 0, 2, no
3428093939,  CristinaGazzin1, 1, 0, 1, no
432778390,  maripetrus, 2, 0, 2, no
7271952,  EnzoPdSUD, 1, 0, 1, no
4352795836,  ROSSANA19593, 2, 0, 2, no
259401630,  chiccarai, 1, 0, 1, no
3547880116,  carlamartamari, 1, 0, 1, no
2336702687,  rotpeter1, 1, 0, 1, no
2736537016,  ComiRomina, 1, 0, 1, no
722527613193990145,  BroggioLaura, 1, 0, 1, no
2433801274,  dinofrix, 1, 0, 1, no
1037847751,  marcomar21, 1, 0, 1, no
798283936950616072,  natalidellavita, 1, 0, 1, no
901626978,  rosolinomirabel, 1, 0, 1, no
444515250,  MTeppista, 1, 0, 1, no
464878898,  aogana, 1, 0, 1, no
2359624218,  saspav, 2, 0, 2, no
2263569021,  GrazianoPasta, 1, 0, 1, no
486053278,  laguerradiP, 4, 0, 4, no
410235395,  gf1953, 1, 0, 1, no
1158224899,  matthewgor, 1, 0, 1, no
786208274261667840,  MarziaRossi13, 2, 0, 2, no
26723126,  Fornario, 3, 0, 3, no
230749847,  aculalap, 1, 0, 1, no
2331802006,  CasaLettori, 1, 0, 1, no
2582226552,  stati_generali, 1, 0, 1, no
451487023,  paridepriamo, 1, 0, 1, no
260337748,  65mauriziobe, 2, 0, 2, no
1375679190,  MarcoVIcm, 2, 0, 2, no
213701690,  attacker_you, 1, 0, 1, no
2372229336,  GrimaldiRoccoI, 2, 0, 2, no
123078219,  uctq101, 1, 0, 1, no
3075932493,  RossLuigi58, 1, 0, 1, no
9627412,  niconarsi, 1, 0, 1, no
84932530,  O_Scarcello, 1, 0, 1, no
734452860113539072,  DarioArmandoDe1, 1, 0, 1, no
246522096,  ValeCalicchio, 3, 0, 3, no
2405213518,  antoniocoz85, 1, 0, 1, no
778540541206204416,  Alberto1332, 1, 0, 1, no
4827491773,  godofunk, 1, 0, 1, no
486682754,  PinoRenato, 2, 0, 2, no
409884335,  manni_andrea, 3, 0, 3, no
627332001,  EdizioniLindau, 1, 0, 1, no
500001834,  Antonio_Grassia, 1, 0, 1, no
430320467,  pepposrussoo, 2, 0, 2, no
311355879,  KelleddaMurgia, 1, 0, 1, no
1005025986,  MicMar77, 1, 0, 1, no
56981877,  clasurf, 1, 0, 1, no
68182390,  davidemontanaro, 12, 0, 12, no
2719691555,  eaiello73, 1, 0, 1, no
394922246,  alessiobenzi, 1, 0, 1, no
253579575,  grillimax, 1, 0, 1, no
452064464,  vanniat66, 5, 0, 5, no
304081834,  SDalleRive, 1, 0, 1, no
515681310,  al_dellacqua, 2, 0, 2, no
497256057,  MarioDanisi, 1, 0, 1, no
262745603,  ricagricolo, 1, 0, 1, no
57572869,  rafros, 1, 0, 1, no
1096629289,  _andrea_braga, 1, 0, 1, no
1067802307,  Robertam_63, 2, 0, 2, no
3882543447,  CallegaroManuel, 1, 0, 1, no
913242168,  DCoriasco, 1, 0, 1, no
1042797620,  PierluigiVito, 1, 0, 1, no
2393681848,  TenaceMarilisa, 1, 0, 1, no
2647287138,  NicoHuettemann, 1, 0, 1, no
3005907202,  letterarosa, 2, 0, 2, no
244140469,  Svagaia, 2, 0, 2, no
461363018,  GiuseppeZangari, 1, 0, 1, no
2854938082,  RovigoPossibile, 2, 0, 2, no
3439821209,  l_capellini, 1, 0, 1, no
48734499,  mauroarcobaleno, 1, 0, 1, no
499862027,  emigaglia, 1, 0, 1, no
3599517983,  patriziavailat1, 1, 0, 1, no
2445913698,  quartopensiero, 1, 0, 1, no
804259262239281152,  LucaCapacci87, 2, 0, 2, no
1251955484,  M_Biccari, 3, 0, 3, no
72368174,  Mangecan, 1, 0, 1, no
88053361,  stormbraver, 1, 0, 1, no
2680148829,  kronodeuss, 2, 0, 2, no
495990520,  maurocrovace, 1, 0, 1, no
894845214,  carmeloalessan2, 1, 0, 1, no
1176909900,  RMarsalli, 1, 0, 1, no
1168367756,  giancarlo_onnis, 2, 0, 2, no
740770152044716032,  degli2811, 1, 0, 1, no
19647604,  RaffRiff, 2, 0, 2, no
2263734461,  Raffa_uff_you, 1, 0, 1, no
3007529356,  Giuliaartibani, 1, 0, 1, no
407000871,  kalufunsui, 1, 0, 1, no
526240914,  picossu, 1, 0, 1, no
444665671,  PinoVittorelli, 1, 0, 1, no
418757627,  GigiSpedicato, 1, 0, 1, no
2290561839,  chris_locci, 1, 0, 1, no
3861824717,  frocietto, 1, 0, 1, no
16511742,  palaMaxx, 1, 0, 1, no
799271957527138304,  SusannaSavini, 1, 0, 1, no
470501464,  siracusa_sandro, 2, 0, 2, no
56493633,  giovannaperduca, 2, 0, 2, no
2846735915,  ciscaleva, 1, 0, 1, no
437426255,  IvhanBurellos, 1, 0, 1, no
757861360864747521,  ellen_gambato, 1, 0, 1, no
491088290,  LorenzoMonni, 2, 0, 2, no
55419861,  barbalberoita, 1, 0, 1, no
413836005,  Clau_Dea74, 4, 0, 4, no
118058340,  TotiCamiolo, 1, 0, 1, no
252116102,  locedrola, 1, 0, 1, no
545883686,  _cristiano73, 2, 0, 2, no
407296746,  FGPo, 1, 0, 1, no
419831287,  lostragio, 1, 0, 1, no
1499415128,  nino__malo__, 1, 0, 1, no
102620569,  Panzernet, 1, 0, 1, no
528915795,  MircoSiri, 2, 0, 2, no
1064161034,  giannirus, 1, 0, 1, no
2589042406,  VitalinoGhiani, 1, 0, 1, no
458236217,  cosefra, 1, 0, 1, no
2848013902,  cristinaannam, 20, 0, 20, no
1724956302,  aglaja_amado, 1, 0, 1, no
775381846695837696,  ElvioCecchinato, 1, 0, 1, no
47758527,  remofer, 1, 0, 1, no
713403141035802624,  Passione_Civile, 1, 0, 1, no
275001458,  alliepistono, 1, 0, 1, no
3290543183,  mariaelenap88, 1, 0, 1, no
333359902,  GiuseAndre, 1, 0, 1, no
1318560558,  ByronBanguera, 1, 0, 1, no
3784148609,  madame_sin, 5, 1, 4, no
338884518,  ciaffa94, 2, 0, 2, no
422419297,  AlexAbramo, 1, 0, 1, no
379856999,  PallePerse, 1, 0, 1, no
2386873076,  Tas_89tas, 1, 0, 1, no
234432349,  n3m0scrapbook, 1, 0, 1, no
388459278,  Luisacatanese, 1, 0, 1, no
2400081577,  sattamatteo, 1, 0, 1, no
299892356,  nfl77, 1, 0, 1, no
146590259,  Salva84, 1, 0, 1, no
3063936611,  PerlaMiseriah, 3, 0, 3, no
249254321,  beppe54, 1, 0, 1, no
181302619,  _Call_Me_Liv, 1, 0, 1, no
93209808,  Gianpymalatesta, 3, 0, 3, no
418182710,  blumichelangelo, 1, 0, 1, no
703580095693385728,  fabrygrifo1974, 3, 0, 3, no
2454677914,  pabumba, 1, 0, 1, no
50456514,  iurisperitus, 1, 0, 1, no
2394639802,  micheletropi, 1, 0, 1, no
109504226,  wikipolis, 1, 0, 1, no
1234787275,  trucchia_alesmi, 1, 0, 1, no
495020368,  StefanoSSenior, 2, 0, 2, no
794168077,  danielesartore, 1, 0, 1, no
1080528002,  WSalvaterra, 1, 0, 1, no
1895168010,  martino_liva, 1, 0, 1, no
36197539,  Cippo1987, 2, 0, 2, no
376069634,  CarloRM61, 1, 0, 1, no
486569755,  lelelanzeni, 1, 0, 1, no
256660575,  alegissi, 1, 0, 1, no
2586223540,  RicciApe, 3, 1, 2, no
232296285,  giampieri_f, 4, 0, 4, no
397597107,  Oi_livio, 1, 0, 1, no
424571011,  leonardosalern2, 2, 0, 2, no
26639870,  labrumdelm, 1, 0, 1, no
943158858,  StellaFerrari80, 1, 0, 1, no
624994930,  CorriereG, 2, 0, 2, no
4924108648,  Silvia_Rose85, 1, 0, 1, no
53396756,  MatteoinivlaS, 1, 0, 1, no
283252587,  luigsab, 6, 0, 6, no
637195543,  siberiano5, 1, 0, 1, no
306686257,  croazia1, 2, 0, 2, no
1010914416,  FollettoFunky, 1, 0, 1, no
2491289936,  fantazita, 1, 0, 1, no
2325991760,  padanianb, 1, 0, 1, no
58009888,  Stefem, 1, 0, 1, no
1051035307,  Fr_Cannone, 1, 0, 1, no
4240753708,  GraziaCicc, 1, 0, 1, no
13479882,  manmatteo, 1, 0, 1, no
2459668985,  mirza16mir, 1, 0, 1, no
3053917222,  sagace424, 1, 0, 1, no
6743422,  caprikorn, 1, 0, 1, no
93705477,  giamartoc, 1, 0, 1, no
484005172,  GonnelliLuca, 1, 0, 1, no
4142289802,  TiaBattistini, 1, 0, 1, no
1885903771,  blkberrynights, 2, 0, 2, no
488478458,  RodyDad, 1, 0, 1, no
1370248890,  PlutoDany, 2, 0, 2, no
2233436648,  madrixlou, 1, 0, 1, no
544559226,  RobertoDepp, 1, 0, 1, no
2829406336,  giulia_gaudenzi, 1, 0, 1, no
1196898859,  nonviolento, 1, 0, 1, no
1606480278,  evpossibile, 2, 0, 2, no
28573067,  marabergomi, 1, 0, 1, no
500096388,  Giubetta, 1, 0, 1, no
1673946037,  giosal1955, 1, 0, 1, no
776474823547555840,  mariagiuliagg, 1, 0, 1, no
241350669,  PaoloProtop, 1, 0, 1, no
980154938,  mikybott2012, 2, 0, 2, no
83555860,  Davidissimo, 1, 0, 1, no
402987347,  bogontwitta, 1, 0, 1, no
1464208735,  ValoreLavoro, 3, 0, 3, no
2390000516,  TipoMoro, 3, 0, 3, no
881014213,  Paolo_Tumolo, 1, 0, 1, no
2938374375,  AndrArma1980, 1, 0, 1, no
167458005,  trisino, 1, 0, 1, no
426731073,  80sebasta, 1, 0, 1, no
400035492,  Gogodemarchis, 1, 0, 1, no
483218400,  ParvusMus, 1, 0, 1, no
2485484660,  PinelliFederica, 1, 0, 1, no
1329181153,  SusannaGaruti, 1, 0, 1, no
1267205780,  ClaBertuzzi1, 1, 0, 1, no
3145657781,  grecomarialaura, 1, 0, 1, no
1718257914,  cescachi, 1, 0, 1, no
397271314,  RobertaLisi1, 1, 0, 1, no
3099635259,  annah_anita, 2, 0, 2, no
31107308,  dav1d3, 1, 0, 1, no
622237378,  StefanoCrosara, 1, 0, 1, no
899443068,  emilnaca, 1, 0, 1, no
785391553716035584,  pro_fiore, 1, 0, 1, no
2674541642,  Meo1948Rm, 1, 0, 1, no
419630516,  GiancarloMatzeu, 2, 0, 2, no
3187818934,  arciprato, 1, 0, 1, no
3075722931,  BernardoArbusti, 1, 0, 1, no
823490869,  viamarconi8, 1, 0, 1, no
12403482,  mariopesce, 1, 0, 1, no
282206798,  mchiaragenovese, 2, 0, 2, no
400619636,  traderscomessa, 3, 0, 3, no
4877204938,  Claudio035210, 2, 0, 2, no
418142650,  CaesarSalade, 3, 0, 3, no
2814370229,  cgilrimini, 1, 0, 1, no
796124878294446080,  orsonapo1960, 1, 0, 1, no
2929361351,  FilleaEmiliaR, 1, 0, 1, no
507195444,  SpiCgilER, 1, 0, 1, no
3694828035,  gei_ste, 1, 0, 1, no
731100264774651904,  _vatan_das, 6, 0, 6, no
50637276,  Piripilla, 1, 0, 1, no
2176682146,  DanielePirozzi, 1, 0, 1, no
3353248005,  FIfrosinone, 1, 0, 1, no
3183628949,  94_giovani, 1, 0, 1, no
4714487295,  figprov, 3, 0, 3, no
776331394607898624,  comitatoNoFigRm, 1, 0, 1, no
487789216,  Nunzio_Saviano, 2, 0, 2, no
466358678,  DiegoDelPro, 1, 0, 1, no
1680602498,  carryflag, 1, 0, 1, no
1056321552,  PaoloMTweet, 1, 0, 1, no
740305952046452737,  UglLatina, 1, 0, 1, no
426555682,  ninimuzzi, 1, 0, 1, no
912041082,  biomillarte, 1, 0, 1, no
391448955,  GioDeJa, 2, 0, 2, no
718873030676582400,  MimmoRelax, 1, 0, 1, no
293183196,  ConilSud, 1, 0, 1, no
69209482,  gcenturelli, 1, 0, 1, no
743420210422648832,  Diaboli98522633, 4, 0, 4, no
716119452304154625,  Pietroleone80, 1, 0, 1, no
474926682,  CGILBari, 2, 0, 2, no
468670990,  cgilpuglia, 1, 0, 1, no
4182189322,  tiziana_tzn, 1, 0, 1, no
2167105112,  spicgilpuglia, 1, 0, 1, no
458400129,  Redazione_ROARS, 1, 0, 1, no
866449578,  marymariani86, 1, 0, 1, no
82849145,  andsigno, 2, 0, 2, no
2921067351,  DotaEnzo, 1, 0, 1, no
3309536651,  Giusepp11426282, 1, 0, 1, no
539277206,  LuigiCuccitto, 1, 0, 1, no
3420048107,  Manilanazzaro, 1, 0, 1, no
1449933242,  LBrogialdi, 1, 0, 1, no
330377596,  MarioDeLeo, 1, 0, 1, no
951231186,  Fiorenzochef, 1, 0, 1, no
517936381,  IlenaCaroli, 1, 0, 1, no
143423461,  DanyCifarelli, 1, 0, 1, no
4879423979,  CampolucciLuana, 1, 0, 1, no
2182154051,  MarRos824, 1, 0, 1, no
2494036502,  GrazziniMichele, 1, 0, 1, no
416644604,  ronas58, 1, 0, 1, no
361788030,  DenisNesci, 1, 0, 1, no
1218018804,  sanspapier66, 1, 0, 1, no
250171655,  saturninox, 1, 0, 1, no
597192031,  FoggiaCittaAper, 1, 0, 1, no
802151489380765696,  fernandomogaver, 5, 1, 4, no
3825806842,  LaylaOHK, 1, 0, 1, no
432053287,  marinabeccuti, 1, 0, 1, no
974503058,  angelociani2, 1, 0, 1, no
240642244,  gianpierozinzi, 2, 0, 2, no
1493349302,  OwlRunning, 1, 0, 1, no
17442496,  gloriabaldoni, 1, 0, 1, no
123291306,  Extra4four, 1, 0, 1, no
397384907,  LucAnnaRomano, 2, 0, 2, no
3184242461,  BucciGigia, 1, 0, 1, no
299620549,  DanieleFinassi, 1, 0, 1, no
250249728,  popama_, 1, 0, 1, no
2966157297,  ArcheoLogica, 1, 0, 1, no
396805970,  massimodeflorio, 1, 0, 1, no
131799077,  GiovanniPa, 1, 0, 1, no
1065761461,  LaceteraFabio, 1, 0, 1, no
43657967,  felixpiemontese, 1, 0, 1, no
945543204,  Twittjamm, 1, 0, 1, no
722364988095074308,  andrea09975000, 1, 0, 1, no
3360426029,  TwocentsTweets, 1, 0, 1, no
818078472,  GiuliaFacilla, 1, 0, 1, no
1402093044,  Garganoeventi, 1, 0, 1, no
2182046839,  Roberta_M_12, 1, 0, 1, no
805315714844397568,  alfonso_terni, 2, 0, 2, no
1037333550,  CiccioTralli, 1, 0, 1, no
84611230,  finoralescani, 1, 0, 1, no
1148946800,  Cicco140, 1, 0, 1, no
527576859,  CrisDiBlasi, 1, 0, 1, no
3313144456,  magariavessi, 1, 0, 1, no
359605242,  DomenicoMicc, 1, 0, 1, no
221841366,  stepecorella, 2, 0, 2, no
1074049374,  CampagnaMarzia, 2, 0, 2, no
151142367,  AndreaLisco, 1, 0, 1, no
1640805493,  MarcoCerasino, 1, 0, 1, no
2885402735,  kedelvecchio, 1, 0, 1, no
3300924790,  cruccumanuela, 1, 0, 1, no
479571162,  GioVegliante, 1, 0, 1, no
2463260997,  lanza_84, 1, 0, 1, no
3300444479,  lovemanfredonia, 1, 0, 1, no
706567527304974336,  Amela_11, 1, 0, 1, no
238107344,  FlavioTroja, 1, 0, 1, no
383820352,  _Sblendorio, 1, 0, 1, no
1037305130,  anin09190671, 1, 0, 1, no
4706925940,  SegreteriaVisit, 1, 0, 1, no
166285112,  28_05_2003, 1, 0, 1, no
3254462871,  MignoloClamgn, 1, 0, 1, no
556357599,  RufusGio, 2, 0, 2, no
2429121827,  CorradoPrati, 1, 0, 1, no
470301417,  FpCgilNazionale, 1, 0, 1, no
3099073484,  _S_T_A_N_D, 1, 0, 1, no
4878348543,  ItaliaCelere, 2, 0, 2, no
802824171755597824,  Hannibalbau, 1, 0, 1, no
802230069179666433,  GayLiberali, 1, 0, 1, no
252588117,  stelfia, 1, 0, 1, no
786904848692289541,  giuliasidd, 1, 0, 1, no
3351720815,  FIGLazio, 1, 0, 1, no
803954858000809985,  GattaTetto, 1, 0, 1, no
421120188,  SavareseVincenz, 2, 0, 2, no
1104133098,  twittatore31, 1, 0, 1, no
428476526,  JacopoCiccani, 1, 0, 1, no
4494003293,  FI_Sardegna, 1, 0, 1, no
134431419,  Ditrast, 1, 0, 1, no
1055810162,  Carmine_52, 1, 0, 1, no
2931666383,  gi_stra, 2, 0, 2, no
309575298,  andreazet, 2, 0, 2, no
951280753,  PirelliLorenzo, 7, 1, 6, no
3367934717,  FabioPinazzo, 1, 0, 1, no
714417878,  GabriGiammanco, 8, 0, 8, no
2610857110,  FeliceBrancati, 1, 0, 1, no
76863835,  Kalotipia, 1, 0, 1, no
705449054248034304,  ttentamente, 4, 0, 4, no
1287447402,  Cybrarian64, 1, 0, 1, no
2761058821,  MBensoni, 1, 0, 1, no
2299875428,  3999Alien, 1, 0, 1, no
2315855603,  E_Belluzzo, 1, 0, 1, no
2844136676,  mariapizzino94, 1, 0, 1, no
2416068015,  valeriodeb, 2, 0, 2, no
757977140491087872,  Elisabetta_ESS, 1, 0, 1, no
3331498624,  ScialpiDebora, 1, 0, 1, no
435737042,  paopalea, 1, 0, 1, no
3802794617,  PrinceKastaDOr, 3, 0, 3, no
3410200684,  robyeverfree, 1, 0, 1, no
1882562786,  FI_Veneto, 1, 0, 1, no
459430520,  michele_zuin, 1, 0, 1, no
454782176,  RBazzarello, 1, 0, 1, no
183132441,  alessandrobersi, 1, 0, 1, no
261635491,  lovisport, 1, 0, 1, no
1259206496,  BianzaleManuel, 1, 0, 1, no
3426426969,  sirottigaudenzi, 1, 0, 1, no
921162848,  Marin63Marco, 1, 0, 1, no
2460235493,  fedmontevecchi, 1, 0, 1, no
3400111648,  GGazze07, 1, 0, 1, no
3410755455,  giovit1961, 1, 0, 1, no
747427933443264512,  easylollo, 1, 0, 1, no
291985468,  GiammariaMelani, 1, 0, 1, no
706451584851566592,  Neyx_, 2, 0, 2, no
2393267188,  DanieleBenini3, 1, 0, 1, no
4661080342,  bressanuttiang1, 1, 0, 1, no
764215328528269313,  massimo_boscia, 3, 0, 3, no
284071406,  francesco96s, 1, 0, 1, no
357584516,  AndresSanto_, 2, 0, 2, no
1073360574,  Ambrogio2001, 1, 0, 1, no
3362536689,  marina_iorio26, 1, 0, 1, no
344138094,  Armando_incz, 2, 0, 2, no
733346979925905408,  diremario, 1, 0, 1, no
426886525,  diegh74, 1, 0, 1, no
263179271,  manusnella, 1, 0, 1, no
724805793594363905,  Lilianabini1, 1, 0, 1, no
722734060284604416,  Sbreighs, 1, 0, 1, no
711691056878714880,  bayon_giovanna, 1, 0, 1, no
337587506,  giummino, 1, 0, 1, no
575436900,  GiovanniTancini, 1, 0, 1, no
57066122,  Basti4n, 1, 0, 1, no
798869652415938560,  michel__vitale, 1, 0, 1, no
633232379,  GessiMenichelli, 1, 0, 1, no
791347713614946305,  siempanc, 1, 0, 1, no
529822329,  CristianoMento, 1, 0, 1, no
799657351334731776,  stanzanifilippo, 1, 0, 1, no
2361214418,  ForaniDaniele, 1, 0, 1, no
125950791,  mimmo62, 1, 0, 1, no
1459430522,  ChristianGerde2, 1, 0, 1, no
2269002804,  pierovernaccini, 1, 0, 1, no
402645799,  goppaiperdu, 1, 0, 1, no
277725208,  anna2482003, 1, 0, 1, no
1013035693,  ElisaVolpetti, 1, 0, 1, no
1259410686,  monogres, 1, 0, 1, no
180834935,  leonardocarella, 1, 0, 1, no
468782303,  icemastromatteo, 1, 0, 1, no
411315576,  RTarussello, 1, 0, 1, no
1223264108,  francesco_danna, 2, 0, 2, no
1640005182,  milazzo_pietro, 1, 0, 1, no
180029912,  bosonedihiggs, 1, 0, 1, no
136686643,  WriterAnnaBells, 1, 0, 1, no
482396556,  BroganMonty, 1, 0, 1, no
735880222243971072,  68_fabrizio, 2, 0, 2, no
806069030499024896,  romilodise, 1, 0, 1, no
273654471,  GRinaldini, 1, 0, 1, no
772423638544941056,  IlM5s, 1, 0, 1, no
781774392262955008,  Veruz060185, 1, 0, 1, no
2375326314,  Sydrobby, 1, 0, 1, no
1053432726,  agzshiro, 1, 0, 1, no
433223568,  sergio8111963, 3, 0, 3, no
55865413,  misswrit, 1, 0, 1, no
1015578030,  LinoDeMatteis, 1, 0, 1, no
390226814,  Oibaf_Isot, 1, 0, 1, no
399011672,  maggi_marco, 1, 0, 1, no
465658194,  222256789, 1, 0, 1, no
540816002,  cavolofiore, 1, 0, 1, no
121551906,  Cloesdays, 1, 0, 1, no
1077801097,  steffvolponius, 2, 0, 2, no
151632758,  VinzCorrado, 1, 0, 1, no
311074404,  amestratus, 1, 0, 1, no
152608093,  Fabriscalzi, 1, 0, 1, no
1028510078,  danielecane, 2, 0, 2, no
30331417,  evgenymorozov, 1, 0, 1, no
348503076,  MarcoToniolo, 1, 0, 1, no
2235916268,  Boske_DG, 1, 0, 1, no
584085438,  Nolan3802, 1, 0, 1, no
112664102,  Chycca, 2, 0, 2, no
155109665,  Giorgioven, 1, 0, 1, no
1102257895,  RVerbi, 1, 0, 1, no
221089264,  victorlaszlo88, 1, 0, 1, no
91967472,  onefitmn, 1, 0, 1, no
2685703353,  giuseppecai1, 1, 0, 1, no
1246085041,  AndreaScanzati, 1, 0, 1, no
1487833586,  allatiziana, 1, 0, 1, no
1348514569,  darcoSan, 2, 0, 2, no
727474294306033665,  silvestro_gi, 1, 0, 1, no
1298956886,  pamypou, 1, 0, 1, no
484784657,  cinziamitika, 5, 0, 5, no
3067898403,  sandrocapretti, 2, 0, 2, no
790347584120381440,  Justice3999, 1, 0, 1, no
796004787049336836,  CristianaCapor, 1, 0, 1, no
576773535,  paoloxbaroni, 1, 0, 1, no
1688088199,  ___catia, 1, 0, 1, no
4853387764,  feliziani_fabio, 1, 0, 1, no
114812293,  alessandrinigen, 1, 0, 1, no
796053127447347200,  VenturiniLSA, 1, 0, 1, no
210476331,  dvaragnolo, 1, 0, 1, no
254233000,  8oltremare, 1, 0, 1, no
795909939164315648,  CarlorfBasso, 1, 0, 1, no
311924133,  AMG_67, 1, 0, 1, no
2787877105,  __Martinello, 1, 0, 1, no
1397599338,  obelaspeza, 1, 0, 1, no
266509631,  pinoneforever, 1, 0, 1, no
756883418,  SanteTricarico, 1, 0, 1, no
768090316612243456,  Prioma2, 1, 0, 1, no
569006883,  GiselleMartino3, 1, 0, 1, no
1068434126,  monitoreromano, 1, 0, 1, no
3037470958,  Azrael899, 1, 0, 1, no
2789862845,  AngelaDPsenior, 1, 0, 1, no
422913943,  IsaTofee, 1, 0, 1, no
401970520,  stefanodina, 1, 0, 1, no
63444111,  aleendo, 1, 0, 1, no
4882825911,  NoOiL666, 3, 0, 3, no
424322762,  MiaomiaoCh, 1, 0, 1, no
431964962,  ricmeo, 1, 0, 1, no
549982210,  CambiareDavvero, 1, 0, 1, no
314712733,  Eissad64, 1, 0, 1, no
2181843523,  paolodeluca72, 3, 0, 3, no
2893477857,  biciversilia, 1, 0, 1, no
1171509590,  PietroBruno12, 1, 0, 1, no
1041831000,  sciantokescia, 2, 0, 2, no
1880756130,  easysister, 1, 0, 1, no
228121512,  tgtourism, 1, 0, 1, no
1667558509,  parcoacquedotti, 5, 0, 5, no
476844153,  FabrizioIta881, 1, 0, 1, no
546828454,  marcohilo, 1, 0, 1, no
493901532,  barbara75toud, 1, 0, 1, no
1178041686,  Aletta_rm, 3, 0, 3, no
57474419,  pietroberga, 1, 0, 1, no
2208429460,  steftak, 1, 0, 1, no
567054197,  DonnaCigno, 1, 0, 1, no
3434374247,  uniamoci_net, 3, 0, 3, no
44206038,  simisimi1972, 1, 0, 1, no
80823138,  simonecerbella, 1, 0, 1, no
2245999991,  Sofia_1_vv, 1, 0, 1, no
3103745741,  mcristinatocci, 1, 0, 1, no
351426252,  astarotte59, 1, 0, 1, no
473236373,  pietrodagostini, 1, 0, 1, no
2274799961,  dottormarcelli, 1, 0, 1, no
306205121,  redbookcarrier, 1, 0, 1, no
727142686688419841,  BoboilSemplice, 1, 0, 1, no
424054992,  SilvanaRovai, 1, 0, 1, no
440054435,  jlesel, 1, 0, 1, no
614322175,  TerraAmbr0se, 1, 0, 1, no
404663122,  gigiomous, 1, 0, 1, no
179984406,  SunnySabry, 1, 0, 1, no
260408682,  fedecentrico, 1, 0, 1, no
428243916,  piccolimaestri, 2, 0, 2, no
3371020601,  BaobabExp, 3, 0, 3, no
590726647,  simone7175, 1, 0, 1, no
2410197857,  Fedex312, 1, 0, 1, no
105218121,  urbelab, 1, 0, 1, no
768476862905479168,  salvatore_pede, 1, 0, 1, no
2163358854,  benzinazero, 1, 0, 1, no
487048219,  DanielCarax, 1, 0, 1, no
3382239311,  sicurinstrada, 1, 0, 1, no
760790168358031364,  Fiorella0003, 1, 0, 1, no
596634369,  RomanaLiuzzo, 1, 0, 1, no
2331085157,  PPANthebrief, 1, 0, 1, no
1197078822,  DisinfoATAC, 3, 0, 3, no
607424962,  amorlucis, 1, 0, 1, no
2829235384,  KlaatuN, 2, 0, 2, no
421691549,  danielesrw, 1, 0, 1, no
236739780,  PaoloIzzo, 2, 0, 2, no
162000741,  Animalistiitaly, 1, 0, 1, no
3817957395,  ViscusiElena, 1, 0, 1, no
28116095,  carlomatt, 4, 0, 4, no
451430891,  scarmat_, 1, 0, 1, no
210636450,  f_random, 1, 0, 1, no
1108371631,  Pat_Marrocco, 1, 0, 1, no
733984270499319808,  ego_sono, 20, 0, 20, no
768869991064211456,  SalrosSalvatore, 1, 0, 1, no
553600293,  rutifra, 1, 0, 1, no
2330906381,  LucianoSiri68, 9, 0, 9, no
354366770,  marcodimarco87, 1, 0, 1, no
90501152,  riko973, 1, 0, 1, no
329694687,  parcoappia, 2, 0, 2, no
2952909982,  CoppolaFrances5, 1, 0, 1, no
1142639090,  gattoboots, 1, 0, 1, no
3958590737,  francylistarm, 1, 0, 1, no
1140881040,  Ivan74C, 1, 0, 1, no
748527449932181504,  biban_guido, 1, 0, 1, no
3293491207,  SiTro82, 1, 0, 1, no
483635358,  runnerstef, 2, 0, 2, no
602706933,  StregaLorelei, 1, 0, 1, no
2280679352,  Ilpizzardone, 2, 0, 2, no
498956277,  SemplificaSas, 1, 0, 1, no
979131565,  robdimol, 1, 0, 1, no
12776392,  Yogasadhaka, 1, 0, 1, no
2482366382,  RobertoDel1955, 1, 0, 1, no
467265563,  MakxBarbi, 1, 0, 1, no
2977084942,  FLabella11, 1, 0, 1, no
3082906144,  lauraconlange, 1, 0, 1, no
1176522596,  wikipazz, 2, 0, 2, no
1037695476,  claumartino1952, 2, 0, 2, no
376070429,  Millo_82, 1, 0, 1, no
375484576,  lexsky03, 3, 0, 3, no
1462217611,  __Misantropia, 3, 0, 3, no
384757380,  SimoneSonnino, 1, 0, 1, no
306160885,  simonilla23, 1, 0, 1, no
371443272,  brandocanide, 5, 0, 5, no
2361705150,  kronos1980, 1, 0, 1, no
2530749611,  FeduzziMassi, 1, 0, 1, no
632913839,  AugustoCrespi, 1, 0, 1, no
1089769556,  infomolo55, 1, 0, 1, no
491076241,  robertocarvelli, 1, 0, 1, no
170689777,  ValeriaDesign, 1, 0, 1, no
479794355,  AWondercakes, 1, 0, 1, no
883108542,  ellabaffoni, 1, 0, 1, no
803253014878388224,  Pisce_it, 2, 0, 2, no
44340289,  ub1settantun0, 1, 0, 1, no
779420777317883904,  araitapersempre, 1, 0, 1, no
2837707258,  marinoamedeo3, 2, 0, 2, no
429422542,  twidado, 1, 0, 1, no
509309976,  FraespoEsposito, 1, 0, 1, no
578436775,  SilviaPizei, 1, 0, 1, no
14844426,  kLn69, 1, 0, 1, no
569528684,  FedericaSaraZol, 1, 0, 1, no
52003616,  LuigiFunari, 1, 0, 1, no
341048101,  Scjx, 1, 0, 1, no
1368234301,  emanuelmaddalen, 5, 0, 5, no
106542611,  zazaraziel, 1, 0, 1, no
319769760,  LivioMeacci, 1, 0, 1, no
115764177,  LorussoFabrizio, 1, 0, 1, no
1259239400,  DeniseScaramell, 2, 0, 2, no
2795074967,  lucinun, 1, 0, 1, no
3379963119,  AtacMerda, 1, 0, 1, no
1880948568,  amp0129, 1, 0, 1, no
788822353048432644,  Frances83358515, 1, 0, 1, no
3202085314,  EmanEleon, 1, 0, 1, no
1020020185,  Rosy9x, 1, 0, 1, no
3939037995,  giovanni_cerva, 1, 0, 1, no
8239432,  maus75, 4, 0, 4, no
802152857759842304,  barbarasertori, 2, 0, 2, no
1163827946,  PaoloVani, 1, 0, 1, no
2633956390,  SONIA051971, 2, 0, 2, no
632735778,  Aiyo07, 1, 0, 1, no
522616321,  GALIX77, 2, 0, 2, no
2949854579,  214c001cafda41f, 1, 0, 1, no
950216629,  old_marlet, 2, 0, 2, no
172503199,  ShioinYoruichi, 1, 0, 1, no
2964821891,  EnricoPazzi, 1, 0, 1, no
428006506,  BartoloTaormina, 1, 0, 1, no
1876630176,  supportersmagaz, 1, 0, 1, no
2743258907,  uspalletti, 1, 0, 1, no
777922906496102400,  MicAmato81, 1, 0, 1, no
2670574903,  2MunicipioRm, 2, 0, 2, no
2619826325,  Lally238, 1, 0, 1, no
310105359,  neopat2007, 1, 0, 1, no
15890886,  lucaboccianti, 1, 0, 1, no
2706096814,  colledegliabeti, 1, 0, 1, no
710806725,  tzaretta, 2, 0, 2, no
3094856279,  GanapiniMaurena, 1, 0, 1, no
420668866,  vivianabroglio, 1, 0, 1, no
266458661,  Falzarego, 3, 0, 3, no
1148764633,  durlindana69, 1, 0, 1, no
721184007,  MicRuggiero, 1, 0, 1, no
382788418,  _lo_ce, 1, 0, 1, no
2250674359,  SULPLROMA, 1, 0, 1, no
2262267598,  federtaxiroma, 1, 0, 1, no
626636550,  marconap75, 1, 0, 1, no
4736696753,  GuidoT29, 1, 0, 1, no
131544026,  DomenicoDB, 1, 0, 1, no
174802800,  ariadnestella, 1, 0, 1, no
2490233792,  lithinglife, 1, 0, 1, no
633805675,  MayoImpazzita, 1, 0, 1, no
149859582,  KavanTropia, 1, 0, 1, no
2517333900,  romandergra, 1, 0, 1, no
402974667,  stefanomarini, 1, 0, 1, no
141677910,  GianmariaPica, 1, 0, 1, no
984716708,  CosBasta, 1, 0, 1, no
323146830,  GiudyP, 1, 0, 1, no
159562066,  DonatellaLiuzzi, 1, 0, 1, no
711096762900025349,  nicopando71, 1, 0, 1, no
1011859734,  wileCoyote81, 1, 0, 1, no
2613282376,  EnricoTerrinoni, 1, 0, 1, no
161719940,  _Honeycomb_, 1, 0, 1, no
629334187,  PaoloSabbatucci, 1, 0, 1, no
2935087216,  AlexDeCinti, 1, 0, 1, no
793526411336228864,  Smartjoepress, 1, 0, 1, no
962101518,  marcostefanovit, 2, 0, 2, no
231011153,  paopape, 1, 0, 1, no
103595040,  dadadanix, 1, 0, 1, no
4004995319,  PazzoCarbonaro, 1, 0, 1, no
326157457,  MECK187, 2, 0, 2, no
2362414955,  DnlAmbrosini, 1, 0, 1, no
3051006873,  Azzurra366, 1, 0, 1, no
384818191,  FabrizioMaiozzi, 1, 0, 1, no
322728085,  Alisernio, 1, 0, 1, no
2872761441,  Davidejanoski, 1, 0, 1, no
1334303052,  moioisabella, 1, 0, 1, no
418530644,  Udaloy2, 2, 0, 2, no
3293156833,  Gelso02, 2, 0, 2, no
2331003771,  cinquantuno63, 2, 0, 2, no
797527253458554880,  Roberto08087298, 1, 0, 1, no
36636510,  lukilotom, 1, 0, 1, no
2923701220,  mrnnni, 1, 0, 1, no
31073250,  dacher70, 1, 0, 1, no
1523391000,  dedalasa, 1, 0, 1, no
91598969,  papero33, 1, 0, 1, no
279488511,  JennyTheComet, 1, 0, 1, no
2313838855,  filippo1936, 1, 0, 1, no
802208027038351360,  MariatittaRita, 1, 0, 1, no
1042958780,  ManiniLuciano, 1, 0, 1, no
1245673243,  GinnuzzuLuigi, 1, 0, 1, no
1395576606,  STEVE_241, 2, 0, 2, no
1430355200,  elaza78_mily, 2, 0, 2, no
287913024,  francescodefeo0, 1, 0, 1, no
138850923,  Leo_nardone, 2, 0, 2, no
1316738234,  CarloSeneci, 1, 0, 1, no
2365041713,  nuvoletta49, 1, 0, 1, no
460964150,  AngeloAspen, 1, 0, 1, no
21331752,  pierdonnini, 1, 0, 1, no
1172609270,  GmTafalia66, 2, 0, 2, no
278663070,  Sonya_Merenwen, 1, 0, 1, no
17465312,  elandel, 1, 0, 1, no
432314687,  gminacapelli, 1, 0, 1, no
758723224486150146,  degliesposti555, 1, 0, 1, no
345355078,  annakoj, 1, 0, 1, no
47699270,  lilloraffa, 1, 0, 1, no
774947929052291072,  Fulvio36491818, 2, 0, 2, no
770987858278674432,  anna_lucantoni, 1, 0, 1, no
3243634917,  Ercole50062492, 1, 0, 1, no
2156447281,  Lordbrady, 1, 0, 1, no
4612076177,  elisabettafabb, 2, 0, 2, no
418941097,  GabrieleMeoni, 1, 0, 1, no
1367853685,  slimnessseeker, 1, 0, 1, no
1249837879,  salvatorealotta, 8, 0, 8, no
801870748524625920,  Salvato12832415, 1, 0, 1, no
767063814235942913,  antonyconguero, 4, 0, 4, no
1269713336,  MartaGrande87, 1, 0, 1, no
264741422,  GioCheru, 9, 0, 9, no
1947326047,  Nervjc, 1, 0, 1, no
915103669,  Ale_Valenzise, 2, 0, 2, no
805559589177593856,  geremiatr, 1, 0, 1, no
2354652397,  astro_gianf, 1, 0, 1, no
777410247698841600,  giampaolo581, 2, 0, 2, no
129916269,  nonabbiatepaura, 1, 0, 1, no
496059257,  Luca_Sferrazza, 1, 0, 1, no
2276721335,  manuanto87, 2, 0, 2, no
1001206868,  Lucantarello, 2, 0, 2, no
467443952,  Philippe_FQSP, 1, 0, 1, no
712723654111588353,  cibi7299, 2, 0, 2, no
2284121413,  Rudi_trento, 1, 0, 1, no
2973475863,  MasiStefano6, 1, 0, 1, no
163822088,  refolina, 1, 0, 1, no
1285999218,  JDanloor, 1, 0, 1, no
973620294,  vincult, 1, 0, 1, no
2328757685,  AngelsMelanco, 1, 0, 1, no
20221833,  SuckMyLEFTJuan, 1, 0, 1, no
3147465341,  luigi_lucaselli, 1, 0, 1, no
60585080,  nicolafocci, 1, 0, 1, no
1320924583,  Gaetano2803, 1, 0, 1, no
549605964,  aledamato1, 1, 0, 1, no
1962640886,  Mr_Ribbo, 1, 0, 1, no
238817640,  mauri_bruzzone, 2, 0, 2, no
805849648569139200,  LuigiGrieco6, 1, 0, 1, no
227199711,  ilvecchioHolden, 1, 0, 1, no
141905030,  bigetto, 1, 0, 1, no
420277197,  Melinda_67, 1, 0, 1, no
760739499236360194,  simocoraggio, 1, 0, 1, no
1382712390,  cfbuffa, 1, 0, 1, no
464680955,  SASSOMICHELE, 1, 0, 1, no
1265473094,  Pat_Manzo, 1, 0, 1, no
75249690,  LuigiStarace, 2, 0, 2, no
829395187,  CabaTattoo, 2, 0, 2, no
590280820,  DINOPiluso, 1, 0, 1, no
2908260178,  GzZanutel, 1, 0, 1, no
1104380844,  ilarial94, 1, 0, 1, no
2255399935,  BaldassarriGiu, 1, 0, 1, no
2897894483,  AlbertoStulfa, 1, 0, 1, no
540761209,  alfo_innuendo, 1, 0, 1, no
286226119,  marcobruno999, 1, 0, 1, no
803477847117598721,  hotscritimver11, 1, 0, 1, no
517651649,  Eleluna83, 1, 0, 1, no
1059018253,  mluis1508, 2, 0, 2, no
1564993735,  rocco_rtlupin, 2, 0, 2, no
853465500,  NostroGianluca, 1, 0, 1, no
1274727440,  giovannicafori1, 1, 0, 1, no
607659598,  SarahFlorGrundy, 4, 0, 4, no
337348136,  LuisellaPasinel, 1, 0, 1, no
83886546,  roxygi, 2, 0, 2, no
727924653407260672,  SigSergio70, 1, 0, 1, no
1272189564,  ASTORPIER, 1, 0, 1, no
3065652119,  NoSiX96, 1, 0, 1, no
473121090,  VladiMurtas, 1, 0, 1, no
2821253656,  davideciurleo, 2, 0, 2, no
414225292,  claudiociancale, 1, 0, 1, no
4353254315,  Hermann_74, 2, 0, 2, no
539425700,  GabrieleCaimi, 1, 0, 1, no
230233730,  apelatti, 1, 0, 1, no
1498521200,  arkino82, 2, 0, 2, no
723554251612499968,  marionecomix, 7, 0, 7, no
2564764786,  SimoAsca, 1, 0, 1, no
588504107,  Ciemme68Claudio, 1, 0, 1, no
237879069,  TheLorenz74, 1, 0, 1, no
801504624,  MarioScfl, 1, 0, 1, no
3131557655,  raffarossi1606, 2, 0, 2, no
90935990,  JJ_OGStaff, 1, 0, 1, no
596682996,  223cotton, 1, 0, 1, no
4608476307,  marcomoschini20, 1, 0, 1, no
784661950286405632,  maryebasta63, 2, 0, 2, no
532610405,  SBazzano, 9, 0, 9, no
2333543961,  CapoferriLidia, 1, 0, 1, no
12660582,  cranius, 22, 0, 22, no
1392931717,  cristinamotta9, 1, 0, 1, no
3333003592,  pietro2015febb1, 1, 0, 1, no
53883,  miaotze, 1, 0, 1, no
858340783,  faustoaron, 1, 0, 1, no
574087401,  andreafdx, 1, 0, 1, no
145752036,  maxshore, 1, 0, 1, no
704746963091267584,  ascoltare2, 6, 0, 6, no
2224822652,  RemoRisoldiM5S, 1, 0, 1, no
1976578177,  ilrossoeilnero2, 2, 0, 2, no
795617180993912833,  Grazia66906651, 1, 0, 1, no
1213474032,  LilloMalillo, 1, 0, 1, no
564911536,  molfra66, 1, 0, 1, no
4120950795,  andrejkoimaskj, 1, 0, 1, no
333434977,  MlleSimona, 1, 0, 1, no
572802695,  angelosaer, 2, 0, 2, no
101765739,  fotoelite, 1, 0, 1, no
3230650755,  concy_manzi, 1, 0, 1, no
287818496,  fralogos32, 1, 0, 1, no
2284081610,  RinoAngeloni, 1, 0, 1, no
63562263,  cettinamellusi, 1, 0, 1, no
1965030139,  CausinPaolino, 1, 0, 1, no
799289611134570496,  Mantinetta, 1, 0, 1, no
576974264,  LCastellese, 1, 0, 1, no
2845226548,  Elybon1, 1, 0, 1, no
412877896,  AlbertSchiavone, 1, 0, 1, no
165001818,  ari1190, 1, 0, 1, no
2409138080,  EnricoBurzi, 2, 0, 2, no
799976204312973312,  c671cf893230427, 1, 0, 1, no
384575017,  alesort, 1, 0, 1, no
3147339230,  bony_rabbit, 1, 0, 1, no
519348439,  the_white_cloud, 1, 0, 1, no
434250277,  data971, 1, 0, 1, no
1124778091,  BiascoKatia, 1, 0, 1, no
592744715,  quamiuvat, 2, 0, 2, no
1261822464,  dibarolomeovinc, 1, 0, 1, no
207066712,  olcaponet, 2, 0, 2, no
707301670246600704,  harry59degroot, 1, 0, 1, no
1055093430,  EHuober, 1, 0, 1, no
449976360,  RossValsecchi, 1, 0, 1, no
2412339565,  Borghizio, 1, 0, 1, no
2189689654,  seresileoni, 1, 0, 1, no
3295324269,  Gattastraordina, 1, 0, 1, no
3039916030,  alessia_cinti, 1, 0, 1, no
803361578087251968,  skyfato, 1, 0, 1, no
2435980673,  77_russo, 1, 0, 1, no
1322053105,  laurapelosi2, 1, 0, 1, no
80838485,  andrea_piras_, 1, 0, 1, no
4603648397,  FilosofoDelCazz, 1, 0, 1, no
796720508427452416,  FLIPPER92843888, 3, 0, 3, no
712042147785080832,  ziocane66, 2, 0, 2, no
161074994,  tonytascino, 2, 0, 2, no
1017064423,  giuseppedisal14, 1, 0, 1, no
801133637911592960,  FernandoPuglie5, 2, 0, 2, no
973525898,  cosimo_adelizzi, 1, 0, 1, no
1094882970,  fontowan, 1, 0, 1, no
10468492,  albemai, 1, 0, 1, no
4575887902,  EnzaLuppino, 3, 0, 3, no
449759153,  MariaDAngelo4, 2, 0, 2, no
436226414,  fpezza, 1, 0, 1, no
14459385,  facio75, 1, 0, 1, no
384431924,  Lidia_Undiemi, 1, 0, 1, no
388891207,  ammaiFiamma, 1, 0, 1, no
2832460317,  Eziosserva, 1, 0, 1, no
751515989716660225,  Roberto94911, 1, 0, 1, no
756919771,  alastarte, 1, 0, 1, no
590943622,  RProti, 1, 0, 1, no
316375408,  DianaDalla, 1, 0, 1, no
221745046,  sailormars05, 1, 0, 1, no
741184122505289728,  EmekaSkd, 1, 0, 1, no
3028280830,  2008_lory, 2, 0, 2, no
393483438,  ilbolly, 1, 0, 1, no
49948347,  lukaduo, 1, 0, 1, no
988884571,  luisacinquestel, 1, 0, 1, no
2187882296,  Ali2_official, 1, 0, 1, no
3046854717,  DondiniLeonardo, 1, 0, 1, no
51423547,  antpa, 1, 0, 1, no
786871864752762880,  mad_maximi, 1, 0, 1, no
575059060,  FaustoBianchini, 1, 0, 1, no
451417249,  ClaudioFasani, 1, 0, 1, no
387087335,  nutella1963, 2, 0, 2, no
2225589287,  diamine71, 1, 0, 1, no
2869252114,  mircop6220, 1, 0, 1, no
1126084872,  SaiCheARoma, 1, 0, 1, no
498645635,  RRandazz, 2, 0, 2, no
1142594798,  V_Gulliver, 1, 0, 1, no
1387027693,  MircoAvanzo, 1, 0, 1, no
3424813330,  Beppe_Giuliano, 1, 0, 1, no
3227062253,  FedericoIIZ, 1, 0, 1, no
92525639,  pierovietti, 1, 0, 1, no
3866051891,  Ralfbevis, 1, 0, 1, no
215305370,  lele_74, 1, 0, 1, no
635668294,  mattegaet75, 1, 0, 1, no
748860623392505856,  PDenocratico, 1, 0, 1, no
794583917999357953,  Antonin0082291, 1, 0, 1, no
591979464,  snusiinfante, 1, 0, 1, no
338976684,  elmarkia, 2, 0, 2, no
2277800886,  emmepi_pr, 1, 0, 1, no
2498384664,  ely7389, 1, 0, 1, no
3546314488,  Mello_1988, 1, 0, 1, no
80038104,  Millazena, 1, 0, 1, no
394763740,  NMarsura, 1, 0, 1, no
52075535,  cristianodemajo, 1, 0, 1, no
1534580701,  TarantinaMente, 1, 0, 1, no
2592010609,  axelmojave, 1, 0, 1, no
125307930,  im_the_king_01, 1, 0, 1, no
2359894718,  stepitts, 1, 0, 1, no
2276619450,  zigon74, 1, 0, 1, no
256072596,  EleonoraGavio, 1, 0, 1, no
104841553,  ORTUCU, 1, 0, 1, no
709797795,  picueb, 1, 0, 1, no
172398463,  giuliodjsun, 1, 0, 1, no
4827008141,  Epesses59Tigre, 2, 0, 2, no
338376782,  EnricaSabatini, 1, 0, 1, no
2361128843,  cago_sui_gobbi, 1, 0, 1, no
174232595,  thosarmas, 2, 0, 2, no
1896572778,  Catilina89, 1, 0, 1, no
2744324373,  Luciliusenex, 1, 0, 1, no
777040765167996928,  LauraLaurablm, 1, 0, 1, no
97515974,  mai_lastessa, 1, 0, 1, no
623027480,  GabboAntoninoN1, 25, 0, 25, no
323764149,  VincenzoAlori, 1, 0, 1, no
401394767,  GENCOSILVIO, 1, 0, 1, no
395419050,  TortOrlando, 1, 0, 1, no
3397375498,  claudiogiammat2, 3, 0, 3, no
2364054668,  lucio06091996, 1, 0, 1, no
732637887263571968,  FilippoMartore2, 1, 0, 1, no
717113875620040704,  Mikythebest7, 1, 0, 1, no
387078143,  dobrevshug, 1, 0, 1, no
4872180215,  evelina_marino, 1, 0, 1, no
798072013655015424,  robcup64, 1, 0, 1, no
476791070,  MarcoLittera, 3, 0, 3, no
260404258,  titoramidara, 1, 0, 1, no
804013588105064453,  jaelz94, 2, 0, 2, no
514599314,  manliomaltempi, 1, 0, 1, no
741042600707297280,  AdaAda72197756, 1, 0, 1, no
390632691,  luca_ics, 4, 0, 4, no
2306326187,  lucyfata, 1, 0, 1, no
3290208330,  serena101178, 1, 0, 1, no
2843657991,  PatriziaCaputo3, 1, 0, 1, no
153368159,  ThFio, 1, 0, 1, no
2603193848,  FabiowFlorio, 1, 0, 1, no
3052729247,  xelecollins, 2, 0, 2, no
2956894029,  cliclirain, 1, 0, 1, no
766317983962656768,  thortellino, 1, 0, 1, no
782100039879589888,  petrelliascoli, 1, 0, 1, no
750306271165898752,  _AlbeireG_, 1, 0, 1, no
1012199538,  Giusy_Campo, 1, 0, 1, no
835547988,  Alessandrouda19, 2, 0, 2, no
408521008,  Sbobtv, 1, 0, 1, no
191592633,  L_Morassi, 1, 0, 1, no
802615953032880128,  ziatina84, 1, 0, 1, no
801109550950662145,  glamtipherta191, 1, 0, 1, no
564068843,  Tushi59058193, 2, 0, 2, no
73846193,  rodibe, 2, 0, 2, no
575127542,  ElisaMusi, 1, 0, 1, no
3930881235,  dix1979, 1, 0, 1, no
1596116120,  papillonpa, 1, 0, 1, no
1228461907,  gian_1973, 1, 0, 1, no
372413317,  aledando88, 1, 0, 1, no
2377000184,  sararicci24, 1, 0, 1, no
18578213,  tavernitimonica, 2, 0, 2, no
4732545197,  Occhiverdi_79, 1, 0, 1, no
1208707927,  salvo86442975, 1, 0, 1, no
1032807428,  Claudio_59_, 1, 0, 1, no
557994791,  fracristiano87, 1, 0, 1, no
408442694,  gryaho, 1, 0, 1, no
29926710,  ItalianSerieA, 1, 0, 1, no
2998817062,  ManfieldPeter, 1, 0, 1, no
113348709,  andreasantopiet, 1, 0, 1, no
593558753,  ClaudioDaBo, 1, 0, 1, no
506425689,  GIUSPY_, 1, 0, 1, no
167562908,  MauroZambelli, 1, 0, 1, no
605281984,  AntoMosca, 1, 0, 1, no
239950313,  zuppel63, 1, 0, 1, no
3089673065,  LinnnusPaolo, 2, 0, 2, no
4431715060,  andrearossiros1, 1, 0, 1, no
183370703,  franciritrovato, 1, 0, 1, no
2531197737,  jackiemopsy, 1, 0, 1, no
500614553,  RvRavenstijn, 1, 0, 1, no
173943002,  valemoyanomunoz, 1, 0, 1, no
3696334103,  viaggiodelmese, 1, 0, 1, no
3014221517,  maurobone54, 1, 0, 1, no
984507426,  mubblemubble, 1, 0, 1, no
2297748609,  nicoletta_lippi, 1, 0, 1, no
1219180723,  dinopuglisi, 2, 0, 2, no
4394989595,  GennaroLacatena, 1, 0, 1, no
115657951,  ldandrea08, 1, 0, 1, no
3115012150,  Claudina_Luci, 2, 0, 2, no
2572855533,  Nbeltrallo, 1, 0, 1, no
29167452,  AnnaChiara66, 1, 0, 1, no
3180067061,  IperDaBidda, 1, 0, 1, no
715564501152768003,  brixtoninnit, 1, 0, 1, no
183402202,  eguanella, 1, 0, 1, no
29963789,  davidezane, 1, 0, 1, no
429874362,  AnnaCBR600, 1, 0, 1, no
793404950353211392,  f_tutto, 1, 0, 1, no
1636428810,  SalvatoreLori, 1, 0, 1, no
141876243,  PaolaBaro, 1, 0, 1, no
487064233,  Ale74terni, 1, 0, 1, no
2413702907,  MaxpasinMap, 1, 0, 1, no
3043115600,  lucacapvt, 1, 0, 1, no
212569744,  forrunner1, 1, 0, 1, no
4896545899,  elio_cnx, 1, 0, 1, no
3102369712,  ORC_MI, 1, 0, 1, no
755398952493674496,  alisa_guida26, 1, 0, 1, no
118057609,  6praia, 1, 0, 1, no
399516281,  CavallariErica, 1, 0, 1, no
714418971060076545,  simone_centra, 1, 0, 1, no
2665959495,  Esp8950, 1, 0, 1, no
518715637,  Mgv19118, 1, 0, 1, no
149972325,  bladimird, 1, 0, 1, no
2649441979,  __Fabiana___, 1, 0, 1, no
989151792,  M_C4R, 1, 0, 1, no
57598603,  LaMuseP, 1, 0, 1, no
223112072,  chesschifo, 1, 0, 1, no
131460484,  Gillocolonna, 1, 0, 1, no
536397889,  MirtillaMering1, 1, 0, 1, no
4843542401,  gabysan63, 1, 0, 1, no
1397942977,  Luca_Montezuma, 1, 0, 1, no
3350956385,  vespro4, 1, 0, 1, no
993157424,  angeluccigi, 2, 0, 2, no
1304080812,  orlandini1996, 1, 0, 1, no
3957668361,  enrigoletto, 1, 0, 1, no
3067621237,  paolainla, 1, 0, 1, no
25706997,  palloncino, 1, 0, 1, no
802859221507276800,  AlexMas74193295, 1, 0, 1, no
755342412,  AngeloBaldes, 2, 0, 2, no
99305428,  il_Gino, 1, 0, 1, no
805128308,  EmilioVia, 1, 0, 1, no
499134939,  SimonettaCarreg, 1, 0, 1, no
3906835099,  1cdfe88d3fa642d, 1, 0, 1, no
1947781513,  GIASORDI, 1, 0, 1, no
769257998,  debenedettimrco, 1, 0, 1, no
2520216374,  Nicky_210855, 1, 0, 1, no
443647219,  MadePam, 1, 0, 1, no
130491008,  brutusway, 2, 0, 2, no
465823907,  saragat0, 2, 0, 2, no
1421610379,  rossanotronto, 2, 0, 2, no
2845726755,  monicabarra29, 1, 0, 1, no
801523742413307904,  Giovann82723282, 1, 0, 1, no
1176004045,  FIngefra, 2, 0, 2, no
768524508932239360,  SIMONEJUVEPAVEL, 1, 0, 1, no
764816634963980288,  sergio_zangara, 1, 0, 1, no
1847744737,  GlucaFerrara, 2, 0, 2, no
4320259347,  58Caterina, 2, 0, 2, no
802174189822218240,  witco14, 1, 0, 1, no
2276032819,  jeannestefan, 1, 0, 1, no
284698211,  rorobelushi, 1, 0, 1, no
438799855,  AntoMelk, 1, 0, 1, no
139051050,  sociopatico87, 1, 0, 1, no
220790490,  otrebored, 1, 0, 1, no
2271870859,  MarcoMcpamposs, 1, 0, 1, no
4665546447,  famigliettiant1, 1, 0, 1, no
822911887,  fedimaro, 2, 0, 2, no
776403104526893057,  LuigiMinali, 1, 0, 1, no
803352915339595776,  dirkcarma, 1, 0, 1, no
1243910071,  5Canatt, 1, 0, 1, no
2347188528,  SergioRizzo70, 1, 0, 1, no
265941526,  StreetSmarts111, 1, 0, 1, no
174780693,  alsky68, 1, 0, 1, no
2998672889,  SiciAntonio, 1, 0, 1, no
782252594974580737,  gianmaria46, 2, 0, 2, no
4084997943,  SeraOsvaldo, 1, 0, 1, no
115359949,  ParmaLaRossa, 1, 0, 1, no
342076860,  AntoninaLeone, 1, 0, 1, no
293699524,  Orypaolo66, 1, 0, 1, no
778213728978399232,  novellifabio57, 1, 0, 1, no
702956983717068800,  f9a196fb52de4b8, 1, 0, 1, no
752179613665812480,  GiorgioVerrecc, 1, 0, 1, no
729765741814292481,  Gigi_Cata, 3, 0, 3, no
2320089569,  BabiDorso, 1, 0, 1, no
491351022,  AnlattLattanzi, 1, 0, 1, no
2300388132,  AntonioEntotar, 1, 0, 1, no
538894700,  paolopancaldi, 1, 0, 1, no
831036938,  sergio_nazzaro, 1, 0, 1, no
22035287,  carmoret, 1, 0, 1, no
528461591,  AdrianoTrop, 1, 0, 1, no
61186603,  massimods, 3, 0, 3, no
784398418949074944,  NicoSusini, 1, 0, 1, no
2678692048,  andrea_ilfalco, 1, 0, 1, no
2209268871,  thenocchius, 1, 0, 1, no
49988368,  Tat_ox, 2, 0, 2, no
287289678,  TheCarbayon, 1, 0, 1, no
52073784,  LizzyFlour, 1, 0, 1, no
4046187219,  _BPdP_, 1, 0, 1, no
145919363,  lukas1970, 1, 0, 1, no
146807161,  th3lastsamura1, 1, 0, 1, no
9619082,  yanez72, 1, 0, 1, no
576487510,  livia_67, 1, 0, 1, no
432029868,  martycly, 1, 0, 1, no
728704486080917504,  TabataRouse, 1, 0, 1, no
1144724168,  colpadelleuro, 1, 0, 1, no
782519200044679168,  MCeretti80, 1, 0, 1, no
1527250062,  vincenzogilard1, 2, 0, 2, no
696271187534598145,  PaltitoDemoclat, 1, 0, 1, no
4891182579,  RenZiTung, 1, 0, 1, no
3742104076,  Grillo_VtruVano, 1, 0, 1, no
4046411357,  Honesty_Int, 1, 0, 1, no
4144056819,  Salvisconi, 1, 0, 1, no
4687135406,  fatto5stelle, 1, 0, 1, no
454204123,  ChiaraFadda2, 1, 0, 1, no
31158194,  maxim63, 1, 0, 1, no
1627351170,  silverblade65, 1, 0, 1, no
160471953,  n_poletti, 2, 0, 2, no
708722387848720384,  mandapeppe, 1, 0, 1, no
712703426468126722,  tangram_ta, 1, 0, 1, no
722341444720193536,  CARLACOSTANTIN5, 1, 0, 1, no
456976486,  SteffRomagnoli, 1, 0, 1, no
976952114,  diceNiNi, 1, 0, 1, no
873484584,  AngelaBevere, 1, 0, 1, no
374520633,  FrancoDrZap, 1, 0, 1, no
1295065447,  billi1963, 1, 0, 1, no
1009888627,  kittkarsen, 1, 0, 1, no
630249596,  annacuciniello, 1, 0, 1, no
2791515574,  AleCosta115, 1, 0, 1, no
124517180,  davidelosito, 7, 0, 7, no
1909146774,  donato_valerio, 1, 0, 1, no
562285429,  bncnln, 1, 0, 1, no
3346548844,  geomsalvatores2, 3, 0, 3, no
782862294338469888,  sinistragargano, 2, 0, 2, no
456219686,  NCampedelli, 1, 0, 1, no
50123208,  Maria_Suma, 1, 0, 1, no
72857016,  fabioturra, 1, 0, 1, no
588968100,  lucapuuu, 1, 0, 1, no
114321159,  RoBlum, 1, 0, 1, no
303175724,  windpier, 1, 0, 1, no
554555095,  Garla51, 1, 0, 1, no
2464823086,  CadoniciGiorgio, 2, 0, 2, no
1062986299,  AlbertoMacr, 2, 0, 2, no
80913303,  peppeuz, 2, 0, 2, no
737695597864595458,  myriadforms, 2, 0, 2, no
2784546021,  mgcarbotti, 1, 0, 1, no
1376631973,  Sherpa_83, 2, 0, 2, no
389436565,  Mauro_da_Pesaro, 1, 0, 1, no
477015981,  pal_lore, 1, 0, 1, no
3383047606,  articolo3savona, 4, 0, 4, no
802140278186459136,  jmaroneh, 1, 0, 1, no
52777649,  justwaitingfor, 1, 0, 1, no
4137817637,  bau_delaire76, 1, 0, 1, no
491319459,  cesko981, 1, 0, 1, no
60042349,  rolentola, 1, 0, 1, no
2315591179,  VerdiTaranto, 1, 0, 1, no
3020685586,  GianniCommodo, 2, 0, 2, no
3405837303,  PaolaBelforte, 1, 0, 1, no
712045138374213632,  giorgiosisti86, 1, 0, 1, no
394127026,  SNicoletti75, 1, 0, 1, no
444090574,  tweetarge, 3, 0, 3, no
3403818359,  bianca08463077, 1, 0, 1, no
1397692812,  Punkaldi16, 1, 0, 1, no
461446104,  risikoGE, 1, 0, 1, no
295067525,  ciro649, 1, 0, 1, no
3297668817,  forzauova, 1, 0, 1, no
3633459021,  PalazzoContessa, 3, 0, 3, no
381378184,  caronte78, 8, 0, 8, no
489721603,  CaliCla, 1, 0, 1, no
608435854,  Save0nIL, 1, 0, 1, no
1377031602,  iostoconCivati, 2, 0, 2, no
1204481552,  valgiovio, 1, 0, 1, no
3438039274,  PossibileMiEst, 1, 0, 1, no
51390659,  Fe4ericoDel, 1, 0, 1, no
707850172307472384,  Uni2grow, 1, 0, 1, no
298032144,  elofoolish, 1, 0, 1, no
1049008081,  RaffaeleRaimon2, 1, 0, 1, no
166252036,  nelpold, 1, 0, 1, no
803607670896857088,  Charles39141784, 2, 0, 2, no
398306711,  D1M9G72, 1, 0, 1, no
953258047,  bdeguglielmo, 1, 0, 1, no
2684317517,  sinivale, 1, 0, 1, no
2937794518,  Tiesfashion, 1, 0, 1, no
2872011039,  marcellocrucia1, 1, 0, 1, no
805089435738054657,  ero_chiara, 3, 0, 3, no
188425804,  dashingdesiree, 1, 0, 1, no
310524063,  LuPoten, 1, 0, 1, no
3239395349,  jackbella96, 1, 0, 1, no
25746502,  herr_ludwig, 1, 0, 1, no
3384893884,  GesinoPaolo, 1, 0, 1, no
86021779,  michele_salv82, 1, 0, 1, no
3336849281,  caccia_mattia, 2, 0, 2, no
1066129710,  patty592008, 1, 0, 1, no
845114430,  EUSocialInnov, 1, 0, 1, no
1134253987,  _Ironica_1, 1, 0, 1, no
546958874,  Labsus1, 1, 0, 1, no
3043999375,  legiones77, 2, 0, 2, no
472308628,  sabrinafiguccia, 1, 0, 1, no
795287627805130752,  felisquitieri, 1, 0, 1, no
877713914,  CarmeloCoppola, 1, 0, 1, no
772900941028884480,  ForzaGiovani, 1, 0, 1, no
402190569,  MaScano10, 1, 0, 1, no
4387739087,  Axel54193208, 2, 0, 2, no
430160994,  Fede_Mariotti, 1, 0, 1, no
2289779280,  Massimopc1, 1, 0, 1, no
1563187658,  giuspetrosillo, 1, 0, 1, no
797794649297588224,  flavia_mataldi, 1, 0, 1, no
177645417,  fucilemario, 1, 0, 1, no
12179872,  Tecnoetica, 1, 0, 1, no
55027498,  mi_vitiello, 2, 0, 2, no
779360904475467777,  DamaMaxx, 1, 0, 1, no
359454995,  TrastevereRM, 3, 0, 3, no
1962577286,  Fajelamulta, 1, 0, 1, no
771984802807418880,  giuguih, 1, 0, 1, no
427297525,  albatortorici, 1, 0, 1, no
1019585222,  MiaSereni, 1, 0, 1, no
1334263597,  DavideConte80, 1, 0, 1, no
35739614,  acidorsa, 1, 0, 1, no
1393562082,  lamiadobermann, 1, 0, 1, no
2873807055,  WasteStrategyIT, 1, 0, 1, no
310153970,  FraSellari, 1, 0, 1, no
1006039993,  davidedionisi_, 1, 0, 1, no
552806581,  AriannaDeValeri, 1, 0, 1, no
75273087,  tonyveco, 1, 0, 1, no
408312540,  lareggio, 1, 0, 1, no
90166301,  batolino, 1, 0, 1, no
2267566928,  tutto_per_Roma, 1, 0, 1, no
4594680445,  Gabriel40844306, 1, 0, 1, no
227452853,  luka91rm, 1, 0, 1, no
400210083,  AnnaMasella1, 1, 0, 1, no
2744519609,  poterenero, 1, 0, 1, no
376218450,  AndreaScanzi, 1, 0, 1, no
782444881335713792,  avanzi_patrizia, 1, 0, 1, no
781174832130093056,  cefis77, 2, 0, 2, no
26444788,  danicat58, 3, 0, 3, no
772909927258005505,  Tower_Maria69, 1, 0, 1, no
2900945285,  BaglioniForever, 1, 0, 1, no
2872060322,  M5SWeAre99, 3, 0, 3, no
1504717525,  SmnCola, 1, 0, 1, no
421024001,  vighicarlo, 1, 0, 1, no
719848094981091328,  ippolitoetta, 1, 0, 1, no
60066745,  diego_sileo, 1, 0, 1, no
429797490,  pasquale_durso, 2, 0, 2, no
2447664170,  putryyy__s, 1, 0, 1, no
2598786017,  piedojole, 1, 0, 1, no
2556424255,  DirittiDem, 2, 0, 2, no
35214768,  Guanto89, 8, 0, 8, no
221538086,  Mini_Karen_, 1, 0, 1, no
1561380732,  mangeazza, 2, 0, 2, no
404051602,  lucianaelefante, 1, 0, 1, no
1251804560,  clabellumori79, 1, 0, 1, no
1572693642,  LaMomoo, 1, 0, 1, no
2712572104,  AndreaMannozzi, 1, 0, 1, no
287430226,  ILSIVA, 1, 0, 1, no
411739086,  carmenthesister, 1, 0, 1, no
496062807,  _CristinaC_, 1, 0, 1, no
987068240,  marcocalvi1973, 1, 0, 1, no
1195403832,  robyavo_, 1, 0, 1, no
596772242,  fausto_delfini, 1, 0, 1, no
1233468889,  ZangTumTumb, 1, 0, 1, no
321561841,  flaviozampa80, 1, 0, 1, no
891590768,  AttReds, 1, 0, 1, no
1978966777,  AbordAlessandro, 1, 0, 1, no
122420347,  lucaottaviano, 1, 0, 1, no
244898765,  43asarisi, 1, 0, 1, no
17948183,  oby1sky, 1, 0, 1, no
469210827,  AndreinaGallo1, 1, 0, 1, no
2325749553,  edoardoelmi, 1, 0, 1, no
751150192959823872,  BiscariLuigi, 1, 0, 1, no
306173200,  izetron, 2, 0, 2, no
1160989914,  graziel18298120, 2, 0, 2, no
457542725,  LBergianti, 2, 0, 2, no
2299501811,  ZZuccher, 1, 0, 1, no
775691826644779008,  SARAWEBO, 1, 0, 1, no
471935159,  Umb70, 1, 0, 1, no
4892086275,  raffaella6596, 2, 0, 2, no
18945486,  so_giovanni, 1, 0, 1, no
795731592950009856,  JeromeDrake69, 2, 0, 2, no
932408082,  monscer1, 2, 0, 2, no
979251522,  AndreaAntonino1, 1, 0, 1, no
2834034868,  simonetta1952c1, 1, 0, 1, no
3087427509,  MonacoGP, 1, 0, 1, no
3898304356,  El_Salbaneo, 1, 0, 1, no
968582010,  kittimanda, 1, 0, 1, no
448338914,  peppecaniglia, 1, 0, 1, no
799259554085216256,  dmzotimova, 1, 0, 1, no
472751675,  asmulevichmoked, 1, 0, 1, no
45763,  sasakifujika, 1, 0, 1, no
863334620,  ilCamisa, 1, 0, 1, no
702956804,  MatildeContino, 2, 0, 2, no
797127617774284800,  BarbaNeraSatira, 2, 0, 2, no
144973074,  weareincolour, 1, 0, 1, no
1039294760,  AntonioRenna5, 2, 0, 2, no
598563,  procionegobbo, 1, 0, 1, no
355808268,  fiorenzacipo, 2, 0, 2, no
917349780,  Gregori_9, 2, 0, 2, no
2865399789,  clementecuadu, 2, 0, 2, no
727701926544969728,  sartoris1960, 1, 0, 1, no
337113181,  LETIZIALOPEZ2, 3, 0, 3, no
941717468,  AlexTebi, 1, 0, 1, no
448083793,  etrusco72, 1, 0, 1, no
483818680,  fred_five, 1, 0, 1, no
1392593060,  bicchierevuoto, 1, 0, 1, no
1186190486,  Zerovirgolasei, 3, 1, 2, no
4301109268,  bobgrindyadown, 1, 0, 1, no
319699679,  cristiano663, 2, 0, 2, no
414369290,  linodan1, 1, 0, 1, no
2565703480,  aldomaria2014, 4, 0, 4, no
737708398125420545,  the_damn_i_give, 1, 0, 1, no
796253532936609792,  manuelaraponi, 1, 0, 1, no
618465622,  grazzi_giovanna, 1, 0, 1, no
1171615016,  GraziaIotti, 1, 0, 1, no
712607537489715200,  Carlotta9125, 1, 0, 1, no
1187920309,  IlBipolare, 1, 0, 1, no
7955602,  michelemezza, 1, 0, 1, no
2744419310,  neXtquotidiano, 1, 0, 1, no
3385762107,  Attypal, 1, 0, 1, no
2512461765,  ferro_sandro, 1, 0, 1, no
1673158423,  linofraschetti, 1, 0, 1, no
41592211,  alfiogilda, 1, 0, 1, no
712263543899480066,  RolandMitti, 2, 0, 2, no
90369822,  gnonino, 1, 0, 1, no
748833146104377344,  RaffaFaffaaa, 1, 0, 1, no
802207720908718081,  NemicaOfficial, 1, 0, 1, no
3297277417,  TonyAnbe81, 1, 0, 1, no
413978233,  ilariapedruzzi1, 1, 0, 1, no
3989830042,  FormaggIgnazio, 1, 0, 1, no
1530015979,  a_gigio, 1, 0, 1, no
462338725,  sempiAnna, 1, 0, 1, no
2534392685,  pickmefron, 1, 0, 1, no
414686697,  AlfredoDAntonio, 2, 0, 2, no
1864429872,  AnnaGiunchedi, 1, 0, 1, no
3298832756,  LMontignani, 1, 0, 1, no
773997726,  PauTarcsio, 4, 0, 4, no
369961961,  denisfruscalzo1, 1, 0, 1, no
38495686,  giutul, 1, 0, 1, no
374510131,  raffotografo, 1, 0, 1, no
2776036158,  BiancaFrondoni, 1, 0, 1, no
1397510738,  PellegriniGio, 1, 0, 1, no
4926495803,  wildflower6422, 1, 0, 1, no
434705268,  EkaterinaVA8, 1, 0, 1, no
3192540098,  Bellajane127, 1, 0, 1, no
2933685617,  SylbermaSylvie, 2, 0, 2, no
792100041733308416,  MonicaTaveras3, 1, 0, 1, no
176238611,  altagrace121, 1, 0, 1, no
2545326607,  ArchangelMagicx, 1, 0, 1, no
326288537,  MariannBenway, 1, 0, 1, no
183263414,  BuonAndrew, 1, 0, 1, no
632940364,  biscaggina49, 1, 0, 1, no
772856434362953728,  ClaudetteDelon1, 1, 0, 1, no
4905181713,  recpnnue, 1, 0, 1, no
776110016369754114,  patatineconpan1, 1, 0, 1, no
459580953,  dyer_mods, 1, 0, 1, no
1905194282,  GianlucaSaiu, 1, 0, 1, no
3010735091,  daniele_social, 1, 0, 1, no
794640388602691585,  ElandrogeEco, 1, 0, 1, no
124020256,  MauroCasciari, 2, 0, 2, no
801425087585021952,  fpp345, 1, 0, 1, no
758782443482652672,  RcomeRinvio, 1, 0, 1, no
859915932,  mmancarell, 1, 0, 1, no
132295001,  mattilgale, 1, 0, 1, no
417957770,  RobSciarelli, 1, 0, 1, no
2366943176,  Pocahontas1913, 5, 0, 5, no
1339157467,  serpilloc, 7, 0, 7, no
2978230006,  vincenzo22964, 1, 0, 1, no
563718067,  Cmg21GRACIA, 1, 0, 1, no
3237119117,  pollybalme, 1, 0, 1, no
710745630839328768,  DavideDaffina, 1, 0, 1, no
1575572551,  l26560185, 3, 1, 2, no
326320843,  ufk37, 1, 0, 1, no
17693719,  valluan, 1, 0, 1, no
113889922,  Coco_Mars_, 1, 0, 1, no
292371234,  ffravolini, 2, 0, 2, no
3371417884,  stafanolilli, 1, 0, 1, no
260317931,  massidoo, 1, 0, 1, no
425882483,  SergCop, 1, 0, 1, no
49921379,  dandreaviola, 1, 0, 1, no
218992548,  madmaxsomm, 1, 0, 1, no
783053092753375236,  lucagiorgi0321, 1, 0, 1, no
957461155,  Retake_Roma, 1, 0, 1, no
2476947931,  LAPIS_NIGER_753, 1, 0, 1, no
3372929813,  Valentina_Sprea, 1, 0, 1, no
626284440,  stefdiste, 1, 0, 1, no
3094881555,  tutinodavide, 1, 0, 1, no
81853766,  elTioRom, 1, 0, 1, no
309933569,  marinaguarnieri, 1, 0, 1, no
3097765179,  robbo_5282, 1, 0, 1, no
449702471,  OcramFerraris, 1, 0, 1, no
511066939,  manu78r, 1, 0, 1, no
636535351,  SMay_76, 3, 0, 3, no
444668246,  ABertirott, 2, 0, 2, no
2350321508,  night82loord, 1, 0, 1, no
2516234993,  lulljassiagmail, 4, 0, 4, no
318371821,  facocero76, 1, 0, 1, no
2460381523,  iotwittodasolo, 1, 0, 1, no
466602032,  DeborahFrate, 1, 0, 1, no
732521189466378244,  ilvago1973, 1, 0, 1, no
781030906278604800,  i_poteri_forti, 1, 0, 1, no
1015406335,  antonellacatta3, 2, 0, 2, no
3225172937,  2f25b18ce75e4fe, 2, 0, 2, no
746789156588765184,  panicuocolo1, 2, 0, 2, no
993891668,  gian_curtis, 1, 0, 1, no
115410183,  robdefab, 1, 0, 1, no
1375557822,  robertoamato65, 1, 0, 1, no
781611241315926020,  PetrilliLidia, 1, 0, 1, no
762289531974512640,  VirgilioIndoran, 1, 0, 1, no
1852086764,  2011LISA2, 1, 0, 1, no
1434986550,  RomaPulita, 1, 0, 1, no
263758608,  mapi_ipam, 1, 0, 1, no
243213767,  zio_ale, 2, 0, 2, no
4823563071,  Liukliuk25, 2, 0, 2, no
386983041,  BEPPECIPOLLA1, 1, 0, 1, no
2411294761,  JanGoodmanJ, 1, 0, 1, no
2417843232,  panicalem5s, 1, 0, 1, no
2332500221,  oliedenzo, 3, 0, 3, no
84554070,  Marfarra, 3, 0, 3, no
