803590719432695808,  mr_ranadeus, 207, 192, 15, yes
524372178,  nicoladeredita, 20, 19, 1, yes
1513455144,  davide_bedini, 22, 19, 3, yes
237816428,  vitochiariello, 49, 38, 11, yes
716357499939586048,  gardamore, 32, 25, 7, yes
2839611267,  martinomcvolo, 5, 5, 0, yes
3009603910,  1ma_Repubblica, 4, 4, 0, yes
1665968257,  sampei71, 10, 9, 1, yes
967839474,  polizia_unica, 45, 45, 0, yes
4924035922,  penskesoenz, 18, 10, 8, yes
419302730,  stexan78, 7, 7, 0, yes
1034473320,  tderossi41, 99, 51, 48, yes
745025263679963137,  beppefiglie, 72, 69, 3, yes
797136508293627904,  dammidamangiare, 167, 97, 70, yes
272317881,  fmollicone, 23, 19, 4, yes
2421052026,  PDBelgio, 6, 6, 0, yes
4426518575,  giulio_egi, 39, 38, 1, yes
1518874812,  fork11977, 48, 46, 2, yes
3354849862,  exsangueamaro73, 10, 6, 4, yes
781359137909248001,  sandrino001, 34, 27, 7, yes
745595735966613504,  fieramosca59, 218, 183, 35, yes
3107282901,  lucaellervai, 9, 9, 0, yes
335385772,  christiandevivo, 9, 8, 1, yes
550205067,  GAlcesti, 19, 17, 2, yes
954041064,  manfredi59, 15, 8, 7, yes
188270789,  FabrizioDalCol, 4, 4, 0, yes
134629516,  sergiogaudio, 12, 12, 0, yes
2239697994,  jekkopp, 21, 21, 0, yes
545978235,  lamescolanza, 26, 23, 3, yes
116468336,  giubberosse, 7, 4, 3, yes
476976196,  miciula83, 35, 34, 1, yes
703360096944988160,  liillimaat, 21, 20, 1, yes
484257494,  LauraFiavor, 28, 28, 0, yes
1294174362,  BeneWalter, 41, 39, 2, yes
1264774998,  AbatediTheleme, 70, 42, 28, yes
341001184,  maxpatacca, 22, 17, 5, yes
83115466,  70sHouse, 19, 18, 1, yes
1636129136,  papito1492, 48, 32, 16, yes
15047521,  stefanoesposito, 24, 12, 12, neutral
432637066,  adrianobusolin, 121, 63, 58, yes
720515573,  curtno67, 82, 56, 26, yes
444914964,  mancinimanu, 10, 9, 1, yes
1675230540,  libertango69, 125, 120, 5, yes
915386305,  NPaciaroni, 6, 6, 0, yes
545384133,  dariolucantoni, 129, 75, 54, yes
2244460336,  amorucci2911, 115, 61, 54, yes
1339138579,  GiovanninoLuca, 12, 12, 0, yes
93953682,  vignettopoli, 58, 45, 13, yes
3291493733,  lucia_for, 338, 305, 33, yes
847193449,  PaoloPiggi, 11, 8, 3, yes
741751231476072448,  roberto_deriu, 5, 4, 1, yes
200896162,  a_califano, 9, 8, 1, yes
775018810491494400,  ester_messina, 5, 4, 1, yes
412665412,  _contrariato, 13, 12, 1, yes
757477214690697217,  Carl_Giord, 22, 22, 0, yes
249862119,  romanilor, 93, 90, 3, yes
797526763962331136,  Plutone_2, 10, 10, 0, yes
1615176902,  grimaudogiusepp, 46, 29, 17, yes
748170127364001793,  Totusmediait, 8, 5, 3, yes
545248089,  beppebottero, 31, 20, 11, yes
2640207038,  silvionicolini, 46, 27, 19, yes
400919857,  LaCorteSerafino, 38, 35, 3, yes
3213490474,  bsvezia, 40, 37, 3, yes
1065254220,  ClaudioAgos, 49, 32, 17, yes
2572209035,  nicoladidio1943, 34, 34, 0, yes
1225629091,  pasquitter, 4, 4, 0, yes
730132426110992384,  difesadellavoro, 39, 35, 4, yes
268378258,  andrea_duranti, 6, 6, 0, yes
2318171590,  PZero28, 17, 17, 0, yes
2523568577,  Beppe_murg, 126, 61, 65, no
492031787,  domemuollo, 7, 7, 0, yes
1077391783,  FdI_parma, 3, 3, 0, yes
4112673143,  TerraNostraIT, 12, 8, 4, yes
59200159,  iz2esv, 167, 164, 3, yes
159285637,  HelenaJacobs, 10, 7, 3, yes
1024976264,  FratellidItaIia, 19, 15, 4, yes
1429916701,  ross27767, 62, 56, 6, yes
728188723075158016,  AleElle1, 30, 6, 24, no
1374016897,  FabDur1968, 4, 3, 1, yes
588275518,  GobboRancoroso, 10, 10, 0, yes
103571895,  mattesiddi85, 8, 8, 0, yes
453365420,  dinomoto3, 9, 9, 0, yes
45116767,  stefanoroma, 3, 3, 0, yes
1219276627,  fra_sica, 4, 3, 1, yes
2307374041,  Phoenix5975, 3, 3, 0, yes
379030927,  ninaoraloso, 5, 4, 1, yes
547883408,  nettuno75, 16, 8, 8, neutral
829914427,  pacopescatori, 4, 4, 0, yes
1007038868,  carlofrateschi, 5, 4, 1, yes
386695561,  SebStefano, 8, 8, 0, yes
4141927199,  7novembre2015, 84, 66, 18, yes
55360087,  alessioDgennaro, 37, 27, 10, yes
3396388150,  broptr53, 73, 55, 18, yes
343285778,  andreaferrari70, 12, 12, 0, yes
1086749148,  maurolarcher79, 69, 57, 12, yes
135190939,  lagrifogliere83, 7, 7, 0, yes
754658882551738368,  Edoardor77, 45, 31, 14, yes
731252371226042369,  News24_it, 236, 138, 98, yes
433725175,  danimarche75, 17, 17, 0, yes
2562814182,  franco_dimuro, 492, 220, 272, no
1549289318,  vaigero, 6, 5, 1, yes
964460408,  szampa56, 82, 74, 8, yes
2448563317,  QuotidianoFango, 34, 18, 16, yes
454191208,  sebaquila, 59, 49, 10, yes
2208960872,  PippoBasilea, 6, 6, 0, yes
424084271,  SONIAGROTTO, 142, 93, 49, yes
785934232698904576,  ElleGiovanna, 130, 79, 51, yes
3973423342,  NellaBellaVR, 127, 105, 22, yes
725728464268066817,  cameranesigio, 28, 26, 2, yes
500174528,  ivra46, 8, 6, 2, yes
222411571,  furiadicheb1897, 45, 18, 27, no
1062583370,  UBrignone, 462, 52, 410, no
3978409253,  ZacchedduFranc1, 8, 6, 2, yes
863171299,  aleposer, 8, 7, 1, yes
1001359057,  a_viscomi, 19, 19, 0, yes
1201012040,  Steno5Stelle, 182, 161, 21, yes
4928491697,  iltonypostin, 178, 150, 28, yes
1107205176,  DCiamei, 17, 9, 8, yes
397249341,  PeppeRosa88, 14, 14, 0, yes
4432360889,  lindaeciao, 72, 27, 45, no
2322998168,  BVito5S, 79, 72, 7, yes
9476932,  InnovateEurope, 79, 76, 3, yes
478894165,  PietroDiGirolam, 3, 3, 0, yes
2970117851,  senzacensura73, 38, 27, 11, yes
2709720835,  IdoneiGdF2012, 16, 16, 0, yes
772076870582042625,  driano84, 11, 11, 0, yes
395908244,  _Orbis_, 16, 7, 9, no
876660793,  SalBullotta, 17, 17, 0, yes
1048569343,  LianoAuletta, 26, 24, 2, yes
1464788840,  lvoir, 260, 86, 174, no
2754543846,  vittoriodiri, 71, 29, 42, no
738775045347119108,  hugosweb, 13, 8, 5, yes
3063738106,  menelaolemanine, 204, 109, 95, yes
968615264,  TiziCip, 7, 6, 1, yes
3094312457,  Tizianaviola46, 107, 19, 88, no
1229121186,  carlucci_cc, 322, 53, 269, no
1328664937,  AngeloVinardi, 31, 11, 20, no
215278944,  Okosama_Starr, 49, 43, 6, yes
3357308483,  demian_yexil, 704, 229, 475, no
702267737,  ACHILLEMARATI, 67, 24, 43, no
753265543633899520,  ProfCeli1, 19, 18, 1, yes
575437784,  angelinabiz, 48, 30, 18, yes
575138798,  francesca58361, 41, 30, 11, yes
338959743,  Cristoferbaldet, 68, 34, 34, neutral
2359832450,  ilarioneri, 45, 30, 15, yes
1385223960,  ManuPalo67, 614, 427, 187, yes
1658117701,  tommasosauro, 32, 31, 1, yes
817413728,  DavideGiac, 3, 3, 0, yes
2858721511,  enricoseidue, 27, 25, 2, yes
426719729,  MarGauFil, 34, 9, 25, no
1190659814,  fabryegio, 271, 176, 95, yes
732773769824047104,  NativiItaliani, 300, 121, 179, no
1039860102,  AndreaManzullo, 17, 13, 4, yes
489656804,  BenedettaCasu, 54, 54, 0, yes
4702133172,  EugenioCardi, 215, 117, 98, yes
499128183,  niemiz1964, 1349, 540, 809, no
464862115,  CorroAndrea, 4, 3, 1, yes
3336455937,  CastaldiniMc, 88, 50, 38, yes
461088423,  FabriBracco64, 69, 54, 15, yes
136342937,  dinoprrj22, 45, 43, 2, yes
2248562482,  ferroliroby, 42, 42, 0, yes
399589131,  francapapini, 13, 6, 7, no
3360210892,  Aldoasgg, 36, 33, 3, yes
503455114,  ALFONSODiego669, 24, 22, 2, yes
3123285591,  RaimondoLazzano, 19, 8, 11, no
1260162366,  profilocriminal, 24, 19, 5, yes
591144361,  Cortez1958, 109, 109, 0, yes
1226056380,  casadasburgo, 14, 10, 4, yes
722050091624833024,  AlessaM1986, 928, 680, 248, yes
4621068317,  andsavandsav, 131, 112, 19, yes
442817553,  sandrolabanti, 50, 25, 25, neutral
243545857,  pimma77, 13, 7, 6, yes
2589077888,  stomei67, 5, 5, 0, yes
464955653,  ErikaIntrisano, 7, 7, 0, yes
150707800,  filippopieri, 6, 6, 0, yes
183287158,  angelinascanu, 696, 616, 80, yes
2180128512,  froma01k, 73, 69, 4, yes
1205137098,  RitaMarcigaglia, 4, 4, 0, yes
4063913308,  crisfontana481, 21, 17, 4, yes
710440429,  _DCarrera, 7, 7, 0, yes
273316238,  massimo_fares, 33, 20, 13, yes
1160278561,  VanessaCorini, 85, 14, 71, no
1109369214,  ciampicuc, 6, 5, 1, yes
1252659014,  Lau539, 6, 4, 2, yes
898297518,  Hibbing59, 30, 26, 4, yes
1054906759,  santangeloitalo, 27, 27, 0, yes
3072009003,  antignani_l, 202, 177, 25, yes
711908751209537536,  bohmahforse, 9, 5, 4, yes
43503218,  FComellini, 158, 103, 55, yes
2608779441,  BGrisafi, 128, 124, 4, yes
1170081618,  Anton1oM, 7, 5, 2, yes
2224402028,  Equinsuocha2, 10, 8, 2, yes
720897240366194688,  MiDispiaceNO, 91, 88, 3, yes
799504971502944257,  Fabio_AZ4737, 125, 67, 58, yes
294482809,  SorMarchese78, 47, 42, 5, yes
2719244173,  ElPiotta, 108, 61, 47, yes
2734867583,  davide_xbxb, 11, 11, 0, yes
1128501696,  taniadigennaro, 5, 5, 0, yes
1228211810,  markor988, 11, 11, 0, yes
3292795744,  alessiabrunett, 11, 11, 0, yes
2760582813,  LindaRandisi, 14, 14, 0, yes
3291848025,  giomorpheus87, 5, 5, 0, yes
792398721661149185,  maccaroneserena, 15, 7, 8, no
557127139,  HURRACANES, 45, 33, 12, yes
2746079253,  fulmine2006, 29, 11, 18, no
498062460,  AjejeBrazorf6, 12, 8, 4, yes
121424128,  La7tv, 81, 42, 39, yes
2530226425,  StefaniaBlandam, 13, 13, 0, yes
255047902,  GiuseppeRoma, 78, 60, 18, yes
1128723278,  winnerinyou, 19, 18, 1, yes
2409382352,  RicciolaSicula, 26, 22, 4, yes
2411144520,  tamara60831262, 14, 12, 2, yes
2407351214,  Simona70653259, 6, 6, 0, yes
534607014,  RosaP184, 7, 6, 1, yes
4155402466,  budax81, 13, 12, 1, yes
482405981,  lollinac73, 44, 39, 5, yes
2543538403,  FedericoRuysch2, 11, 10, 1, yes
2532567086,  PatriziaVerz, 9, 8, 1, yes
925583479,  TeresaLoprete1, 49, 36, 13, yes
2435476444,  pistucc, 22, 21, 1, yes
1150606010,  ombrettacianti, 22, 19, 3, yes
380243648,  Mollica71, 3, 3, 0, yes
2857247674,  pierapanichelle, 5, 4, 1, yes
2437524017,  NataliPatty, 30, 22, 8, yes
783227203433664512,  CodiceConcorsi, 26, 26, 0, yes
116871279,  Parmigiani_S, 36, 27, 9, yes
2718407860,  AndreaLucciL7, 5, 5, 0, yes
95482042,  gs5654, 60, 12, 48, no
744524292050788352,  antony220970, 112, 51, 61, no
2373624002,  RegioneLazio, 42, 42, 0, yes
2497838698,  fortunatolino, 226, 174, 52, yes
1173010872,  GentaPaolo, 4, 4, 0, yes
89651876,  luigipiva, 43, 43, 0, yes
1066131648,  MARCOLODICO1, 8, 8, 0, yes
296499025,  CONDURSO, 17, 13, 4, yes
3392585361,  jungle1970, 64, 47, 17, yes
2217674274,  cstambul, 105, 56, 49, yes
2165771,  mrmcphisto, 15, 12, 3, yes
352321483,  marco_tinti, 9, 9, 0, yes
22659500,  mauriziosantin, 351, 346, 5, yes
13294452,  pdnetwork, 244, 241, 3, yes
773929798192300032,  AlbertoForesti3, 418, 409, 9, yes
257953952,  CinziaEmanuelli, 126, 87, 39, yes
489312732,  ocagiulietta, 16, 14, 2, yes
1269116011,  TananbaumMinnie, 9, 9, 0, yes
1145584326,  Francesco__78, 38, 25, 13, yes
1642762838,  marybrunb3, 24, 24, 0, yes
1331086867,  51fini, 154, 114, 40, yes
348323243,  willkingly, 33, 23, 10, yes
2835100096,  francoG101, 7, 4, 3, yes
800817923606528004,  bester_64, 10, 7, 3, yes
1056454514,  MimmoFiori55, 7, 5, 2, yes
2391652852,  alloggio73, 27, 26, 1, yes
479764945,  traveler_69, 12, 11, 1, yes
1036983026,  Abaddon333ROCCO, 53, 49, 4, yes
458458943,  WESTADRIANO, 12, 7, 5, yes
465753888,  GAcquistapace, 215, 148, 67, yes
435173619,  LuigiRuggerone, 141, 81, 60, yes
3374386924,  fmugnani1, 24, 11, 13, no
2585597700,  marpa64, 56, 33, 23, yes
22252395,  desnos_bob, 6, 5, 1, yes
986431795,  MauroLosapio, 10, 10, 0, yes
1381899780,  fepolidori, 8, 6, 2, yes
1409217584,  fabiotermentini, 21, 17, 4, yes
460049464,  ValentinoColdan, 5, 4, 1, yes
473994961,  MassimoLazzaro, 15, 15, 0, yes
1018268425,  BudinoIl, 4, 4, 0, yes
1897585116,  RosMiki81, 57, 40, 17, yes
206419028,  venvela, 5, 3, 2, yes
3052197933,  _StefanoPuglisi, 3, 3, 0, yes
2719760326,  MarziaLoreti, 112, 100, 12, yes
2511809006,  vettavi, 9, 9, 0, yes
49709806,  giatav, 15, 9, 6, yes
23295072,  fabioottouno, 10, 9, 1, yes
705029912265097218,  MarrostafX, 109, 46, 63, no
486456375,  marcovarini, 53, 38, 15, yes
311694861,  carlokarl, 63, 34, 29, yes
1324250802,  LaconicaMente, 25, 15, 10, yes
3458373497,  epicuro12, 41, 25, 16, yes
593237139,  alexcar1975, 13, 10, 3, yes
966699302,  Leo_Frescura, 34, 12, 22, no
716244045220212736,  virgolettte, 6, 6, 0, yes
197913402,  palermanlio78, 6, 5, 1, yes
37434853,  RobRuggio, 17, 6, 11, no
988579303,  marica_scolari, 4, 4, 0, yes
1035817940,  a_panarella, 4, 4, 0, yes
84331830,  lnuvoli90, 3, 3, 0, yes
377660882,  Hellzapoppin80, 487, 326, 161, yes
1710334843,  AScribellito, 9, 9, 0, yes
728693657159794688,  slowcheetah___, 8, 8, 0, yes
2401805054,  Gianf167, 3, 3, 0, yes
752853790508867584,  BastaUnSiBXL, 11, 11, 0, yes
777855788882812928,  RTgovernoRenzi, 107, 102, 5, yes
76769340,  sandrogozi, 51, 51, 0, yes
58300699,  87Nico, 11, 7, 4, yes
1114135652,  MaCriCocc, 3, 3, 0, yes
2479620311,  danieledvpd, 624, 537, 87, yes
986811270,  BarbaraRaval, 31, 21, 10, yes
2892216196,  anticorrotti, 248, 234, 14, yes
781046072865087488,  GianniGrasso7, 38, 36, 2, yes
420194671,  mariamastrangel, 113, 98, 15, yes
2995932370,  pstasio81, 8, 8, 0, yes
775318412507643904,  JoeleCorigliano, 14, 14, 0, yes
256920776,  Nukios, 4, 4, 0, yes
4854132653,  Giusepp18483681, 120, 90, 30, yes
2812859778,  stefanodelisio, 1226, 960, 266, yes
782584298964672512,  PaolaSalcuni, 199, 172, 27, yes
1579008720,  GiusiPlebot, 1689, 1444, 245, yes
4885620221,  FedericaBidiVal, 1697, 1534, 163, yes
783023868378279940,  monica_bosso, 1501, 1444, 57, yes
3041446144,  tramas30, 238, 214, 24, yes
782669007975395328,  Pat35053636, 166, 160, 6, yes
788754158241378305,  Regina84Claudia, 404, 356, 48, yes
793787252040142848,  Pimpapallina, 1871, 1687, 184, yes
753229135611396096,  fil_otto, 7, 5, 2, yes
1594040222,  marobe997, 161, 95, 66, yes
2252899982,  JPCK72, 18, 12, 6, yes
4792934663,  IlDucaBianco94, 21, 18, 3, yes
728807104790794240,  Toni978374641, 261, 149, 112, yes
253550542,  pieroomega, 41, 30, 11, yes
737320057190133760,  IlpiDiOTaH, 9, 8, 1, yes
139678228,  matmoli, 10, 8, 2, yes
2476119007,  ElisabScalambra, 87, 83, 4, yes
731394546,  panteganarosa, 5, 5, 0, yes
2754876919,  villani_e, 16, 11, 5, yes
21929177,  pbaro, 19, 12, 7, yes
421427868,  Shamaysan, 35, 16, 19, no
429974408,  MarosticaR, 42, 30, 12, yes
1467415374,  valiante_s, 23, 23, 0, yes
405662253,  gal_nic, 7, 7, 0, yes
800750620818800640,  gensjulia1, 246, 64, 182, no
1021727540,  MarcoMorosini3, 24, 11, 13, no
119365569,  luscertola, 9, 9, 0, yes
4148238154,  LucaSandrini8, 8, 4, 4, neutral
1368793633,  gjscco, 820, 475, 345, yes
372937945,  leonemaschio, 38, 17, 21, no
3038103838,  mafaldina61, 211, 72, 139, no
2921447206,  Ilenia1970, 261, 76, 185, no
1623140270,  LegaNordArcene, 407, 179, 228, no
1601251586,  lanzanera, 7, 4, 3, yes
716591970106417152,  claudiobonura, 222, 12, 210, no
985080900,  usaipiero, 19, 7, 12, no
1853857640,  ricrrooll, 60, 25, 35, no
3300865876,  marcolecce1998, 4, 3, 1, yes
407296758,  MPezzin, 37, 23, 14, yes
399660676,  Bell85Mat, 6, 5, 1, yes
2292403348,  CitraGaetano, 4, 3, 1, yes
4048087467,  crissscri871, 41, 13, 28, no
152673484,  AleKenobi, 101, 33, 68, no
721084485190688768,  besso_paolo, 33, 4, 29, no
1276339076,  ALEXIxoic, 8, 3, 5, no
318549168,  FerfraHemp, 119, 11, 108, no
3332448431,  benetti1961, 213, 44, 169, no
222157419,  guerrieriP, 16, 5, 11, no
82512613,  att5stelle, 4, 3, 1, yes
443193400,  soleterramare, 80, 17, 63, no
186399539,  aculpo, 112, 3, 109, no
1316630180,  micheladania, 127, 6, 121, no
427372566,  Minerva_86, 10, 3, 7, no
70179939,  aniaclug, 10, 7, 3, yes
97773643,  pallina60, 36, 8, 28, no
2267581078,  perozzzi, 20, 6, 14, no
2898075617,  MPenikas, 725, 100, 625, no
416422287,  sernam22, 52, 33, 19, yes
474745734,  Padreinforma, 6, 3, 3, neutral
478663552,  DevidPorrello, 14, 4, 10, no
618138331,  Antony5S, 18, 8, 10, no
84452627,  fedefox85, 7, 6, 1, yes
1066461174,  MaxCose, 17, 10, 7, yes
123235814,  silvestroso, 80, 6, 74, no
317680130,  rosa857, 32, 10, 22, no
405498561,  trottamirco, 124, 44, 80, no
796436116249444355,  RodaAnnalisa, 4, 3, 1, yes
2496989087,  DavideRibolini, 70, 7, 63, no
2979240557,  TS1078, 75, 26, 49, no
483258299,  TommasoMiele, 73, 22, 51, no
357074444,  OttaviDeborah, 58, 11, 47, no
99645256,  ylatIemoR, 47, 36, 11, yes
1534486934,  m5ssuper, 66, 24, 42, no
262100774,  francescosgold, 35, 28, 7, yes
3290984981,  BabbaiFabry, 150, 11, 139, no
2973459185,  Charlie7311, 44, 21, 23, no
1354935949,  M5S_Camera, 82, 6, 76, no
2838570387,  CiofiniGiulio, 42, 9, 33, no
170781140,  ald962, 63, 9, 54, no
12005212,  dainotenace, 4, 3, 1, yes
782558833835147265,  Nadine67816028, 39, 22, 17, yes
1262939593,  occhiverdi57, 48, 10, 38, no
39592910,  clemente_tw, 8, 5, 3, yes
332885533,  Virus1979C, 292, 90, 202, no
410764821,  DiegoMaykail, 68, 14, 54, no
471347700,  kijuyu, 16, 3, 13, no
2527780688,  igorbrickil5S, 129, 9, 120, no
1412500075,  soniabetz1, 424, 162, 262, no
2390797348,  dindolone, 25, 7, 18, no
2386237696,  gioart79, 83, 36, 47, no
967124340,  pino_micali, 81, 4, 77, no
1375679971,  Mickpronest75, 10, 9, 1, yes
616372545,  GIORGIOBELLINO2, 14, 3, 11, no
3239105697,  FogliAdriano, 18, 13, 5, yes
556780444,  fred6001, 10, 9, 1, yes
1039549512,  rainbowfree82, 16, 11, 5, yes
783613594810351616,  ortu_sandra, 52, 29, 23, yes
154587914,  faetto, 11, 3, 8, no
57472352,  aledif3, 29, 4, 25, no
2350811871,  DavideDeVivo98, 23, 4, 19, no
1001303996,  decontentabile, 30, 13, 17, no
2804469977,  pittapittore, 8, 3, 5, no
2487298258,  RobertLonigro84, 17, 4, 13, no
1205594306,  MadagioPepe, 241, 147, 94, yes
3758739195,  VaniaCecconi, 90, 33, 57, no
2962772146,  GiulyFrac, 49, 18, 31, no
704779333307650048,  celestinoceles7, 165, 54, 111, no
943396292,  furiamp73, 9, 4, 5, no
1294725276,  GuerriJimmy, 33, 33, 0, yes
3244021258,  CatiaMassimi, 710, 508, 202, yes
2239737678,  FraMu83, 633, 456, 177, yes
4405998622,  paolocaccamo68, 164, 156, 8, yes
1272928376,  doctorloquax, 142, 114, 28, yes
3334148349,  Autarith, 140, 112, 28, yes
752559084881211392,  ronniehowlett3, 9, 9, 0, yes
721303651575341057,  Alessan93449691, 651, 486, 165, yes
2225303229,  ElenaBrunoG, 272, 214, 58, yes
3198028097,  volpedora67, 887, 666, 221, yes
1103554206,  GaspareRuiz, 106, 103, 3, yes
1114460935,  alecelli1994, 13, 13, 0, yes
3311137528,  alkimj, 148, 131, 17, yes
1934578106,  lldr70, 5, 5, 0, yes
716326404707713024,  andrea_visc, 509, 337, 172, yes
4851423724,  VittoriaCicu, 919, 690, 229, yes
3313832169,  marianna_cosma, 255, 192, 63, yes
4284959421,  cristianovilla9, 40, 15, 25, no
1069422908,  NOnsoNOsandro, 39, 22, 17, yes
722053268587855872,  Sandranino1977, 982, 708, 274, yes
4905992363,  ISolimeo, 508, 364, 144, yes
1923616602,  BabuskaBabuska, 387, 296, 91, yes
3092809936,  Claudette_84, 388, 285, 103, yes
953887928,  caracutaf, 20, 17, 3, yes
16986506,  lisanna, 29, 21, 8, yes
1103450372,  miconsentatwitt, 41, 15, 26, no
2422875421,  tonyooooo0, 42, 12, 30, no
2527788012,  robe_marc, 53, 16, 37, no
909082868,  nanucciogr, 16, 14, 2, yes
51140493,  albertitaly, 15, 15, 0, yes
2168651339,  jose78man, 9, 7, 2, yes
795892733781180416,  uil_pl_mi, 5, 5, 0, yes
1334865294,  ClaudioRoasio, 406, 152, 254, no
1171065324,  ClaudioStecca, 11, 3, 8, no
1356675511,  andreagallo_it, 7, 3, 4, no
157474913,  matteocacciola, 12, 10, 2, yes
714325641,  Ogma80Vito, 8, 8, 0, yes
419739649,  degiorgi64, 80, 47, 33, yes
356404890,  archiettoliber, 38, 26, 12, yes
69030213,  paolobalestri, 36, 25, 11, yes
2970014416,  Geremia1989, 17, 15, 2, yes
1017412344,  DanieleBibo, 40, 17, 23, no
1462955294,  FedericoDiGenna, 6, 5, 1, yes
633147468,  la_masseria, 10, 3, 7, no
431904458,  LuigiVanno1, 21, 17, 4, yes
4327300043,  maxlooking, 15, 10, 5, yes
3458620516,  ItalianitaMP, 14, 14, 0, yes
118978778,  12qbert, 37, 27, 10, yes
413185210,  Mauri983, 5, 4, 1, yes
716259184,  GridoDitalia, 35, 21, 14, yes
455659876,  PaoloMedioli, 2, 2, 0, yes
382650535,  Steipad, 14, 7, 7, neutral
293518432,  de_capitani, 13, 12, 1, yes
2512832146,  68e6cb0bac504ec, 20, 16, 4, yes
3879187997,  PiazzaSimonetta, 244, 201, 43, yes
764073381532753920,  Amelia898314041, 382, 302, 80, yes
783162012067106816,  martru8, 66, 52, 14, yes
721937520771129344,  SalacristRenata, 232, 188, 44, yes
801808342125514752,  IsabellaGallio1, 160, 129, 31, yes
791671139521142788,  susannabartolo2, 359, 319, 40, yes
4075531942,  licia_roffia, 97, 80, 17, yes
323105001,  GiovannelliIris, 58, 39, 19, yes
799383480396300288,  VandaLa10, 57, 50, 7, yes
504894136,  GermanaGiani, 181, 123, 58, yes
728267401,  OriettaG, 283, 216, 67, yes
794906422320447488,  elenamoroni1959, 81, 68, 13, yes
3793353617,  MariellaBonotti, 185, 126, 59, yes
3555797841,  lilla_trilly, 299, 241, 58, yes
3879969267,  germy59, 85, 67, 18, yes
722850803464015872,  HelgaVirdis, 580, 470, 110, yes
3385699887,  FrancescoGesua7, 37, 33, 4, yes
15191260,  lorenzabo, 36, 34, 2, yes
417111368,  MaximilianDolce, 30, 30, 0, yes
2358348371,  marini_gian, 55, 49, 6, yes
773240110120927232,  franco_tinghi, 8, 4, 4, neutral
130851801,  lucianonobili, 33, 29, 4, yes
415608754,  GiuliaTempesta, 11, 9, 2, yes
794822744840007680,  bastaunsiRoma, 26, 26, 0, yes
12514212,  orfini, 13, 12, 1, yes
371749840,  straditeresa, 211, 148, 63, yes
550588728,  PD_ROMA, 14, 13, 1, yes
255674310,  alisabn, 27, 25, 2, yes
417904492,  BorioniStef, 11, 11, 0, yes
26801513,  TiSalvati, 3, 3, 0, yes
422581944,  antogulli, 3, 3, 0, yes
763694739854090240,  Amaro57024721, 17, 11, 6, yes
15712835,  smorelli, 259, 253, 6, yes
99475834,  ilariomaiolo, 34, 13, 21, no
1032237176,  marco_bisogni, 20, 20, 0, yes
225168723,  ricpuglisi, 45, 41, 4, yes
556650372,  RParavati, 69, 52, 17, yes
3083483560,  AscoltaP78, 17, 15, 2, yes
424153335,  AnnaLeonardi1, 242, 195, 47, yes
396218442,  lucaM1966, 249, 118, 131, no
781749446908477440,  gargiulodaniel2, 41, 23, 18, yes
253018480,  realiroberto, 34, 29, 5, yes
1690434842,  RAIsenzaBerlusc, 164, 115, 49, yes
3398394214,  marialuisazocc1, 194, 138, 56, yes
797787538844958720,  corrado_massaro, 13, 11, 2, yes
352164101,  CorradoRabbia, 32, 10, 22, no
3431319455,  martinaital, 16, 7, 9, no
414278508,  Zuckerman3, 7, 5, 2, yes
427739699,  paolo_porcari, 33, 17, 16, yes
431884957,  _effe17, 11, 7, 4, yes
436124417,  paoloabbadir, 94, 56, 38, yes
550460960,  BernyZb, 3, 3, 0, yes
18618749,  mylae_67, 36, 23, 13, yes
1055140058,  clem24067977, 49, 28, 21, yes
142204068,  italia1971luca, 21, 15, 6, yes
19592755,  xposeidone, 101, 63, 38, yes
512500400,  LilyTessa, 3, 3, 0, yes
414807138,  SkylabStudios_, 2, 2, 0, yes
1109134129,  RosaGiancola, 4, 4, 0, yes
4185673192,  retesoletv, 16, 15, 1, yes
351668873,  leonardotosoni, 2, 2, 0, yes
2512905313,  luciavalente_tw, 6, 6, 0, yes
3377125691,  Corecom_Lazio, 4, 4, 0, yes
2296173870,  SISSILUCE, 12, 12, 0, yes
499700281,  RosellaPre, 4, 4, 0, yes
2166335324,  FaRitardo1, 16, 15, 1, yes
403544693,  nzingaretti, 18, 18, 0, yes
2860979986,  MarioAssennato, 4, 4, 0, yes
55527972,  karda70, 8, 8, 0, yes
3688803513,  dippolitowilma, 204, 154, 50, yes
55286165,  LazioInnova, 2, 2, 0, yes
755102530527457280,  carpa55, 101, 78, 23, yes
790813980180840448,  VsPennivendoli, 9, 9, 0, yes
68719786,  daniele_panzeri, 4, 2, 2, neutral
708302967234039809,  Pallepanzane, 119, 119, 0, yes
789223163305615360,  ilmoro0, 36, 36, 0, yes
4821193318,  onestaverita, 282, 282, 0, yes
1635172152,  LucaMantelli1, 7, 7, 0, yes
4910860665,  sanCefa, 23, 23, 0, yes
4818775001,  inaccettabile20, 13, 13, 0, yes
2508927513,  Ch12Mc, 67, 67, 0, yes
2308162216,  EvaMannelli, 41, 41, 0, yes
1367758146,  DrNicolaromano, 4, 4, 0, yes
580344256,  marconicolett11, 8, 5, 3, yes
950266993,  aleantinori, 36, 25, 11, yes
365304824,  smkarhu, 36, 33, 3, yes
2883758397,  nogender_it, 18, 17, 1, yes
101573147,  giamma71, 133, 29, 104, no
2380592546,  silmauve775, 43, 12, 31, no
1114542462,  RobertoCoscelli, 10, 1, 9, no
865157341,  gaspare58, 11, 2, 9, no
390753281,  SaggioYogurt, 61, 25, 36, no
533059229,  rosaannapapiri, 78, 46, 32, yes
737896079669231616,  RLamanna195, 4, 2, 2, neutral
585968039,  Yi_Benevolence, 60, 28, 32, no
80200885,  Stefbazzi, 94, 33, 61, no
52035837,  pino_catizone, 76, 70, 6, yes
605749807,  zum_zug, 24, 5, 19, no
2185717829,  riccio_fra, 15, 9, 6, yes
403652993,  franzfleck, 15, 3, 12, no
167566334,  F_Baldux, 56, 41, 15, yes
2333218579,  Fumino14, 3, 3, 0, yes
2932258043,  Ancona54731159, 34, 21, 13, yes
2714596672,  PaolaTacconi, 135, 56, 79, no
473848168,  Scugnizzobrigan, 127, 74, 53, yes
508680506,  GioPertica, 26, 22, 4, yes
51720974,  andrushya, 43, 39, 4, yes
713721722613211136,  matdio78, 15, 11, 4, yes
1717274785,  mdpennalunga, 533, 336, 197, yes
3319305760,  Franc970, 70, 51, 19, yes
368935338,  titti_disalvo, 29, 29, 0, yes
87950192,  _Barfolomew_, 38, 22, 16, yes
372410270,  BeingGreta, 4, 4, 0, yes
2902258413,  markmoreskins, 19, 9, 10, no
779622776999178240,  DimerP, 8, 7, 1, yes
1434038420,  SerglocSergio, 156, 115, 41, yes
798743088206319616,  Melania11564076, 462, 124, 338, no
741592495155478528,  FioreVero123, 95, 28, 67, no
843757543,  assuntapaganucc, 54, 9, 45, no
499227001,  ANDREAZANETTIN, 235, 66, 169, no
2361360169,  SirioFerri, 702, 205, 497, no
3401876698,  marianomores61, 24, 11, 13, no
105433403,  ContiAlessio, 38, 32, 6, yes
3010269323,  TESOROF1, 9, 6, 3, yes
3251331238,  kalyaMail, 112, 83, 29, yes
493914599,  emanuelbutti, 19, 15, 4, yes
3385105642,  ElenaCerci, 513, 75, 438, no
1274899394,  cobraalveleno, 38, 15, 23, no
557827565,  luca_vidoni, 251, 40, 211, no
741762693972021248,  Owl37761656, 12, 7, 5, yes
3377428947,  EntiLocaliFI, 27, 4, 23, no
4160203479,  LPincia, 143, 55, 88, no
2455541630,  66liuk, 103, 36, 67, no
565619420,  renatodepaoli1, 5, 3, 2, yes
759712744044056577,  giulioam, 327, 171, 156, yes
26982622,  FaustoConti, 314, 71, 243, no
1384265604,  ventodilibertaa, 64, 32, 32, neutral
20430345,  renatobrunetta, 334, 132, 202, no
63126601,  danteferraris, 55, 15, 40, no
263046135,  marcobassini, 13, 8, 5, yes
377680158,  03Stefania55, 41, 41, 0, yes
554226467,  ScrgduS, 16, 16, 0, yes
28526655,  samgam75, 11, 8, 3, yes
85636061,  AiseStampa, 34, 34, 0, yes
1713647664,  MarcoZago7, 46, 40, 6, yes
2359663543,  francocoach, 34, 20, 14, yes
421146026,  MonacoMarco, 21, 17, 4, yes
303139807,  Chiara5Stelle, 30, 14, 16, no
261736361,  GabriellaMan, 11, 8, 3, yes
440716175,  TobrukBruno, 19, 9, 10, no
2787225059,  vvoxonline, 47, 36, 11, yes
2948155437,  6a5e656eeb68484, 34, 27, 7, yes
313323905,  EnricoColtri1, 15, 15, 0, yes
2575440461,  c0dd6789363840e, 21, 14, 7, yes
419285776,  CCabiddu, 100, 83, 17, yes
524184932,  chproietti, 5, 3, 2, yes
746008230757867520,  AleGalvaniEdu, 19, 13, 6, yes
2298394045,  AntonioD64, 12, 7, 5, yes
963144078,  rkatalano, 40, 37, 3, yes
390118819,  Unomattina, 53, 33, 20, yes
431649074,  elisabellamorbi, 35, 27, 8, yes
84874030,  mcapu100, 26, 12, 14, no
3399075250,  titzbiltz, 105, 64, 41, yes
433789331,  GMustacchi, 13, 10, 3, yes
317348328,  carminescafa, 5, 3, 2, yes
724648551561728000,  MaraB710413, 49, 37, 12, yes
737724815780499457,  giannimorodonin, 16, 15, 1, yes
1354437403,  micheledannibal, 43, 29, 14, yes
2361394675,  LeoGuerini, 414, 276, 138, yes
303298353,  GMilioto, 70, 60, 10, yes
2201641540,  legalite952, 28, 18, 10, yes
2739361664,  TheAdviceStaff, 9, 6, 3, yes
485031544,  SileoLucia, 35, 34, 1, yes
45400255,  vincen11, 33, 23, 10, yes
714739556747243520,  boettoisabella1, 16, 2, 14, no
3154767440,  ritagargiulo63, 14, 10, 4, yes
1374652910,  simonavitelli60, 78, 36, 42, no
440333722,  Vito_Romaniello, 12, 7, 5, yes
500881322,  Irishsara1980, 81, 59, 22, yes
304035042,  FraMoriconi, 4, 3, 1, yes
4620748593,  aldebaran1581, 3, 2, 1, yes
1362144619,  FcaPitti, 41, 31, 10, yes
2416044272,  effe1312, 53, 31, 22, yes
569492527,  alessiotacconi, 14, 8, 6, yes
70602731,  darcocri, 11, 10, 1, yes
3294901019,  Marcell01010589, 31, 23, 8, yes
392987772,  summa57, 31, 28, 3, yes
2410911599,  seggen56, 85, 70, 15, yes
2887193787,  costarpa, 33, 32, 1, yes
224759837,  gio1893, 21, 14, 7, yes
608125539,  ADM_assdemxmi, 57, 54, 3, yes
259254286,  enigiro, 6, 5, 1, yes
184489591,  ChiccaToscana, 27, 21, 6, yes
761282595019689984,  luigigiorgi3, 6, 4, 2, yes
1273311685,  IoFausto, 16, 9, 7, yes
2172017830,  caracash57, 4, 3, 1, yes
103646510,  luigi9912, 64, 33, 31, yes
438339383,  LucaBellinzona, 21, 17, 4, yes
1370308218,  ffrrbbrr, 40, 25, 15, yes
33489313,  Francy71, 5, 3, 2, yes
432688797,  morissese, 93, 57, 36, yes
2499664019,  PatrickAloisi, 9, 5, 4, yes
418814614,  FrancescoBonif1, 21, 20, 1, yes
133461180,  antgentile, 130, 123, 7, yes
743514238493278208,  silvermelluso, 407, 362, 45, yes
495466998,  zluca2, 31, 12, 19, no
1039048494,  SacchiGg, 104, 71, 33, yes
1111225376,  MariaPiaRagosa, 29, 28, 1, yes
482343716,  japocostante, 15, 13, 2, yes
727918765,  PinoManc, 5, 4, 1, yes
1948013262,  1diaiaco, 9, 3, 6, no
474746645,  nabru11, 70, 14, 56, no
1566546614,  verdelombardo1, 8, 5, 3, yes
75588319,  NMammato, 18, 14, 4, yes
29442185,  Max_Alle, 5, 4, 1, yes
2865546393,  AMTomarchio, 207, 141, 66, yes
586437384,  ste_zanni, 3, 2, 1, yes
1222000628,  stemar9288, 143, 94, 49, yes
104239528,  MilaSpicola, 55, 43, 12, yes
486400626,  ruggides, 5, 2, 3, no
889816856,  PaoloOltolina, 9, 8, 1, yes
466390775,  Impera12, 3, 2, 1, yes
1849326181,  GloBackita, 52, 45, 7, yes
1896618822,  denardimax, 8, 7, 1, yes
1927224049,  RafSabb, 19, 14, 5, yes
1356673152,  mursino71, 103, 78, 25, yes
1229387604,  filiagost, 29, 27, 2, yes
30248306,  ivanscalfarotto, 30, 27, 3, yes
180317088,  RobRe62, 312, 283, 29, yes
710864700851032064,  Caillebotte5, 81, 54, 27, yes
743030635707650048,  xliberopensare, 9, 8, 1, yes
930194618,  tobiamc, 237, 221, 16, yes
297435979,  willtruman70, 15, 12, 3, yes
554546400,  LucioPfm, 13, 7, 6, yes
1156714753,  annacla14, 3, 2, 1, yes
1226137165,  PieroBizzarri, 14, 9, 5, yes
783200025853751296,  DanyRocchetti10, 308, 275, 33, yes
422529041,  domenicocarreri, 22, 21, 1, yes
443187387,  marpol55, 275, 115, 160, no
1930695714,  lorianomovie, 77, 49, 28, yes
1372461787,  luisaloffredo28, 334, 111, 223, no
456894487,  pugganagga, 62, 29, 33, no
495323941,  DOcastaldo, 11, 10, 1, yes
99125540,  Marte61, 21, 18, 3, yes
428588499,  GessaMarta, 36, 19, 17, yes
807581581,  DAmboldi, 50, 27, 23, yes
589286587,  JohnHard3, 118, 48, 70, no
395759988,  gabry_v, 14, 4, 10, no
144138429,  NioZeroPlastica, 8, 8, 0, yes
2178600592,  ITestini, 78, 50, 28, yes
294535863,  FlatMarco, 25, 16, 9, yes
136013337,  menguicc, 8, 7, 1, yes
530990399,  luchinux, 47, 11, 36, no
3871871513,  genovesi_mg, 65, 14, 51, no
2216179636,  _marlene1265, 39, 32, 7, yes
602069331,  FedeleAmico, 34, 32, 2, yes
1283518398,  vicky68_, 40, 20, 20, neutral
1022123316,  biffino, 39, 14, 25, no
2940410703,  085a2db71d18453, 52, 13, 39, no
3369517217,  enricomaino, 19, 8, 11, no
3957645843,  Massimo27355129, 215, 50, 165, no
440691898,  ErmannoKilgore, 223, 116, 107, yes
3243380165,  robbe1978, 9, 4, 5, no
3052918302,  italiano201415, 51, 42, 9, yes
1368152558,  TAL77SVAD, 227, 45, 182, no
159551952,  slipknotoverall, 24, 15, 9, yes
265385204,  manilamatic, 48, 22, 26, no
2854387281,  Angel5stars, 25, 14, 11, yes
1278202914,  A77362729, 23, 8, 15, no
1359735968,  zanzotteramauro, 25, 11, 14, no
1338857240,  crosta_giovanni, 18, 16, 2, yes
1042134122,  sgrecciaantone1, 42, 26, 16, yes
2496237324,  MatteoStaSereNO, 14, 13, 1, yes
436833006,  AfinetAlberto, 28, 11, 17, no
48142375,  sedicizero, 11, 9, 2, yes
1261559155,  lucvit69, 84, 13, 71, no
1263818557,  CiceroM5S, 59, 20, 39, no
932888491,  BardelliSimone, 124, 80, 44, yes
1614960044,  occhidisoleluna, 16, 8, 8, neutral
2465000210,  IoSonoUnoLibero, 29, 16, 13, yes
3034869375,  mappoa73, 17, 14, 3, yes
3124240699,  lucamedico, 53, 23, 30, no
712713408806842368,  menteressameli, 98, 65, 33, yes
815758254,  SetDamper, 66, 39, 27, yes
702128508835860480,  LauraGio_75, 170, 68, 102, no
3028742807,  marcos_sup, 41, 15, 26, no
2431061097,  francescade54, 215, 70, 145, no
139188966,  Valnao, 73, 18, 55, no
753519234710376449,  pantanac, 88, 17, 71, no
362168367,  Serotino, 37, 21, 16, yes
752010888,  tranellio, 298, 176, 122, yes
2975094340,  ADTacitus, 55, 25, 30, no
2883830458,  renzoferrari61, 19, 9, 10, no
318939574,  ginocalcinotto, 93, 57, 36, yes
752897299186155520,  Alex46928800, 39, 16, 23, no
2749231737,  Alecrema26, 21, 17, 4, yes
161450764,  aanddrreaa, 56, 24, 32, no
343239720,  catarvoyageur, 107, 27, 80, no
4372999402,  Sempre5S, 106, 36, 70, no
701425649169338368,  MariuolinoR, 40, 20, 20, neutral
113424592,  mate2411, 27, 23, 4, yes
1133516726,  returnofthema13, 51, 38, 13, yes
265333818,  Massross, 5, 3, 2, yes
1037555461,  cdlmarcello, 20, 10, 10, neutral
995021599,  enricovik, 129, 88, 41, yes
1176618985,  pigi02, 291, 84, 207, no
415394913,  Nino_Germana, 9, 9, 0, yes
776453763624214528,  insiemesicambia, 60, 60, 0, yes
462861866,  Guvizzini, 2, 2, 0, yes
730899685825601537,  beppepedala, 18, 16, 2, yes
496211634,  DANTONIOALFREDO, 21, 21, 0, yes
1664957023,  BertottisArgent, 11, 10, 1, yes
1524322628,  laurelcondor, 111, 58, 53, yes
3096871079,  lefrasidiosho, 18, 16, 2, yes
2788303634,  MianiStefano, 14, 14, 0, yes
1419854173,  FraRomanelli, 26, 26, 0, yes
1101689227,  rey_ns, 42, 30, 12, yes
775421050054139906,  guylaroc, 20, 18, 2, yes
521337019,  RRivellini, 180, 164, 16, yes
187124340,  pucciluca, 3, 3, 0, yes
2672276654,  fabiocacchiata, 3, 3, 0, yes
331629012,  MisuracaClaudio, 21, 21, 0, yes
1558587134,  GiorgioCorrado4, 22, 11, 11, neutral
750612188688154624,  21081e5f0e14478, 16, 16, 0, yes
283215401,  MisterSelva1, 14, 9, 5, yes
4142636141,  Sergio_torino, 9, 3, 6, no
1372517456,  filsurace, 18, 13, 5, yes
2348638410,  RENATO18879102, 2, 2, 0, yes
784066684852310016,  antoniolotadio, 20, 13, 7, yes
575654596,  moicano68, 305, 281, 24, yes
2406506894,  antoniorunci, 7, 6, 1, yes
433426566,  GiuliettAR11, 22, 21, 1, yes
2932010800,  fantasia1954207, 17, 9, 8, yes
737934742461526016,  charas2, 8, 2, 6, no
791545816322306049,  Paolo55734818, 7, 4, 3, yes
254646788,  angelorm66, 11, 11, 0, yes
260230310,  partimeasylover, 39, 39, 0, yes
732954867833176064,  CarmineSantor15, 12, 12, 0, yes
361450396,  Stefanoferrero_, 2, 2, 0, yes
516388193,  MaurizioScurci, 2, 2, 0, yes
743821644150476800,  paparosso60gma1, 7, 5, 2, yes
268749571,  lucadome76, 30, 12, 18, no
750670310,  57Davide, 65, 56, 9, yes
419046277,  RobertoRavagli1, 16, 15, 1, yes
3030746020,  gargano_aurelia, 4, 4, 0, yes
1731978230,  teodornasi, 3, 3, 0, yes
1241106426,  porcupine_tweet, 15, 12, 3, yes
2198193816,  Sarx88, 39, 25, 14, yes
3024843525,  RealGottlieb, 114, 53, 61, no
730660405761191936,  Ant__RI, 23, 6, 17, no
797519058031824896,  kettymarra, 2, 2, 0, yes
796908372,  RiccardoGervas1, 10, 10, 0, yes
451279327,  giorgio_trentin, 11, 4, 7, no
4393094843,  Renato74321072, 11, 11, 0, yes
13158872,  GoriSavellini, 2, 2, 0, yes
3115484254,  recordisco, 41, 39, 2, yes
1662331873,  danpreziuso, 9, 7, 2, yes
796759446370271232,  giuseppinanico8, 308, 251, 57, yes
771232888381550593,  maur_i_zio, 30, 24, 6, yes
2359548435,  mikiden62, 31, 12, 19, no
2282469222,  francesco201423, 175, 67, 108, no
798635240889651200,  Mpaszk, 225, 172, 53, yes
3879573977,  chantal_mirella, 133, 97, 36, yes
4299066556,  patriziaparide, 323, 238, 85, yes
766664451223330816,  soldi_anna, 179, 133, 46, yes
764525968623071236,  laurayellowduck, 172, 97, 75, yes
937463430,  annaperina, 211, 167, 44, yes
424243905,  _melchiori, 19, 10, 9, yes
4911191667,  GianluSag, 124, 47, 77, no
81689292,  ziomau59, 24, 12, 12, neutral
3145299803,  FabSt81, 15, 15, 0, yes
259949070,  speleodori, 19, 10, 9, yes
76616277,  Deputatipd, 247, 244, 3, yes
2534968364,  edumaestra, 4, 4, 0, yes
53306660,  lucidellanotte, 21, 18, 3, yes
96580657,  lucianoserrau, 28, 21, 7, yes
438176540,  AodiFoad, 13, 13, 0, yes
786893011191996416,  EUdemPD, 2, 2, 0, yes
2557719974,  DanielemoroMoro, 6, 6, 0, yes
1040184410,  SteGiannini, 4, 4, 0, yes
1064232619,  flaviamoratelli, 40, 40, 0, yes
463696074,  MassoniSerafino, 5, 4, 1, yes
521306441,  GiosueVerta, 1, 1, 0, yes
114553027,  Mande19, 8, 7, 1, yes
964876040,  M_Berlinghieri, 28, 27, 1, yes
999278988,  laura_coccia, 29, 24, 5, yes
1066071158,  diegoteloni, 2, 2, 0, yes
154896410,  Gianni_Ciasullo, 40, 34, 6, yes
2807420534,  alelkhoury, 1, 1, 0, yes
143474661,  OSTO27, 4, 4, 0, yes
607174392,  ItalyinEU, 2, 2, 0, yes
885084290,  frances42830555, 9, 9, 0, yes
288967832,  nachoalarcon94, 1, 1, 0, yes
1165954860,  GisellaAlizoni, 7, 7, 0, yes
339066423,  LBorino, 7, 7, 0, yes
2872452713,  italia_riparte, 50, 47, 3, yes
4818092890,  noisiamoilpd, 44, 42, 2, yes
778321813,  RattiEnrico, 232, 86, 146, no
227292792,  Furerm, 1, 1, 0, yes
428648797,  NicolaEMVerola, 5, 5, 0, yes
500214625,  bifabri, 23, 18, 5, yes
2687289798,  paolopizzi6, 23, 21, 2, yes
793414057223135232,  AAgrigento, 63, 56, 7, yes
385571810,  Izmi6393, 34, 26, 8, yes
986981292,  ptreppi, 1, 1, 0, yes
3217711420,  VGentilomo, 117, 65, 52, yes
1345269470,  akastwee, 4, 2, 2, neutral
514377723,  julyette17, 45, 41, 4, yes
576362054,  MassimoDeMeo, 7, 7, 0, yes
1142378659,  Psymate, 11, 8, 3, yes
192258181,  albinobistacco, 69, 24, 45, no
135612352,  silviafrance, 4, 4, 0, yes
3030465038,  Remeggiare, 39, 21, 18, yes
3067642931,  brusalucia, 15, 5, 10, no
2363490707,  CarmelaBeninato, 27, 23, 4, yes
301516514,  bepiborsari, 9, 7, 2, yes
140002958,  Costanzo64, 3, 3, 0, yes
3632667623,  507172dd3828437, 22, 17, 5, yes
2680541218,  ragioca, 1, 1, 0, yes
3153937600,  greenco2zero, 4, 4, 0, yes
1307016348,  poke_dem, 157, 68, 89, no
1076649404,  DipPoliticheUE, 10, 10, 0, yes
555309932,  eunewsit, 13, 13, 0, yes
2466472062,  Fineosservatore, 12, 12, 0, yes
177237683,  mfrancescaguida, 2, 2, 0, yes
1670823475,  ffedericabander, 8, 7, 1, yes
2800729570,  thebrightside0, 113, 74, 39, yes
1088677627,  marisaLaDestra, 38, 13, 25, no
602903174,  Storace, 80, 31, 49, no
228051072,  marco_itas, 90, 50, 40, yes
413217587,  gasparripdl, 292, 88, 204, no
1037692622,  frafra61_rossi, 137, 62, 75, no
3607235297,  ninalives81, 21, 10, 11, no
2708607896,  LordManlio, 27, 15, 12, yes
4098447160,  Elena07617349, 615, 209, 406, no
787009091373850625,  Salvato01143095, 337, 111, 226, no
413354451,  IlariaCalvani, 90, 34, 56, no
3050488523,  domenicod976, 3, 3, 0, yes
448998373,  PDibattista, 112, 36, 76, no
1478297786,  PravatoSilvano, 62, 10, 52, no
2436608759,  Uleprr, 343, 110, 233, no
194972957,  cinmir89, 174, 48, 126, no
1084193910,  kidstu, 99, 45, 54, no
1148226661,  soloio0509, 22, 18, 4, yes
4863618933,  CretellaRoberta, 183, 65, 118, no
118183154,  GianelliniR, 17, 6, 11, no
175783590,  shakerman1971, 10, 4, 6, no
742013658268598273,  Anna05600885, 33, 11, 22, no
2258689712,  italiaxitalia, 106, 78, 28, yes
796246539668692993,  claudia_bionu, 192, 184, 8, yes
115139827,  ardovig, 35, 10, 25, no
38032906,  DarioBallini, 36, 20, 16, yes
1480106364,  SilviaBM5S, 3, 2, 1, yes
282624338,  surgeondiver, 22, 20, 2, yes
4468775656,  rexforte1, 19, 13, 6, yes
254803562,  Migna66, 42, 38, 4, yes
950249966,  GittoMaria, 2, 2, 0, yes
410748554,  lorenzosolimene, 4, 4, 0, yes
22799265,  alexyahoo, 16, 11, 5, yes
526552069,  gioritucci, 15, 7, 8, no
2228600094,  vincenzodinanna, 14, 14, 0, yes
1127733265,  8giuseppe3, 80, 68, 12, yes
467439918,  CinoRiccardo, 13, 13, 0, yes
2346647000,  petroglifi, 12, 8, 4, yes
425759519,  AlessRabiti, 28, 26, 2, yes
264211609,  VicoZanetti, 23, 20, 3, yes
2755045636,  fedezic, 3, 3, 0, yes
459438013,  SalviGianni, 7, 7, 0, yes
3430565794,  SintagmaToi, 32, 28, 4, yes
2525778087,  todorov_denis, 27, 22, 5, yes
501225131,  AlexZan87, 30, 8, 22, no
432434135,  pippo_romano, 10, 8, 2, yes
60836149,  AldoModica, 4, 3, 1, yes
416928501,  alfidom, 11, 4, 7, no
737350565957623808,  ilpiDiOta, 4, 4, 0, yes
241086708,  magia313, 8, 7, 1, yes
4212866417,  bastaececi1, 55, 42, 13, yes
107729277,  MarianoEder, 75, 70, 5, yes
1531171376,  micky_sat, 12, 11, 1, yes
1280953482,  Maila1974, 140, 84, 56, yes
2969726416,  enzo_eam1984us, 3, 3, 0, yes
447990031,  andreagiacobin1, 15, 4, 11, no
423686178,  plasticpavement, 4, 4, 0, yes
798551815742701568,  idonei_CC10, 8, 6, 2, yes
395383733,  TotoChiaramonte, 13, 11, 2, yes
378212172,  roberto_bonina, 3, 3, 0, yes
749248856,  martinorosario2, 44, 34, 10, yes
859582356,  Giornaleditalia, 27, 21, 6, yes
3503051356,  Kekkokekko80, 17, 17, 0, yes
477757835,  coledoni, 143, 106, 37, yes
4688837276,  almacuba15, 61, 54, 7, yes
425016519,  SilviaSalemi, 2, 2, 0, yes
243631237,  gaiaitaliacom, 6, 6, 0, yes
2749566881,  alexa5313, 61, 35, 26, yes
256491020,  Tluigi15, 53, 29, 24, yes
366188528,  daninbio, 8, 6, 2, yes
1611260352,  luciomummio, 18, 12, 6, yes
1562752760,  asocialesempre, 210, 198, 12, yes
257499288,  FrancoTrax, 71, 23, 48, no
3906213625,  amadeu_prado, 37, 31, 6, yes
475234937,  valy_s, 169, 84, 85, no
3058996408,  IFreeInfo, 13, 6, 7, no
803299268136173574,  Violett14177504, 49, 28, 21, yes
1170061058,  christiancili, 5, 5, 0, yes
488765562,  Monica_torino, 36, 15, 21, no
408964746,  almahadomanzo, 2, 2, 0, yes
945407058,  GiovanniMoglia, 78, 70, 8, yes
773155625127796737,  alfuturosi, 35, 32, 3, yes
989346433,  summo_t, 73, 56, 17, yes
773956774932127744,  2025annamaria, 284, 193, 91, yes
2431985092,  Camusdele, 63, 53, 10, yes
233963729,  iz0ewj, 14, 7, 7, neutral
236335841,  macondo83, 33, 26, 7, yes
3588475175,  Luca_1998, 142, 128, 14, yes
3131729685,  pdmilano7, 59, 59, 0, yes
1386751423,  tal_Marco, 72, 59, 13, yes
610814425,  RobertoDanesi2, 17, 14, 3, yes
1036813327,  gianaima, 20, 18, 2, yes
1313490145,  MariFabbri, 39, 39, 0, yes
911093208,  francesco_tassi, 12, 11, 1, yes
273853899,  Declich_x, 2, 2, 0, yes
118053242,  _sofino, 23, 9, 14, no
3193977725,  PdCircolo, 22, 22, 0, yes
389104963,  alcinx, 189, 179, 10, yes
406437699,  LeonardoMonte67, 16, 16, 0, yes
199264427,  Claudiano1979, 20, 18, 2, yes
256154322,  darboit, 2, 2, 0, yes
329937650,  GiordanoBattini, 289, 211, 78, yes
385980814,  MSparpaglione, 40, 36, 4, yes
217456749,  touareg250, 14, 13, 1, yes
2265980124,  BabykidbikeD, 2, 2, 0, yes
288815072,  seawolf7021, 6, 6, 0, yes
245715438,  pierapis, 114, 108, 6, yes
739885032983154692,  Iron107811791, 19, 13, 6, yes
391466134,  massimomileto, 22, 15, 7, yes
987294012,  monicaalbanese8, 6, 4, 2, yes
1039152966,  amoreandrea84, 43, 24, 19, yes
2906554709,  margherita951, 63, 60, 3, yes
1015392134,  tommysensi, 95, 85, 10, yes
402863215,  bigimauro, 33, 30, 3, yes
1259908111,  Riccardo_msc93, 8, 7, 1, yes
1128807018,  FFiamengo, 56, 48, 8, yes
398023821,  CarloBorghetti, 9, 9, 0, yes
10350822,  mmanca, 13, 7, 6, yes
447005422,  enortam, 36, 31, 5, yes
470364053,  ninos49, 10, 5, 5, neutral
459115038,  GiorgioPerugia, 33, 33, 0, yes
987220201,  Bertoldo41, 34, 24, 10, yes
519746098,  GoriNello, 17, 17, 0, yes
2878097184,  62a9d0ad80394a3, 37, 28, 9, yes
184881757,  andreapaolo1, 8, 8, 0, yes
274014643,  PD_Lentate, 163, 158, 5, yes
2907756975,  badkiki1, 59, 30, 29, yes
2210084110,  saberrasc, 43, 35, 8, yes
49318571,  danielhazan, 11, 10, 1, yes
759717599328411648,  jacques_jj6592, 37, 29, 8, yes
436640636,  TheLambkin_, 140, 116, 24, yes
735366894857916416,  Vota_Si_, 41, 37, 4, yes
545879796,  MauroT57, 16, 16, 0, yes
451410343,  doriananera, 13, 13, 0, yes
1113995520,  StefanoMasche, 8, 8, 0, yes
47987007,  eligiobonfrate, 26, 20, 6, yes
1024715064,  letiziaog, 2, 2, 0, yes
401687825,  diegobarberio, 36, 29, 7, yes
630918299,  cristinafavati, 48, 46, 2, yes
2480246000,  rumba15342942, 274, 259, 15, yes
780409230788554753,  StudioA2_Arch, 20, 16, 4, yes
579271577,  maurizioft, 102, 68, 34, yes
2289164481,  petrucci_3, 9, 3, 6, no
4829874545,  sissi010258, 24, 22, 2, yes
3058699804,  giptr2010, 4, 4, 0, yes
836271002,  marino29b, 844, 177, 667, no
759428777793429505,  il_brigante07, 197, 66, 131, no
1967120184,  AntonyFederico, 15, 7, 8, no
3070315479,  PaoloScaramella, 3, 2, 1, yes
728107134714437633,  bauhusi, 49, 46, 3, yes
705462413169205255,  luca_mitri, 30, 20, 10, yes
800808214283448320,  tellurikus, 34, 33, 1, yes
749364032310743041,  AvvMDerosa, 17, 16, 1, yes
421166716,  tutticonilm5s, 22, 20, 2, yes
1348840861,  daninterno, 7, 5, 2, yes
2822423930,  sandrobuccella, 9, 8, 1, yes
2978091879,  HooverMindmap, 5, 4, 1, yes
1368048013,  MaCheTipa_, 28, 24, 4, yes
4832426261,  albyfloyd, 6, 4, 2, yes
3694572081,  CriEarth, 3, 3, 0, yes
3405754877,  RossMuroni, 10, 10, 0, yes
3036835001,  GRAB_Roma, 11, 9, 2, yes
845413776,  taccola10, 7, 6, 1, yes
2376140579,  NasoCarla, 19, 3, 16, no
3127760257,  GioMatLTER, 2, 2, 0, yes
2363684405,  AlessioFraumene, 75, 12, 63, no
521235818,  isabellavecch, 3, 2, 1, yes
427590626,  zappataromana, 3, 2, 1, yes
2277559444,  andipa_di, 6, 2, 4, no
1291226797,  MiVa_didire, 4, 4, 0, yes
1374489680,  FelicioManzo, 13, 8, 5, yes
1261729915,  maverick_982, 4, 2, 2, neutral
414872489,  Severaf64, 2, 2, 0, yes
487730099,  LeilaLoureiro2, 3, 3, 0, yes
409427594,  giu_alessi, 21, 18, 3, yes
1160400798,  Simo_Aq, 6, 6, 0, yes
541114609,  sabrina77777777, 179, 120, 59, yes
2446549197,  donze71, 9, 8, 1, yes
947879034,  Cosi49Cosimo, 70, 28, 42, no
96350254,  BizMichele, 92, 86, 6, yes
730878351150354432,  Giovann32040731, 8, 8, 0, yes
1327639712,  paparcura, 101, 56, 45, yes
50662478,  IlMontanari, 33, 30, 3, yes
2360749273,  ascialpi59, 17, 12, 5, yes
221767233,  taro291070, 19, 19, 0, yes
477976894,  SalisNicola, 2, 2, 0, yes
781136131140222976,  daniela_bonfire, 21, 20, 1, yes
324946999,  Io_spero, 50, 31, 19, yes
2243750130,  aleale_75, 2, 2, 0, yes
553788916,  piemme7881, 6, 6, 0, yes
2811089575,  prof1976, 22, 22, 0, yes
191488665,  Spicug, 54, 40, 14, yes
1179979477,  PietroParrotta, 11, 9, 2, yes
2871622477,  611Gianni, 4, 4, 0, yes
131450639,  ventoMio, 38, 30, 8, yes
785805987190046721,  kimbiki1, 3, 3, 0, yes
41893618,  giulianoio, 5, 3, 2, yes
143250248,  MICHAELBUSCHINI, 4, 4, 0, yes
1141016323,  CChiama, 26, 20, 6, yes
416419905,  pa_mare, 4, 2, 2, neutral
3294587596,  RANADEUS, 102, 102, 0, yes
3097038575,  marlepidi, 2, 2, 0, yes
523757170,  gd1907, 5, 5, 0, yes
1384670900,  F_Calarco, 4, 4, 0, yes
1036788019,  nick__67, 21, 5, 16, no
2791075913,  GalloCostantino, 118, 58, 60, no
3230165817,  MarcoLuceri1, 220, 215, 5, yes
2814253391,  ProfParlamento, 4, 2, 2, neutral
420654713,  AleGaffuryngia, 6, 5, 1, yes
203595715,  silviasse, 3, 3, 0, yes
4129589421,  IreneBertuzzi, 22, 22, 0, yes
995463295,  vinci_antonino, 6, 6, 0, yes
889396670,  luisarizzitelli, 15, 13, 2, yes
1200136616,  frago_fragolina, 5, 4, 1, yes
774882052185481216,  rebelraduno, 10, 9, 1, yes
4772904255,  Calimer85812928, 29, 29, 0, yes
1855419937,  Maurizio_fagg, 7, 7, 0, yes
561917560,  pallypy, 10, 10, 0, yes
3474585855,  mimancaoriana, 62, 47, 15, yes
726387113105707008,  Paolo_Crisafi, 5, 5, 0, yes
761729339201318913,  Raffael36241886, 33, 22, 11, yes
781588515821875202,  la_londinese, 36, 31, 5, yes
559883501,  CreeEdge, 23, 12, 11, yes
1533578659,  vit_marco, 11, 7, 4, yes
766601799155449857,  XMERIDIO78, 30, 12, 18, no
497021694,  ilcorvoparlante, 52, 33, 19, yes
783741519564005376,  Giusepp47963781, 39, 28, 11, yes
540748776,  GaetanoDiPalo, 17, 9, 8, yes
96333128,  albertozen, 34, 24, 10, yes
363158162,  rcarangelo, 42, 22, 20, yes
1328976937,  19484893, 31, 25, 6, yes
2720583173,  cristalaltea, 46, 24, 22, yes
151390694,  Tigre_E632, 74, 65, 9, yes
1891583048,  elisabetta7991, 31, 14, 17, no
384340494,  vanabeau, 8, 8, 0, yes
1601594792,  Leonidalibero, 9, 8, 1, yes
4007851,  minguzzi, 5, 4, 1, yes
381097192,  RaffaeleMerella, 7, 2, 5, no
776255018181722112,  ernst_agent7, 30, 25, 5, yes
237248877,  nottruv, 10, 4, 6, no
1064261450,  StefaniSer, 42, 34, 8, yes
19441340,  grillocb, 15, 5, 10, no
4765712722,  paca_angela, 20, 19, 1, yes
1267096375,  ste_stella00, 33, 29, 4, yes
788063079418499072,  maximocasale, 4, 1, 3, no
722919613,  mariamacina, 94, 81, 13, yes
3169603576,  ItaliaRecord, 195, 130, 65, yes
716911634871160832,  simosimona05, 177, 36, 141, no
1673607168,  pamyluigi, 19, 10, 9, yes
369728921,  ruiciccio, 493, 199, 294, no
705849685190295552,  ClaudioDiLore93, 4, 2, 2, neutral
2181953194,  velluto13, 40, 22, 18, yes
754232386259476481,  Frank9318, 65, 63, 2, yes
432010252,  aghi7723, 12, 2, 10, no
2906264861,  celeste_bazzoli, 71, 29, 42, no
2588051975,  GiampaoloScopa, 58, 50, 8, yes
70684476,  simonefagioli, 3, 1, 2, no
561823534,  totobrocchi, 43, 33, 10, yes
1556455656,  RobertoSignore7, 127, 106, 21, yes
3403081833,  cesaranodany1, 27, 25, 2, yes
150254340,  VilmoModoni, 4, 1, 3, no
2170742693,  rosabta, 104, 28, 76, no
865947528,  mary_caridi, 7, 5, 2, yes
1667689482,  GonzDeGadda, 65, 28, 37, no
4845403365,  Andyesti, 53, 22, 31, no
490602212,  Maselli_Andrea, 47, 30, 17, yes
3046529709,  giulietino11, 35, 11, 24, no
792341976138051584,  CaleffiGiulio, 11, 8, 3, yes
534655010,  TizianaGl60, 282, 193, 89, yes
126691082,  Sfurmy, 25, 16, 9, yes
396878417,  maurilm79, 5, 3, 2, yes
418918882,  MMastrantuono, 126, 102, 24, yes
706086896275955712,  5risi1, 163, 68, 95, no
594802573,  carlomarroni, 4, 1, 3, no
1747158031,  libe12andre, 78, 44, 34, yes
523387439,  pagio_paola, 38, 33, 5, yes
734725512950603776,  TitiCasati, 64, 20, 44, no
481920011,  dani0470, 9, 4, 5, no
602182097,  SpaceCowboy21, 75, 34, 41, no
379812142,  janebaol, 4, 2, 2, neutral
771613884,  lorenzodalai, 31, 27, 4, yes
1367572112,  SandraSonnino, 18, 9, 9, neutral
1257355178,  GianfrancoB3, 69, 29, 40, no
422586035,  FranceManto64, 69, 51, 18, yes
949372327,  ivancatalanodep, 40, 28, 12, yes
480757316,  marcobalsughi, 5, 1, 4, no
387198659,  AdriMCMLXI, 70, 43, 27, yes
478622166,  mari171258, 15, 8, 7, yes
816899671,  AldoMaddalena78, 7, 5, 2, yes
498846820,  CarloSantaroni, 105, 72, 33, yes
753772110783320065,  Sloymele1, 14, 10, 4, yes
432516884,  Moonlightshad1, 8, 6, 2, yes
1880399689,  Lux_Cipolletta, 49, 39, 10, yes
2906792414,  only_jimmy_it, 3, 1, 2, no
405170821,  Luka1961, 65, 15, 50, no
123712076,  andrearossi76, 49, 46, 3, yes
2723029636,  lo_zio_gino, 33, 17, 16, yes
2221902807,  rambomicio, 8, 5, 3, yes
968459856,  PaoloProsdocimi, 35, 26, 9, yes
544352838,  MarioRigoni2, 220, 186, 34, yes
391286828,  Ealloraditelo, 33, 27, 6, yes
775636532,  garridino, 88, 37, 51, no
2980862283,  CateCollovati, 3, 1, 2, no
2397844595,  annalisapanello, 106, 46, 60, no
318713537,  laura_ceruti, 132, 71, 61, yes
371781632,  RaffaelePizzati, 134, 128, 6, yes
2427311741,  clabellocchi, 256, 106, 150, no
2928052491,  Mario04607, 3, 2, 1, yes
715925457774972929,  BrunoTulliani, 10, 4, 6, no
2176219136,  DeborahRaptus, 5, 2, 3, no
1012822723,  EmileFrancy, 40, 18, 22, no
153342663,  emato64, 29, 13, 16, no
4038647320,  erminio_erminia, 42, 36, 6, yes
2795593730,  11B_Mic, 27, 8, 19, no
478277622,  TorelloDiego, 14, 10, 4, yes
3524610567,  Claudio85806751, 17, 1, 16, no
2315044228,  claudiosgarigli, 56, 43, 13, yes
52332450,  simy77ss, 67, 41, 26, yes
2876085995,  peppins2, 29, 13, 16, no
2214275961,  GFalzi, 6, 5, 1, yes
2780434112,  reydecopas_mn, 3, 3, 0, yes
4063692863,  fabio_pergetti, 26, 17, 9, yes
906349453,  AlbaDoratait, 39, 21, 18, yes
3165299303,  italodisco1975, 368, 192, 176, yes
2850037264,  ornizoe31, 6, 6, 0, yes
778195022973923329,  BeniaminoGiust1, 31, 24, 7, yes
172170794,  HopeDieBefore, 26, 18, 8, yes
382539264,  UGiangrieco, 239, 217, 22, yes
201314106,  ronin6666, 10, 6, 4, yes
416409904,  toni_dellanna, 3, 3, 0, yes
3143810488,  Bierbrauer53, 28, 16, 12, yes
2813435920,  Salvo332Salvo, 21, 8, 13, no
426716463,  bloodaxes1, 15, 11, 4, yes
1426350500,  mirco_scartoni, 5, 5, 0, yes
1630204784,  CorbelliFranco, 82, 45, 37, yes
319166186,  brontolous, 41, 33, 8, yes
132810751,  stefaniami, 8, 8, 0, yes
2835640580,  AlvinSerse, 19, 12, 7, yes
773200264635490304,  mmr_services, 25, 14, 11, yes
1556491195,  pa_tere, 91, 41, 50, no
802875456747962368,  PDappesi, 37, 36, 1, yes
1471608194,  erpedrini, 171, 82, 89, no
1644456139,  NiklausRt, 29, 16, 13, yes
268744692,  moefan90, 33, 19, 14, yes
2748105759,  FaticoniPiero, 22, 18, 4, yes
447965111,  TizioGiusto, 22, 17, 5, yes
488356774,  andreavarsalona, 204, 122, 82, yes
467901885,  LuciMariMonti, 10, 7, 3, yes
264332440,  polato95, 10, 6, 4, yes
4611199415,  Mibavi1, 132, 83, 49, yes
428415112,  sailor889, 41, 21, 20, yes
765113425882218497,  UghettoSuper, 271, 211, 60, yes
292275504,  NunzioRovito, 6, 3, 3, neutral
72546577,  WWFitalia, 2, 2, 0, yes
1195176624,  YahFiorito, 51, 25, 26, no
545474882,  FabozziGennaro, 16, 3, 13, no
1513860781,  SimoM95, 22, 17, 5, yes
612930809,  ruggero99, 5, 4, 1, yes
534489366,  Nikke70, 6, 5, 1, yes
2977934441,  senantoniorazzi, 340, 21, 319, no
4243700865,  MaiorinoOlga, 44, 43, 1, yes
362550965,  ErosBonazzi, 61, 12, 49, no
536600780,  GianlucaBardell, 34, 16, 18, no
840337094,  SteveBurst, 29, 22, 7, yes
1009626624,  IsaaakCAErvello, 80, 38, 42, no
591215948,  MarcoRanzani_pc, 8, 4, 4, neutral
491969040,  CereIvan, 16, 7, 9, no
328172814,  70giovanni, 15, 12, 3, yes
3156887011,  fortux70, 47, 45, 2, yes
2986513055,  egoantonne, 214, 151, 63, yes
2346570771,  PaoloRonk, 6, 6, 0, yes
1235964151,  Daniele8Morelli, 23, 14, 9, yes
1333621646,  misscilla69, 3, 3, 0, yes
398928323,  luigielena, 79, 79, 0, yes
2933100036,  antofer77, 9, 9, 0, yes
81075901,  twmario917, 26, 17, 9, yes
2756017623,  andreanselmitw, 5, 4, 1, yes
754694678314901504,  bavgio, 32, 20, 12, yes
4604699980,  GiuseppeBucci17, 11, 10, 1, yes
345918295,  ilpoetaestinto, 115, 83, 32, yes
216281928,  maurizioi, 34, 18, 16, yes
53200070,  bonhomme69, 33, 31, 2, yes
385512892,  enzo958, 43, 32, 11, yes
764140480775020544,  1984_paride, 185, 94, 91, yes
722098819110985728,  Sergiochem, 27, 27, 0, yes
478077452,  AlexBienati, 7, 7, 0, yes
356050856,  giuaddo99, 60, 53, 7, yes
970022552,  antoninosiino, 24, 23, 1, yes
991024189,  webfrench, 17, 17, 0, yes
1432794030,  Roberto7008, 8, 5, 3, yes
842378066,  bodyzen52, 26, 11, 15, no
3348087791,  ilrossimario, 15, 15, 0, yes
717965900062793729,  Andreas_Kartack, 48, 41, 7, yes
402002433,  LucaBelatti, 3, 3, 0, yes
231245861,  MicheleCotugno, 9, 8, 1, yes
469495566,  giseffina, 10, 8, 2, yes
2937209879,  1f32670ca804475, 67, 35, 32, yes
3129948658,  licia1958licia, 34, 18, 16, yes
2859316269,  31239a839db94c9, 50, 28, 22, yes
2553289698,  masterofmate, 15, 12, 3, yes
476051821,  danielacastri2, 151, 148, 3, yes
423780098,  ManninoClaudia, 6, 6, 0, yes
2185623257,  aleamodo, 5, 5, 0, yes
206831627,  pierluscanu, 15, 11, 4, yes
720592519,  silvavol, 21, 20, 1, yes
544700808,  RenatoLega, 49, 39, 10, yes
278210313,  carmencasablanc, 61, 27, 34, no
1269055614,  massimo991, 11, 10, 1, yes
2318610186,  futura09, 95, 29, 66, no
3229982559,  barberini_luigi, 11, 9, 2, yes
1106230255,  mzavarone, 46, 15, 31, no
410876976,  Wise_and_Lazy, 12, 12, 0, yes
2942103525,  NadirTacchi, 6, 6, 0, yes
3070544530,  snailale, 6, 6, 0, yes
424907920,  cisonom, 18, 10, 8, yes
4850369241,  STRANATTRATTORI, 55, 30, 25, yes
789443113651699715,  atregl1, 284, 248, 36, yes
2477156634,  GallozziMrita, 10, 7, 3, yes
82349024,  giulitMI, 6, 5, 1, yes
444853905,  nicolettamanzio, 2, 1, 1, neutral
75538541,  marcosimbula, 20, 9, 11, no
4655248997,  fbianco91, 52, 40, 12, yes
1038231816,  EdiGirolami, 75, 68, 7, yes
794550709178007552,  RES_Online, 6, 6, 0, yes
63060955,  RiprendRoma, 42, 7, 35, no
783613497749938177,  stefano_versano, 20, 14, 6, yes
775039590784729088,  CalogeroVolpe21, 96, 23, 73, no
407685967,  Grand_Battery, 195, 57, 138, no
4229498536,  silviaantonel15, 145, 99, 46, yes
772030120097935360,  Cinzia04358781, 110, 82, 28, yes
2180831464,  VivoliDonatella, 180, 153, 27, yes
790540888237830144,  ciresini, 121, 93, 28, yes
3825308554,  LellaNic2, 198, 145, 53, yes
953571752,  luciafangi, 41, 35, 6, yes
605303095,  BLuciarini, 28, 17, 11, yes
753569175944171521,  ivana_tessarolo, 18, 12, 6, yes
454052150,  P_Pignotti, 19, 19, 0, yes
561947512,  RConfetti, 3, 3, 0, yes
2414256985,  LAZIOcrea, 4, 4, 0, yes
13727692,  fiordisale, 118, 51, 67, no
985118000,  arlello, 70, 48, 22, yes
409089494,  avanti_xxx, 50, 14, 36, no
1001291,  jamm3r, 4, 4, 0, yes
101456289,  Valdieu, 9, 7, 2, yes
3405634973,  ManfredoRoma, 72, 45, 27, yes
257665435,  robylum, 87, 44, 43, yes
705813420973621248,  MAD13021966, 397, 108, 289, no
241289430,  MoniShantiRani, 89, 50, 39, yes
2322947462,  ValeMameli, 55, 21, 34, no
1384894520,  MauroBarin, 123, 59, 64, no
697799370297774080,  tuttixgiachetti, 43, 42, 1, yes
746826249222430720,  la_sardella, 30, 29, 1, yes
248453535,  tryggiu, 20, 17, 3, yes
73007739,  Bilancia2409, 3, 3, 0, yes
138699924,  germoleo, 6, 4, 2, yes
318434829,  GiuliaGenito, 22, 6, 16, no
3228521201,  Gio2020Gio, 42, 34, 8, yes
1911991346,  social_5stars, 102, 13, 89, no
871589084,  LiaPerrone, 11, 6, 5, yes
353575520,  emanuelapetrucc, 82, 40, 42, no
617101203,  giuseppe_sarra, 11, 9, 2, yes
789786960470614017,  MaurizioGattus1, 29, 7, 22, no
1566329647,  ARosestolato, 9, 8, 1, yes
3299563144,  sdavite110, 47, 46, 1, yes
782530039338401792,  MBartolelli, 3, 3, 0, yes
787718928638341120,  LucianoCirulli, 13, 9, 4, yes
2891346688,  TiberiRaffi, 6, 3, 3, neutral
773183546966048768,  FischerM55, 404, 26, 378, no
710498404531630080,  lidiapres08, 569, 24, 545, no
4016008995,  riccagilli, 46, 4, 42, no
3342531046,  iostoconmarino, 218, 11, 207, no
700817890497310720,  1vocexRoma, 214, 11, 203, no
708997585139318784,  annadivalerio, 213, 11, 202, no
4474043243,  ParteCivile, 375, 15, 360, no
4405643841,  lidiera1, 500, 22, 478, no
268925772,  fabiodivita, 6, 3, 3, neutral
313652711,  giulioguazzugli, 33, 18, 15, yes
2546064788,  ERIKBABINI, 11, 6, 5, yes
2282008813,  cla_cur, 1376, 605, 771, no
1059984817,  avvocatorinaldi, 24, 11, 13, no
4858527059,  Valedance11, 41, 22, 19, yes
173110361,  Francesco_Viola, 7, 5, 2, yes
337767301,  borghi_claudio, 38, 23, 15, yes
59073202,  svissero, 15, 8, 7, yes
1063332403,  dsalvucci5, 446, 224, 222, yes
418462661,  fagiitalia, 7, 5, 2, yes
224226820,  dumbo54, 81, 44, 37, yes
3860196976,  tantosec62, 203, 105, 98, yes
1096235264,  LucianoBarraCar, 10, 2, 8, no
508645944,  BordignonAngelo, 23, 10, 13, no
479604138,  RitaccoAlessan1, 91, 52, 39, yes
3971921128,  nientediniente1, 16, 8, 8, neutral
782111222745427969,  NastassiaFi, 7, 4, 3, yes
702253149189439488,  LaVolage, 7, 2, 5, no
1045330356,  Ant_VITALE56, 144, 72, 72, neutral
3217923085,  IlTweetDiDio, 24, 10, 14, no
2223966992,  Sonounpopulista, 25, 14, 11, yes
1189981854,  meribia51, 18, 8, 10, no
1067801792,  Rosaria94182979, 55, 41, 14, yes
1193780617,  IMoresi, 95, 49, 46, yes
151826671,  PDPiemonte, 65, 62, 3, yes
2589309643,  moryzerotre, 3, 2, 1, yes
3042269272,  Jimmyjo1527, 13, 8, 5, yes
2235047637,  AntonioSpadafo4, 39, 33, 6, yes
3355338993,  voragano, 23, 4, 19, no
2966503372,  paoegilles, 37, 20, 17, yes
2765940990,  GianniTorre2, 24, 13, 11, yes
547050389,  LusiPatrizia, 285, 22, 263, no
2572975391,  pippuspippus, 8, 6, 2, yes
594364753,  SteOrion, 16, 8, 8, neutral
1544336527,  elvise1657, 51, 21, 30, no
762658396881428482,  PoliticsRai3, 21, 12, 9, yes
537662962,  EmanueleCagnes, 23, 14, 9, yes
941567396,  AntonellaGramig, 138, 122, 16, yes
1339993381,  Ro78Fas, 31, 15, 16, no
2309237552,  Zedar73, 38, 9, 29, no
2751139073,  PinnaUgo, 56, 34, 22, yes
209891777,  Sorriento_tw, 29, 14, 15, no
1489965936,  argento62, 74, 2, 72, no
509039455,  myrand72, 14, 7, 7, neutral
1371970536,  AquilabyClaKi, 9, 3, 6, no
701388779114930177,  micaleafacchini, 133, 56, 77, no
1238102628,  bmancuso8, 3, 3, 0, yes
779455265045438464,  palermosicambia, 11, 11, 0, yes
785032312123719681,  GiovaniSIcambia, 31, 31, 0, yes
966528644,  NOIFONDAZIONE, 2, 2, 0, yes
3536432607,  MAREvigliosa_15, 2, 2, 0, yes
529483712,  cucinotta85, 20, 20, 0, yes
4838445220,  Galapagos_78, 27, 27, 0, yes
3193772039,  odarroc71, 9, 6, 3, yes
3166034463,  ApCamera, 74, 73, 1, yes
429565076,  vigarofalo, 5, 5, 0, yes
2199795114,  NCD_tweet, 43, 42, 1, yes
1558834609,  Roma22Sa, 23, 21, 2, yes
3164540885,  pinogabrielep, 7, 5, 2, yes
750262751285637121,  lukasposato, 2, 2, 0, yes
419951447,  aldoceccarelli, 114, 99, 15, yes
805762492802723841,  Annanardi5, 3, 3, 0, yes
704330777190907905,  Annaaloi7, 36, 36, 0, yes
786233441742364672,  elide_tasselli, 26, 23, 3, yes
713852625867960320,  ivanovillani1, 35, 35, 0, yes
3095233408,  Laurinalan, 51, 41, 10, yes
768148325942095872,  Pinovito11, 2, 2, 0, yes
305481008,  pizziliberal, 27, 21, 6, yes
2759833728,  ritabassi36, 2, 2, 0, yes
735788453737041921,  magnigiancarlo1, 97, 76, 21, yes
405817197,  acajouli, 15, 13, 2, yes
126375816,  RavennaWebTV, 2, 2, 0, yes
144040138,  EnricoGarbuglia, 40, 31, 9, yes
1291656504,  megasabgio, 67, 44, 23, yes
2956420149,  gioquattrozero, 13, 8, 5, yes
10282412,  giuliog, 7, 6, 1, yes
4860423380,  franchino46, 16, 16, 0, yes
2763511049,  giustinik59, 4, 4, 0, yes
716944964924620801,  biagiobiagio967, 7, 7, 0, yes
794287344715235328,  JeanMarc1171, 87, 77, 10, yes
1208620304,  umbymazzola, 44, 26, 18, yes
585397603,  stefanoba64, 63, 59, 4, yes
337316698,  robertobani, 12, 6, 6, neutral
1715437566,  AvvBERNARDO, 23, 17, 6, yes
941772781,  brunasaracco, 45, 43, 2, yes
548616993,  Lcungi, 300, 199, 101, yes
468521672,  25091264, 12, 12, 0, yes
914050591,  VikSom71, 31, 15, 16, no
768892852017438720,  PatriziaCarena, 2, 2, 0, yes
1642833512,  paolacoccioli, 111, 110, 1, yes
736617948257865729,  VINCENZ15058749, 11, 11, 0, yes
512049031,  MariottiGiorgio, 8, 7, 1, yes
709052668220743684,  Nuvoleitor, 7, 6, 1, yes
131870202,  AlfiereNero, 2, 2, 0, yes
18616891,  LeonardDini, 38, 29, 9, yes
1037152033,  Sabina1956, 127, 61, 66, no
408027768,  NadiaSangoi, 11, 6, 5, yes
472905491,  gabelmanu, 29, 14, 15, no
2197727347,  edoardopastego, 57, 30, 27, yes
3426670696,  enkai_pan, 170, 63, 107, no
4161901551,  7444_334, 6, 5, 1, yes
4069173009,  Bacc_investor93, 128, 43, 85, no
213818443,  scudieromn, 19, 7, 12, no
984646254,  ElenaInvernizzi, 21, 11, 10, yes
1140857102,  PippaPas, 14, 7, 7, neutral
1074173322,  MatteoSeghezzi, 26, 26, 0, yes
2934397120,  PMarchitetto, 4, 4, 0, yes
206993379,  Rob_Capp, 12, 12, 0, yes
729981130007531520,  StefaniaVentu16, 143, 141, 2, yes
947730906,  LeopoldoFreyrie, 17, 17, 0, yes
1228536066,  Monteverde_g, 19, 18, 1, yes
402997564,  erealacci, 61, 61, 0, yes
1341462944,  paoloigna1, 149, 112, 37, yes
430437851,  franco_sala, 383, 253, 130, yes
186118049,  CarminePassante, 5, 5, 0, yes
465390684,  Ariachetira, 35, 12, 23, no
62951965,  Be_Strega, 25, 10, 15, no
2994896470,  CerinoAnnamaria, 51, 45, 6, yes
2591060556,  roberta_marone, 10, 9, 1, yes
45125540,  tzocchi, 2, 2, 0, yes
91820766,  _lyan_, 2, 2, 0, yes
736915646773100544,  pitupitum, 4, 4, 0, yes
3293573594,  justoutofmood, 4, 4, 0, yes
2405839948,  soloversacexme, 13, 11, 2, yes
465337259,  lafrogh, 3, 3, 0, yes
930659928,  phildancefc, 67, 38, 29, yes
51727698,  porelmorro, 19, 13, 6, yes
742656572086747136,  claudioliga63, 26, 16, 10, yes
4726174575,  forzafedele, 82, 24, 58, no
2471273369,  OBigiani, 39, 35, 4, yes
3350423657,  Dilucavittorio, 11, 11, 0, yes
2272705066,  pascalino03, 37, 36, 1, yes
3164390831,  frido1962, 126, 106, 20, yes
543700451,  TommasoTrucco, 5, 5, 0, yes
9650902,  kornfeind, 17, 10, 7, yes
470113437,  pivagiancarlo, 4, 4, 0, yes
83185672,  Animalisti_FVG, 6, 4, 2, yes
762326924,  al2395, 12, 5, 7, no
33226107,  marconardella, 39, 34, 5, yes
2970456022,  EflottaRosa, 1, 1, 0, yes
7426572,  akmur, 2, 2, 0, yes
427580882,  NazzarenoCarusi, 2, 2, 0, yes
1031087262,  EduardoBalletta, 1, 1, 0, yes
704666616,  libraiovoce, 1, 1, 0, yes
2500017885,  elafatt, 1, 1, 0, yes
488768033,  Giulianongiulia, 9, 7, 2, yes
1357710228,  SIPARISipari, 142, 85, 57, yes
863627952,  MarcoSorrenti15, 1, 1, 0, yes
383800270,  visitorcity, 8, 8, 0, yes
52061287,  roxiciocca, 1, 1, 0, yes
2476666696,  Scorpio__Lovee, 1, 1, 0, yes
801469835200839684,  giovannatafuto, 1, 1, 0, yes
470083954,  emanuelebenini, 1, 1, 0, yes
57060570,  PuglisiPD, 34, 33, 1, yes
2788765798,  giusyrus, 133, 128, 5, yes
460987611,  MarinaLongo5, 1, 1, 0, yes
3063946601,  susi_pie, 2, 1, 1, neutral
428411345,  TognazziR, 12, 11, 1, yes
406153137,  peppe_delucia, 4, 4, 0, yes
558598786,  valclo65, 1, 1, 0, yes
424269965,  PapaleoDomenico, 7, 6, 1, yes
2413663977,  ElenaMaccolini, 3, 2, 1, yes
86987331,  EvaElisabetta, 3, 3, 0, yes
146522828,  Fatafutura, 2, 2, 0, yes
738033666811678720,  Runway32, 26, 26, 0, yes
2958027549,  enry81go, 6, 6, 0, yes
220308940,  pdcampania, 81, 79, 2, yes
899385834,  arte_moses, 33, 13, 20, no
859927674,  mariellarosati, 110, 104, 6, yes
3333382456,  tieriantonio1, 4, 3, 1, yes
372448589,  fabianodurso, 7, 7, 0, yes
251558516,  tatianadereani, 1, 1, 0, yes
412250316,  PersanoA, 17, 11, 6, yes
204479365,  olivierocasale, 22, 22, 0, yes
982037941,  PPanzarino, 10, 5, 5, neutral
4126847733,  Gigi_Dario, 2, 2, 0, yes
543308970,  AvvMVeronelli, 1, 1, 0, yes
2597478629,  RobertaCorvaro, 16, 13, 3, yes
960676736,  edoardobraschi, 2, 1, 1, neutral
989797758,  GioveccaGardini, 7, 7, 0, yes
602802570,  matcamme, 61, 59, 2, yes
194281970,  belligerans, 2, 2, 0, yes
423519154,  marconipop, 22, 19, 3, yes
4873612929,  giolaska, 4, 4, 0, yes
2786077631,  MegaleHellas, 2, 1, 1, neutral
142393098,  Paogiu, 83, 83, 0, yes
937263451,  criscuolo_m, 1, 1, 0, yes
540101622,  AndreaFormi, 2, 2, 0, yes
89177842,  aldojani, 2, 2, 0, yes
2412727890,  GamberoRossoTO, 1, 1, 0, yes
4104175103,  GiulianoPalotto, 6, 2, 4, no
2179369755,  AlbertoGiorda16, 1, 1, 0, yes
1091861113,  AlonziSara, 1, 1, 0, yes
2275860026,  gia_taurino, 1, 1, 0, yes
4409054069,  giusy_belfiore1, 1, 1, 0, yes
1131780324,  gpfputignano, 5, 5, 0, yes
781114803465191424,  animativerina, 30, 27, 3, yes
474951309,  giovannilomba14, 1, 1, 0, yes
3253702029,  sabapverona, 1, 1, 0, yes
798448339851313152,  FrancescoAtta18, 10, 10, 0, yes
32832926,  Mainograz, 3, 3, 0, yes
404048864,  SenatoriPD, 331, 318, 13, yes
849022136,  buonstef76, 17, 17, 0, yes
857796026,  saturno1747, 1, 1, 0, yes
380296639,  nikoncolucci, 1, 1, 0, yes
402944688,  cfabio2001, 1, 1, 0, yes
2485617681,  lovellfeNM, 1, 1, 0, yes
405004713,  RobyGuardiero, 39, 39, 0, yes
2829805719,  pdcaposele1, 5, 5, 0, yes
2479818873,  ILMomBuslnesses, 1, 1, 0, yes
383842954,  LucaBartolini1, 9, 9, 0, yes
2190386613,  bobocom1971, 1, 1, 0, yes
452343838,  lucianoghelfi, 10, 9, 1, yes
1086700214,  AdalucDe, 53, 45, 8, yes
1384962734,  madazzo, 2, 1, 1, neutral
236530231,  neriercoli, 6, 6, 0, yes
999469686,  Antonella180262, 74, 49, 25, yes
733330743800258560,  a_m_295, 119, 74, 45, yes
171678019,  pftasso, 1, 1, 0, yes
1202375064,  MfFenice, 1, 1, 0, yes
1065819612,  VSemprevivo, 1, 1, 0, yes
3214544331,  mikruss69, 8, 8, 0, yes
2225201833,  pdcatanzaro, 3, 3, 0, yes
2426934927,  GiopirGiovanni, 3, 3, 0, yes
56635829,  WellnessCoachFF, 9, 7, 2, yes
868624478,  LauraDelliColli, 1, 1, 0, yes
411729803,  giovannaspagno2, 1, 1, 0, yes
2866417823,  MrLafleur89, 2, 2, 0, yes
130859076,  tartaruga02, 2, 2, 0, yes
443181203,  VittorioTito, 1, 1, 0, yes
1304878068,  tommasopetrillo, 2, 2, 0, yes
2984894152,  AlessandroRuina, 75, 75, 0, yes
363571731,  CapoNerdBlog, 2, 2, 0, yes
2278958635,  57_mimmo, 31, 21, 10, yes
394241598,  iltrenoromalido, 15, 5, 10, no
2724485722,  mennuni_luca, 6, 3, 3, neutral
3431405176,  CastaldiErminio, 5, 5, 0, yes
533628186,  Diseconomia, 1, 1, 0, yes
252120336,  Ciucia60, 2, 2, 0, yes
111069141,  ari87massa, 1, 1, 0, yes
3084427084,  MusiCraftMilano, 1, 1, 0, yes
1645295228,  mariarosariacio, 30, 29, 1, yes
2298207128,  ProgettoMuseo, 1, 1, 0, yes
91504554,  sarahc351, 22, 14, 8, yes
762645694792499200,  marcella_sardo, 1, 1, 0, yes
316364685,  FrancescaNimo, 30, 22, 8, yes
477062211,  cettaleonardi, 1, 1, 0, yes
4440861137,  tuttizitti73, 1, 1, 0, yes
2956811146,  MaurizioCulicc1, 241, 196, 45, yes
748790752084316160,  PremioAugusta, 1, 1, 0, yes
622868610,  giacomo_darrigo, 8, 8, 0, yes
504249100,  rstrucchi, 8, 7, 1, yes
416945846,  francescopalu11, 2, 2, 0, yes
284745832,  luigisimonetti, 1, 1, 0, yes
1066747375,  bardome, 1, 1, 0, yes
403273945,  SirioFusani, 15, 13, 2, yes
2496933837,  marferraioli, 1, 1, 0, yes
913038170,  maxscattolin, 6, 4, 2, yes
474251278,  giovannicentore, 12, 12, 0, yes
4559130286,  24Eventi, 2, 2, 0, yes
4850195242,  KatiaFreire11, 1, 1, 0, yes
784759793349234688,  SCasorati, 1, 1, 0, yes
241786073,  Sfregiatore, 1, 1, 0, yes
2347049569,  diegodaquilio, 2, 2, 0, yes
746201840,  leofaraldi, 2, 2, 0, yes
4900841223,  cr_polytropos, 1, 1, 0, yes
185197808,  tyenesaend, 1, 1, 0, yes
792430148,  GiuliaDeCarlo, 1, 1, 0, yes
22634187,  tozzini, 4, 4, 0, yes
760061452388560896,  patonzi, 1, 1, 0, yes
1362068263,  CarolinaBotti2, 1, 1, 0, yes
2238798353,  AlbertoGandoss1, 24, 24, 0, yes
1251326239,  ClaudioSacconi, 33, 30, 3, yes
600852507,  bncfirenze, 2, 2, 0, yes
706596340306984961,  Frances33526378, 33, 9, 24, no
433338399,  michelegentile7, 1, 1, 0, yes
724573957781856256,  GiorgiRonchi, 19, 7, 12, no
757287162115137536,  Mgiuseppe10, 3, 3, 0, yes
231098857,  ottaviaricci, 5, 5, 0, yes
774917832228343808,  GIADEFRAN2, 35, 31, 4, yes
246727528,  Andreeee96, 2, 2, 0, yes
1570341018,  henrybets, 18, 18, 0, yes
797483052331126784,  ars404, 1, 1, 0, yes
805852083224268800,  arka_con, 45, 34, 11, yes
1172372250,  TizianoTagliani, 2, 2, 0, yes
423793242,  matteoG1990, 10, 7, 3, yes
793955419815346176,  excess_irene, 1, 1, 0, yes
948505447,  grace2012fe, 3, 3, 0, yes
602111192,  tizianafilone, 5, 5, 0, yes
286202651,  DrunkyBorghy, 1, 1, 0, yes
374526655,  gmercuriotweet, 1, 1, 0, yes
1872223814,  InsdataInter, 97, 77, 20, yes
407164131,  katiaursillo, 2, 2, 0, yes
2904770691,  VerdiStudio, 16, 10, 6, yes
222170521,  AgrimensoreK2, 97, 50, 47, yes
2535752901,  semolina1979, 1, 1, 0, yes
740277257424523264,  seneca1900, 151, 108, 43, yes
2853286186,  MediterraneoAnt, 2, 2, 0, yes
1128223242,  Reartwo, 15, 14, 1, yes
2332403320,  AdelinaRicciar1, 3, 3, 0, yes
48302086,  super_beda, 1, 1, 0, yes
715878276946911233,  ncoppovesuvio, 4, 4, 0, yes
4298506517,  giuliaghia3, 4, 4, 0, yes
32545774,  tobiastms, 1, 1, 0, yes
1137449617,  pdsardegna, 20, 20, 0, yes
821799522,  peppe_consoli, 12, 11, 1, yes
392909961,  notaro_paolo, 1, 1, 0, yes
4089454995,  Ernesta_dag, 1, 1, 0, yes
447869043,  virginiapetrell, 1, 1, 0, yes
569994798,  IICAtene, 3, 3, 0, yes
3208985039,  sharepompeii, 2, 2, 0, yes
4920588358,  Hopeesperanz, 1, 1, 0, yes
77835911,  LuisMiguelMenin, 2, 2, 0, yes
920626381,  FabQuintiliani, 13, 13, 0, yes
562947998,  aef66116232, 5, 2, 3, no
773792248735666176,  ZagoVania, 7, 7, 0, yes
2807377528,  gabriliberata, 2, 2, 0, yes
3362545354,  rob_mascellani, 1, 1, 0, yes
1192672903,  CesareHandala, 7, 3, 4, no
157408274,  NastyFemme, 12, 12, 0, yes
1031322212,  andwarriors, 16, 10, 6, yes
30632987,  fispmed, 3, 3, 0, yes
51857387,  Lemillebolleblu, 2, 2, 0, yes
15438622,  chiaradimizio, 2, 2, 0, yes
620351637,  marcimarti17, 63, 30, 33, no
428405892,  Jack_Modi, 2, 2, 0, yes
784018656657305600,  x1cinemadiverso, 1, 1, 0, yes
395260666,  lorella_a, 1, 1, 0, yes
51721614,  fabiodondelli, 1, 1, 0, yes
2479372688,  ariete8aprile, 51, 31, 20, yes
4377139335,  elefantedt, 2, 2, 0, yes
85544383,  danielapoli, 2, 2, 0, yes
1022893682,  JKoupermann, 1, 1, 0, yes
441990177,  PrudenzanoAnton, 1, 1, 0, yes
2886697851,  VivianaMerlino, 1, 1, 0, yes
779294731230740480,  festbookitaly, 1, 1, 0, yes
421758109,  VezzaroAndrea, 46, 30, 16, yes
3236308146,  LAnniboletti, 5, 5, 0, yes
752127985155801088,  mgra2016, 5, 4, 1, yes
780095104132509696,  Malandra1957, 39, 17, 22, no
820383907,  IzquierdoMariaa, 1, 1, 0, yes
776116078124687360,  giunga92, 51, 49, 2, yes
508816367,  luci69dc, 5, 4, 1, yes
2829900668,  ale_cohn, 2, 2, 0, yes
2444547424,  legacoopcultura, 4, 4, 0, yes
1431424932,  RottasuTorino, 18, 15, 3, yes
3291626026,  simony87_simona, 14, 14, 0, yes
384392306,  Roseinfiore, 1, 1, 0, yes
75068313,  ladytoffe, 2, 2, 0, yes
414646088,  AssocAReS, 73, 73, 0, yes
148133850,  marcobertozzi, 4, 4, 0, yes
417904049,  VanniPetrelli, 17, 16, 1, yes
3939268456,  chia_verga, 1, 1, 0, yes
68994168,  SimplyBenny, 1, 1, 0, yes
609438275,  PoggiRossi, 4, 4, 0, yes
2743862297,  p_capasso, 23, 22, 1, yes
2220186288,  CircoloPDPoa, 62, 58, 4, yes
3695737995,  FraLuna1109, 1, 1, 0, yes
944721086,  SiSituni, 50, 34, 16, yes
877896098,  MegatonTweet, 5, 5, 0, yes
239434137,  armfel, 21, 14, 7, yes
270163547,  LuigiPalumbo_, 1, 1, 0, yes
1306691233,  Renzoseccia, 72, 32, 40, no
545969776,  StudioFrasi, 2, 2, 0, yes
235323455,  fnicodemo, 49, 43, 6, yes
400359479,  agomariagreco, 6, 6, 0, yes
883099326,  sscaramelli, 32, 32, 0, yes
169584409,  Frasix, 2, 2, 0, yes
1236902449,  sciencedriven, 3, 3, 0, yes
30628682,  fedeavanzi, 1, 1, 0, yes
3304225534,  SaralunaT, 2, 2, 0, yes
2674941708,  gdcbari, 31, 31, 0, yes
4017915148,  museomixIT, 1, 1, 0, yes
2390930591,  AleAbbamessi, 2, 2, 0, yes
197495235,  Danielaamdz, 1, 1, 0, yes
428300383,  eminnucci, 15, 14, 1, yes
1456631540,  PTambani, 32, 30, 2, yes
120206776,  albertolosacco, 3, 3, 0, yes
227507782,  vitodero, 9, 9, 0, yes
112485367,  RominaMura, 15, 15, 0, yes
69896457,  nan_nan_an, 28, 10, 18, no
209786311,  7SirAlex, 10, 9, 1, yes
763484096211349504,  MarBaNext, 1, 1, 0, yes
2711033285,  dadina06, 1, 1, 0, yes
414741143,  AStroin, 1, 1, 0, yes
999773377,  miononnoin, 43, 32, 11, yes
2415586640,  dinomarsan, 2, 2, 0, yes
410001580,  mary_auriemma, 2, 1, 1, neutral
469398862,  Agenzia_Dire, 21, 18, 3, yes
469408654,  ValentinaGrippo, 3, 3, 0, yes
417920790,  AntonellaTomas1, 22, 19, 3, yes
725881747,  tonini_92, 1, 1, 0, yes
466571036,  FabioAx95, 3, 2, 1, yes
618244710,  ottovanz, 31, 29, 2, yes
429312499,  AlessiaMorani, 12, 11, 1, yes
4076656275,  pompeii_sites, 14, 14, 0, yes
75018145,  robertocalari, 2, 2, 0, yes
465732305,  caramiacatia, 11, 10, 1, yes
577023890,  BendiniBarbara, 73, 47, 26, yes
482107935,  GloriaBracchi, 31, 28, 3, yes
2514594951,  GuidoMaxCalanca, 5, 5, 0, yes
788123704546983936,  GenerazioneSiIM, 2, 2, 0, yes
3621473295,  gd_imperia, 2, 2, 0, yes
2367015206,  giuseppecavarr5, 5, 4, 1, yes
2993303818,  Pontix19Claudio, 26, 23, 3, yes
476874456,  ValeBiagiotti, 8, 5, 3, yes
3110315039,  MiBACTLiguria, 1, 1, 0, yes
952533872,  renovo2004, 26, 25, 1, yes
1513143780,  ValeZolla, 1, 1, 0, yes
1031222876,  maestrolanzetta, 10, 10, 0, yes
966592213,  BomprezziMarco, 13, 13, 0, yes
2345206182,  nicomar2610, 20, 14, 6, yes
2984266637,  EevaRuokosalmi, 1, 1, 0, yes
206221960,  ValerioFrancola, 1, 1, 0, yes
318660927,  LucaSappracone, 5, 5, 0, yes
1103389747,  funkyenrico, 6, 6, 0, yes
1971399660,  lbernoulli13, 1, 1, 0, yes
288204711,  paolacsc, 35, 28, 7, yes
445705786,  mr_gwyn, 6, 5, 1, yes
1701151104,  ste_castellazzi, 19, 14, 5, yes
396581898,  SergiSalvatore, 2, 2, 0, yes
3217898110,  SenzaMo, 2, 2, 0, yes
2819557083,  Calcaterra1S, 1, 1, 0, yes
785389296807272448,  depriscoanna, 1, 1, 0, yes
2780653621,  AgneseMelis, 18, 18, 0, yes
273381975,  pieroBENEDETTO, 2, 2, 0, yes
2224891988,  alefreda, 4, 4, 0, yes
779948887754870784,  3131dt, 1, 1, 0, yes
57293063,  SalvatoreAmura, 1, 1, 0, yes
793126435221372928,  starplex_roma, 1, 1, 0, yes
229753610,  OsDiste, 5, 5, 0, yes
33502178,  MiBACT, 3, 3, 0, yes
13168002,  Mtcascino, 1, 1, 0, yes
281427065,  gigioneds, 1, 1, 0, yes
2359465576,  MarioLogrieco, 68, 44, 24, yes
105793968,  antonellacerchi, 7, 5, 2, yes
456984448,  PaoloMastino, 3, 3, 0, yes
344753854,  paolocalvano, 9, 9, 0, yes
426525876,  mele_nando, 2, 1, 1, neutral
423732690,  CarmelinaCarmi, 88, 87, 1, yes
987309366,  ABarilani, 1, 1, 0, yes
119799052,  Leviedegliorti, 2, 2, 0, yes
420526736,  spadafora59, 3, 2, 1, yes
4195440875,  spillatriceblu, 39, 13, 26, no
14712388,  MrsBlonde, 3, 2, 1, yes
756427452575080448,  lamichymichy, 2, 2, 0, yes
68695059,  Hygbor, 7, 5, 2, yes
1292352410,  rengorini, 2, 2, 0, yes
1710375336,  matteo_delve83, 6, 6, 0, yes
460020367,  frasisam, 1, 1, 0, yes
2303466121,  MicolLucchi, 6, 6, 0, yes
800775774244483073,  GiuseppeElicio1, 3, 3, 0, yes
406555334,  DMassimilla, 2, 2, 0, yes
148012452,  giottorossetti, 1, 1, 0, yes
734482973790212099,  angiecestari86, 1, 1, 0, yes
800126931463073792,  Gioia_Sarino, 3, 3, 0, yes
474023066,  nunziarusso4, 35, 24, 11, yes
4928346046,  bennypanto, 4, 4, 0, yes
498234811,  Falcon74A, 26, 13, 13, neutral
426812759,  raimondoaufiero, 2, 1, 1, neutral
340965292,  RiccardoFani, 9, 9, 0, yes
3406885985,  AurysKitchen, 2, 2, 0, yes
1042229546,  BrunaDiBerardin, 3, 3, 0, yes
1272334554,  RiccardoBiso, 1, 1, 0, yes
947262590,  franconemarisa, 1, 1, 0, yes
791559506,  brunellamanghi, 4, 4, 0, yes
538974085,  lidiaulisse, 11, 7, 4, yes
4891854041,  noicittadini1, 1, 1, 0, yes
2149841097,  CFMaggi, 1, 1, 0, yes
39273093,  depaolismarco, 44, 38, 6, yes
586641570,  andreapoerio, 1, 1, 0, yes
1594277756,  EseAghatise, 2, 2, 0, yes
591826484,  spiagge_972, 3, 3, 0, yes
2995908064,  CutronaDomenico, 34, 6, 28, no
2951027260,  paolomorelli37, 3, 2, 1, yes
3448001980,  SignaniPatrizia, 1, 1, 0, yes
51040020,  a8enga, 3, 3, 0, yes
1152242833,  vescovi13, 8, 4, 4, neutral
777125546899701760,  andrea_dtn, 1, 1, 0, yes
739791783111077889,  pro_torre, 9, 5, 4, yes
17268435,  Robotrix, 61, 39, 22, yes
429233004,  TIZIANAMEDDA, 1, 1, 0, yes
4024562895,  StefanoRauco, 18, 18, 0, yes
603082123,  PaolaOrsa, 1, 1, 0, yes
2842069119,  Taliasoleluna, 2, 2, 0, yes
256968344,  Desiree_Rossi, 3, 3, 0, yes
379398034,  maracondreas, 3, 3, 0, yes
715423321094033408,  PoloMusealeLig, 4, 4, 0, yes
94562956,  _geniodelmale, 6, 6, 0, yes
217128078,  corgius, 1, 1, 0, yes
1062955644,  mz_arte, 3, 3, 0, yes
61987587,  Riccardo049, 1, 1, 0, yes
1860935300,  MaurizioIsola66, 9, 4, 5, no
383414938,  matteocannito, 2, 2, 0, yes
395172198,  Luca_Coraci, 25, 25, 0, yes
593487302,  GiancarloTonga, 24, 17, 7, yes
482482938,  magar0, 4, 2, 2, neutral
1000080896,  robertaianni, 1, 1, 0, yes
1000188997,  ChessMassim, 44, 8, 36, no
375352671,  FabioPariante, 9, 3, 6, no
583840659,  GiovannaZabotti, 1, 1, 0, yes
2494554724,  ClaudioCavazzu1, 3, 3, 0, yes
69623968,  aldomodo, 4, 4, 0, yes
479602890,  SIAE_Official, 1, 1, 0, yes
2936002895,  RaffasantiSanti, 1, 1, 0, yes
83459297,  giampicam, 1, 1, 0, yes
414073021,  Simondarc, 2, 2, 0, yes
3827667076,  JacopoBa, 4, 3, 1, yes
804069436491698176,  Marcopiombini1, 6, 5, 1, yes
777727512189239297,  fpicciaiola, 3, 3, 0, yes
2339983460,  UgoAllocati, 1, 1, 0, yes
798797834698883072,  Silvio37596511, 12, 11, 1, yes
93055456,  FreddyVideo, 1, 1, 0, yes
72253054,  AxiomBaduanjin, 8, 7, 1, yes
2388661380,  AntoPando, 6, 4, 2, yes
2525254006,  PiercarloBonini, 1, 1, 0, yes
49475565,  d10sk0ur01, 12, 11, 1, yes
467473645,  EfisioErriu, 71, 43, 28, yes
4259474481,  massimociampi11, 4, 4, 0, yes
481368611,  enzobianco_, 3, 3, 0, yes
2417056379,  saremme, 5, 5, 0, yes
844579639,  SardiniaPost, 4, 4, 0, yes
766731574616424448,  Maurizio090561, 97, 68, 29, yes
802236554362109952,  Visjnica1, 1, 1, 0, yes
792123038439530496,  lesque_bebe, 12, 9, 3, yes
784520952474439684,  ettoremuto62, 5, 3, 2, yes
2521671494,  FrancoSuSarellu, 32, 12, 20, no
774167585168371713,  ItalianDigitalR, 2, 1, 1, neutral
84300444,  mazzettam, 65, 57, 8, yes
440724583,  MarinaSereni, 20, 20, 0, yes
1126319712,  lorema52, 21, 19, 2, yes
1020682514,  tuttocambiera, 9, 7, 2, yes
2280648054,  serenel14278447, 68, 57, 11, yes
2174264578,  karmendida, 1, 1, 0, yes
838292834,  cla77san, 1, 1, 0, yes
700874780031975424,  NicoloFranzoso, 1, 1, 0, yes
1538261798,  PierretteUSO, 7, 7, 0, yes
712027921083277312,  BarbaraBawita, 4, 4, 0, yes
734381796,  FnpCisl, 2, 2, 0, yes
1425576013,  fabio1964ott, 19, 18, 1, yes
82625683,  RBcasting, 2, 2, 0, yes
497346830,  mavialbano, 1, 1, 0, yes
21228323,  maurett, 1, 1, 0, yes
281966090,  AntoFerrantePD, 26, 26, 0, yes
436629007,  MariannaBifulco, 17, 7, 10, no
396665771,  SvePac, 5, 5, 0, yes
1105944535,  matteoculocchi, 15, 15, 0, yes
793825525483442176,  12duchesse, 24, 24, 0, yes
437807935,  embubiz, 3, 3, 0, yes
2417383332,  ninasprock, 1, 1, 0, yes
333920625,  motnip, 1, 1, 0, yes
899672546,  RiccardoUrbani3, 35, 16, 19, no
1871088685,  davideinno85, 22, 13, 9, yes
759346461758939136,  Luigi27221381, 82, 56, 26, yes
761663528,  DUrzoDurzo, 21, 21, 0, yes
733711848,  vicalvan, 4, 4, 0, yes
3949335315,  claudiatorre74, 1, 1, 0, yes
573607391,  LumsaNews, 18, 16, 2, yes
2350615438,  LiukGrieco, 23, 21, 2, yes
838485198,  Heavyale, 18, 13, 5, yes
964333646,  duemme6, 27, 18, 9, yes
2385571964,  Raffo_1982, 1, 1, 0, yes
745916794100125696,  yuribellini, 74, 66, 8, yes
473021625,  dpetrolo, 10, 10, 0, yes
3012771052,  BilloCamera, 1, 1, 0, yes
405071321,  Corrao_Lack, 1, 1, 0, yes
1075024345,  DADALILIA, 2, 2, 0, yes
822492199,  OldCinemas, 1, 1, 0, yes
4601698335,  aquino5vincenzo, 31, 31, 0, yes
747451360715616257,  giu33liana, 85, 43, 42, yes
484515352,  elena_gentile, 4, 4, 0, yes
2495079298,  fgent7, 46, 44, 2, yes
134554873,  mariallegra, 35, 35, 0, yes
33640390,  GweiddiatEcate, 1, 1, 0, yes
171453953,  _Davide_21, 26, 19, 7, yes
1285648478,  marcobonfico, 31, 31, 0, yes
758291580793094144,  ToreAggiggio, 49, 25, 24, yes
418636676,  daniedario, 37, 21, 16, yes
2370601775,  stepadpv, 4, 4, 0, yes
96319859,  correntere, 21, 18, 3, yes
4445065097,  laura_liso, 7, 6, 1, yes
1043113560,  mazzoneseby, 5, 5, 0, yes
117026070,  vinmoccia, 9, 2, 7, no
3182903687,  Bea___gallo, 14, 11, 3, yes
2188884396,  MicheleManescal, 18, 16, 2, yes
2467935126,  MicheleMastroi7, 1, 1, 0, yes
306735266,  OnofrioRomito, 1, 1, 0, yes
2166133390,  Rita190De, 19, 19, 0, yes
1070911692,  DominusFrancy, 8, 7, 1, yes
276665800,  eliasalis, 29, 14, 15, no
2389507018,  ManziIrene, 2, 2, 0, yes
802168605676859393,  Frances21126725, 1, 1, 0, yes
877300502,  UKEfrittola, 2, 2, 0, yes
1474855951,  GraziaSanta, 11, 8, 3, yes
197581465,  ErosSantoni, 10, 6, 4, yes
4868655040,  dotti_battista, 56, 43, 13, yes
379741776,  emmeguido, 31, 26, 5, yes
4859833099,  poisaranno, 1, 1, 0, yes
778924404617207808,  Robbbbbbbbbi, 16, 14, 2, yes
612478035,  maria_barban, 16, 16, 0, yes
4899487839,  DpkrLuca, 10, 7, 3, yes
334301320,  enricusi, 1, 1, 0, yes
305449685,  scuolanormale, 6, 6, 0, yes
724321908,  mattia_cielo95, 7, 6, 1, yes
98899503,  Ricky8219, 3, 2, 1, yes
718402632126197760,  leonardo1ao, 29, 23, 6, yes
464020852,  andrealoca77, 10, 9, 1, yes
743477715790077952,  Giovanni76Kr, 33, 26, 7, yes
42191372,  Comeilgiorno, 2, 2, 0, yes
109573130,  unitaonline, 29, 28, 1, yes
2680393077,  SimonaSr29, 2, 2, 0, yes
538327949,  essemme63, 4, 3, 1, yes
799913852255240192,  luciasteri, 1, 1, 0, yes
398291306,  albipietroboni, 30, 24, 6, yes
313199623,  enricolanza, 95, 92, 3, yes
414926221,  PAsproni, 14, 12, 2, yes
2445230108,  SchermieLavagne, 1, 1, 0, yes
303810430,  SALVATORECOSCIA, 28, 9, 19, no
383831016,  teresa_1970, 5, 5, 0, yes
358729484,  andreapotenza87, 1, 1, 0, yes
484881943,  SavinoItaliano, 12, 11, 1, yes
117701249,  Miti_Vigliero, 76, 49, 27, yes
341422914,  MariaFrega, 1, 1, 0, yes
336539426,  dousi96, 1, 1, 0, yes
583540282,  lau_sol_smArt, 1, 1, 0, yes
78653081,  luckyluciano83, 1, 1, 0, yes
2527690677,  DomiMMili, 5, 5, 0, yes
145563443,  tamerida, 7, 7, 0, yes
2373588490,  Fabio363T, 40, 40, 0, yes
774133777412923393,  lucacampitello, 255, 167, 88, yes
1610530982,  ValeMagi_c, 1, 1, 0, yes
1037393713,  albertocaldana, 6, 5, 1, yes
221179969,  maxmorinelli, 24, 24, 0, yes
1076737932,  FlaviaNardelli1, 2, 2, 0, yes
63745515,  Bad_Hands, 11, 7, 4, yes
169248718,  la_dante, 1, 1, 0, yes
3227318753,  marinapiva67, 120, 47, 73, no
2617314057,  The_James_Cook, 3, 2, 1, yes
3949821407,  VRita24, 1, 1, 0, yes
238059911,  RagazzidiTehran, 3, 2, 1, yes
339016603,  ClpMilano, 2, 2, 0, yes
113643008,  mifio16, 56, 53, 3, yes
2354423243,  GiacoGiovanni, 1, 1, 0, yes
3001014469,  anthonybarbaga2, 10, 9, 1, yes
121106879,  Fabio_Vita, 35, 16, 19, no
386456950,  LeonardoCodex, 2, 2, 0, yes
2333497668,  PaoloPaolacci1, 2, 2, 0, yes
1162245110,  cornobianco, 8, 6, 2, yes
802265146164998144,  Stefanosatta11, 16, 8, 8, neutral
799362847373488128,  matteopolimanti, 3, 3, 0, yes
2220318664,  meburgi, 1, 1, 0, yes
1058075719,  MylordPier, 7, 4, 3, yes
452299310,  QuadaDr, 2, 2, 0, yes
141896036,  a_medici, 21, 16, 5, yes
415437027,  i1ygq, 27, 12, 15, no
53449660,  uainot, 1, 1, 0, yes
796421015052189697,  fallujaj2008, 12, 8, 4, yes
96220057,  Maur94, 20, 13, 7, yes
4142762261,  mao_balza, 60, 60, 0, yes
719815038807068672,  pinina46, 4, 4, 0, yes
3038479445,  alesslat, 1, 1, 0, yes
450812323,  ceconidiego, 2, 2, 0, yes
748139485335011328,  r_castiglia, 20, 9, 11, no
118680450,  noresr, 2, 2, 0, yes
4074228269,  ItalyinGreece, 3, 3, 0, yes
4370357957,  vincenzopezzit5, 4, 4, 0, yes
458632561,  enzosantagada, 80, 80, 0, yes
353492673,  Grosci, 16, 12, 4, yes
400019001,  CarloMirante, 1, 1, 0, yes
420983046,  dirkgain, 2, 1, 1, neutral
3349395617,  anelli_c, 2, 2, 0, yes
2355657519,  EM1L10F, 4, 4, 0, yes
477543705,  ernestocaprari, 86, 69, 17, yes
2377363345,  AlessandroLoPr3, 37, 37, 0, yes
707152435966509056,  PonCultura, 1, 1, 0, yes
581697530,  MarcoCiacchi, 12, 7, 5, yes
564693328,  paulgal78, 6, 6, 0, yes
264914692,  valente08, 1, 1, 0, yes
370172207,  Monia_Merli, 38, 27, 11, yes
1167287822,  igni1955, 15, 15, 0, yes
1341254522,  renzinews, 55, 54, 1, yes
1158224455,  GiobattaG, 6, 6, 0, yes
352339485,  Maggiearte, 4, 4, 0, yes
364189418,  matteot483, 26, 25, 1, yes
430633617,  gianpieromarino, 9, 7, 2, yes
160290152,  TitaBrambilla, 1, 1, 0, yes
2422131402,  HeinrichTreviri, 24, 6, 18, no
2365498822,  m_darienzo, 25, 24, 1, yes
394729845,  fax1974, 39, 21, 18, yes
2845429815,  pinomellone, 70, 66, 4, yes
481550568,  maguccione, 1, 1, 0, yes
479628118,  PDFedFermo, 5, 5, 0, yes
2190187865,  Sabine_SAB1NE, 6, 6, 0, yes
350260649,  Rafa7227, 8, 5, 3, yes
1485861086,  giuliano_vacca, 2, 2, 0, yes
210842234,  gyalmarta, 2, 2, 0, yes
2529708649,  GioMaToBe, 1, 1, 0, yes
758304360543707137,  laltravocenews, 29, 8, 21, no
215573918,  AleFush, 1, 1, 0, yes
138772797,  itsaudade, 38, 27, 11, yes
386504254,  FabrizioMoscato, 1, 1, 0, yes
3635334923,  claviggi, 1, 1, 0, yes
217069836,  recovery_servic, 1, 1, 0, yes
331013206,  Nicodipla, 1, 1, 0, yes
548714946,  1966francesco, 2, 2, 0, yes
583373343,  arabistaanonima, 4, 3, 1, yes
18762875,  matteorenzi, 7, 7, 0, yes
122476603,  pepper4961, 23, 23, 0, yes
770466882,  Il_Piri, 18, 17, 1, yes
178618972,  forza_inter01, 5, 3, 2, yes
3117151365,  molinaro_enrico, 93, 87, 6, yes
361341817,  LilloFalsini, 48, 7, 41, no
429850368,  manuela081, 4, 4, 0, yes
2965000805,  massimodiacoge1, 44, 40, 4, yes
233268316,  luca_marocchi, 1, 1, 0, yes
713737407636586496,  PDGrottaglie, 28, 27, 1, yes
2318991212,  antov2401, 16, 5, 11, no
14824456,  graziano88, 6, 5, 1, yes
584163766,  MelyLittleApple, 1, 1, 0, yes
481902422,  RalloGiovanni, 4, 3, 1, yes
23052200,  simoneferiti, 4, 3, 1, yes
231808438,  OrazioLicandro, 1, 1, 0, yes
1277404100,  pasky48, 17, 17, 0, yes
263858624,  artribune, 1, 1, 0, yes
476007564,  CBaciami, 1, 1, 0, yes
385614406,  MTriscornia, 11, 7, 4, yes
2212485620,  AOstrouska, 30, 30, 0, yes
535591667,  carminepisanu, 5, 5, 0, yes
1134804595,  Molo31Monica, 173, 168, 5, yes
2724307709,  gracebmw58, 9, 9, 0, yes
2741910808,  clladm, 4, 4, 0, yes
1144716949,  VissiaLucarelli, 1, 1, 0, yes
3143841076,  AntoPignatari, 13, 13, 0, yes
611690326,  AntoBrandizzi, 1, 1, 0, yes
2736489995,  cate_gina, 3, 3, 0, yes
3207925227,  TDesire1964, 1, 1, 0, yes
501811802,  tomei_tomei, 13, 6, 7, no
182411035,  irenben1, 10, 8, 2, yes
599247299,  nannaenik, 53, 33, 20, yes
392191824,  CarpenellaPaolo, 2, 2, 0, yes
496779040,  LVinegar, 5, 5, 0, yes
2417805268,  mircabassini, 2, 1, 1, neutral
2951349335,  VillaIsolina, 16, 12, 4, yes
22616757,  pellescura, 10, 4, 6, no
2370233666,  Viciupacciu, 3, 3, 0, yes
1307992418,  condipodaro1, 18, 17, 1, yes
429235317,  PaolaIlari, 3, 3, 0, yes
2768324587,  MozzyMozz86, 2, 2, 0, yes
2401536942,  ramosveronica86, 1, 1, 0, yes
2447213385,  IChieregatti, 8, 8, 0, yes
512170866,  Bpepita, 3, 3, 0, yes
483151386,  MasMacig, 5, 5, 0, yes
953264690,  fedecaffagni, 3, 3, 0, yes
2356846439,  atlantide_Chris, 23, 22, 1, yes
804243421682601985,  OperazioniC, 1, 1, 0, yes
9508802,  carloreggiani, 1, 1, 0, yes
1227778538,  GiorgioAlbe, 6, 6, 0, yes
554071926,  mcgovepc, 1, 1, 0, yes
104612663,  caligola00, 4, 3, 1, yes
3032428733,  AphroditiTheo, 1, 1, 0, yes
2595286561,  DanielaSmits, 1, 1, 0, yes
795327254834384897,  nicmann59, 4, 4, 0, yes
370071160,  LucaValvano, 2, 2, 0, yes
3678789377,  angelonedom, 1, 1, 0, yes
903966229,  eugeniotocci, 4, 4, 0, yes
701493349983903745,  inRomaNews, 2, 1, 1, neutral
731840430774599681,  bluesoverall, 1, 1, 0, yes
2626187763,  Bassi10Bassi, 1, 1, 0, yes
3152000205,  FdrcAmato, 1, 1, 0, yes
794648418014658560,  Galbio1, 1, 1, 0, yes
133391525,  CurlyBB, 2, 2, 0, yes
1193333923,  stu_svi, 1, 1, 0, yes
223868628,  geekeconomist, 3, 3, 0, yes
299195161,  engaibaat, 2, 2, 0, yes
2970189689,  ffedeli01, 2, 2, 0, yes
139352742,  becare_29, 3, 3, 0, yes
4277251709,  ElisaChieca, 1, 1, 0, yes
722718822134849539,  valensvale82, 3, 1, 2, no
35438522,  alfabi, 1, 1, 0, yes
4219308970,  MariaRocc, 1, 1, 0, yes
450654477,  enrico_farda, 43, 24, 19, yes
1476718243,  AgrandeAt, 10, 9, 1, yes
774612532036329474,  ripofnail, 54, 47, 7, yes
334283957,  SantePalmieri, 1, 1, 0, yes
114712439,  giuseppesantomo, 12, 12, 0, yes
77789716,  eceriz, 5, 5, 0, yes
442642037,  FrancescaMelli, 2, 2, 0, yes
102031293,  Ventunotre, 3, 3, 0, yes
440737015,  MicheleSolari70, 29, 14, 15, no
572469988,  AleCozzolinoo, 7, 7, 0, yes
93679179,  krikali, 2, 2, 0, yes
398946027,  herlock_captain, 10, 10, 0, yes
636856145,  manuela_marchi, 2, 2, 0, yes
161373525,  71Billy1, 2, 2, 0, yes
1920910009,  tombolini_ortop, 1, 1, 0, yes
431901295,  PietroEbner, 11, 11, 0, yes
487824356,  Manu_sole, 55, 29, 26, yes
437358087,  _s_andr_a, 9, 9, 0, yes
3341932025,  Alice_Ilardi, 2, 1, 1, neutral
3424436500,  NicoliniNadia, 58, 33, 25, yes
906045619,  LuiNardi, 2, 1, 1, neutral
3201052948,  MariaCricri6757, 107, 64, 43, yes
1006529666,  davide_bira, 2, 2, 0, yes
2732427263,  cisomgenova, 5, 5, 0, yes
776897719122202625,  ElisaT78022602, 2, 2, 0, yes
486548645,  AnnaNella7, 1, 1, 0, yes
743437317130575874,  crasicap, 26, 23, 3, yes
722105587635499008,  pabre64, 2, 2, 0, yes
523533255,  ElenaCarfora, 1, 1, 0, yes
1708185948,  rosariacaliend1, 3, 2, 1, yes
779608679037411328,  pupuce_d, 1, 1, 0, yes
1874790332,  TamburiTIP, 37, 37, 0, yes
391945446,  simonabonafe, 5, 5, 0, yes
460923865,  gioiasalvatori, 1, 1, 0, yes
1180016617,  80yeye80, 37, 22, 15, yes
292439152,  CarloScheggia, 1, 1, 0, yes
1183037616,  StefanoSans, 1, 1, 0, yes
456113087,  vinima77, 21, 21, 0, yes
4228347137,  Mat1Mattia, 1, 1, 0, yes
41762089,  andreapu, 1, 1, 0, yes
2407084437,  fabrizio_berti, 2, 2, 0, yes
1522338079,  raineri_raineri, 2, 2, 0, yes
585788757,  Ninanelvento, 8, 8, 0, yes
66114621,  marcelloorizi, 4, 2, 2, neutral
4864187548,  RIndrio, 1, 1, 0, yes
349062616,  i_ponzo, 1, 1, 0, yes
2355391573,  graziellaisabel, 8, 8, 0, yes
492928982,  mariraf, 11, 11, 0, yes
429928689,  ErasmoDAngelis, 50, 50, 0, yes
422521005,  AleSampa77, 1, 1, 0, yes
43654859,  maumacosi, 1, 1, 0, yes
2821199728,  GF_Ginelli, 4, 4, 0, yes
1855120692,  r_tomaiuolo, 3, 3, 0, yes
410245492,  denis_derivo, 15, 12, 3, yes
1567861014,  danielemiglior4, 2, 2, 0, yes
3306953649,  figliodelcaos, 5, 2, 3, no
477897185,  sud_delmondo, 25, 17, 8, yes
776016576,  ermacsse, 72, 62, 10, yes
4847651633,  LupeRam89073615, 49, 48, 1, yes
932393936,  openpolitica, 59, 36, 23, yes
387278075,  loturcofrancesc, 1, 1, 0, yes
473743143,  KikaMariani, 2, 2, 0, yes
705377386746015745,  LorenaRetteghi1, 2, 2, 0, yes
1521649369,  natieds, 1, 1, 0, yes
487473538,  vania_leto, 2, 2, 0, yes
862978044,  CastelloSannazz, 1, 1, 0, yes
2427072883,  giovanna_dt, 115, 91, 24, yes
861799729,  pierinopurismi, 2, 2, 0, yes
367128084,  vallyroscia, 1, 1, 0, yes
589818340,  laurabertoldi65, 1, 1, 0, yes
3008403862,  6perseo30seo, 2, 2, 0, yes
2377741687,  Iantt31, 1, 1, 0, yes
2559438244,  Alessi1Aldo, 2, 2, 0, yes
1069041798,  paolamagionesi, 3, 3, 0, yes
192244668,  SMerlChest, 35, 33, 2, yes
720897887014645760,  gracemng4, 5, 1, 4, no
988968690,  MaraDiNunzio, 1, 1, 0, yes
4859831949,  filmassari1, 1, 1, 0, yes
306064701,  Di48Ma, 12, 11, 1, yes
4819127818,  luciana_gianni, 1, 1, 0, yes
16046615,  bettalm, 1, 1, 0, yes
2719186852,  MorinelliTony, 55, 55, 0, yes
2482962214,  SmmMaris, 1, 1, 0, yes
2158613047,  andrea_frascati, 1, 1, 0, yes
781894109963358208,  Arcangelo_UIL, 19, 17, 2, yes
424991328,  Maggie_bi, 1, 1, 0, yes
2353976618,  silvio966, 21, 21, 0, yes
2940897785,  federicadn67, 6, 6, 0, yes
452278988,  MariaDOrdia1, 3, 2, 1, yes
894920761,  ANTONIACUE, 17, 17, 0, yes
623841901,  GrasselliMarco, 2, 2, 0, yes
1088733919,  GiovanniBracone, 1, 1, 0, yes
802957785386418176,  g_matassa, 1, 1, 0, yes
1065381944,  francescobonimb, 1, 1, 0, yes
590176994,  CGioioso, 2, 2, 0, yes
4419158368,  ildottormea, 9, 7, 2, yes
458549603,  CChiominto, 2, 2, 0, yes
489501389,  FalcionelliFede, 2, 2, 0, yes
376248879,  sasatim, 1, 1, 0, yes
91145342,  sebalestrieri, 1, 1, 0, yes
803496125487517696,  mirko_medori, 2, 2, 0, yes
458877688,  TizianaBasciani, 5, 5, 0, yes
3322478014,  CarmenClaudia9, 5, 5, 0, yes
2301430825,  luigicastronuov, 2, 2, 0, yes
424964797,  zazaruni, 3, 3, 0, yes
417260423,  glfelicetti, 5, 3, 2, yes
34387114,  Giuly_s84, 4, 3, 1, yes
525546422,  fat4ta6, 1, 1, 0, yes
606537801,  mariacosimato, 1, 1, 0, yes
93691257,  donatobuc, 45, 37, 8, yes
3321594688,  lo_ghio, 1, 1, 0, yes
96327061,  luciano080, 22, 8, 14, no
444606700,  _racanati, 4, 4, 0, yes
458543147,  GiuseppeAlfano6, 2, 2, 0, yes
1453663939,  DanielaGrancini, 1, 1, 0, yes
122731676,  elizha323, 1, 1, 0, yes
296489835,  sauro_rossi, 8, 8, 0, yes
423294786,  BeaGio62, 60, 29, 31, no
2527208301,  sarzanapartitod, 6, 6, 0, yes
136343557,  itinagli, 20, 20, 0, yes
161627357,  GrooveMasterEdt, 4, 4, 0, yes
4718345116,  MGardich, 1, 1, 0, yes
3297645763,  VEeLagunaUNESCO, 1, 1, 0, yes
4208755703,  LaLpnmrz, 6, 5, 1, yes
801764256299569152,  mattiapareddu, 17, 8, 9, no
1152071204,  cavina7gianluca, 11, 11, 0, yes
2605463304,  gpoli160, 1, 1, 0, yes
606518947,  AlessiaMascia1, 2, 2, 0, yes
18680083,  papa_cannolo, 15, 11, 4, yes
2321258784,  salvo_pistaract, 8, 1, 7, no
398954870,  Gianluigi05, 1, 1, 0, yes
333733826,  bebongia, 1, 1, 0, yes
789752828097069056,  robertaafilosa, 3, 2, 1, yes
321898067,  CMifsudBonnici, 1, 1, 0, yes
1472353806,  BozzaLbozza412, 58, 54, 4, yes
962462347,  mrjaco83, 10, 6, 4, yes
1060032493,  silviagatti8, 1, 1, 0, yes
1347527786,  robertatelesca, 2, 2, 0, yes
1514243647,  sfracelli, 1, 1, 0, yes
574017966,  Verderame4, 12, 12, 0, yes
486988544,  ottavio05, 6, 6, 0, yes
761940143968227328,  EdoardOrsi, 1, 1, 0, yes
3298095608,  AlmaArtis, 1, 1, 0, yes
4008275807,  va_varca, 20, 19, 1, yes
811764625,  mongiusti, 4, 4, 0, yes
3432845669,  Leonardoschizz1, 5, 4, 1, yes
2577125284,  ErmenegildaF, 2, 2, 0, yes
481457729,  AntoDiMario, 81, 80, 1, yes
428368107,  akanikkytheboss, 9, 8, 1, yes
285840456,  BSDavide, 1, 1, 0, yes
803844682920890368,  saverio11o61947, 1, 1, 0, yes
636836087,  ritadisimone, 2, 2, 0, yes
2914286685,  4f250559f1a94d7, 26, 26, 0, yes
374385397,  Bernardi_UK, 11, 9, 2, yes
90891882,  geaschiro, 10, 10, 0, yes
38314752,  Stevefromit, 1, 1, 0, yes
2354777003,  IafrateMonia, 2, 1, 1, neutral
238507280,  SabatinoUrzo, 1, 1, 0, yes
22901191,  Blinky74, 19, 7, 12, no
271541039,  lecheey, 77, 41, 36, yes
862766647,  ElettraDeLor, 2, 2, 0, yes
512534556,  imusumarra, 7, 7, 0, yes
746539553771651072,  AerariumL, 42, 28, 14, yes
791372432682655746,  villapao68, 1, 1, 0, yes
783020674952626176,  gloriadonati17, 160, 129, 31, yes
1100260202,  M5SLegnano, 2, 2, 0, yes
2154291479,  AnselmiRossy, 1, 1, 0, yes
473870179,  RitaCararo, 1, 1, 0, yes
58440383,  heilig79, 4, 4, 0, yes
801845830483382272,  Contemax51, 31, 24, 7, yes
396043184,  cristinadedona, 11, 10, 1, yes
2163708479,  dailyroma1, 1, 1, 0, yes
428953891,  silviaiulianell, 5, 5, 0, yes
970835599,  paladoc69, 44, 39, 5, yes
3003902002,  mattarellum, 2, 2, 0, yes
329697987,  MatevzNovak, 1, 1, 0, yes
906275624,  vaetorna, 1, 1, 0, yes
422226921,  DOMENICOMINNIT1, 1, 1, 0, yes
386200933,  FedeRicaConato, 1, 1, 0, yes
796011204397465601,  Noemiarabafenix, 1, 1, 0, yes
2356991855,  AdeleLongobardi, 6, 5, 1, yes
442187636,  leodimpo, 1, 1, 0, yes
726128018,  francesco_spf, 1, 1, 0, yes
40656163,  lorenzomuscoso, 4, 3, 1, yes
69610047,  laserre, 1, 1, 0, yes
8329782,  f_broccardi, 1, 1, 0, yes
719855009928716288,  paolopaolo2516, 109, 44, 65, no
84862444,  SimonePiloni, 6, 2, 4, no
737243526983999488,  NadiaMAI4, 2, 2, 0, yes
1212795266,  Insegnarte, 1, 1, 0, yes
2197924583,  torr_jack, 1, 1, 0, yes
590008754,  Route192, 2, 2, 0, yes
4404703516,  volchitza_, 1, 1, 0, yes
471281332,  MONICA_ARIOLI, 10, 7, 3, yes
2388009454,  WebAteneo, 1, 1, 0, yes
50645038,  FELDart, 6, 6, 0, yes
1532077525,  colourasexperie, 26, 22, 4, yes
1478144047,  xpadriano18, 2, 1, 1, neutral
2428842874,  paoloco55, 1, 1, 0, yes
424388863,  MarinoLizza, 20, 9, 11, no
1366648526,  GiusiSarcina, 10, 4, 6, no
802901865407152128,  xxANTONELLOxx, 1, 1, 0, yes
4846573275,  gabriellasever8, 3, 2, 1, yes
44487069,  chedisagio, 11, 9, 2, yes
359283321,  93Annetta, 1, 1, 0, yes
240205118,  lusiettados, 1, 1, 0, yes
1719811099,  GennyDeTommaso, 15, 14, 1, yes
27231018,  coccodj, 3, 3, 0, yes
2589101987,  LudovicaScalco, 1, 1, 0, yes
3348998127,  somepizzaplease, 1, 1, 0, yes
2172768409,  ersorpasso, 5, 5, 0, yes
19515882,  panapp, 3, 3, 0, yes
803881178096955392,  destinationmkrs, 1, 1, 0, yes
476089720,  CarterSogno92, 1, 1, 0, yes
247789962,  Alessandraz86, 1, 1, 0, yes
75341933,  GFT78, 1, 1, 0, yes
2872330055,  DGBezzi, 5, 5, 0, yes
280918637,  giarcieri, 1, 1, 0, yes
1852228682,  LizNeuhoff, 4, 3, 1, yes
4058886123,  tiny_dancer_gp, 1, 1, 0, yes
774526172201967616,  Frances29668335, 1, 1, 0, yes
989322810,  francescamagna4, 17, 16, 1, yes
1522300363,  CarloSuchende, 1, 1, 0, yes
2990123956,  dimarcantonios1, 13, 8, 5, yes
2540480404,  mimmoscordino, 53, 28, 25, yes
800318031398244352,  Maegon23, 1, 1, 0, yes
725657324,  mavi300, 7, 6, 1, yes
558085585,  consulgeneralLA, 4, 4, 0, yes
594415123,  StatelloG, 4, 4, 0, yes
810711224,  Anarkikka, 7, 4, 3, yes
520775496,  TonuttiLuisa, 1, 1, 0, yes
545867898,  Lilia_Zannoni, 10, 7, 3, yes
796050302038376448,  carla_comelli, 3, 3, 0, yes
354767880,  chiccacor, 3, 3, 0, yes
2802044224,  titty_napoli, 1, 1, 0, yes
494376940,  FilomenaZurlo, 1, 1, 0, yes
702248011250974721,  diaiuai, 5, 5, 0, yes
70490565,  BBQAmore, 77, 42, 35, yes
430200691,  GeCortese, 46, 31, 15, yes
758329839573172224,  TOR_ART_, 1, 1, 0, yes
115623241,  graziatomasso, 6, 6, 0, yes
1292029244,  TelmoPetrelli, 1, 1, 0, yes
418361902,  MaurizioBrando, 13, 8, 5, yes
420644527,  minaclem, 3, 3, 0, yes
289538124,  GiovannaBerluti, 16, 15, 1, yes
2359270292,  ecampania, 1, 1, 0, yes
391219296,  antocrispino, 1, 1, 0, yes
1166637379,  ti_rossan, 99, 60, 39, yes
81694801,  moj1to, 3, 2, 1, yes
518840520,  gp_panky74, 7, 7, 0, yes
386576472,  PaolettCataleya, 23, 18, 5, yes
798852146,  avvmaietta, 7, 7, 0, yes
3089012589,  donatellaluisa, 11, 10, 1, yes
2754525981,  duesoli, 3, 2, 1, yes
507970638,  dabos1973, 8, 7, 1, yes
2942209786,  01e3feec74fe4e6, 16, 15, 1, yes
2717305705,  matgra82, 1, 1, 0, yes
2845678707,  B30Luce, 2, 2, 0, yes
2578671909,  kappeshark, 9, 6, 3, yes
996989875,  ToniaBaviello, 1, 1, 0, yes
3613456812,  EnricoMonachino, 1, 1, 0, yes
1377558510,  nonhotutto, 3, 1, 2, no
743041027712405504,  1marcolorenzoni, 10, 7, 3, yes
2341272574,  domenico_italo, 1, 1, 0, yes
202978046,  gonfianuvole, 1, 1, 0, yes
770748258440376321,  DottorSergi, 4, 2, 2, neutral
1254440240,  74_pippo, 14, 5, 9, no
931570489,  g4lvuz, 2, 2, 0, yes
3305721243,  FabChimpex, 3, 2, 1, yes
213344914,  frapik, 1, 1, 0, yes
2948897212,  PancoliniSergio, 60, 44, 16, yes
801827480172658688,  lachy66, 4, 4, 0, yes
2267806358,  ottogattotto, 42, 12, 30, no
80126134,  giansemeraro, 1, 1, 0, yes
119742732,  umbertorega, 9, 6, 3, yes
408374858,  LauraVenneri, 4, 4, 0, yes
1092058644,  piemanenti, 7, 7, 0, yes
27606971,  awolfatthedoor2, 38, 29, 9, yes
2237016785,  giovapronte, 6, 4, 2, yes
58795620,  carragl, 1, 1, 0, yes
936507216,  farfantina, 1, 1, 0, yes
26513504,  MarchTellini, 1, 1, 0, yes
133783953,  GianpaoloIzzo, 1, 1, 0, yes
425274065,  albertoruggieri, 8, 6, 2, yes
994748629,  maxmassimilla, 1, 1, 0, yes
1163796132,  anna_anybell, 26, 24, 2, yes
2240178557,  LioneLeonardo, 23, 20, 3, yes
831280344,  luisacolcerasa, 4, 2, 2, neutral
632151062,  ClaudioVolpe_wr, 13, 8, 5, yes
146931375,  angelo_greco, 2, 2, 0, yes
1475844757,  CremoniniGianca, 8, 8, 0, yes
1025169505,  fondieuropei20, 17, 12, 5, yes
4016459956,  flo502691, 3, 3, 0, yes
4888778955,  uffstampaTv2000, 2, 1, 1, neutral
1305597956,  dvaldi1, 13, 9, 4, yes
2921199801,  Artemide_81, 9, 7, 2, yes
2309053094,  AnnarosaCostant, 2, 2, 0, yes
51189176,  FERRIROBERTO, 3, 3, 0, yes
9667572,  piccimario, 1, 1, 0, yes
88873456,  bobandini, 4, 2, 2, neutral
580422411,  bCreativo_, 28, 28, 0, yes
4849677359,  carlogir54, 12, 12, 0, yes
1095937459,  lamonica_luigi, 14, 13, 1, yes
317769975,  agorarai, 25, 17, 8, yes
4904313471,  AttiusRegulus, 4, 4, 0, yes
328200371,  Crinary, 1, 1, 0, yes
604628522,  abianchibg, 5, 2, 3, no
802880899461382144,  France_guzzi, 1, 1, 0, yes
472322457,  Azzurrosumiele, 6, 5, 1, yes
2919306970,  CapitanBil, 8, 8, 0, yes
2787549467,  IsoldiFranco, 14, 14, 0, yes
34915849,  NicolaTesone, 1, 1, 0, yes
122014351,  Tommasolabate, 4, 1, 3, no
2357482587,  enri_iron, 2, 2, 0, yes
4179625401,  fedepel1, 15, 15, 0, yes
1223033204,  SKvint, 1, 1, 0, yes
139681145,  ilnesi, 22, 21, 1, yes
280543999,  TV2000it, 5, 4, 1, yes
1911560335,  ZERINImichele, 1, 1, 0, yes
85360316,  LucianoPetrullo, 3, 3, 0, yes
801816502466908161,  Gianchipr, 4, 4, 0, yes
3011035791,  niegotiziana, 32, 28, 4, yes
2993021697,  grandemax60, 80, 29, 51, no
319578825,  baronegiuseppe, 76, 36, 40, no
3613181357,  iovotono, 262, 102, 160, no
4634898946,  AlbertLoesher, 4, 4, 0, yes
2873586507,  Massi74Mazza, 5, 5, 0, yes
548642346,  Lukamessy, 5, 5, 0, yes
475248885,  donatogaetano, 232, 75, 157, no
314537220,  PersilQ, 24, 17, 7, yes
406880559,  RaiPortaaPorta, 25, 13, 12, yes
1063694274,  Max_elDoc, 53, 28, 25, yes
1020431113,  marinanardi5, 6, 5, 1, yes
499876766,  maelmale, 53, 39, 14, yes
422625426,  Marcello_Gatto, 11, 8, 3, yes
2631427167,  noto_concetta80, 41, 32, 9, yes
1505560448,  fabripep, 33, 18, 15, yes
3041843135,  Gatto80Nicola, 6, 3, 3, neutral
781034881073684480,  FedericoRana1, 92, 51, 41, yes
599807864,  il_potatore, 25, 7, 18, no
2971568187,  PellegriniLuisa, 82, 29, 53, no
406290147,  GottardoAlberto, 5, 3, 2, yes
308306330,  LoveDolomites, 6, 3, 3, neutral
800121351235248129,  ale__veg, 3, 2, 1, yes
2982641339,  Zepp87, 69, 24, 45, no
477548046,  rosabevilacqua1, 20, 9, 11, no
1358611800,  MraCnz, 153, 99, 54, yes
1491065850,  Legionary69, 6, 3, 3, neutral
553646924,  MelaniaRizzoli, 4, 3, 1, yes
1116913561,  MARCOTARSI, 3, 3, 0, yes
426094795,  regis_andrea, 42, 14, 28, no
4135497845,  PalluccoStefano, 34, 32, 2, yes
266066911,  Tucchia, 19, 5, 14, no
1156772688,  Kikkablues01, 4, 4, 0, yes
1168596805,  alextredici, 11, 7, 4, yes
65335565,  Possidonio_GG, 85, 51, 34, yes
833224730,  thatslollable, 3, 3, 0, yes
52330988,  maxnever, 4, 3, 1, yes
1640766590,  marcograsso581, 94, 27, 67, no
2207687193,  Chiarajuve_, 3, 3, 0, yes
207642935,  steocossavella, 4, 3, 1, yes
483434707,  LAvvelenato, 22, 14, 8, yes
275068021,  fmartino89, 4, 4, 0, yes
593582642,  m5sTess, 31, 13, 18, no
455266241,  Corrado_info, 122, 58, 64, no
739140549299568640,  giosephstop, 70, 66, 4, yes
448039159,  IleanaArgentin, 17, 17, 0, yes
3336714819,  morologiulio, 18, 6, 12, no
1221944630,  damalida, 13, 9, 4, yes
604760466,  Franc_Petrucci, 4, 4, 0, yes
51698926,  fabiopazzini, 4, 3, 1, yes
3011800271,  VELENO93405049, 24, 17, 7, yes
612924968,  GiacomoCampora, 2, 2, 0, yes
1871156755,  AlessandroDalai, 6, 6, 0, yes
4797073893,  bateson_55, 40, 27, 13, yes
2306307694,  matteo_ereno, 6, 4, 2, yes
4256026096,  elena_elnmrl15, 26, 13, 13, neutral
456674882,  evakent62, 62, 24, 38, no
441676801,  bersa56, 7, 6, 1, yes
1035880770,  TINAGULLI1, 5, 4, 1, yes
2245403146,  MbPippo299, 3, 3, 0, yes
4034460233,  salvolove2, 138, 121, 17, yes
802263885755666433,  kendoblu, 13, 9, 4, yes
728522599513337856,  campanellafilip, 2, 2, 0, yes
2966187939,  Giuliab71, 89, 49, 40, yes
450898381,  DonatellaZini, 2, 2, 0, yes
3327831430,  xenonian1, 7, 5, 2, yes
8266162,  my_cinquestelle, 48, 21, 27, no
2589915440,  LemmeVincenzo, 12, 7, 5, yes
3046288851,  DavideCervino, 11, 6, 5, yes
2391369431,  borsarisharon, 65, 39, 26, yes
4883029437,  Avril6667, 18, 11, 7, yes
3987937325,  rebybor, 15, 7, 8, no
1332630272,  CoSksIMone, 55, 26, 29, no
371245774,  SynesthesiaRAC, 12, 4, 8, no
80867890,  lucabambu, 10, 7, 3, yes
2726498655,  loryhipster57, 67, 66, 1, yes
1382051539,  MassimoGaudina, 2, 2, 0, yes
4755350878,  TgrRaiFVG, 5, 5, 0, yes
612883421,  CafeoGiovanni, 6, 6, 0, yes
328060514,  faustorac, 4, 4, 0, yes
3123284926,  Spero2020, 5, 5, 0, yes
899978641,  mipiaceBarca, 138, 119, 19, yes
4885903612,  pantera2318, 87, 28, 59, no
2334105918,  toninifranco1, 3, 2, 1, yes
2241274927,  Manuel_Ghezzi, 150, 31, 119, no
3305419432,  esoldini9, 3, 2, 1, yes
532222780,  LelloEsposito5, 198, 59, 139, no
611680497,  lazzaro14, 14, 9, 5, yes
2414898811,  pinomarte168, 16, 8, 8, neutral
3012881507,  gobbo_dentro, 10, 9, 1, yes
142807042,  ricdil1, 56, 21, 35, no
270623814,  Surfiniae, 102, 25, 77, no
400902983,  ste_santini, 59, 26, 33, no
3315474928,  RensilR, 24, 18, 6, yes
483304367,  donnadimezzo, 108, 69, 39, yes
53139843,  speranza58, 152, 77, 75, yes
61773288,  SaoncellaNews, 19, 18, 1, yes
2366958341,  brigantonisud, 6, 5, 1, yes
556848315,  Clod_Agrelli, 2, 2, 0, yes
4461491152,  RobyErrecis, 3, 3, 0, yes
109251997,  IngMirkoPaglia, 20, 11, 9, yes
271803051,  francescodriver, 23, 17, 6, yes
1386632492,  miaudit, 24, 18, 6, yes
131820687,  rafpenn, 4, 4, 0, yes
841517665,  Anton50Ognis, 8, 8, 0, yes
296528124,  JacopoVannucchi, 16, 7, 9, no
1154788808,  SergioNunziati, 19, 19, 0, yes
3781434735,  AglAbruzzi, 19, 19, 0, yes
849988268,  aibipres, 17, 17, 0, yes
139502285,  Andrea_Baiocco, 5, 5, 0, yes
272876921,  RFURESI, 21, 19, 2, yes
1059528432,  flao16, 31, 30, 1, yes
594767169,  eglemaresca, 8, 7, 1, yes
3297423564,  freelancemilano, 13, 11, 2, yes
1091717713,  cieliviola, 15, 9, 6, yes
446090752,  NicolaTenerelli, 15, 15, 0, yes
238659406,  katiazzurra, 8, 5, 3, yes
451535619,  LovisAldo, 7, 5, 2, yes
575708094,  microfritz, 2, 2, 0, yes
802561415802396672,  selfielettorare, 2, 2, 0, yes
216057569,  antoniozoppola, 2, 2, 0, yes
3365915002,  marco_bragazzi, 59, 44, 15, yes
291328012,  1Poster1, 19, 7, 12, no
295024898,  elianto63, 9, 8, 1, yes
499921719,  leleone46, 12, 9, 3, yes
468583219,  LeleNeville, 2, 2, 0, yes
162103856,  Jumpingmalefrog, 8, 8, 0, yes
1573352107,  clalop1974, 30, 28, 2, yes
550084298,  gonews_it, 10, 9, 1, yes
1112850756,  puponeA, 7, 6, 1, yes
805792441127342080,  daniele_955, 3, 3, 0, yes
725759263025577985,  Dissenten2, 47, 22, 25, no
778634730975686656,  ahsefossi, 4, 2, 2, neutral
429279647,  mariomariov1, 23, 13, 10, yes
1495475762,  ERWINARDUINO, 2, 2, 0, yes
164680904,  vincenzosavoia, 10, 7, 3, yes
478505615,  rboni47, 7, 3, 4, no
551979725,  comunikiamo, 15, 15, 0, yes
796097962384433153,  lofagiannone, 40, 24, 16, yes
515410436,  marcaglio, 3, 3, 0, yes
3589544177,  massimo18368940, 10, 9, 1, yes
314087585,  pauldolomites, 2, 2, 0, yes
368862221,  franco_bagnasco, 3, 3, 0, yes
795290773642215428,  Gianmar85262144, 86, 63, 23, yes
2590515409,  paolucci1970, 8, 8, 0, yes
1395455083,  MCurcuruto, 3, 3, 0, yes
2854635105,  gemmatellerjr, 10, 6, 4, yes
4871884721,  nakisady, 71, 39, 32, yes
3433378229,  GranelliPaolo, 134, 49, 85, no
2792050237,  comitatoart26, 30, 24, 6, yes
522987521,  Mara_Morini, 16, 16, 0, yes
1039725007,  thinkingmelon, 2, 2, 0, yes
17565436,  gaetano_rizza, 39, 14, 25, no
178436339,  calabrinterista, 13, 8, 5, yes
3091275909,  A_Lianse, 4, 4, 0, yes
472979543,  LuigiDiRaffaele, 2, 2, 0, yes
3415778469,  scarfimaurizio, 14, 11, 3, yes
397310696,  alecolombo71, 2, 2, 0, yes
796018298328678401,  jmdleurope1, 15, 15, 0, yes
436167495,  systhemes, 8, 6, 2, yes
1210007809,  DidiCorbetta, 3, 3, 0, yes
4579125253,  Jenfakoko, 423, 421, 2, yes
57596665,  antonicellicus, 15, 15, 0, yes
2987996997,  fgiulia76, 2, 2, 0, yes
97532453,  matteosoraci, 5, 2, 3, no
849951920,  FabriSalvador, 2, 2, 0, yes
3344039001,  ReteDem, 10, 10, 0, yes
2973508025,  fernandella25, 83, 53, 30, yes
3082586581,  diacetilmerdina, 8, 6, 2, yes
145802194,  mrcrto, 10, 9, 1, yes
2839729055,  PhotoshopLoverz, 2, 2, 0, yes
1377648812,  KirilFedi, 9, 9, 0, yes
138193677,  Miriam_Tuscia, 4, 3, 1, yes
1447215498,  MeridionaleASud, 83, 63, 20, yes
2429092036,  angeloSica1965, 90, 69, 21, yes
125022031,  saraemma_, 4, 2, 2, neutral
268899621,  trattovideo, 30, 26, 4, yes
391954792,  Mega_Fauna, 23, 15, 8, yes
3039737343,  eczczcz, 2, 2, 0, yes
283416650,  barbarab1974, 13, 12, 1, yes
765851485133418496,  BBilanShit, 11, 11, 0, yes
4178355137,  Daniele955i, 3, 3, 0, yes
485598617,  ValeRagaglia, 24, 23, 1, yes
2988110818,  NonSiamoStuPD, 32, 28, 4, yes
83847970,  SchiacciaTwitti, 16, 11, 5, yes
474333987,  Barbara_Tomio, 7, 4, 3, yes
2931982966,  Luca_Auditore, 8, 8, 0, yes
1199579786,  luca_c24, 22, 19, 3, yes
267698945,  Newpasta, 6, 5, 1, yes
173887749,  adapre1975, 2, 2, 0, yes
65861682,  danielefrongia, 4, 2, 2, neutral
216304742,  LucaRuss0, 2, 2, 0, yes
121716897,  GianlucaPomante, 2, 2, 0, yes
797076670884773888,  ma_cossu, 8, 6, 2, yes
491362972,  fraschianchi, 2, 2, 0, yes
1324566829,  laurarmalone, 21, 12, 9, yes
188072000,  alexgiamby, 11, 11, 0, yes
503288686,  smanga75, 54, 43, 11, yes
87248746,  adilasalah, 8, 6, 2, yes
754366457975275520,  Avatar00amazons, 4, 4, 0, yes
131444859,  maxxfiore, 7, 3, 4, no
62785991,  Massiwalker, 3, 3, 0, yes
180480028,  MaurizioVana, 8, 8, 0, yes
431790909,  pigardi, 2, 2, 0, yes
794302419203215371,  ildefor, 150, 149, 1, yes
767795023970697216,  roca2272, 50, 27, 23, yes
781480445783531520,  giant_58, 5, 5, 0, yes
133030062,  npreiti, 22, 20, 2, yes
166999580,  serpikiii, 5, 5, 0, yes
38573759,  giamps78, 44, 31, 13, yes
4110208667,  CommediaDidioti, 5, 5, 0, yes
299059994,  criceto50, 13, 12, 1, yes
1627870369,  sabagiroletti, 8, 7, 1, yes
177654794,  indignado61, 9, 5, 4, yes
552207219,  DottDi_Cast, 2, 2, 0, yes
90157200,  grostein, 6, 5, 1, yes
589997252,  sovvertitor, 25, 14, 11, yes
150259190,  eachshadeofblue, 5, 4, 1, yes
1919814602,  HenricusDiabol, 14, 14, 0, yes
1323956112,  d_n_andrea, 2, 2, 0, yes
2851165852,  Sanpiotr, 19, 12, 7, yes
367428130,  jordisparrow, 2, 2, 0, yes
53053554,  tixis, 52, 34, 18, yes
350469171,  giovanniaprea1, 16, 6, 10, no
618961022,  CardarelliMario, 13, 13, 0, yes
3018290121,  versoilfuturo2, 64, 24, 40, no
449736439,  SHIN_Fafnhir, 43, 37, 6, yes
4409676869,  Francescoidro57, 4, 4, 0, yes
209583572,  DrManq, 8, 7, 1, yes
377428756,  VittorioGrecoMi, 3, 3, 0, yes
596663344,  BCRedway, 5, 5, 0, yes
449280374,  AntonellaCasula, 15, 15, 0, yes
34572462,  texisinthehouse, 2, 2, 0, yes
157754632,  MaterialGirl91, 3, 3, 0, yes
4315493897,  PD_WAS, 2, 2, 0, yes
565658427,  Mattyvic87, 9, 6, 3, yes
736832288361709568,  BlogSocialPolis, 8, 6, 2, yes
125639099,  raissa8482, 3, 3, 0, yes
2813579953,  ariccia76, 13, 12, 1, yes
1086810552,  angenaldi, 14, 14, 0, yes
33854963,  marziac, 2, 2, 0, yes
58190435,  AndreaFasano, 2, 2, 0, yes
225490204,  La_Struttura, 109, 63, 46, yes
2320446328,  carmen_ilaria, 2, 2, 0, yes
91559209,  camilla_staff, 30, 23, 7, yes
755225798,  76_cesko, 6, 3, 3, neutral
737693,  ribo, 11, 10, 1, yes
399004609,  YCaula, 4, 3, 1, yes
237230761,  Mariannaflo, 2, 2, 0, yes
1940337368,  grandefirenze, 2, 2, 0, yes
336474458,  CesareBt, 4, 4, 0, yes
282545240,  andrjet, 3, 3, 0, yes
491105685,  PaoloSuppa84, 2, 2, 0, yes
566175729,  Alessio_76, 2, 2, 0, yes
558500019,  Fradesa84, 2, 2, 0, yes
1223079336,  Giuliano_Berta, 39, 12, 27, no
552168790,  FedeFraschetti, 12, 7, 5, yes
232908749,  AndFranchini, 192, 122, 70, yes
409944497,  antasp, 17, 17, 0, yes
484850334,  Lucchisius, 21, 19, 2, yes
426986134,  massimilianoct, 7, 7, 0, yes
276029690,  maui974, 10, 7, 3, yes
723963523655720960,  ilaria_kld, 7, 6, 1, yes
25538825,  ivomej, 5, 5, 0, yes
50288106,  pierpaolobonora, 3, 3, 0, yes
2915424393,  cagra1978, 3, 3, 0, yes
547582136,  IlAnGri, 3, 3, 0, yes
55049219,  extrowebsite, 21, 19, 2, yes
330349571,  FabrizioDelpret, 2, 2, 0, yes
937796372,  DinamoPress, 5, 5, 0, yes
356898366,  Rosariovox, 5, 4, 1, yes
1421508788,  CarolaColnago, 18, 16, 2, yes
592546016,  Machelavoro, 37, 15, 22, no
1056227316,  canzian_mario, 4, 4, 0, yes
116174976,  toroprato, 10, 10, 0, yes
556818121,  CarloDelSante, 68, 60, 8, yes
3115905790,  Darktiv, 101, 85, 16, yes
455394612,  VinnyPadul, 2, 2, 0, yes
576471812,  cominif, 20, 7, 13, no
791366730069213184,  ugo34917518, 5, 5, 0, yes
403034488,  Giannaway, 3, 3, 0, yes
987513386,  IvanGamberini, 6, 2, 4, no
238623067,  mapensate, 2, 2, 0, yes
327387104,  binettigmarco, 6, 6, 0, yes
1025908122,  2joker8, 2, 2, 0, yes
837900613,  obaldi37, 2, 2, 0, yes
487921167,  FedericaNota, 7, 7, 0, yes
282545544,  tmirante, 7, 5, 2, yes
3099708933,  RaiolaFeli, 10, 4, 6, no
557366826,  IVANCONF, 92, 79, 13, yes
278422359,  HSQMYP, 25, 20, 5, yes
3948685096,  OmoSfragno, 14, 9, 5, yes
83386342,  giulianabellino, 117, 50, 67, no
714896919349346304,  giulianocartec2, 107, 82, 25, yes
2493142851,  Attiacarusu, 34, 33, 1, yes
734763192,  danimanduc, 7, 5, 2, yes
2244061237,  YanezPeter, 6, 4, 2, yes
512899781,  alesberti53, 7, 5, 2, yes
232559332,  GASirianni, 203, 123, 80, yes
1017233557,  Vidzinsky, 8, 8, 0, yes
158301310,  nervoso2010, 4, 3, 1, yes
3759723689,  miky52754993, 18, 18, 0, yes
1062995012,  royfraroy, 37, 19, 18, yes
1055346697,  BartoloMercone, 26, 6, 20, no
396645282,  WebMarketing8, 2, 2, 0, yes
325145422,  cdugos, 32, 31, 1, yes
23288693,  pierpaoloflammi, 3, 3, 0, yes
536941243,  mtribolini, 6, 3, 3, neutral
2741753878,  fabxxx81, 20, 20, 0, yes
492121189,  giuseppefranch4, 27, 27, 0, yes
2377047254,  mimmoconi, 5, 5, 0, yes
513144334,  renatosouvarine, 145, 72, 73, no
1256447174,  freyluc, 12, 11, 1, yes
1037835342,  adelescillone, 14, 14, 0, yes
357998864,  checcouno, 15, 13, 2, yes
1608647216,  MassiPerro, 21, 20, 1, yes
434180931,  EdoPiso, 44, 44, 0, yes
2890594157,  mariourania, 8, 8, 0, yes
475994227,  MauroIovino1, 14, 5, 9, no
717894055405961216,  Rosy87234986, 59, 28, 31, no
195374632,  Mr_GianBo, 22, 20, 2, yes
544270231,  marco_rullo, 10, 10, 0, yes
145351696,  lucabarbuto, 4, 3, 1, yes
1337519239,  carmelo_cutolo, 7, 7, 0, yes
416439103,  CordioliMirco, 202, 148, 54, yes
519667200,  vincenzoiannie2, 10, 9, 1, yes
870599125,  paologico, 9, 9, 0, yes
1143153842,  XerLItalia, 22, 7, 15, no
619969557,  FabioMixtodonte, 4, 4, 0, yes
1490192112,  c_ma55i, 2, 2, 0, yes
738336313892560896,  Klausrocchi1, 4, 4, 0, yes
489301209,  CamillaCaccia, 13, 12, 1, yes
252676505,  pdabruzzo, 24, 24, 0, yes
98921343,  frabarraco, 26, 26, 0, yes
2283221770,  NCopetti, 20, 16, 4, yes
1000210050,  alisapalazzo, 22, 22, 0, yes
428357975,  Giuseppes90, 10, 9, 1, yes
191245909,  PDLIMBIATE, 14, 14, 0, yes
395562472,  picapatti, 5, 5, 0, yes
2246257107,  Manuel33060175, 23, 22, 1, yes
116290984,  marinaterragni, 2, 2, 0, yes
2163574795,  Saguaro47, 5, 5, 0, yes
2280764604,  nontelodicomai_, 60, 30, 30, neutral
192227404,  Franpican, 3, 2, 1, yes
1707121399,  Pat_Zago, 9, 9, 0, yes
744819568909029377,  emeritoinsulso, 34, 13, 21, no
419916083,  s_tarantino, 10, 10, 0, yes
776841423421308928,  Felix_caT2016, 12, 12, 0, yes
1397930744,  Vitgi76, 4, 4, 0, yes
2565153327,  nicolsermoneta, 8, 5, 3, yes
222431192,  PDMONZABRIANZA, 27, 27, 0, yes
2788736669,  alevedovini, 32, 32, 0, yes
746357318959403009,  dar__io, 16, 15, 1, yes
2820807579,  GRACE882883, 2, 2, 0, yes
452010658,  serebellardinel, 84, 59, 25, yes
763274024675897344,  AMandice1, 68, 53, 15, yes
739879899280904192,  gghegel, 2, 2, 0, yes
299510970,  Tatella_77, 2, 2, 0, yes
1926324451,  Pholey_vn, 63, 28, 35, no
396841926,  MauroLumini, 135, 97, 38, yes
788016239188860928,  Sabrinabarb4, 69, 16, 53, no
2212638076,  CTerrum, 28, 17, 11, yes
742094210447335424,  Viky66jane, 54, 51, 3, yes
3102666957,  giodellari, 6, 5, 1, yes
801712182744514560,  Caterin89259097, 3, 3, 0, yes
532562936,  salvatorescor, 8, 6, 2, yes
4854526624,  rosy67087784, 4, 4, 0, yes
2197516867,  castelliloredan, 14, 13, 1, yes
433597260,  scialdonegiova, 7, 4, 3, yes
1219137853,  DalaiFlyer, 4, 3, 1, yes
324231882,  pps62, 17, 17, 0, yes
3364814494,  13d5e827fcb847d, 17, 2, 15, no
2155572632,  danieledeange, 6, 6, 0, yes
2615395379,  ValentinaM626, 4, 4, 0, yes
47310459,  sveva83, 18, 17, 1, yes
738724048901971969,  deianirakallis2, 2, 2, 0, yes
2436005241,  emanuelamilici, 16, 13, 3, yes
22011421,  marspira, 2, 2, 0, yes
743039255472164865,  MirellaSquilla3, 30, 30, 0, yes
2846509326,  Kom1683, 3, 3, 0, yes
241625905,  MissBradshaw85, 9, 6, 3, yes
3305521049,  annabis_ca, 32, 17, 15, yes
3022681938,  stefffi5, 30, 13, 17, no
728040729088561152,  PeppePorricelli, 29, 15, 14, yes
495907707,  AdolfoCarta, 5, 5, 0, yes
989351852,  ComitatoIdoneiN, 79, 22, 57, no
434295067,  S_Dieci, 4, 3, 1, yes
1042515348,  A_Stillavato, 26, 25, 1, yes
4651949435,  tizzi_ge, 3, 3, 0, yes
477068697,  alilibere69, 6, 6, 0, yes
3298850979,  PatriziaCaronna, 7, 7, 0, yes
1344701089,  angelotesta74, 62, 22, 40, no
2795115634,  lessini2, 55, 20, 35, no
118742948,  oruamihcs, 5, 5, 0, yes
447439107,  stagliacollo, 85, 27, 58, no
555551022,  Trappetta1, 14, 6, 8, no
328473338,  ladyrosmarino, 37, 28, 9, yes
2939419132,  ghions82, 3, 3, 0, yes
2194877690,  herrbenanton, 71, 70, 1, yes
2950650945,  Maurizio0901, 14, 13, 1, yes
726031112632471552,  dario_pernicone, 12, 11, 1, yes
2960217431,  beppenonbeppe, 59, 57, 2, yes
2871007953,  grinaldi8, 91, 86, 5, yes
2927551738,  vivistar81, 93, 23, 70, no
4196157927,  b678d23c8ff8462, 3, 3, 0, yes
448631884,  orsolina71, 67, 15, 52, no
3167053779,  CanapiniN, 6, 6, 0, yes
2997976379,  CristinaContin5, 26, 23, 3, yes
794535156291866624,  EnricoE76337284, 27, 25, 2, yes
1320264439,  donadove1, 6, 5, 1, yes
2927049323,  arch_fava, 67, 12, 55, no
292240445,  vincenzoturi, 4, 4, 0, yes
2531896218,  adasantonastaso, 2, 2, 0, yes
496654038,  39BorgoPinti, 29, 24, 5, yes
795367212328620033,  pm75pe07, 2, 2, 0, yes
797906158325534721,  monica6848, 17, 17, 0, yes
159205894,  respira55, 3, 3, 0, yes
2933876943,  PrecariProvMI, 3, 3, 0, yes
728561907720966144,  GiuseppinaMosc5, 2, 2, 0, yes
3130552521,  ciroriccio74, 76, 11, 65, no
4196215025,  FrancoPaqua, 33, 25, 8, yes
316511531,  AlessioMercanti, 7, 6, 1, yes
515895360,  CoccinellaRN, 2, 2, 0, yes
4876302513,  ConcasRita, 22, 16, 6, yes
460042639,  mvguasticchi, 21, 21, 0, yes
1198500139,  GiLilium, 3, 3, 0, yes
3025401051,  cucciniello74, 16, 16, 0, yes
728214116859559937,  FaTony73, 9, 7, 2, yes
566434899,  Gi_Grimaldi, 20, 5, 15, no
745937591158071296,  RosarioTorrisi7, 8, 8, 0, yes
420150286,  GianlucaDeFilio, 2, 2, 0, yes
420867117,  elvikkia, 2, 2, 0, yes
730492350133317633,  LussyChessa, 28, 26, 2, yes
1205274991,  AleKappaS, 30, 2, 28, no
424527918,  Cervellino61, 4, 4, 0, yes
2440801809,  vinceporretto, 6, 6, 0, yes
748385951521595392,  FulvioScappati2, 7, 7, 0, yes
2538895314,  d_ollio, 6, 6, 0, yes
742054546487271429,  VitoIezzi, 16, 16, 0, yes
381943815,  cisaleo, 26, 23, 3, yes
746325002627190784,  salv964, 7, 7, 0, yes
743029209564651520,  AngelaMBelvede2, 3, 3, 0, yes
2658993140,  raffaele161965, 61, 60, 1, yes
127532707,  CislNazionale, 7, 7, 0, yes
3357544672,  Esercito4, 10, 6, 4, yes
3510108957,  PietroF70, 55, 30, 25, yes
461962554,  watchandwrite, 25, 18, 7, yes
770279483609849856,  MidullaIgnazio, 6, 6, 0, yes
800665008384315392,  Paolo_Piattelli, 38, 28, 10, yes
720282686556770304,  Mconcettascara2, 6, 6, 0, yes
421903161,  giancarlocribio, 3, 3, 0, yes
498915523,  DKaleeva, 15, 3, 12, no
746004773753724928,  Daniela48523252, 4, 4, 0, yes
788825081552244736,  angelitobellito, 7, 7, 0, yes
1317191599,  hector_g66, 5, 5, 0, yes
46361600,  AntonioCaruso, 6, 6, 0, yes
801701662041718784,  frandreo75, 5, 5, 0, yes
788740635952050176,  cate281272, 5, 5, 0, yes
801787932109602816,  RosaliaLoPrest1, 4, 4, 0, yes
765943894756458496,  Caloger04240294, 5, 5, 0, yes
801707005887082497,  MARTA05838826, 4, 4, 0, yes
743109926759829505,  AntoninoPratti2, 4, 4, 0, yes
756171345310781440,  FilomenaCostan1, 4, 4, 0, yes
368819722,  EMILIANAPICCHIO, 30, 17, 13, yes
3762450316,  graficalabrese, 5, 5, 0, yes
744500821337964544,  Mariann17676203, 3, 3, 0, yes
725708427696181248,  sa_jua03, 4, 4, 0, yes
3130801499,  BouBou05361280, 4, 4, 0, yes
2996679838,  AgnolettiS, 19, 19, 0, yes
1082984088,  SenatoreF, 488, 245, 243, yes
2504004971,  Rmilell66, 68, 68, 0, yes
2203686361,  MaSpadavecchia, 76, 33, 43, no
2396523013,  toroseduto7, 14, 14, 0, yes
22130220,  NicoloMardegan, 8, 6, 2, yes
616971625,  deitrlchdave, 3, 3, 0, yes
2436510070,  Shaegray38, 3, 3, 0, yes
65733768,  luorsi, 5, 5, 0, yes
4830251404,  orianamerlo234, 20, 20, 0, yes
309265389,  enzovcr2, 21, 11, 10, yes
857753196,  Mosquitas77, 67, 64, 3, yes
1219022928,  puravidaita, 44, 42, 2, yes
428299064,  vittoriocalfa, 1, 1, 0, yes
2817618494,  freepress62, 3, 3, 0, yes
258415002,  TuttoSportUSA, 1, 1, 0, yes
2983726085,  berardi_matteo, 1, 1, 0, yes
1125816168,  twantonioc, 28, 22, 6, yes
2984502441,  nedopaglianti, 34, 9, 25, no
4447879955,  NCarapellese, 1, 1, 0, yes
63961191,  Gabgar71, 1, 1, 0, yes
402174719,  RobertoMattiaz1, 17, 14, 3, yes
101057515,  ombradellanotte, 8, 8, 0, yes
726150285870157824,  AdelBScott, 133, 83, 50, yes
420494257,  ClaudioCattivo, 6, 3, 3, neutral
81809541,  AntonioPtr, 4, 4, 0, yes
842122568,  pbonifati, 2, 2, 0, yes
2976535643,  DisantiAnna, 23, 22, 1, yes
637254997,  codapurple, 172, 103, 69, yes
83912604,  liber_cogitatio, 23, 22, 1, yes
1095109520,  lucamagarotto1, 39, 23, 16, yes
2331849409,  ManglaDan, 34, 8, 26, no
469447619,  PaoloSticcotti, 2, 1, 1, neutral
386474826,  MaridaMonaco, 23, 20, 3, yes
600150904,  elebrug, 15, 11, 4, yes
966932797,  SelvaticaGioia, 3, 3, 0, yes
245924561,  Ross444, 56, 28, 28, neutral
3094969685,  CagliEdoardo, 17, 11, 6, yes
3168684905,  IdoneiLocale, 10, 10, 0, yes
554336117,  g_giuseppina, 61, 49, 12, yes
464127310,  PaoloIvanoCucce, 95, 71, 24, yes
508768772,  amperinelli, 20, 20, 0, yes
73371594,  GeremiaGuzzon, 1, 1, 0, yes
45788443,  troprunner, 1, 1, 0, yes
4863546172,  gd_ventimiglia, 1, 1, 0, yes
2228667795,  margheritalesi2, 14, 11, 3, yes
41331918,  pompieri, 2, 2, 0, yes
1096331473,  GaetanoOrtolano, 33, 29, 4, yes
50040128,  00MrFrost00, 7, 6, 1, yes
757949254765834240,  OttoIso, 28, 20, 8, yes
86519478,  arazisofia, 1, 1, 0, yes
470917335,  GianckyMacca, 12, 11, 1, yes
2404846878,  giuseppeforna11, 2, 2, 0, yes
2376927394,  CfFanizzi, 5, 5, 0, yes
2888908630,  unblogpolitico, 26, 19, 7, yes
307741565,  lucianoperco, 4, 2, 2, neutral
1098034316,  gambarellif, 3, 2, 1, yes
50346361,  mottolese, 10, 7, 3, yes
19835812,  Rafaga1, 1, 1, 0, yes
591932616,  Michelcohen65, 2, 2, 0, yes
725882047,  AntonioParisi00, 84, 54, 30, yes
487431063,  zitoGiuseppe2, 8, 7, 1, yes
2785239689,  silvio1288, 1, 1, 0, yes
497371191,  beppac, 1, 1, 0, yes
22015813,  DogeMocenigo, 15, 12, 3, yes
416553734,  TabitaLuigi, 2, 2, 0, yes
754620296993333249,  RafVitale79, 8, 7, 1, yes
2957122799,  Isabi14, 9, 6, 3, yes
392626820,  GianpieroScanu, 37, 25, 12, yes
1857295158,  GattoBrina, 52, 40, 12, yes
26504043,  glopizzo, 33, 33, 0, yes
1373273234,  falcao_fo, 7, 7, 0, yes
492959239,  Amico5S, 24, 24, 0, yes
42401967,  Trouvilleville, 2, 2, 0, yes
978557845,  esapelucco, 31, 17, 14, yes
423241175,  Alfrrizzo, 1, 1, 0, yes
2374304431,  edocolo46, 1, 1, 0, yes
2410447644,  giacasta85, 100, 80, 20, yes
2948577789,  DanielaParodi9, 1, 1, 0, yes
387298370,  19411942LG, 7, 5, 2, yes
778089012,  CathedralWall, 22, 12, 10, yes
1162917516,  DzZini, 2, 2, 0, yes
2350347318,  UlrikeMeinhof1, 62, 43, 19, yes
1064067836,  AmedeoBaldan, 1, 1, 0, yes
759049972700487682,  GIOBEN71988, 3, 3, 0, yes
2512419964,  GJodi1962, 1, 1, 0, yes
851456364,  anto4261, 75, 40, 35, yes
528800955,  enricaspezie, 4, 4, 0, yes
524493374,  nebookanizer, 35, 13, 22, no
2336993334,  giorgio_prof, 21, 17, 4, yes
472014480,  VergaraAntonioV, 21, 14, 7, yes
613766004,  AnnaKm1985, 21, 14, 7, yes
3893394741,  CRampinini, 6, 6, 0, yes
3239175100,  CapaccioMc, 16, 10, 6, yes
2395171044,  espositoand, 1, 1, 0, yes
58453980,  PiazzapulitaLA7, 48, 18, 30, no
2711951166,  ABilardo19, 1, 1, 0, yes
387043149,  SilviaNicolucci, 29, 24, 5, yes
7184902,  andros3000, 24, 19, 5, yes
3010643289,  Scienzamarcia, 4, 2, 2, neutral
290585680,  pensierozoppo, 15, 13, 2, yes
270070566,  NOANNA2007, 45, 16, 29, no
120711642,  sabiensabi, 1, 1, 0, yes
3398885945,  FroioPietro, 28, 24, 4, yes
387120328,  monigia99, 3, 3, 0, yes
270366109,  Angelo_De_Rosa, 5, 5, 0, yes
2992689333,  fiorucci82, 50, 35, 15, yes
2875204096,  GeranioAnna, 17, 10, 7, yes
382034832,  francone12b, 22, 12, 10, yes
1168797480,  bertolire, 94, 69, 25, yes
515635680,  Zooppyx, 14, 14, 0, yes
2366719264,  mcdellamico, 4, 4, 0, yes
1533077491,  lucabrus, 1, 1, 0, yes
2304414910,  Giu_Lauricella, 10, 10, 0, yes
486509124,  CarloCochetti, 22, 11, 11, neutral
870218785,  SergbarsSergio, 7, 1, 6, no
742397869,  ebolige, 67, 67, 0, yes
496233111,  AccusoEnzo, 9, 2, 7, no
1415199168,  BrunoApicella1, 12, 10, 2, yes
2243781349,  IvanFittipaldi, 9, 9, 0, yes
2174535898,  nerodiseppia56, 119, 99, 20, yes
2724098874,  NicoleDollase1, 15, 15, 0, yes
269889614,  surveyor58, 3, 3, 0, yes
2780267589,  straniero1946, 26, 26, 0, yes
545008992,  hastum98, 22, 16, 6, yes
1312010358,  GianLucaArtizzu, 12, 10, 2, yes
45317110,  MinaZingariello, 6, 5, 1, yes
445611250,  EBergomi, 28, 16, 12, yes
849274159,  ladyonorato, 11, 6, 5, yes
98689547,  comunichiamo, 2, 2, 0, yes
33856651,  magabulli, 8, 7, 1, yes
331648841,  paola_di1, 8, 3, 5, no
236939562,  lelegno, 35, 35, 0, yes
1128086798,  GiuseppeMaruggi, 3, 2, 1, yes
198199124,  m_daros, 4, 4, 0, yes
13573252,  flavio78, 24, 18, 6, yes
3169965514,  VostraEminenza, 13, 6, 7, no
3110560259,  BrucatoGiusepp, 31, 14, 17, no
795971425127591936,  antonio24121942, 15, 13, 2, yes
1962207937,  Gabrontolo_72, 7, 1, 6, no
3457524023,  jack3514, 28, 20, 8, yes
258382452,  Palestro_Mario, 61, 36, 25, yes
1424819972,  fioredipisa, 4, 3, 1, yes
400601927,  Danilo_Rossetto, 5, 4, 1, yes
533329366,  francalanna, 16, 15, 1, yes
281195121,  Manualex14, 1, 1, 0, yes
260904873,  Angelo2456, 1, 1, 0, yes
1036494895,  BumgazMancini, 45, 31, 14, yes
2961876645,  AccettoAnna, 29, 23, 6, yes
1092084720,  mdimagritt, 132, 80, 52, yes
949920186,  tiani_giuseppe, 1, 1, 0, yes
210239170,  Eliseo905, 4, 4, 0, yes
510781274,  Tonycat13, 1, 1, 0, yes
2236656979,  AndreaIrbeti, 35, 31, 4, yes
1406267430,  mirl_ook, 31, 25, 6, yes
111629254,  lnaverri, 2, 2, 0, yes
446903999,  Vanson61, 29, 20, 9, yes
43703232,  Torakjkj, 20, 6, 14, no
3076910169,  Gabriele_Vernuz, 10, 10, 0, yes
1443706704,  laltrodiego, 64, 52, 12, yes
995790745,  pkvitto, 2, 2, 0, yes
2206836308,  IratoNicoletta, 1, 1, 0, yes
239316251,  GiacomoRota68, 1, 1, 0, yes
597137554,  Giusepp73199528, 3, 1, 2, no
2223696221,  AGherbitz, 2, 2, 0, yes
2377444536,  procapio, 21, 16, 5, yes
2182257900,  Chini_para, 4, 4, 0, yes
767813014309535744,  domenicoXXV0VII, 7, 7, 0, yes
344767294,  chimera4180, 15, 11, 4, yes
352314354,  _angelo_a, 6, 3, 3, neutral
3155822716,  e2f2ab15db2043b, 4, 4, 0, yes
2744358657,  BalduiniChiara, 28, 20, 8, yes
394837520,  MatteoDonelli, 10, 4, 6, no
2567751526,  FrancaAgnoletti, 1, 1, 0, yes
1396237206,  sviglietto, 1, 1, 0, yes
134206590,  arcanodavvero, 87, 21, 66, no
508555134,  guidamimmo, 19, 3, 16, no
1061297432,  gasparini2013, 1, 1, 0, yes
4868432043,  Gianni150550, 21, 21, 0, yes
202219931,  77swords, 11, 11, 0, yes
2890764376,  MassariGiacomo, 2, 2, 0, yes
1080423679,  LucaGiangre, 26, 25, 1, yes
735980645273489408,  PaolaSacchi3, 55, 23, 32, no
73587691,  GiuliaPaolucci, 8, 8, 0, yes
1021660854,  El_Nanos, 20, 18, 2, yes
434189594,  Essenze_di_me, 2, 2, 0, yes
955821968,  Abbipazienza, 17, 13, 4, yes
2318455535,  benedettversaci, 8, 8, 0, yes
44839560,  martagraziosi, 13, 12, 1, yes
1065081188,  mimmamax, 38, 32, 6, yes
19394469,  lucafaccio, 3, 3, 0, yes
219278789,  Ggcrm, 2, 1, 1, neutral
28820399,  autodafeio, 29, 21, 8, yes
317382077,  carladiveroli, 2, 2, 0, yes
784318068889559040,  daniloc229, 91, 61, 30, yes
503452485,  fra95it, 88, 88, 0, yes
788049329403506688,  matahar02398720, 82, 62, 20, yes
335595246,  salvodal, 39, 28, 11, yes
2398143679,  StefanoDeloren1, 48, 32, 16, yes
1219317607,  Moni5Moni, 7, 5, 2, yes
396686981,  liviow23, 7, 6, 1, yes
1886319823,  alessandroladia, 2, 2, 0, yes
439060498,  CeciliMarco, 1, 1, 0, yes
414993771,  giotoni, 15, 12, 3, yes
1562752760,  nicoladamalegh, 38, 34, 4, yes
944428878,  joyclub72, 4, 4, 0, yes
2789842566,  dariodalb10, 18, 18, 0, yes
801046891,  danruper, 2, 2, 0, yes
133231909,  musicondriaco, 9, 7, 2, yes
44160875,  AlexTheMod, 34, 12, 22, no
68689180,  putipo, 32, 23, 9, yes
17647690,  luissGINO, 46, 46, 0, yes
521748405,  DavideVikingo, 3, 3, 0, yes
457926975,  VitaleLorenzo, 3, 3, 0, yes
406580561,  adealdis, 27, 25, 2, yes
413010349,  vladfrulletti, 21, 19, 2, yes
843528308,  gracolaianni, 9, 9, 0, yes
522667905,  CafaroGiorgio, 12, 12, 0, yes
242367360,  giacomotomei, 24, 16, 8, yes
488895138,  sghi29, 112, 46, 66, no
700914468,  SasoMolly, 3, 3, 0, yes
4112771547,  kidzette, 2, 2, 0, yes
536244238,  orsi_laura, 16, 16, 0, yes
2745157399,  alessandro_fato, 10, 7, 3, yes
3345672868,  martamaccag2, 12, 8, 4, yes
141689363,  claudioderrico, 1, 1, 0, yes
847963362,  ubaldo_angelo, 9, 6, 3, yes
2983119910,  agiliberti51, 105, 77, 28, yes
3433009643,  salvatoremolfe3, 8, 4, 4, neutral
415055892,  angelomontarsol, 5, 2, 3, no
3053183649,  francornldi, 26, 18, 8, yes
57466155,  galeazzi66, 18, 5, 13, no
2190313025,  mauriziogil46, 23, 17, 6, yes
424858530,  gdipaola1, 2, 2, 0, yes
1686581238,  JfkCaruso, 1, 1, 0, yes
97962621,  Chiappuz, 58, 49, 9, yes
934748839,  w_girardi, 2, 2, 0, yes
284706444,  AndreaRomano9, 41, 38, 3, yes
1586042605,  DanielaDaffin, 158, 102, 56, yes
2180163853,  RedPostorino, 9, 9, 0, yes
4853784417,  sergiovero855, 30, 9, 21, no
53775671,  rickytrips, 2, 2, 0, yes
587706164,  _lubeck, 15, 9, 6, yes
714096155152486400,  OCunlimited, 49, 49, 0, yes
2149489765,  squalotigre77, 2, 1, 1, neutral
701859259789799424,  SotgiaAle, 2, 1, 1, neutral
4839141616,  dando_dodo, 3, 2, 1, yes
2345320392,  Auiueio, 13, 8, 5, yes
3326878185,  calcio_cagliari, 14, 10, 4, yes
483132230,  eugenianicolicc, 9, 9, 0, yes
1292204629,  michelecampa65, 4, 4, 0, yes
708369888679743489,  griecogiovanni1, 9, 7, 2, yes
589312435,  m_dellobuono, 7, 4, 3, yes
50104200,  tritono0, 18, 18, 0, yes
831129830,  luliban, 11, 6, 5, yes
773983087348899840,  Saggita23539780, 18, 18, 0, yes
434242329,  FlaviaPaoli, 39, 37, 2, yes
776702932523839489,  ettore_agostino, 11, 10, 1, yes
1554098461,  ERTIGRE2, 2, 2, 0, yes
400103989,  fortezza55, 22, 16, 6, yes
281477534,  EuPaleu, 23, 10, 13, no
736176289372098560,  TheGrumpyDwarf, 4, 4, 0, yes
2480250012,  PasquaMattia, 1, 1, 0, yes
1360162670,  alessia_riva, 3, 3, 0, yes
2617511263,  Cate0011, 9, 8, 1, yes
1639030544,  giacomino_02, 5, 5, 0, yes
513335052,  Dottmaury, 15, 10, 5, yes
403277858,  FaPensiero, 10, 5, 5, neutral
2489764008,  cornizzolo, 16, 6, 10, no
444716468,  DanieleMennella, 16, 12, 4, yes
2860101424,  AlexMarty2014, 34, 20, 14, yes
440680061,  vincef_, 4, 2, 2, neutral
421802707,  _Total_Recall_, 3, 3, 0, yes
1037526320,  BenCharlies, 17, 13, 4, yes
207034666,  CarloMusa, 13, 11, 2, yes
1250044405,  macpro8491, 14, 13, 1, yes
1333010497,  valerodipi, 1, 1, 0, yes
184366311,  klaudio1967, 6, 5, 1, yes
500096474,  milenamartini3, 26, 21, 5, yes
2481871779,  marcovisent, 6, 6, 0, yes
402594859,  Anna_Bandettini, 1, 1, 0, yes
786778001790959616,  Geppo7503, 23, 15, 8, yes
364502468,  davibere, 3, 3, 0, yes
481314037,  manuelventuroli, 13, 8, 5, yes
290755183,  francyriky12, 2, 2, 0, yes
730673331851132928,  ambiente_pd, 30, 30, 0, yes
45176195,  enzo2308, 8, 6, 2, yes
2666044296,  notripforcat, 1, 1, 0, yes
2757090658,  _annazeta_, 2, 2, 0, yes
1693164817,  ninogeremicca, 24, 18, 6, yes
3228099125,  GrappaTommaso, 20, 9, 11, no
1142667001,  fabbri333, 2, 2, 0, yes
2597512767,  rob79rm, 160, 159, 1, yes
714555676417265664,  Takezo85, 18, 6, 12, no
125851628,  lopec15, 23, 17, 6, yes
262823808,  lucafrusone, 2, 2, 0, yes
366747858,  piej87, 10, 9, 1, yes
386440603,  gariwo_onlus, 1, 1, 0, yes
573872757,  samualebutti, 27, 16, 11, yes
85590368,  TIZIANAPOESIA, 87, 66, 21, yes
1444738142,  giugia57, 25, 17, 8, yes
353581028,  HonJules, 1, 1, 0, yes
84130259,  zanzy82, 54, 24, 30, no
322528854,  nabu65, 67, 56, 11, yes
791628536557793280,  CasaSiPiemonte, 54, 51, 3, yes
206595230,  LucFava, 2, 2, 0, yes
257397349,  TorreDoro, 8, 6, 2, yes
1268297346,  grullobeppe, 20, 4, 16, no
3254705038,  ArnaboldiF, 11, 10, 1, yes
428134332,  cinerino, 4, 3, 1, yes
2451869940,  Lorenzo_Ruff, 20, 16, 4, yes
916522718,  ConteZero76, 127, 54, 73, no
420405373,  cesareporto, 8, 6, 2, yes
859058736,  de_massy, 18, 18, 0, yes
17425302,  sandroboeri1, 4, 4, 0, yes
302259113,  giorgiopasi, 5, 4, 1, yes
411434409,  forgix74, 1, 1, 0, yes
402282664,  giovilan, 6, 6, 0, yes
1498786196,  polizia_locale_, 13, 5, 8, no
220093935,  Niceriano, 4, 4, 0, yes
805321414907727874,  AntonioGaldi7, 43, 27, 16, yes
4895241172,  b_ciccarello, 2, 2, 0, yes
2968750552,  WisedomMike, 30, 25, 5, yes
414385318,  protoromantica, 33, 13, 20, no
4610672903,  omepenny, 2, 2, 0, yes
2207177382,  teobaratto90, 2, 2, 0, yes
397997207,  AndreaGContini, 16, 8, 8, neutral
721428113373208577,  LidiaRizzo7, 1, 1, 0, yes
521450521,  enzo_salanitri, 27, 18, 9, yes
757599598395482113,  GaudensNews, 6, 5, 1, yes
581069910,  angelomarra3, 18, 16, 2, yes
723211184690872325,  dd_davidelai, 12, 12, 0, yes
2255408790,  colaianto, 14, 12, 2, yes
2598862667,  AndreaIori1969, 6, 6, 0, yes
453821510,  robisica, 4, 4, 0, yes
1377898921,  Maxfinas, 4, 3, 1, yes
2391532789,  antoniacinzia, 2, 1, 1, neutral
408021280,  zampolex, 15, 8, 7, yes
344159343,  marosa259, 1, 1, 0, yes
4818884571,  giancarlogian83, 5, 4, 1, yes
426640529,  alesweetshadow, 8, 3, 5, no
752968181661261825,  ArA43319192, 3, 3, 0, yes
831665582,  dawac72, 43, 28, 15, yes
256143387,  MatteoRouge83, 9, 9, 0, yes
3299152901,  GattiEmanuele, 4, 4, 0, yes
735107028,  IngFerrara, 52, 42, 10, yes
591963862,  Antoauto, 2, 2, 0, yes
1037713867,  giancalex, 26, 10, 16, no
354125985,  MaxLandra, 53, 35, 18, yes
540718926,  raffatortorelli, 5, 5, 0, yes
4910181370,  francesca707070, 43, 43, 0, yes
1176499273,  uscito, 23, 14, 9, yes
2416492224,  maxbax33, 42, 16, 26, no
4815678869,  patrizia6591, 11, 10, 1, yes
59786185,  barus59, 1, 1, 0, yes
71887780,  VittorioPecorar, 18, 18, 0, yes
705608478,  pongufogu, 9, 5, 4, yes
3373801840,  PaoloBura, 3, 2, 1, yes
2278888628,  TagaNicholas, 8, 7, 1, yes
1367363988,  SardellaBarbara, 26, 12, 14, no
2292219675,  PierluigiCaval2, 4, 4, 0, yes
1499307636,  reagire67, 7, 7, 0, yes
49194850,  Tiziana1223, 1, 1, 0, yes
1454953412,  MariangelaRoss9, 3, 3, 0, yes
132887861,  Ferdy1957, 1, 1, 0, yes
3709809921,  SilpCGIL_Milano, 4, 3, 1, yes
3070135450,  adelaid93680776, 45, 45, 0, yes
2356768939,  pierodallerive, 19, 10, 9, yes
1635670363,  CivettaneviE, 8, 8, 0, yes
769651270613426176,  dave_araya, 9, 9, 0, yes
2543774477,  Mauro7551, 4, 2, 2, neutral
416094664,  FabriMalvi, 5, 4, 1, yes
584658845,  GiuseppeSantis, 4, 4, 0, yes
2519061382,  labenny_33, 6, 5, 1, yes
2355359638,  GiomedMario, 3, 2, 1, yes
4919837110,  castell32082033, 73, 59, 14, yes
2184144110,  GianniLaGreca, 40, 26, 14, yes
2730482441,  annapapamiki071, 33, 15, 18, no
772298888,  primo_novembre, 5, 5, 0, yes
579087793,  beoalex, 1, 1, 0, yes
257401804,  mdbroma, 1, 1, 0, yes
215976090,  ritalaura2000, 7, 6, 1, yes
788831011081715712,  MauroMelone1, 1, 1, 0, yes
514803990,  DariaSensi, 16, 10, 6, yes
1036959080,  alex50va, 3, 3, 0, yes
367312496,  abonardo, 4, 4, 0, yes
2997985672,  vbenedetti66, 2, 1, 1, neutral
78592524,  alehuber, 8, 8, 0, yes
586731493,  madairob, 4, 3, 1, yes
3431896313,  BoscoloMiriam, 44, 28, 16, yes
2852162818,  lm13dec, 35, 25, 10, yes
147131446,  marinaXXaniram, 4, 4, 0, yes
546377024,  valentinopresta, 2, 1, 1, neutral
2494105081,  StillPed, 2, 2, 0, yes
773074386,  cinzia_ficco, 24, 18, 6, yes
1056262754,  FrancaFerrari4, 2, 2, 0, yes
1158460105,  RendaMarco, 1, 1, 0, yes
878309744,  FollettoAllegro, 2, 2, 0, yes
2342272249,  FrancescaMfs, 7, 7, 0, yes
1364124920,  CalabreseNuccio, 6, 4, 2, yes
1023906182,  gioicaro, 14, 10, 4, yes
55238295,  annapaolaconcia, 18, 15, 3, yes
1253719668,  Annah1976, 7, 7, 0, yes
711909518121312256,  pepe01420152, 32, 16, 16, neutral
514124269,  diloretoale, 8, 7, 1, yes
619084943,  diennetwitt, 5, 5, 0, yes
2472256093,  ivaldiriccardo, 1, 1, 0, yes
31255401,  Davide72, 43, 38, 5, yes
2899612829,  CuginoPaolo, 13, 12, 1, yes
338363115,  giannimunizza, 5, 3, 2, yes
367390935,  Andrea_Beretta, 17, 8, 9, no
1050589128,  SandroBonomi2, 41, 38, 3, yes
2846559233,  esterbaum, 6, 4, 2, yes
493533192,  albertocencetti, 16, 10, 6, yes
3044594085,  Ansicora1, 12, 11, 1, yes
866601420,  RuiPete, 4, 4, 0, yes
3092389516,  BorroniAnna1, 16, 9, 7, yes
16156600,  Omo_Neri, 11, 11, 0, yes
2153157170,  PDBarlassina, 4, 4, 0, yes
2583026273,  Padre_Ramirez, 12, 6, 6, neutral
415884853,  giannivaraschin, 2, 2, 0, yes
1038941972,  RobertoDiGreg, 14, 12, 2, yes
3408677429,  Giorgio92242895, 23, 20, 3, yes
406250595,  javieryearson, 1, 1, 0, yes
430995535,  spacecowboy31, 77, 47, 30, yes
963955711,  IvanoStrizzolo, 8, 8, 0, yes
4249227922,  giuseppe1831, 10, 10, 0, yes
2338484714,  MinutemanItaly, 3, 2, 1, yes
4805159374,  fracag87, 8, 8, 0, yes
424947562,  EdmondoRho, 5, 5, 0, yes
712367299,  guido_porta, 7, 7, 0, yes
379810648,  fafo1962, 2, 2, 0, yes
584877389,  resistenza1938, 8, 8, 0, yes
1292021606,  FrancyP_, 40, 27, 13, yes
85657467,  MarcoMariani_IT, 151, 101, 50, yes
591741476,  drmaurus, 5, 4, 1, yes
218641201,  Sassaf75, 9, 8, 1, yes
2294719548,  gigliointi, 3, 3, 0, yes
2478827076,  apolloatena, 2, 2, 0, yes
2763753587,  Hughellmuth, 6, 5, 1, yes
293608717,  iomaredinverno, 5, 2, 3, no
98625281,  FrancBen, 1, 1, 0, yes
475836408,  74josef, 11, 6, 5, yes
425174482,  giancarlo2508, 1, 1, 0, yes
1871000750,  MazzOnedaje, 37, 27, 10, yes
2251852801,  Vento_lin, 4, 4, 0, yes
1476648654,  seawind13, 1, 1, 0, yes
1015943750,  magog53, 7, 7, 0, yes
787685347,  danielefabiano1, 1, 1, 0, yes
64139825,  Sm4rtlio, 34, 31, 3, yes
4861481447,  erika_prenner, 38, 30, 8, yes
805569505049067520,  Dakota18548454, 7, 7, 0, yes
1015929492,  santogio65, 2, 2, 0, yes
606438986,  panmatt, 10, 10, 0, yes
906677365,  monicadamb, 1, 1, 0, yes
22598131,  FabrizioFalconi, 10, 7, 3, yes
779976176416722944,  cosimo1890, 15, 13, 2, yes
804368763781021696,  ukulele_baobab, 39, 38, 1, yes
537155694,  CristinaBargero, 1, 1, 0, yes
2604042187,  lampis65, 8, 8, 0, yes
279198457,  Diaboclick, 3, 2, 1, yes
1588252674,  fuscovincenzo, 1, 1, 0, yes
1422657997,  MatteoF13712178, 2, 2, 0, yes
703956848836222977,  nadia_moroni, 5, 3, 2, yes
75299581,  ragusaibla, 9, 7, 2, yes
197193073,  morello67, 9, 9, 0, yes
861320575,  fabribelloni, 4, 4, 0, yes
585455321,  ValeryMell1, 7, 5, 2, yes
2198032835,  Lorenzo_Tei, 13, 12, 1, yes
371310263,  FabioFabio83, 12, 9, 3, yes
2616680851,  10261940, 51, 19, 32, no
246882205,  linomeschieri, 7, 4, 3, yes
986714714,  DossiCarla, 89, 68, 21, yes
14727477,  titticimmino, 3, 3, 0, yes
1126191505,  nandopagliara, 9, 6, 3, yes
168335388,  Jocrega, 3, 3, 0, yes
15491749,  michelelan, 24, 17, 7, yes
2234448710,  Publio_Marone, 3, 1, 2, no
39022638,  giomaggiora, 74, 31, 43, no
176921640,  Federica2115, 13, 12, 1, yes
27390026,  claudio2502, 4, 3, 1, yes
1102070556,  asromafollower, 34, 28, 6, yes
52356694,  Carloferrario, 3, 3, 0, yes
2964119115,  AndreaM_Zerbini, 28, 14, 14, neutral
2329972429,  AdmirariN, 8, 7, 1, yes
265060963,  maluni54, 8, 8, 0, yes
409444860,  francabaratella, 56, 27, 29, no
962311958,  licia_la, 88, 43, 45, no
96172514,  luca22676, 2, 2, 0, yes
1278700207,  marangelo2005, 33, 16, 17, no
3105108137,  FrancoAlfieriPD, 27, 27, 0, yes
411196574,  carlocappello67, 21, 18, 3, yes
3001084382,  marcocarrozzo66, 9, 9, 0, yes
1366886233,  rosannatodi, 30, 19, 11, yes
1136910044,  SilviaMorelli81, 5, 3, 2, yes
802299785906683905,  ImmiInforma, 12, 11, 1, yes
1598877840,  GrifondoroM, 6, 6, 0, yes
3841779982,  MarcoGranelliMI, 4, 4, 0, yes
2858759915,  massimo_limonta, 48, 24, 24, neutral
4003940735,  GiovanniRota52, 15, 8, 7, yes
564934521,  giannisvizzero, 3, 3, 0, yes
631412764,  LuisTorrenteee, 4, 4, 0, yes
703875686218522624,  Bill30745412, 21, 10, 11, no
261291536,  ilviaggiodelvia, 16, 8, 8, neutral
1598253523,  Lanzichenecco7, 17, 8, 9, no
3007527855,  domizzo15, 2, 1, 1, neutral
2502131693,  BettaninManuela, 28, 14, 14, neutral
1648043496,  fradepal, 1, 1, 0, yes
73065144,  matteoricci, 50, 48, 2, yes
1121935962,  CRCalcagno, 69, 51, 18, yes
763844678005432320,  pio_pantusa, 19, 18, 1, yes
615868685,  jneliypuppy, 1, 1, 0, yes
3372528161,  6b329aecd2ae4e7, 11, 11, 0, yes
811586132,  MarcoTjTansini, 1, 1, 0, yes
1408430185,  Filip965, 19, 10, 9, yes
533176044,  fedquattrocchi, 43, 21, 22, no
2786975403,  EsercitoParenzo, 19, 11, 8, yes
1307442482,  marylu1945, 17, 11, 6, yes
1085901524,  Solelunarosa, 36, 22, 14, yes
10281172,  savethedrop, 7, 6, 1, yes
154508155,  Montesimona, 9, 8, 1, yes
161740961,  Serfiss, 60, 27, 33, no
1044932990,  discordoconme, 122, 86, 36, yes
46194698,  lucadimarco, 16, 16, 0, yes
797679000,  ilNonnoSimpson, 38, 26, 12, yes
61727028,  robertalombardi, 4, 3, 1, yes
1522499318,  StefanoCiuoffo, 5, 5, 0, yes
16109886,  intoscana, 2, 2, 0, yes
383052987,  sikeliota, 47, 0, 47, no
2910674200,  AmataSalvo, 54, 43, 11, yes
1857148146,  rodolfo80838139, 57, 27, 30, no
821719770,  bruno_degus, 48, 44, 4, yes
204765687,  AnnaFumagalli, 7, 5, 2, yes
4331454017,  GiorgiaBaba24, 23, 16, 7, yes
1664716250,  ASorbolini, 12, 9, 3, yes
242351511,  araccontarlo, 33, 8, 25, no
724952777240248320,  edstazionefs_an, 12, 8, 4, yes
745784576719589377,  AndriaClaucio, 18, 4, 14, no
316660583,  barbarapasquali, 4, 4, 0, yes
207122050,  PDLiguria, 17, 17, 0, yes
87306292,  brandobenifei, 12, 9, 3, yes
2250843821,  demarcla91, 4, 4, 0, yes
2903029769,  Nicola_Alberta, 85, 85, 0, yes
709104359905300480,  Amalia80258162, 647, 646, 1, yes
716735185409155076,  maribonanno72, 441, 441, 0, yes
780087732949413888,  NunziellaU, 19, 19, 0, yes
732951802363150336,  ElinaCaruana, 24, 24, 0, yes
731131129336627200,  AmaliaDeMartin2, 136, 136, 0, yes
2193007701,  mirecannizzaro, 1024, 1018, 6, yes
1045245656,  LUIHELELI, 197, 196, 1, yes
788467491299287041,  Marinel25496216, 361, 359, 2, yes
783192988285595648,  GiusiGreco10, 40, 40, 0, yes
788605410529992704,  Frances8030660, 137, 137, 0, yes
3347934334,  francoxgreco, 246, 4, 242, no
455500859,  taxistalobbysta, 29, 13, 16, no
878913366,  APinnone, 7, 7, 0, yes
461072651,  waltersantillo, 7, 7, 0, yes
564773110,  pinolacicerchia, 6, 3, 3, neutral
2913072586,  lapiazzaweb, 13, 7, 6, yes
928609825,  FrancoCasonato, 15, 13, 2, yes
238331462,  vicarioimperial, 21, 21, 0, yes
2253601698,  PieroPedro51, 2, 2, 0, yes
17288700,  radiopopmilano, 31, 30, 1, yes
58891895,  freechef, 7, 6, 1, yes
325760306,  Cor_Core_Acceso, 118, 53, 65, no
590188450,  s_fusco, 109, 17, 92, no
4659874881,  RosenthalEllery, 7, 7, 0, yes
523343629,  AcquaPuglia, 163, 145, 18, yes
781571361919631360,  rossana1944, 1, 1, 0, yes
455446061,  SBemporad, 1, 1, 0, yes
554179159,  Peleo59, 5, 2, 3, no
494198440,  CannellaPaolo, 5, 5, 0, yes
418886119,  GiuseppeZezza, 6, 5, 1, yes
1006685844,  Gb2002Gb, 21, 13, 8, yes
737601787796955136,  depadario, 2, 2, 0, yes
2479440949,  cmarini4, 2, 2, 0, yes
2910002759,  basabasae, 2, 1, 1, neutral
1355209729,  m__benny, 13, 13, 0, yes
1278132380,  luxbolo, 12, 12, 0, yes
802152204459184129,  darioborghi1, 3, 3, 0, yes
496229128,  GTStranera, 5, 3, 2, yes
457700602,  davidcolantoni, 18, 18, 0, yes
866687046,  granderex, 1, 1, 0, yes
1109887628,  Max_Deidda, 26, 25, 1, yes
2242163899,  ilsibarita1, 5, 3, 2, yes
3004273738,  petaLoosti, 1, 1, 0, yes
2465231682,  manuela_bora, 2, 2, 0, yes
25676606,  Adnkronos, 124, 77, 47, yes
242318672,  luca_arf, 2, 2, 0, yes
986711527,  NowPoppi, 2, 2, 0, yes
795755549614886912,  cussignaperilsi, 2, 2, 0, yes
2433335486,  DiegoPavoni1, 1, 1, 0, yes
1077656766,  AllegriMara, 4, 4, 0, yes
379160375,  nandoleva, 4, 4, 0, yes
74399982,  moaiamorfo, 6, 6, 0, yes
983065508,  AristarcoScann1, 46, 35, 11, yes
362516905,  crazybalzano, 3, 1, 2, no
595786440,  FalchiLuca, 23, 16, 7, yes
606186463,  FraFragomeli, 6, 3, 3, neutral
458347992,  lubenasich, 49, 39, 10, yes
535489574,  VeronicaAiroldi, 3, 3, 0, yes
504271524,  maurosecci1, 9, 9, 0, yes
2171028731,  mazzarellantoni, 24, 14, 10, yes
514596328,  Valtes65, 1, 1, 0, yes
520275529,  mismas00, 2, 1, 1, neutral
756798814518964224,  SalariniMassimo, 2, 1, 1, neutral
165530020,  alegiova, 3, 3, 0, yes
32937876,  maxworkout, 17, 16, 1, yes
46224994,  vitalbaa, 23, 18, 5, yes
2521176917,  MMon50, 1, 1, 0, yes
427522940,  gianma1980VR, 19, 15, 4, yes
738932299,  bostongeorge121, 14, 12, 2, yes
2934930969,  giuseppe_March, 28, 28, 0, yes
1405465094,  lenuccia82, 100, 39, 61, no
51800118,  perfilitalia, 4, 4, 0, yes
47368039,  fabiofantozzi, 2, 2, 0, yes
73489499,  AlexMolinari72, 1, 1, 0, yes
497988880,  MarceGilardi, 1, 1, 0, yes
480556099,  giorgiocolombi, 1, 1, 0, yes
1510136666,  LorenziTania, 67, 66, 1, yes
2778855315,  VitaleSusy, 15, 14, 1, yes
416310352,  animerrante, 20, 10, 10, neutral
1257980089,  CarloRienzi, 1, 1, 0, yes
4038219195,  bb51517, 1, 1, 0, yes
2207562784,  JFC1082, 7, 7, 0, yes
771773707085832192,  Angelo41813393, 7, 7, 0, yes
460959521,  stefanomagnone, 34, 24, 10, yes
406549098,  mattiamass, 1, 1, 0, yes
2984790945,  RsSebastiano, 5, 2, 3, no
974687502,  antokean, 1, 1, 0, yes
504235049,  giovygiovy76, 2, 2, 0, yes
455291448,  _Sillyhound, 3, 2, 1, yes
2700985849,  guida_geremia, 2, 2, 0, yes
110414714,  pguarnieri7, 10, 9, 1, yes
357311919,  MASENELLO, 2, 2, 0, yes
928564856,  paoloeusebi, 2, 2, 0, yes
748249787309395969,  alessandrobabba, 3, 3, 0, yes
1857779947,  MNRuggiero, 39, 37, 2, yes
242969281,  tirandrea, 2, 2, 0, yes
359443477,  KkDarius, 2, 2, 0, yes
609790313,  savinotr, 14, 7, 7, neutral
1104348871,  Erre_Rosa, 4, 4, 0, yes
425285683,  albertorossiniR, 9, 9, 0, yes
785455883228684288,  MoniRiccardo, 1, 1, 0, yes
1405789050,  Venticello_, 52, 31, 21, yes
2972722234,  seb_galati, 3, 3, 0, yes
2948932000,  BolognesiTino, 1, 1, 0, yes
3837061107,  PaolaeAntonio1, 3, 3, 0, yes
51246619,  eliociralli, 2, 2, 0, yes
3049973297,  nuvxkm1, 1, 1, 0, yes
67276534,  fsirabella, 1, 1, 0, yes
854466968,  angiotti, 4, 3, 1, yes
105602878,  angelobruno19, 21, 15, 6, yes
892929787,  albertobolzani, 15, 14, 1, yes
2857413639,  FEDELE_AL_M5S, 262, 207, 55, yes
416372229,  ABisciotti, 5, 4, 1, yes
1399394359,  LabGov, 1, 1, 0, yes
431916684,  GuglielminoS, 3, 2, 1, yes
1221335432,  ernesto95255940, 12, 9, 3, yes
801731765765308416,  Fab1DD, 2, 2, 0, yes
2631238199,  pinapriola, 5, 5, 0, yes
2525069528,  GiuseppeLeg, 14, 7, 7, neutral
45960215,  matteocelebron, 3, 2, 1, yes
2196528408,  PietroLeonexxx, 6, 6, 0, yes
960597678,  GeomCITRO, 4, 4, 0, yes
2938502967,  CantelmoPino, 4, 4, 0, yes
3033185758,  sonialombardel1, 8, 8, 0, yes
712755541110603776,  CinnyCinliber, 1, 1, 0, yes
3313351684,  MetaSociale, 93, 6, 87, no
2167432183,  MisterCariola, 9, 6, 3, yes
197493967,  MAXIMUS15477, 4, 4, 0, yes
797773134669680640,  placidialex, 3, 1, 2, no
1566728018,  Tommaso_sicuro, 1, 1, 0, yes
400899688,  EnzoTiberi, 20, 18, 2, yes
2532606925,  LVeramici, 2, 2, 0, yes
3293835712,  bodakugga, 3, 3, 0, yes
41094956,  sardikus, 9, 8, 1, yes
438418495,  AmiciRob, 3, 3, 0, yes
366233393,  ezaccheroni, 2, 2, 0, yes
2292740047,  alfio31254, 3, 3, 0, yes
4914890062,  alberto70853020, 1, 1, 0, yes
811076442,  mzatini, 34, 18, 16, yes
2872888186,  miletta2000, 1, 1, 0, yes
285099275,  AlfAnnunziata, 38, 36, 2, yes
918651830,  SPizzicannella, 1, 1, 0, yes
155514374,  maiaga81, 12, 12, 0, yes
367090986,  valerio_romeo, 10, 10, 0, yes
3225188031,  PsicoPolicy, 4, 3, 1, yes
1068754034,  FrancescoForm88, 5, 4, 1, yes
407751232,  ste_vavassori, 1, 1, 0, yes
505630677,  Paolett0, 2, 2, 0, yes
839698230,  FabioCapra3, 10, 10, 0, yes
233913376,  Ettore_Ribaudo, 4, 3, 1, yes
151106698,  DaVelSign, 9, 9, 0, yes
4794652822,  cislFPbasilicat, 7, 7, 0, yes
763347591899865088,  MattyMenca93, 9, 9, 0, yes
2444192547,  PontiMario, 3, 3, 0, yes
242081903,  silviavacirca, 1, 1, 0, yes
2679363606,  benedettog_2013, 2, 2, 0, yes
2661453455,  BellaSfacciata, 14, 12, 2, yes
806075480986226688,  RinascitaNaz, 10, 9, 1, yes
3270063726,  MicheleLeone78, 8, 6, 2, yes
2462609518,  GrandukaC, 6, 2, 4, no
2190892188,  bepiolivieri, 7, 7, 0, yes
280182034,  Predon61, 1, 1, 0, yes
492964938,  ASgrulletti, 8, 8, 0, yes
126680070,  AcquaBeneComune, 1, 1, 0, yes
170621912,  ErikaMunno, 3, 3, 0, yes
988659876,  riparteilfuturo, 3, 3, 0, yes
1921125602,  VianelloRita, 10, 2, 8, no
2940223193,  alessio_olenska, 6, 6, 0, yes
2491194481,  eliogullo, 4, 4, 0, yes
96364636,  anpolt, 9, 3, 6, no
739338470783627265,  opengovitaly, 10, 10, 0, yes
400837792,  estellamarino, 18, 16, 2, yes
397199507,  movittone, 81, 80, 1, yes
45199793,  marcosimoni_, 3, 3, 0, yes
3021476907,  and_sammarco, 1, 1, 0, yes
453821249,  Orticalab, 10, 9, 1, yes
244087105,  Codacons, 5, 3, 2, yes
50361109,  fforzano, 19, 13, 6, yes
728184625,  francasilvani, 4, 4, 0, yes
1919454733,  c_mastrorocco, 5, 5, 0, yes
1308112182,  MimmoBaeli, 19, 7, 12, no
1048095474,  francyfior, 6, 3, 3, neutral
522507912,  SebyFerlisi, 1, 1, 0, yes
561077546,  PatriCaligiuri, 6, 6, 0, yes
766147249718042624,  8ales2, 10, 10, 0, yes
18935802,  repubblicait, 30, 23, 7, yes
1125130326,  giusi_jose, 3, 3, 0, yes
49319803,  BorzattaP, 132, 117, 15, yes
486032628,  SimoneTenducci, 2, 2, 0, yes
175030109,  serenalaudisa, 4, 4, 0, yes
404756677,  raffacascioli, 2, 2, 0, yes
14685648,  diritto2punto0, 6, 6, 0, yes
2541012626,  studiotecnicoto, 2, 2, 0, yes
1914030042,  Simcor51, 3, 3, 0, yes
2477603211,  DerricoPia, 83, 60, 23, yes
111243620,  maxrevello, 1, 1, 0, yes
633595333,  MarcoSenatore75, 13, 11, 2, yes
1296801535,  _epoc24, 19, 7, 12, no
802704560,  pietromancini5, 1, 1, 0, yes
2872933583,  grippt, 3, 3, 0, yes
2915545942,  anoperibi, 1, 1, 0, yes
797814002445352960,  giuseppe31182, 3, 3, 0, yes
739538599918571520,  marpveg, 47, 33, 14, yes
425803153,  SilvanoSalviato, 7, 5, 2, yes
414185837,  michyl09, 9, 9, 0, yes
413455293,  ValeriaSirigu, 5, 4, 1, yes
560466555,  m_musacchi, 50, 26, 24, yes
1107010261,  RobRossetti77, 5, 3, 2, yes
406820061,  suxsonica, 3, 2, 1, yes
482112828,  SaAzzinnari, 4, 4, 0, yes
260357937,  CoordRomaAcqua, 2, 2, 0, yes
704633833,  GildaInsegnanti, 1, 1, 0, yes
26295447,  RossellaFidanza, 158, 88, 70, yes
2483355627,  hazmie09, 1, 1, 0, yes
427739095,  GarraRossella, 7, 7, 0, yes
4910534572,  CasulaGabriella, 3, 3, 0, yes
968871944,  GiuGiupa82, 10, 8, 2, yes
472047884,  lauralandolfi1, 19, 19, 0, yes
3300508887,  WvQrPOpVq4RYvyP, 5, 3, 2, yes
873734450,  amenoklean, 11, 5, 6, no
1971962198,  matra63, 1, 1, 0, yes
422468997,  vincenzocacace4, 21, 12, 9, yes
1242311772,  gcammarot, 4, 4, 0, yes
417526349,  LucaGiandomenic, 2, 1, 1, neutral
375706716,  paolodeluca73, 1, 1, 0, yes
272467769,  GiuFranz82, 10, 5, 5, neutral
2760251254,  francescocorda9, 4, 1, 3, no
702134290470072321,  StefanoGVi, 9, 6, 3, yes
22996510,  david547, 5, 5, 0, yes
804707078615040000,  GiuseCaru, 1, 1, 0, yes
532733052,  mmnetta, 22, 20, 2, yes
801449731805347840,  Giancarloxx01, 21, 20, 1, yes
781366033231802368,  bannamix1, 38, 31, 7, yes
482940177,  lorenzotuo, 7, 7, 0, yes
482246533,  dantefaccenda, 4, 4, 0, yes
558987287,  Roby_Pez, 5, 5, 0, yes
603613167,  EdoardoCini, 10, 10, 0, yes
425153508,  solinas_marco, 21, 20, 1, yes
2400326462,  Adriano__Barone, 63, 49, 14, yes
493949099,  MaxJWWallace, 30, 18, 12, yes
141955179,  nikcarte, 2, 2, 0, yes
66305303,  gaspacio07, 2, 2, 0, yes
586487449,  1947mn, 8, 8, 0, yes
1068056972,  brizzo51, 29, 29, 0, yes
3131012013,  imbizzarrito, 11, 10, 1, yes
805727603751612416,  lucia_colizzi, 12, 12, 0, yes
3025669096,  Democrazy_blog, 36, 14, 22, no
3001742419,  BertulessiPaolo, 16, 15, 1, yes
702922119508856832,  LunaticFringeDA, 4, 4, 0, yes
787620843320905728,  Giringa16, 12, 10, 2, yes
1047886850,  nickarter56, 1, 1, 0, yes
742445565368209408,  TruduMarcello, 9, 9, 0, yes
456487302,  LauraAglio, 1, 1, 0, yes
694604698771427328,  ecodaipalazzi, 8, 4, 4, neutral
3313650268,  TriskellStefi, 2, 2, 0, yes
714440237276119040,  AoveJimara, 5, 5, 0, yes
22604437,  attila47, 4, 1, 3, no
134386098,  mariomaddaloni, 3, 3, 0, yes
428376594,  FascianiRoberto, 6, 6, 0, yes
72657937,  dominikos90, 7, 6, 1, yes
804014310066450432,  salvator_deli, 26, 10, 16, no
2517892513,  UgoGrassi1, 5, 3, 2, yes
522292867,  giovann92391754, 60, 26, 34, no
498288910,  biondo2k, 7, 2, 5, no
988375248,  Solsbury93, 11, 4, 7, no
412410683,  MelantoP, 22, 16, 6, yes
410206647,  JackBraca, 48, 48, 0, yes
790541461095714816,  cinvello, 6, 6, 0, yes
2234131669,  sinan_zekiri, 3, 3, 0, yes
993579870,  Daniscandella, 6, 6, 0, yes
197370410,  giovannaleoni, 7, 7, 0, yes
1068728030,  nonegoziabili, 45, 36, 9, yes
85161350,  Bublelicious70, 14, 9, 5, yes
2572632515,  76Eros, 12, 11, 1, yes
295791934,  igorpadovano, 3, 3, 0, yes
854329560,  vane97cevi, 10, 8, 2, yes
2764299866,  GalassiGlsmnl, 9, 5, 4, yes
4054551945,  PecoraNegra, 12, 10, 2, yes
18542632,  talentosprecato, 7, 6, 1, yes
784398647471595520,  mariaederabosk, 24, 17, 7, yes
2356372447,  greguari, 8, 8, 0, yes
736469367379087360,  marcovinci14, 11, 9, 2, yes
794982794631987200,  idriettina, 24, 22, 2, yes
776472160172924928,  Alice__Ga, 19, 19, 0, yes
247369956,  FiduciaInRenzi, 6, 5, 1, yes
2468035339,  danype5, 7, 7, 0, yes
103056844,  AndreaSorb, 10, 2, 8, no
1855414472,  Mattialei, 21, 13, 8, yes
777086417294032896,  7266Dvd, 5, 3, 2, yes
1894270790,  FalvoGianluca, 32, 4, 28, no
4920372220,  MStueder, 4, 3, 1, yes
3761076075,  isolahokkaido, 4, 2, 2, neutral
318656163,  Michael2958, 9, 9, 0, yes
474014663,  Anto6798, 20, 16, 4, yes
1086393973,  michele_giove, 6, 6, 0, yes
447120305,  goodyear22, 7, 7, 0, yes
414978233,  amariMarisa, 25, 10, 15, no
2147915990,  Ricky11LC, 7, 7, 0, yes
752076895055966208,  cevoleculoanche, 4, 2, 2, neutral
96325649,  antonio911975, 8, 4, 4, neutral
805858804588023808,  PapiriAnna, 32, 14, 18, no
2184944111,  NaniPuffo, 21, 7, 14, no
4548508636,  SettimoFiorenzo, 49, 16, 33, no
2840111003,  fkbrandy, 16, 8, 8, neutral
1586227562,  rugaskipper, 67, 43, 24, yes
74759588,  RCapaccioli, 9, 6, 3, yes
379256309,  GiuliaDiVita, 27, 8, 19, no
782577416548020225,  SeliniFrancesco, 151, 99, 52, yes
9381672,  guidobaldoni, 2, 2, 0, yes
3069843927,  webnauta59, 165, 156, 9, yes
1197644424,  giuseppezorzi, 42, 27, 15, yes
755028067517693953,  FabioDerviscio, 36, 23, 13, yes
3094278383,  novemberman3000, 166, 65, 101, no
1105814539,  andrea_pertici, 143, 32, 111, no
423531049,  NICOLACATAR, 106, 59, 47, yes
541171533,  DavideRonni, 5, 4, 1, yes
1161191406,  bellogatto1, 48, 30, 18, yes
390835478,  rebeccamanzoni1, 13, 7, 6, yes
2941355506,  RGreco10, 4, 3, 1, yes
1208394690,  RaiUno, 15, 12, 3, yes
763943146531139585,  normaaversente1, 10, 8, 2, yes
2260660337,  ciclista1231, 114, 56, 58, no
828894186,  schuko14, 5, 4, 1, yes
95049929,  GioGaudio89, 7, 4, 3, yes
419443005,  tmsboldrini, 29, 15, 14, yes
780806706066395136,  BufaledelNO, 13, 9, 4, yes
2876784275,  MaurizioNastasi, 21, 19, 2, yes
271990882,  askanews_next, 44, 25, 19, yes
2817131786,  LoMangioSoloSeM, 24, 10, 14, no
532253531,  playhack43, 15, 14, 1, yes
955314738,  MassimoBindi, 249, 140, 109, yes
4869095007,  disabile1968, 152, 77, 75, yes
731920891735605248,  GiocondaGallina, 27, 16, 11, yes
360105746,  Paulusxt, 77, 42, 35, yes
805697989218013184,  tamburotamburo, 8, 3, 5, no
424473892,  nicoirto, 13, 13, 0, yes
784949792,  stefano82003330, 19, 10, 9, yes
997876723,  nonnaloretta, 4, 4, 0, yes
270050737,  Giacinto_Bruno, 23, 16, 7, yes
2220382963,  DIOGENECINICO, 9, 9, 0, yes
486478353,  CarloMaccio, 19, 19, 0, yes
133673973,  twleggi, 29, 26, 3, yes
1275239096,  Beppesardinia, 45, 9, 36, no
593744793,  piepulo, 6, 5, 1, yes
213616021,  _kuball_, 128, 55, 73, no
1454614525,  CapitanoNemo, 60, 36, 24, yes
331763256,  DiegoAngelino83, 10, 10, 0, yes
802239899017613312,  PDvotaNO, 10, 10, 0, yes
2231919056,  ortigia55, 11, 10, 1, yes
415423066,  amerutigliano, 33, 26, 7, yes
1905601525,  Sandra_Savino, 28, 2, 26, no
2327342227,  Riccardi_FVG, 7, 2, 5, no
348141611,  giancarloscordo, 55, 29, 26, yes
2858584827,  scuroscuroscuro, 149, 27, 122, no
1858061390,  Forza_ItaliaFVG, 51, 2, 49, no
796763568,  cinziamolizzi, 26, 5, 21, no
1252946868,  foxtrottcharly1, 9, 5, 4, yes
3471435689,  lullo64, 90, 12, 78, no
407746253,  ANTONIOMAUTAREL, 25, 3, 22, no
3387034282,  CantIdee, 23, 2, 21, no
2277583123,  Operaio2, 12, 12, 0, yes
4889849530,  PensieroDem_, 24, 22, 2, yes
483872778,  speriamobbene, 4, 3, 1, yes
538378384,  Flavio77125194, 2, 2, 0, yes
2308197236,  BasileMf, 9, 7, 2, yes
704698759800885249,  cirichic, 5, 5, 0, yes
604477428,  BrancaFrancesc1, 19, 15, 4, yes
4526622501,  sindacocaorle, 20, 13, 7, yes
4839028402,  peterjoints, 6, 5, 1, yes
521355230,  PaoloDisdicchi, 11, 11, 0, yes
710525705277325313,  Leo93362024, 58, 48, 10, yes
1853565056,  fabioncas, 2, 2, 0, yes
1004946811,  NicolaRotolo, 3, 3, 0, yes
2189190782,  gbonfardino, 71, 63, 8, yes
1896592458,  DomenicoNila, 7, 7, 0, yes
3717571997,  MauriPranda, 4, 3, 1, yes
3007267479,  aapi_brindisi, 10, 10, 0, yes
1146221761,  accipiter61, 3, 2, 1, yes
2245422521,  ClaudiaStrata, 3, 3, 0, yes
2741727190,  Vituzzo_Zuccone, 90, 30, 60, no
447213283,  franz_greg, 3, 3, 0, yes
426680463,  clmanfred, 4, 2, 2, neutral
907687309,  robyducklings, 20, 19, 1, yes
2373837249,  cipa63, 2, 2, 0, yes
896973488,  sandroliuti, 4, 4, 0, yes
1074413634,  TuminoMaurizio, 11, 10, 1, yes
2207932479,  martared2, 6, 6, 0, yes
460372157,  1979Giorgio, 3, 2, 1, yes
2728896824,  matiolo1, 27, 24, 3, yes
2719674982,  ale62fra, 2, 2, 0, yes
19484936,  Stefano7, 22, 17, 5, yes
184754844,  paolopezzoli, 9, 8, 1, yes
1639987099,  Mastercip1, 5, 4, 1, yes
2275956998,  SuraceLuciano, 2, 2, 0, yes
368118881,  LeoDeSanc, 3, 3, 0, yes
596330003,  glemando, 8, 8, 0, yes
478482504,  MarcoMai1, 2, 2, 0, yes
204235294,  pietromare, 2, 2, 0, yes
829790846,  voltolina63, 13, 11, 2, yes
721336143564926981,  Rossi6100Rossi, 2, 2, 0, yes
3245026150,  GBajoli, 8, 8, 0, yes
788860048768458752,  try_mar, 6, 5, 1, yes
126000118,  cranci, 38, 29, 9, yes
487012569,  brunodellamaria, 9, 7, 2, yes
2754565029,  rosad24, 17, 12, 5, yes
2739356051,  volgiu, 22, 21, 1, yes
260786308,  hashlamounf, 4, 2, 2, neutral
318940180,  fabiosantoro1, 7, 7, 0, yes
1257881796,  MarcoMermarco, 27, 12, 15, no
446974952,  benassiluciana, 13, 13, 0, yes
2189430449,  magrini_sandra, 14, 6, 8, no
1346509117,  guilledigi1, 6, 6, 0, yes
1012939532,  gianprof, 7, 7, 0, yes
777025956078813184,  robgat51, 23, 11, 12, no
57479575,  lyunberg, 49, 45, 4, yes
787689894,  Ann1k3, 6, 6, 0, yes
878586168,  RoccoSavasta, 5, 5, 0, yes
340841609,  andreamesiano, 4, 3, 1, yes
1620517057,  AndreaMatyellow, 13, 13, 0, yes
481295090,  chaos_60, 2, 2, 0, yes
2982705353,  giuliatwitta60, 8, 7, 1, yes
989315192,  ApeMag, 7, 5, 2, yes
1477768746,  FredaRaffa, 5, 2, 3, no
2584004759,  byba_98, 5, 5, 0, yes
852781370,  carloarbini51, 6, 5, 1, yes
1975150249,  FScalmati, 58, 51, 7, yes
4871561392,  freebrain83, 4, 3, 1, yes
467361179,  MZorzy, 31, 21, 10, yes
3806382809,  StefanoSbardel2, 57, 5, 52, no
439340200,  cigliuti, 2, 1, 1, neutral
426026934,  PaoloVerri, 4, 1, 3, no
202220813,  SaraBentivegna, 11, 9, 2, yes
708312172619808768,  BlogSocialTv1, 6, 4, 2, yes
343295926,  andreaspinopico, 10, 5, 5, neutral
1433286055,  RaiTre, 28, 13, 15, no
1075099969,  Mordiglia, 3, 1, 2, no
135880913,  Dom_DeSantis, 6, 2, 4, no
317188499,  Leftfordummies, 5, 4, 1, yes
2900503457,  fragrisanti, 41, 29, 12, yes
389920206,  cirobuonajuto, 9, 9, 0, yes
431987028,  ninonot, 29, 24, 5, yes
2409473389,  BisbeticoDom4to, 13, 9, 4, yes
2407099948,  a_cozzolino, 2, 2, 0, yes
741180294343036928,  faustomartinel3, 11, 11, 0, yes
4286750921,  CislPdRo, 9, 9, 0, yes
794957025994215424,  bacioross, 26, 26, 0, yes
4806536835,  M5SAn, 118, 89, 29, yes
783025828326244352,  Acli_e_Caos, 5, 5, 0, yes
1360341044,  maratonhouse, 8, 8, 0, yes
367391294,  salva__tore, 34, 34, 0, yes
435810111,  MaddalenaGissi, 5, 5, 0, yes
771398734588604416,  ernestinapsi, 9, 5, 4, yes
513032518,  gioacchinofeder, 4, 4, 0, yes
587433499,  cesare_proti, 2, 2, 0, yes
747404363027652608,  PippoPinoc, 33, 20, 13, yes
396698099,  FDelB, 27, 24, 3, yes
2336286075,  diricatti, 3, 3, 0, yes
1886228065,  GFeduzi, 88, 66, 22, yes
2490158805,  fox194556, 28, 27, 1, yes
2725144065,  GilbertoNanni, 8, 8, 0, yes
783427641298808832,  gasle54, 34, 20, 14, yes
212706560,  Giopaman, 2, 2, 0, yes
723835861989756928,  SalentoConsult1, 16, 16, 0, yes
411018458,  Nursar70, 33, 30, 3, yes
4182142288,  cadoniantonella, 232, 78, 154, no
2911726889,  er_cometa, 4, 4, 0, yes
2731186360,  lumacadaguardia, 9, 9, 0, yes
2862216426,  Ruz7007Ste, 40, 40, 0, yes
785773375385923584,  dalzottoflorian, 48, 38, 10, yes
779734651984351232,  anemona_paola, 4, 4, 0, yes
3521541201,  andreawo3y, 10, 9, 1, yes
1228335115,  PowerBaldax, 6, 6, 0, yes
2958702779,  pavanriccardo51, 19, 19, 0, yes
480295579,  Renzame67, 6, 4, 2, yes
1274581027,  enzostudio2000, 55, 55, 0, yes
470687559,  BilelloFabrizio, 9, 9, 0, yes
385411925,  andreacalisti2, 2, 2, 0, yes
559988325,  Jumbo2773, 49, 40, 9, yes
792051353921134592,  aldo_padovan, 13, 13, 0, yes
502768582,  cerreto1961, 4, 4, 0, yes
3408660209,  attedolo, 4, 4, 0, yes
151195304,  carminestanizzi, 2, 2, 0, yes
606731466,  gielle30, 17, 14, 3, yes
341500085,  _ferdinandoi, 2, 2, 0, yes
790127568,  Almorange, 2, 2, 0, yes
229758375,  fonzo685, 2, 2, 0, yes
782482968581378049,  PDMAIPIU1, 55, 52, 3, yes
505133357,  Michelerussoing, 2, 2, 0, yes
570925801,  RobertoDattis1, 12, 12, 0, yes
501178012,  Nannini_M, 4, 4, 0, yes
4737081682,  gico53_, 16, 15, 1, yes
864312458,  sauromariotti, 9, 5, 4, yes
478026574,  LaMiki72, 14, 8, 6, yes
3017089606,  angelotedesco63, 3, 3, 0, yes
1066519238,  miccoli_paolo, 4, 4, 0, yes
4351705817,  PastoreCarmen, 15, 9, 6, yes
96863587,  Traglius, 2, 2, 0, yes
493147568,  vincenzofireman, 3, 3, 0, yes
421766004,  Sergio0331, 13, 13, 0, yes
788679345749516289,  robertoblumetti, 2, 2, 0, yes
353031276,  AndreaEmaMadasc, 36, 23, 13, yes
425741057,  funzilogik, 18, 13, 5, yes
1861352574,  SpinelliFs, 3, 3, 0, yes
4289486477,  FimRomaLazio, 2, 2, 0, yes
955568864,  RosannaLaplaca, 8, 7, 1, yes
1681786022,  RosalbaVisone, 7, 7, 0, yes
771439311229186049,  espoannalisa, 106, 53, 53, neutral
1384913983,  antonia_sinisi, 13, 8, 5, yes
3043905536,  cislfpimsv, 12, 12, 0, yes
2907795123,  GianfrancoGasb1, 13, 13, 0, yes
3290975685,  BarcaRino, 20, 20, 0, yes
525586699,  CISLAbruzzoMoli, 3, 3, 0, yes
2496002029,  MNdatv, 3, 3, 0, yes
286821862,  LUCIANO_CISL, 3, 3, 0, yes
2352161865,  salvatoreblanc7, 5, 5, 0, yes
2809553673,  massimoluca63, 2, 2, 0, yes
3108724325,  CislOlbia, 2, 2, 0, yes
501881606,  DeBiaseGiuseppe, 2, 2, 0, yes
2874907796,  MComberiati, 3, 3, 0, yes
1129531465,  AlessandroGeria, 2, 2, 0, yes
94369309,  crisafull, 2, 2, 0, yes
2382604415,  cardill_o, 4, 4, 0, yes
416466936,  olivieripennesi, 7, 7, 0, yes
3317374379,  FirstCislUdine, 3, 3, 0, yes
3345796306,  MircoPupo, 4, 4, 0, yes
1710219649,  iannace_a, 4, 4, 0, yes
2186436367,  Chiaolla, 3, 3, 0, yes
3298098616,  Saurross, 4, 4, 0, yes
418175268,  davipaderi, 3, 3, 0, yes
2774661425,  FimSede, 5, 5, 0, yes
1972687604,  smastrovincenzo, 4, 4, 0, yes
121160830,  cislmarche, 5, 5, 0, yes
3117906651,  PaolaZito2, 6, 6, 0, yes
3218016436,  guagliandre, 4, 4, 0, yes
710765979320623104,  Mariocanale47, 2, 2, 0, yes
425866423,  BarbaraCerutti, 3, 3, 0, yes
89983030,  sandokan968, 3, 2, 1, yes
2886911452,  Tilloca_Matteo, 2, 2, 0, yes
4791885441,  CislTaBr, 9, 8, 1, yes
1566555380,  fibacislbas, 2, 2, 0, yes
1653188624,  CrFiori, 6, 4, 2, yes
3542464695,  andreanardella1, 7, 7, 0, yes
486759593,  mauriziobernava, 11, 10, 1, yes
1280347904,  DellOreficeEnzo, 4, 4, 0, yes
473838944,  FIMCislStampa, 5, 5, 0, yes
1046140855,  Andrea_Done, 10, 7, 3, yes
3815570657,  alfmaz76, 2, 2, 0, yes
1206105060,  FimCislBergamo, 4, 4, 0, yes
4536789317,  FimLombardia, 4, 4, 0, yes
217358294,  cislareametrobo, 2, 2, 0, yes
2315349157,  cislpugbas, 8, 5, 3, yes
4631681177,  GiovaniFimCisl, 5, 5, 0, yes
1246162544,  SanrandaSanto, 6, 6, 0, yes
4143353975,  FitSicilia_cisl, 11, 11, 0, yes
451428588,  antoniodb69, 13, 13, 0, yes
412133707,  DanFrancesconi, 3, 3, 0, yes
2313554308,  fredianoleu, 29, 14, 15, no
4811969481,  castigapolitici, 19, 8, 11, no
485012318,  Frankov74, 13, 2, 11, no
760872623538597889,  KdovejGrazie, 19, 8, 11, no
373942178,  Frall91, 4, 2, 2, neutral
59272021,  bonebag69, 8, 4, 4, neutral
3300431854,  bastaunsiiiiiii, 22, 16, 6, yes
1207662294,  Esticattsi, 4, 2, 2, neutral
3720860206,  Dr_Aus_, 28, 14, 14, neutral
1093512139,  GIORGIO170675, 95, 57, 38, yes
3024921597,  SimoneCaricato, 32, 19, 13, yes
348137712,  AntonioYomo, 27, 22, 5, yes
3466428077,  vonalexandro74, 23, 12, 11, yes
85136516,  sergimagugliani, 299, 65, 234, no
1225509780,  nessunoindietro, 96, 20, 76, no
248339544,  FuryBionda, 12, 3, 9, no
325473654,  RaffaCo54, 50, 21, 29, no
915191390,  paolo_solia, 87, 63, 24, yes
3135173073,  marioOrrico9, 26, 7, 19, no
2418921020,  EnricaFantinell, 147, 110, 37, yes
17154727,  FilippoDeLuca, 2, 1, 1, neutral
3381325839,  Peritas65, 66, 18, 48, no
1319275574,  siceid, 151, 77, 74, yes
3360914247,  PietroGriffino, 2, 1, 1, neutral
2296057788,  SalviOtto, 8, 4, 4, neutral
1488338479,  Orzo83, 91, 10, 81, no
443736469,  EnzoDAmbruoso, 2, 1, 1, neutral
2328923415,  MrLocci, 70, 8, 62, no
522329714,  AriCaldarella, 32, 8, 24, no
22743702,  alejorey, 12, 1, 11, no
1450171,  elnaza, 40, 25, 15, yes
500963329,  annalisaveneto, 6, 3, 3, neutral
988373714,  Mania48Mania53, 128, 71, 57, yes
602125481,  cdaria1, 7, 5, 2, yes
2716739703,  cutolotto, 13, 3, 10, no
4857416872,  lupacchiotto64, 35, 19, 16, yes
585674249,  cettymontemurro, 15, 3, 12, no
128998224,  johnnydsg, 14, 4, 10, no
255448965,  dadoricca, 11, 10, 1, yes
402995375,  Lapid1, 23, 9, 14, no
331136187,  DanieleSpanu, 23, 11, 12, no
8858022,  pvalente, 4, 4, 0, yes
410852015,  dalbi62, 31, 3, 28, no
4187567045,  battaglia_persa, 90, 2, 88, no
478835343,  IoSonoColui, 9, 2, 7, no
513352329,  fabridef, 2, 1, 1, neutral
861332947,  chiccoeri, 5, 1, 4, no
562805089,  Gattina721, 17, 2, 15, no
718185423571390464,  Solo_A_Roma, 35, 4, 31, no
2294163321,  EmanueleApp, 7, 2, 5, no
2227239038,  barbamob, 58, 18, 40, no
867633500,  fraway73, 11, 11, 0, yes
793096447914827776,  LucaOlroby, 12, 7, 5, yes
108528750,  ilteologo, 4, 3, 1, yes
33706512,  EnfantProdige, 7, 5, 2, yes
2494181366,  Giginet8472, 26, 11, 15, no
204041863,  Deepakumara, 28, 13, 15, no
525752406,  49Francesco, 5, 4, 1, yes
105102290,  rominamaro, 3, 3, 0, yes
753896468113678336,  Veronic70902762, 15, 6, 9, no
531137922,  Savj1951, 10, 4, 6, no
1440784603,  DomenicoMazzil5, 2, 1, 1, neutral
1122157453,  dariabianco, 10, 4, 6, no
166976785,  Arcy_McB, 13, 13, 0, yes
938563370,  bruemg, 10, 10, 0, yes
418546477,  dilloamaurizio, 6, 1, 5, no
745709113552867328,  BestiaaitseB, 6, 2, 4, no
426036632,  edoardomaria, 6, 3, 3, neutral
1955153960,  orazio_ramon, 14, 11, 3, yes
541112195,  futurwork, 52, 32, 20, yes
21825227,  nonnoenzo, 24, 20, 4, yes
1331529962,  astrambaci, 6, 0, 6, no
2201369448,  Lukid_23, 21, 11, 10, yes
2532491303,  ToninoR118, 22, 6, 16, no
47880910,  andycnv, 36, 18, 18, neutral
154289060,  giraparole, 9, 9, 0, yes
2385838316,  DOVEEEEEE, 12, 9, 3, yes
766066296618414081,  proudman811, 414, 70, 344, no
2543265306,  bernadettethebe, 8, 4, 4, neutral
1369005530,  GiovanniCalcara, 94, 10, 84, no
1170278395,  1907chepiero, 2, 1, 1, neutral
768399420367011841,  luigi19545, 82, 41, 41, neutral
2873782396,  xsoniadm, 30, 13, 17, no
395969612,  MauraPazzaglia, 2, 2, 0, yes
104275102,  trescogli, 19, 11, 8, yes
735316014,  asenalimo, 20, 18, 2, yes
538529568,  are_dead, 12, 12, 0, yes
419552991,  PedroCastaldell, 5, 4, 1, yes
1143922956,  schiavone2012, 23, 8, 15, no
1042524565,  EPanzini, 2, 2, 0, yes
2353752559,  dersuchende24, 50, 49, 1, yes
580147561,  EMafrolla, 3, 3, 0, yes
544951549,  mancinelliv, 1, 1, 0, yes
409839478,  infocamere, 2, 2, 0, yes
2222783701,  sergioalesi, 52, 24, 28, no
388144170,  mikultra, 13, 7, 6, yes
24428317,  MassiSantini, 1, 1, 0, yes
424355891,  Fiorellissimo, 57, 36, 21, yes
6541352,  maxciociola, 1, 1, 0, yes
2729520336,  SVentidue, 48, 48, 0, yes
4919311773,  PerilliAndea, 1, 1, 0, yes
200434967,  patriziacenti, 3, 3, 0, yes
749137898,  LorenzoTersi, 1, 1, 0, yes
491620674,  lucasamor1, 2, 2, 0, yes
882235051,  MiurSocial, 4, 3, 1, yes
296371084,  ansaeuropa, 20, 17, 3, yes
475678078,  DavideDenti, 10, 7, 3, yes
2853383397,  GuidoniaBigBang, 2, 2, 0, yes
231915122,  recubans, 3, 3, 0, yes
380405533,  Mariettatidei, 5, 5, 0, yes
15375883,  Metascover, 2, 2, 0, yes
3309946937,  To_Arise, 241, 73, 168, no
399568152,  franzbungaro, 4, 4, 0, yes
4871798075,  SimoneGuglielm, 2, 2, 0, yes
2679205663,  rfaoga, 4, 3, 1, yes
412224353,  civistarentus, 1, 1, 0, yes
777664636300718080,  nicocchipinti67, 2, 2, 0, yes
618964794,  mozzo20, 3, 3, 0, yes
300744871,  CSpillmann, 3, 3, 0, yes
261233190,  Cuccbriw, 60, 39, 21, yes
810289994,  tgrregioneuropa, 3, 3, 0, yes
899887304,  Filena7, 33, 29, 4, yes
3438570748,  mptuitter, 10, 8, 2, yes
797197311201972229,  MatteoTieffiani, 197, 165, 32, yes
2362797030,  Rome2017EU, 4, 4, 0, yes
1089498344,  pugliese1962, 3, 3, 0, yes
2319542538,  SenVincenzo, 73, 68, 5, yes
14451153,  dcalabrese75, 8, 8, 0, yes
442064935,  LucioFilipponio, 1, 1, 0, yes
254179369,  massimocali, 7, 7, 0, yes
1465205899,  villacalendasco, 10, 5, 5, neutral
412424802,  marziaminozzi, 24, 21, 3, yes
92940490,  topoeformaggio, 1, 1, 0, yes
334777310,  straneuropa, 2, 1, 1, neutral
2821597763,  la_ciccia, 23, 9, 14, no
3995124705,  AdelaidaDVeen, 42, 19, 23, no
2941989598,  PetrolatiRenato, 24, 12, 12, neutral
2941902833,  Elenasciakky, 9, 4, 5, no
4329077177,  hhesterm, 1, 1, 0, yes
221147459,  Karine_Gautreau, 1, 1, 0, yes
2380531476,  AlePassoni94, 2, 2, 0, yes
34570586,  gaetanoconsorti, 2, 1, 1, neutral
61741831,  fabriziovitali, 7, 4, 3, yes
412371895,  DanteMannarino, 2, 1, 1, neutral
4305328665,  robysantoprete, 4, 4, 0, yes
1177462297,  58_paolo, 7, 7, 0, yes
99686746,  alexproietti, 1, 1, 0, yes
306342758,  BariSeckin, 4, 4, 0, yes
386500959,  EsmaCakirrr, 3, 3, 0, yes
484589440,  GiuseppeGuerin1, 7, 7, 0, yes
21100803,  PES_PSE, 2, 2, 0, yes
785400651878629376,  carmelodipaol, 17, 9, 8, yes
426464556,  CarmineFotia, 7, 4, 3, yes
321939235,  LauraGaravini, 5, 5, 0, yes
429139349,  CanzioDusi, 2, 2, 0, yes
333923672,  Esseciblog, 2, 2, 0, yes
21302947,  PierreKanuty, 1, 1, 0, yes
143536359,  m_giuffrida, 6, 6, 0, yes
522591515,  roderiu, 5, 4, 1, yes
721598010476621824,  Bgrisafi1, 2, 2, 0, yes
44358785,  Echodemondo, 1, 1, 0, yes
560636317,  mlombardo81, 14, 13, 1, yes
2895077031,  shopenauerwho, 169, 83, 86, no
474980381,  ATIOMEGUIM, 7, 7, 0, yes
395990396,  dariabig, 3, 2, 1, yes
356219289,  AldoGiannuli, 4, 2, 2, neutral
251663248,  PatriceinMilano, 83, 58, 25, yes
402894474,  gerrygreco, 3, 2, 1, yes
573977989,  EnricoNicolai1, 99, 87, 12, yes
2393222217,  TramLor, 49, 29, 20, yes
504329686,  ChrFani, 25, 12, 13, no
3144446056,  GiulianaOsti, 38, 19, 19, neutral
1621311559,  speranza_viva, 23, 12, 11, yes
3298528972,  lu_b04, 32, 17, 15, yes
24855530,  andreamarcato, 14, 12, 2, yes
1978729974,  clcaramaschi, 327, 165, 162, yes
561473002,  ntonioGiordano, 262, 130, 132, no
51167606,  GlaucoLora, 14, 6, 8, no
2948429116,  elisabettadovi2, 10, 5, 5, neutral
2703675064,  fragola1957, 67, 32, 35, no
3049826433,  NapolitanoPaul, 6, 3, 3, neutral
700448999610970112,  Robysante93, 7, 4, 3, yes
567159863,  augh_da_angelo, 350, 175, 175, neutral
780806706066395136,  _Referendum_, 12, 3, 9, no
2174144839,  PianiSandra, 20, 10, 10, neutral
2841791595,  WHITE_SHARK1986, 4, 2, 2, neutral
2979050746,  frelich1988, 8, 3, 5, no
432211151,  sevoglioio, 33, 17, 16, yes
1494873888,  robazzaco, 34, 18, 16, yes
106673706,  massimobitonci, 10, 5, 5, neutral
2387902377,  Miky_born2read, 4, 2, 2, neutral
428507062,  tiziboni, 9, 5, 4, yes
3305152361,  Alessia58469603, 12, 6, 6, neutral
158051510,  danileleorsato, 42, 22, 20, yes
69532732,  DavideBoni, 41, 16, 25, no
771387619360043008,  danielaebasta4, 37, 18, 19, no
2597695185,  RcCamera, 21, 10, 11, no
923213636,  Danieladanilla, 12, 6, 6, neutral
96563143,  guscabin, 11, 7, 4, yes
3124079014,  dolcenovembre12, 327, 155, 172, no
1100783203,  fabio70AR, 272, 115, 157, no
1603393657,  matteopredica, 10, 4, 6, no
772074670208221184,  soemiade, 199, 179, 20, yes
790171114278445057,  canetti195, 22, 17, 5, yes
3814697663,  antonancy58, 41, 32, 9, yes
1656227935,  lordfrappo, 2, 2, 0, yes
472061775,  cp75pe, 6, 6, 0, yes
2478544539,  bel_she_ari_, 4, 4, 0, yes
212724190,  VaeVictis, 8, 7, 1, yes
1311236318,  nite3107, 18, 17, 1, yes
250064801,  carloceglia, 13, 12, 1, yes
3394434651,  PBassRW, 5, 4, 1, yes
829358672,  LuisellaSaro, 19, 17, 2, yes
607226144,  MarcoTognini, 17, 9, 8, yes
79211525,  kattolikamente, 14, 9, 5, yes
1328501954,  LionDiscoRoma, 11, 11, 0, yes
379984058,  ninocosta89, 4, 4, 0, yes
140534746,  DGianturco, 4, 2, 2, neutral
27326931,  PaoloRovis, 21, 16, 5, yes
3313238927,  TS__POP, 7, 6, 1, yes
721148434,  fabiopetrocelli, 49, 35, 14, yes
804354408,  TgrRai, 39, 32, 7, yes
14110067,  rampi, 9, 9, 0, yes
2629809153,  TIvoliUnesco, 2, 2, 0, yes
440741372,  GiovanniIaconi2, 4, 4, 0, yes
705414120,  zanoneg, 2, 2, 0, yes
2889852755,  thelondonboys11, 164, 40, 124, no
2937388577,  CelliLuana, 71, 55, 16, yes
4074742552,  barbararozap, 110, 76, 34, yes
3427709602,  VBenetello, 79, 59, 20, yes
4446307913,  Annabel27034387, 106, 36, 70, no
961168160,  liliagiugni, 7, 5, 2, yes
765577612441817088,  Lisa57460820, 13, 9, 4, yes
703619424,  _ayecaptainswan, 5, 4, 1, yes
746943549661450240,  CORINNA07595792, 23, 7, 16, no
795733403006025728,  ixlGamingReal, 2, 2, 0, yes
1336555694,  exploitpisa, 12, 10, 2, yes
1052704188,  SnoqLodi, 7, 7, 0, yes
48682262,  radiosonar_net, 2, 2, 0, yes
470480835,  blueyes_3, 10, 6, 4, yes
422547117,  Didiluce, 3, 3, 0, yes
281613626,  DonneViola, 3, 3, 0, yes
2819754561,  RigilKent9, 18, 15, 3, yes
1329057858,  OCCHIOCHETIVEDO, 3, 2, 1, yes
141181225,  Matildaeditrice, 2, 2, 0, yes
2218411411,  annaros70527446, 32, 16, 16, neutral
779404570808225792,  AquiliaClaudia, 6, 6, 0, yes
324861314,  susiboh, 2, 2, 0, yes
4069821075,  PIERANG60383345, 50, 35, 15, yes
470180296,  Etruria72, 17, 11, 6, yes
776050554418171905,  Vinskr1971, 25, 16, 9, yes
2379017327,  maracip8, 17, 13, 4, yes
1089800894,  ElElbeva, 179, 137, 42, yes
404177172,  pinotom45, 3, 3, 0, yes
2902835315,  BlackroseVanity, 2, 2, 0, yes
712157952430448640,  zacoizitaanna, 2, 2, 0, yes
760935300189356032,  rivamatteoriva, 31, 20, 11, yes
274531908,  sirianni27, 3, 3, 0, yes
766676307967082496,  Musique71, 2, 2, 0, yes
791713072549335040,  paiogiuse, 35, 20, 15, yes
2322290576,  Vigan_Lt, 19, 9, 10, no
3121596654,  antcrisalli24, 4, 4, 0, yes
2994083519,  senodelpoi, 8, 5, 3, yes
534616483,  RipEnzo, 50, 28, 22, yes
183158267,  Bladestarr, 33, 17, 16, yes
794889137845366784,  AntonellaC59, 72, 55, 17, yes
589253599,  RadiantCatalyst, 15, 9, 6, yes
799233061435146241,  Carla79799829, 28, 19, 9, yes
724517094491037696,  MarinellaGadda, 24, 15, 9, yes
2719761311,  giulio_angelis, 32, 15, 17, no
1106167964,  EGrigia, 6, 3, 3, neutral
253714436,  robinit66, 66, 19, 47, no
3028809503,  kategullo75, 161, 87, 74, yes
1318384008,  filllyebbast, 2, 2, 0, yes
3108348141,  Scarfato_Guglie, 5, 5, 0, yes
4010873177,  GIUSEPP80600779, 6, 3, 3, neutral
1353602473,  SAlbarosa, 29, 11, 18, no
1270045470,  InfoCinti, 3, 3, 0, yes
2460104746,  BonoraGabriella, 30, 13, 17, no
456696352,  JacopoZannini, 2, 2, 0, yes
1376724398,  SteOrru, 21, 19, 2, yes
2740710173,  sauroxxxx, 2, 2, 0, yes
226532072,  mbolognetti, 38, 25, 13, yes
774691439435481088,  Spartagladio, 19, 17, 2, yes
572125780,  CryPaolo, 213, 143, 70, yes
22609483,  violaprile, 34, 29, 5, yes
602574015,  kirumakataossi1, 71, 31, 40, no
2901728910,  ArchideVivaio, 81, 40, 41, no
526855898,  noamianto, 2, 2, 0, yes
3309510766,  debbigiancarlo, 38, 11, 27, no
312349466,  GeppoGreco, 2, 2, 0, yes
2530670296,  MAvanta, 35, 19, 16, yes
700841898,  deaperduta, 44, 43, 1, yes
267174899,  mariolavia, 15, 4, 11, no
3188172256,  vanillamarcodi1, 9, 6, 3, yes
56405358,  ilBatti, 32, 19, 13, yes
1849153957,  franca_canzani, 54, 33, 21, yes
110386522,  ltdipietro, 2, 2, 0, yes
2605662403,  maffia_camillo, 6, 6, 0, yes
84046970,  RadicalParty, 2, 2, 0, yes
3388169050,  roccasecca1558, 7, 7, 0, yes
2276659249,  mt2561, 10, 10, 0, yes
67107066,  Bukaniere, 17, 12, 5, yes
2870726057,  alessiasodano5, 2, 2, 0, yes
1047455850,  MFerraglioni, 26, 12, 14, no
82068999,  woodoow, 20, 6, 14, no
3019629387,  BarrioLatino67, 89, 9, 80, no
939067902,  Danvas_, 4, 3, 1, yes
746053497750228993,  Isabell86356282, 18, 11, 7, yes
2203488436,  GAlloero, 32, 15, 17, no
566179919,  faustorenzi, 14, 14, 0, yes
2379935336,  Goeland63, 5, 3, 2, yes
77207264,  cristiana_viola, 69, 59, 10, yes
2332571271,  elisabettap38, 132, 16, 116, no
482969926,  Ermano1Luigi, 16, 9, 7, yes
4414946656,  GianMarinelli86, 93, 57, 36, yes
2783546414,  PDSanFrancisco, 5, 5, 0, yes
391661534,  AGiam, 72, 36, 36, neutral
392566310,  EdithZanoni, 2, 2, 0, yes
77240565,  OneBitterBit, 24, 22, 2, yes
1208853571,  val_lui, 54, 27, 27, neutral
241602781,  marcocarezzano, 16, 12, 4, yes
1011372067,  AAcciaro, 4, 4, 0, yes
3063964024,  Piermari_Basile, 5, 5, 0, yes
986140489,  Urobertu, 14, 11, 3, yes
2730593590,  MarcoFer1975, 36, 21, 15, yes
805286678,  giulianaperris, 15, 15, 0, yes
953895188,  carloazzarone47, 24, 10, 14, no
23301182,  arosasco, 21, 4, 17, no
986673500,  AndreinaG1945, 9, 9, 0, yes
2884254329,  NGMangano, 2, 2, 0, yes
2866161418,  milazzo1987, 3, 3, 0, yes
603304951,  NickMrTre, 11, 9, 2, yes
1495539583,  SurrexitVere, 64, 62, 2, yes
2885630548,  GianpyZeno1, 32, 17, 15, yes
3401862604,  MarillaMarib, 3, 3, 0, yes
3216441514,  volonellaluce, 23, 11, 12, no
56740850,  ilfaber, 5, 3, 2, yes
1292743813,  giacomomonnanni, 6, 6, 0, yes
3291092002,  rocco_ciotti, 4, 4, 0, yes
4078358001,  DakraouiHoussam, 6, 6, 0, yes
1104562232,  giova_martelli, 5, 5, 0, yes
5901232,  bici, 4, 3, 1, yes
1180381488,  LauraLonetti, 3, 3, 0, yes
2251020168,  vincenzocovell3, 12, 12, 0, yes
726108618051997696,  HondaClaudio, 33, 11, 22, no
453531668,  FrankSfarzo, 31, 30, 1, yes
421236822,  isolano1972, 16, 11, 5, yes
445567589,  ermannofaccio, 12, 7, 5, yes
2236568389,  EricaCeola, 13, 13, 0, yes
3152228475,  toscaross, 69, 28, 41, no
1085534767,  IaOranaItalia, 21, 15, 6, yes
3360432215,  AVende22, 9, 9, 0, yes
3264794374,  soniatabacco, 12, 12, 0, yes
2446828928,  gorgaclelia, 6, 6, 0, yes
244654932,  gasterya, 18, 9, 9, neutral
2939010891,  ugoilbrugo, 6, 6, 0, yes
4089359207,  cescongiovanni1, 68, 42, 26, yes
420366735,  monique_ici, 8, 8, 0, yes
1009243501,  marinabrunelli1, 69, 33, 36, no
1328476232,  cattif_49, 12, 11, 1, yes
4743531021,  trxtrx1, 58, 39, 19, yes
2516349323,  francisperrone, 2, 2, 0, yes
2361364791,  LunatiLuciano, 14, 10, 4, yes
418028983,  GiulioTerzi, 14, 12, 2, yes
55568482,  marco69rm, 16, 8, 8, neutral
2440237919,  carmen_piscopo, 43, 14, 29, no
2414500381,  barbara17767819, 43, 18, 25, no
3302069128,  antcampan, 42, 18, 24, no
3328977022,  ninnibera, 10, 6, 4, yes
772120295465443328,  AlbyRazionale, 37, 22, 15, yes
98149280,  ilCandido, 4, 4, 0, yes
2913111359,  contini_rosario, 22, 14, 8, yes
1829960281,  GiorgioMorresi, 528, 156, 372, no
423088643,  IlariaRicciP, 13, 8, 5, yes
972589147,  CarlottaRicchet, 21, 21, 0, yes
719751136,  Giusepp55418771, 3, 3, 0, yes
2768661999,  BaraccoPb, 94, 83, 11, yes
635280499,  romanocaravita, 3, 3, 0, yes
2595985139,  antoniocacciol2, 10, 7, 3, yes
453341089,  Woody64_2012, 25, 23, 2, yes
1880747821,  fiorenzo1972, 50, 25, 25, neutral
198981234,  Poppians, 22, 10, 12, no
2279477919,  effemme1957, 25, 5, 20, no
51522357,  RaffyB_68, 89, 17, 72, no
2832335447,  dukana2, 35, 15, 20, no
253093345,  antonellopili, 2, 2, 0, yes
3387594292,  jmrhockey93, 13, 4, 9, no
766901213371793408,  laura_quaglia1, 30, 21, 9, yes
3305477253,  MorettiFabio3, 35, 21, 14, yes
3303278242,  CasoliEnza, 11, 5, 6, no
327455219,  emanuelefiano, 13, 6, 7, no
1286324820,  Elibet_Ape, 19, 10, 9, yes
409821771,  vitoballarino, 9, 9, 0, yes
364452450,  Lorenza_Morello, 67, 63, 4, yes
2997572434,  michela_desanti, 7, 7, 0, yes
467573735,  francetomm, 64, 21, 43, no
324262863,  demmy747, 356, 27, 329, no
1016682894,  ELodolini, 19, 19, 0, yes
481929883,  GiangioTheGlide, 134, 12, 122, no
2559910725,  AntoTavolieri, 30, 8, 22, no
50588947,  NeriTorrigiani, 14, 10, 4, yes
735888541079732225,  BurimZairi, 24, 7, 17, no
762983877849800704,  GabriellaMargh2, 25, 4, 21, no
396756630,  gstelluti, 417, 75, 342, no
321469139,  fmeringolo, 18, 17, 1, yes
77889072,  ScipioMSC, 10, 10, 0, yes
804449929,  antoniolecce72, 4, 4, 0, yes
390775547,  primianino, 8, 8, 0, yes
70054648,  SanremoAncheNoi, 4, 3, 1, yes
21419159,  argiovan, 4, 4, 0, yes
333498140,  Dottor_Strange, 29, 9, 20, no
821879334,  ottimistasemper, 49, 27, 22, yes
2306414611,  ferne1908, 5, 2, 3, no
495011205,  nozze89, 60, 54, 6, yes
94529815,  Mauronick, 125, 102, 23, yes
100610543,  lucatelese, 7, 5, 2, yes
2984721340,  IUParioli, 2, 2, 0, yes
3064945486,  punkpopkorn, 35, 19, 16, yes
2207285738,  Peppone1955, 8, 5, 3, yes
3664503135,  beppe14788251, 14, 6, 8, no
707302113093799936,  IndagatoPd, 18, 18, 0, yes
697447492112269312,  NomeNel, 28, 28, 0, yes
772766178313904129,  PiddinoInfame, 9, 9, 0, yes
1070289462,  bezzoneclaudio, 17, 14, 3, yes
3254009057,  10_cosimo, 11, 5, 6, no
4186758514,  marcopietro49, 103, 42, 61, no
1225691011,  valteroma, 13, 7, 6, yes
588543892,  CAPOLONGOPIETR1, 5, 2, 3, no
2165464137,  Przmra, 12, 4, 8, no
858517812,  ernesto_piro, 15, 7, 8, no
3217393599,  lorenacelano61, 54, 21, 33, no
3341844040,  jonni69321, 7, 6, 1, yes
2341083257,  battistabd, 147, 50, 97, no
2847348915,  AP_Zone, 18, 12, 6, yes
1701836234,  cotrozzi_lisa, 30, 16, 14, yes
3014521558,  GsSeidita, 19, 4, 15, no
16401526,  SergioLoGiudice, 6, 6, 0, yes
4024081156,  ConDiprospero, 15, 5, 10, no
535318339,  EnrichettaNegri, 41, 10, 31, no
923347921,  RussoRosa7, 452, 419, 33, yes
215735286,  ilconteamar, 66, 31, 35, no
281239582,  italia_franco, 3, 3, 0, yes
1121521046,  PPIHAD, 9, 8, 1, yes
460611317,  kickmyballs222, 78, 16, 62, no
355608779,  karlkarkar, 25, 13, 12, yes
403430248,  DDeliolanes, 20, 12, 8, yes
744832700633255936,  noidiciamono, 2, 2, 0, yes
762284905145438210,  POAxSI, 23, 23, 0, yes
4203607113,  FioriAndreetta, 21, 15, 6, yes
716353562020855810,  Andrea_D74, 34, 16, 18, no
2438043317,  mikeorsetto, 6, 6, 0, yes
889235600,  AllegraSalvador, 16, 16, 0, yes
1067008310,  Vale339Vale, 13, 9, 4, yes
1429966902,  dirittofrontier, 9, 5, 4, yes
2472761502,  jackpol7, 4, 4, 0, yes
73380336,  lauruzi, 157, 145, 12, yes
734083116919365632,  marioaf18, 15, 4, 11, no
788124436406923264,  bot_tav, 25, 5, 20, no
2994986278,  lucabenvet70, 5, 3, 2, yes
437635996,  gioporce, 31, 15, 16, no
626845548,  novellarese, 20, 14, 6, yes
714382420,  CarmelaEmma, 183, 78, 105, no
1355024335,  SampieriValdis, 8, 3, 5, no
788829890,  francannalire, 2, 2, 0, yes
320874837,  Mauro_Cattaneo_, 2, 2, 0, yes
1591737049,  AMARANTINE5, 43, 27, 16, yes
42113491,  paolo_cova, 4, 4, 0, yes
470889853,  nnsocmmichiamo, 12, 7, 5, yes
563894209,  riccimeri, 10, 10, 0, yes
1929877436,  BBertaberry, 45, 22, 23, no
1063034107,  MauraNerva, 27, 15, 12, yes
319116894,  francocrepaldi1, 27, 18, 9, yes
499633425,  NonUnodiMeno, 16, 6, 10, no
506544504,  CantoroEmanuele, 15, 15, 0, yes
777145679181471744,  NicolaNbalestra, 28, 26, 2, yes
244734060,  uNrvus, 18, 15, 3, yes
623760226,  luanavirgili, 2, 2, 0, yes
570833587,  pancraziovaleri, 135, 44, 91, no
3025536011,  BKatiabucci, 5, 5, 0, yes
2465901637,  simonettasc, 11, 8, 3, yes
1219456740,  Lsp74Simone, 19, 15, 4, yes
799300362930974721,  pvalentini22, 32, 27, 5, yes
2990106417,  mauroleli1, 8, 8, 0, yes
801168992622837760,  Mihaela17666362, 3, 3, 0, yes
856476714,  GiovanniSestit1, 8, 8, 0, yes
2811414913,  kit960, 24, 15, 9, yes
820435746,  dilettina19, 2, 2, 0, yes
423799588,  AssuntaTorsello, 12, 9, 3, yes
448402028,  cinziaspoletini, 20, 17, 3, yes
602340681,  bumble2505, 5, 5, 0, yes
325127006,  marilamb2011, 40, 21, 19, yes
3524549843,  TizianaBolzoni, 21, 9, 12, no
128880613,  giannipieve55, 13, 12, 1, yes
420905398,  sax0lino, 25, 18, 7, yes
516918398,  ARosanio, 29, 9, 20, no
1257959892,  gianluca_prato, 5, 4, 1, yes
340847319,  etchisei, 85, 41, 44, no
2447574735,  366daniele, 151, 50, 101, no
93453242,  apacchia, 9, 9, 0, yes
600136789,  GhitaIacono, 158, 22, 136, no
1843782967,  edocogoo, 56, 2, 54, no
414319027,  luiginotedesco, 14, 2, 12, no
1332423037,  Diamarionino, 3, 3, 0, yes
365089731,  FedericoQuadrel, 8, 8, 0, yes
2325858085,  PD_Berlino, 7, 7, 0, yes
22958706,  uomopanda, 2, 2, 0, yes
3225190005,  EEnricoielasi, 139, 39, 100, no
534732052,  SergCami, 22, 21, 1, yes
68362418,  krigepa, 26, 16, 10, yes
2231871937,  Karly_It, 30, 23, 7, yes
2239534579,  ClicLinkMiche, 5, 5, 0, yes
1318358461,  isabellasida, 11, 11, 0, yes
4617627196,  giulianobernar7, 8, 3, 5, no
2772829228,  matteoc1951, 70, 28, 42, no
454942463,  ireneleone1, 9, 5, 4, yes
29173778,  ForzaInter, 11, 10, 1, yes
875125242,  pacianarosina, 10, 8, 2, yes
799219281451958272,  Serenel73, 133, 37, 96, no
2819178244,  Pombo54, 44, 22, 22, neutral
2850871143,  nicomanetta1, 36, 20, 16, yes
301171038,  Talete1, 4, 3, 1, yes
767250170488688640,  Nicolet67982301, 78, 63, 15, yes
2391603191,  maxwolf63, 15, 11, 4, yes
774806549357355008,  DartNose, 2, 2, 0, yes
435213350,  AvanzaSilvia, 16, 15, 1, yes
85610558,  Siroblue, 4, 2, 2, neutral
1179711277,  Grace_1207, 46, 37, 9, yes
885661050,  FrancescoCarr11, 48, 5, 43, no
732206617341595650,  basilicatasi, 151, 150, 1, yes
3043362960,  BriataStefania, 520, 263, 257, yes
3121853856,  gm_digiuda, 11, 10, 1, yes
1875161478,  Luigi_GVL, 6, 6, 0, yes
1488305112,  arosamor, 5, 4, 1, yes
2259459451,  effebore, 67, 16, 51, no
3939491242,  freeuniversityR, 3, 3, 0, yes
9476072,  MassimoPreziuso, 16, 16, 0, yes
1961048316,  Lucaducabob, 2, 2, 0, yes
3342727865,  stylesxthings, 5, 4, 1, yes
2220903223,  Antichrista89, 4, 2, 2, neutral
385651457,  GuerraDino, 18, 10, 8, yes
3601606947,  LuisellaLuis, 40, 25, 15, yes
1101963793,  uolller, 113, 57, 56, yes
1699665619,  incoronatacap, 46, 19, 27, no
1100350039,  fabiomorelli75, 74, 13, 61, no
4133217027,  ilpellicano88, 208, 6, 202, no
420626048,  cesaridan, 5, 3, 2, yes
146802560,  Debe_n, 2, 2, 0, yes
296923133,  GiacomoManini, 2, 2, 0, yes
251407688,  giusev76, 22, 15, 7, yes
586917844,  PietroPav, 2, 2, 0, yes
40242521,  freud_77, 5, 3, 2, yes
70364552,  aprimondo, 10, 8, 2, yes
309347048,  Valer10ASR83, 19, 8, 11, no
751978328,  alepinzan, 5, 5, 0, yes
4642395077,  Paolo050978, 6, 6, 0, yes
738260368364056576,  occhioacosadici, 3, 3, 0, yes
361722068,  erasfb4, 25, 23, 2, yes
1128760278,  CovelloStefania, 19, 19, 0, yes
2331609421,  cesco1944, 39, 24, 15, yes
291692348,  armandoscalia, 7, 5, 2, yes
764195579081752576,  TeTeo81, 36, 35, 1, yes
2767985158,  PsiCaloveto, 5, 5, 0, yes
2847984473,  FranzCaruso59, 4, 4, 0, yes
208518075,  pennadoca, 10, 5, 5, neutral
4192397553,  gianmarioli, 3, 3, 0, yes
726166828028989441,  MileniAlfonso, 4, 4, 0, yes
752969999518670856,  Laurascuola83, 10, 5, 5, neutral
4881267029,  giod_arco, 117, 82, 35, yes
366332600,  Pavi93Antonio, 26, 21, 5, yes
751772149606744068,  Prof_Sheldon_, 9, 5, 4, yes
782677432964788224,  lorisvox, 3, 3, 0, yes
2594801938,  valecpu, 2, 2, 0, yes
747963714,  _Antonio_Maria_, 13, 7, 6, yes
3982211543,  LorenzaPall, 16, 13, 3, yes
288718876,  adamoprogresso, 58, 52, 6, yes
2987972555,  50809e70fc29437, 20, 15, 5, yes
2986211373,  PDshitwork, 14, 11, 3, yes
428184160,  TeresaSicoli, 5, 2, 3, no
786864752953790464,  MarinellaSix, 2, 2, 0, yes
2262040708,  archmeo, 12, 6, 6, neutral
2717902222,  fulvia_fv, 76, 32, 44, no
715525255972917249,  Incazz_ato, 17, 7, 10, no
739177143574364160,  ilsorteggione, 3, 3, 0, yes
736491984081281024,  azzurra2016, 10, 3, 7, no
305255857,  Rosyfree74, 76, 41, 35, yes
3359722569,  Stefaniadambra1, 9, 3, 6, no
493011238,  mariSadurny, 7, 5, 2, yes
863028571,  diegovlifonti, 16, 16, 0, yes
440756482,  SignorAldo, 12, 11, 1, yes
421048683,  rosangeladiza, 2, 2, 0, yes
245053650,  mklfbrz000, 4, 2, 2, neutral
440265526,  VSerpentino, 2, 2, 0, yes
2341209893,  CiosiSuprbike, 11, 8, 3, yes
2802841287,  sandrafurnari3, 7, 6, 1, yes
826996970,  fattisettimanal, 9, 6, 3, yes
81240147,  gioFALEG, 7, 7, 0, yes
841735190,  MGmarcoGM, 16, 16, 0, yes
481225656,  paolotjti, 43, 36, 7, yes
574185238,  Thush264, 64, 42, 22, yes
611553781,  AndreaB4rt, 5, 5, 0, yes
4549627264,  __maistovladi, 2, 2, 0, yes
524745118,  Al_Be_to, 13, 2, 11, no
266700017,  SaP011, 179, 32, 147, no
464881732,  mgcorrias, 10, 9, 1, yes
609278295,  chrispasq72, 2, 2, 0, yes
795749937157931009,  MarinaAlloggio, 20, 15, 5, yes
759365241667026944,  CadelboscoSi, 2, 2, 0, yes
2155070496,  MirkoMartinez91, 101, 8, 93, no
82351989,  gio_firry, 2, 2, 0, yes
297903655,  delPecora, 16, 7, 9, no
243993181,  Pandora_laperla, 4, 4, 0, yes
4048644567,  giustiziera2, 26, 13, 13, neutral
1037427926,  LinoMantero, 4, 2, 2, neutral
2565072187,  cedronepalmira5, 14, 7, 7, neutral
283107590,  rocselli, 24, 16, 8, yes
2982251703,  GennaroIl, 7, 4, 3, yes
898298473,  GarsiMarianna, 18, 13, 5, yes
2247784613,  modica63, 2, 2, 0, yes
3303096424,  laura93112231, 3, 3, 0, yes
3898463973,  mazthetelling, 2, 2, 0, yes
1346676926,  ginopupi2, 23, 19, 4, yes
4243675906,  marinellafly12, 115, 6, 109, no
391291922,  b_soncini, 5, 5, 0, yes
2219899278,  noallaviolenza2, 30, 24, 6, yes
98135433,  fagottino, 13, 11, 2, yes
1069605998,  katmanduk2000, 12, 4, 8, no
1306369771,  FaenzaStefano, 29, 11, 18, no
538359759,  andreafurgiuele, 3, 2, 1, yes
719959127846449154,  xMyhusbandLukex, 3, 3, 0, yes
9808092,  sparkgap, 39, 16, 23, no
126462116,  DeePal072, 7, 6, 1, yes
402803669,  Fra_Lancellotti, 17, 3, 14, no
1275673248,  FrancFortuzzi, 2, 2, 0, yes
188043254,  jabbaTM, 27, 16, 11, yes
113613468,  alioscia_pirata, 3, 3, 0, yes
1322863322,  CommuniaRoma, 5, 5, 0, yes
1394356609,  Ely_Vally, 5, 5, 0, yes
3332411590,  ivanbazzucchi1, 124, 10, 114, no
4188671596,  Marco_Zum, 108, 42, 66, no
578467058,  AnnalisaSally, 2, 2, 0, yes
703889823090806785,  GiggiFrat, 6, 6, 0, yes
2271564014,  tueetterin, 15, 5, 10, no
1468203008,  uomoperverso, 4, 4, 0, yes
521164308,  AlessandraZadro, 3, 3, 0, yes
1084360147,  dartagnampolo, 20, 6, 14, no
3973104981,  Fe_de_ri_co_, 11, 10, 1, yes
758028983208468480,  LuigiBuccino2, 9, 5, 4, yes
1000153962,  MartaDavanzo2, 3, 3, 0, yes
15073292,  badicea, 12, 6, 6, neutral
236642820,  Zero81Na, 8, 7, 1, yes
255708244,  ugoichi, 7, 6, 1, yes
745988095825293313,  codicedarwin, 7, 4, 3, yes
191737043,  geoguida, 2, 2, 0, yes
2980771604,  ninconanco62, 3, 3, 0, yes
2366461149,  benaest, 6, 4, 2, yes
1035456523,  Valish_J, 3, 3, 0, yes
291757240,  diegobertin86, 3, 3, 0, yes
3326316339,  ecortomaltese, 36, 9, 27, no
302708364,  meobirba, 8, 6, 2, yes
442717300,  Carus89, 2, 2, 0, yes
896111983,  FaberCova, 6, 6, 0, yes
87964051,  danielapreziosi, 6, 6, 0, yes
3843282933,  Marius81287749, 21, 11, 10, yes
982628515,  salvodimartino6, 60, 34, 26, yes
60582224,  FrancoAgliata, 6, 6, 0, yes
2376999356,  FabrizioRira, 150, 22, 128, no
174615207,  fumardac, 6, 5, 1, yes
3816198827,  1973_luigi, 24, 21, 3, yes
1433806334,  ben_aio, 82, 16, 66, no
442950090,  Norrsken87, 56, 13, 43, no
566540382,  CivaRoma, 108, 7, 101, no
579760787,  straordikikko, 2, 2, 0, yes
3044947366,  nicocalle661, 15, 8, 7, yes
357621458,  marcoiarussi, 7, 7, 0, yes
464516274,  frank9you, 22, 18, 4, yes
4777957102,  helipylori, 36, 20, 16, yes
892954382,  Penelopy2000, 62, 36, 26, yes
422340734,  AnnaxNar, 81, 24, 57, no
486787100,  sorso73, 39, 8, 31, no
1229478864,  autoctoNO_it, 16, 8, 8, neutral
558032072,  sevenseasmarina, 67, 43, 24, yes
925596565,  galopetendido, 2, 2, 0, yes
725949864,  IlariaBifarini, 11, 10, 1, yes
254969508,  corvonero75, 42, 28, 14, yes
3458047347,  FrancMolica, 28, 7, 21, no
1314132968,  Renato47Rm, 56, 19, 37, no
552738376,  MicheRo15, 6, 6, 0, yes
432482501,  Grgre83_1, 4, 4, 0, yes
2534513566,  maryy_red, 129, 92, 37, yes
4121288038,  violaaa1981, 5, 2, 3, no
2244512143,  Frugis72, 4, 4, 0, yes
3764059997,  GualcoGabriella, 30, 6, 24, no
2237489719,  andrealandi63, 2, 2, 0, yes
2665893564,  licherigius, 2, 2, 0, yes
463347621,  ZampieriChiara, 57, 37, 20, yes
398032197,  AnnaMariaCastel, 49, 28, 21, yes
537540867,  GiuseppeColaci1, 5, 5, 0, yes
745014260087070720,  EdinburghWatch, 3, 3, 0, yes
2769312723,  GattiMaurizio59, 2, 2, 0, yes
410271241,  Biarend, 4, 4, 0, yes
442887020,  marty_dintrono, 7, 4, 3, yes
426064773,  sarettaa7, 41, 25, 16, yes
452985926,  iLGae75, 60, 24, 36, no
1077627415,  ironmiki, 40, 25, 15, yes
3068966572,  rossanarossana4, 112, 79, 33, yes
2784216706,  EffeF61, 143, 93, 50, yes
706123199415754752,  adoantea, 2, 2, 0, yes
89164664,  baronebianco, 6, 4, 2, yes
498308599,  AgoArmy, 10, 9, 1, yes
484047462,  zerotto08, 4, 4, 0, yes
2184417408,  antoniorampinel, 3, 3, 0, yes
4603127836,  denber1974, 45, 27, 18, yes
721718300,  alebertz82, 7, 7, 0, yes
3417233499,  fabri_61, 112, 64, 48, yes
418837513,  Valeriavale51, 27, 18, 9, yes
1031879690,  marioromanu, 6, 3, 3, neutral
404107697,  gioverduci, 2, 2, 0, yes
2259346508,  simona_campo, 44, 43, 1, yes
350812368,  CuboniAle, 2, 2, 0, yes
345488835,  DanilaScurria, 66, 17, 49, no
754691314176892929,  sara_babette_, 41, 39, 2, yes
515467579,  lorenzaiello, 4, 3, 1, yes
770283244751388677,  family4children, 7, 7, 0, yes
2663566529,  ALMCalabria, 3, 3, 0, yes
1064087622,  fabioselini, 10, 10, 0, yes
3007418795,  Heartdrizzling, 21, 11, 10, yes
1397374658,  pagliaro62, 19, 10, 9, yes
1171486081,  moderf47, 44, 20, 24, no
1307698028,  zappste, 61, 58, 3, yes
1117639170,  lifesdream1, 5, 3, 2, yes
67746303,  masuccio67, 30, 14, 16, no
700939605521145856,  liliana14229842, 35, 12, 23, no
1037995544,  ConzoSavino, 35, 21, 14, yes
4914915772,  SegnalazioniSS, 28, 11, 17, no
401701859,  ErikaGamberale, 4, 4, 0, yes
384003817,  elluas, 4, 4, 0, yes
1602815845,  valfed09, 9, 6, 3, yes
567278450,  oznerol4, 23, 7, 16, no
1170295874,  MementoFabiano, 9, 6, 3, yes
106738070,  ilburch, 5, 4, 1, yes
69325472,  FPetrelli, 26, 9, 17, no
2390043691,  fabiobrunoen, 21, 6, 15, no
1275988495,  AlvarDflake, 34, 30, 4, yes
140149955,  NinoMascia, 5, 4, 1, yes
2777724153,  0687a7f23bb34d4, 15, 9, 6, yes
261621525,  imarkez, 6, 5, 1, yes
1159945879,  andrea_mazzella, 8, 7, 1, yes
40985455,  lascherillo, 36, 30, 6, yes
485582381,  alfonsoleone1, 8, 8, 0, yes
2400285224,  Iris6354, 22, 11, 11, neutral
2310543444,  ciranapoletano, 34, 34, 0, yes
948171079,  Stephnoia, 8, 8, 0, yes
781169072604151809,  crisimeone, 12, 6, 6, neutral
370588169,  vocidelmattino, 8, 6, 2, yes
118468984,  elicriso2, 2, 2, 0, yes
1420759189,  lanciamoreno, 28, 26, 2, yes
3023038268,  kleliacer, 4, 4, 0, yes
1230361375,  AlbinoMalfara, 133, 113, 20, yes
1857528240,  Inmezzora_Rai3, 33, 3, 30, no
1372922408,  belfast2609, 3, 1, 2, no
1867361222,  BartNicolotti, 17, 6, 11, no
773161248099803137,  Sirena_bionda, 31, 18, 13, yes
1111297184,  Newsinunclick, 61, 21, 40, no
1063780303,  feelmads, 7, 7, 0, yes
723922930304995330,  sosserio, 7, 7, 0, yes
2584048844,  domenicovisagg2, 3, 3, 0, yes
306633266,  gracerolla, 6, 3, 3, neutral
396697870,  pvergari, 7, 6, 1, yes
2230346403,  gimo1955, 52, 46, 6, yes
398569269,  robertozolli, 6, 6, 0, yes
737280573383806976,  ofnocera, 3, 3, 0, yes
3355048384,  mzc82rm, 7, 4, 3, yes
544245306,  Marco_Nicodemi, 4, 4, 0, yes
2761079639,  barbara_nando, 18, 16, 2, yes
2981114476,  2dfce3b5d3d9428, 7, 4, 3, yes
534538273,  AngeloRosanio, 3, 3, 0, yes
2464828514,  lievemente, 111, 37, 74, no
3663181830,  RocLon2, 43, 24, 19, yes
258743828,  mimmo1012, 3, 3, 0, yes
337185218,  CarloMontanari, 62, 44, 18, yes
434279064,  ELiberati, 21, 21, 0, yes
1410209468,  babi_lolita, 251, 160, 91, yes
1116938592,  RiccardoRoscill, 9, 7, 2, yes
2640275823,  MauriZucchi, 10, 10, 0, yes
2316301654,  Massimo9456, 16, 7, 9, no
886811412,  MariaLiviaPaltr, 10, 9, 1, yes
623813447,  luigiderosa17, 5, 4, 1, yes
1468326630,  Praguebynight79, 16, 12, 4, yes
420538185,  Francocerbo, 10, 8, 2, yes
471232887,  Arik27Giovanni, 18, 9, 9, neutral
1092735302,  MinSviluppo, 2, 2, 0, yes
472130584,  Gentiluomo54, 37, 24, 13, yes
494239795,  PasqualeADP10B, 18, 16, 2, yes
431862853,  algiordans, 14, 10, 4, yes
788386859072249856,  andrealeo80, 8, 4, 4, neutral
414184489,  Mi_consento, 19, 11, 8, yes
110091649,  salclem2, 3, 2, 1, yes
2240836459,  giorgagliano, 6, 5, 1, yes
2540030877,  mauriziolosavio, 33, 28, 5, yes
571133532,  wertjb, 35, 19, 16, yes
150725695,  Agenzia_Ansa, 42, 30, 12, yes
493278355,  pietromancini52, 29, 20, 9, yes
558066518,  MrkPirola, 7, 6, 1, yes
98212565,  fedeilrossi, 14, 10, 4, yes
298123237,  FabioClerici, 150, 50, 100, no
1080490561,  mariagraziacal2, 44, 44, 0, yes
4651751608,  laurapetrillo3, 125, 125, 0, yes
750646010314104832,  TizianaRug, 54, 54, 0, yes
4703595042,  decicco_carmen, 61, 61, 0, yes
4701854126,  AngelaFoti9, 154, 152, 2, yes
418778432,  incrollabile, 10, 3, 7, no
17649765,  Gcesare, 9, 3, 6, no
612793180,  nucciogatto, 11, 8, 3, yes
543546376,  orabastaa, 11, 8, 3, yes
857119807,  carneluttiV, 2, 1, 1, neutral
4877601425,  marioricciard18, 24, 20, 4, yes
420627699,  fabriziobarca, 66, 63, 3, yes
295592416,  LilGrasso, 11, 9, 2, yes
1381974631,  ondadimare004, 12, 9, 3, yes
3043907500,  depaolis_t, 5, 3, 2, yes
442005205,  LucianoDavite, 32, 8, 24, no
744659342738210816,  muntzer_thomas, 5, 3, 2, yes
408670406,  MatteoDalvit, 6, 4, 2, yes
134232431,  pietrolatino, 8, 7, 1, yes
48473114,  AlleBraglia, 2, 1, 1, neutral
497382096,  seaborn3, 8, 8, 0, yes
4547668037,  bertausen, 22, 22, 0, yes
471328170,  gpsalandin, 58, 34, 24, yes
210376076,  spe1977, 27, 18, 9, yes
3318877703,  katrinyanuo, 27, 18, 9, yes
4824399766,  luigidibattist2, 19, 10, 9, yes
1120077589,  GiampaoloGalli, 22, 18, 4, yes
723203630917136384,  GraziaGio1, 211, 96, 115, no
325739333,  gasalmi, 40, 13, 27, no
2652696807,  AgnelliPom, 22, 5, 17, no
2610299144,  NetracerRob, 18, 10, 8, yes
1555826826,  rcolucci58, 13, 6, 7, no
4773242133,  CisasCampania, 19, 4, 15, no
822164642,  dapigat, 16, 13, 3, yes
1148946079,  dariodav711, 10, 9, 1, yes
708028845950169093,  azionenazional1, 20, 12, 8, yes
68421930,  corriereveneto, 13, 8, 5, yes
557229572,  francor71282755, 18, 12, 6, yes
2435638248,  sandropasotti, 7, 7, 0, yes
1276033099,  fabio_cattani, 12, 7, 5, yes
802176344515866624,  Santo_CIEL, 147, 109, 38, yes
735221863,  GuidoAllegrezza, 17, 9, 8, yes
1493589848,  cettiqualunque, 19, 2, 17, no
3247960643,  giornalecomuni, 10, 9, 1, yes
250774432,  angeloally, 122, 59, 63, no
744818179172536320,  P_Gonsalvus, 6, 4, 2, yes
258755575,  delromano, 46, 35, 11, yes
298508176,  GCaperna, 2, 2, 0, yes
2882526197,  RadioCusano, 121, 69, 52, yes
24398244,  GPS_SPINATO, 2, 2, 0, yes
319735845,  globalistIT, 3, 2, 1, yes
828717014,  TgLa7, 42, 28, 14, yes
4810630096,  ilcorvo20, 15, 8, 7, yes
21771426,  andreafin8, 2, 2, 0, yes
181712865,  maxfalduto, 2, 2, 0, yes
249167257,  Vito_Troiano, 18, 10, 8, yes
908199462,  smith44m, 6, 6, 0, yes
2594867485,  donnadeipegni, 73, 18, 55, no
2511962844,  Antonel87691591, 152, 24, 128, no
418671782,  GiorgioLourier, 2, 1, 1, neutral
459584150,  robesPR1, 30, 22, 8, yes
1380421874,  cesareaugustoca, 46, 34, 12, yes
753570089094504448,  Guthrie693, 72, 45, 27, yes
3029167981,  giovannilorell1, 7, 5, 2, yes
786132636473319424,  ciIO7GnP9fIAYXc, 12, 12, 0, yes
782874183365779456,  alexandermarchi, 20, 20, 0, yes
794495973124874240,  dacciedoardo, 27, 27, 0, yes
2572430290,  LanzettaMarco, 13, 8, 5, yes
1299375126,  LucaCapra67, 67, 56, 11, yes
906331746,  ronaldinarina, 27, 24, 3, yes
798182778772852736,  giordanadonate2, 7, 6, 1, yes
434752212,  Vandauga, 67, 19, 48, no
164371866,  indiabrazil, 20, 20, 0, yes
1262007300,  TaibiMichela, 34, 32, 2, yes
712668381,  marinoaop, 17, 12, 5, yes
1158164456,  MG462gm, 311, 149, 162, no
3153959603,  Silvana25762928, 6, 6, 0, yes
3393861599,  ipasvibo, 4, 4, 0, yes
429700379,  Ienapiangens, 45, 43, 2, yes
20128307,  holyghostpro, 6, 2, 4, no
2540910636,  AndreaGnarluz, 7, 3, 4, no
2318477410,  Ephedra06Edmond, 4, 3, 1, yes
448045395,  trecy369875412, 15, 6, 9, no
795555849892691968,  gianAnt48908531, 13, 5, 8, no
439389927,  Magicaci, 11, 5, 6, no
754226905864400896,  grazianoloreni1, 6, 3, 3, neutral
2453297123,  danielabongior3, 15, 5, 10, no
2226318312,  M_Convertino, 13, 11, 2, yes
161414985,  SorrentinoEnzo, 10, 7, 3, yes
438495557,  JamesFilingo, 4, 4, 0, yes
891432866,  d73_alex, 12, 3, 9, no
466397112,  paolagargiulo1, 4, 4, 0, yes
1080507391,  DeivFur, 40, 16, 24, no
943572877,  carmelocarat, 41, 40, 1, yes
122744687,  federicogironi, 6, 3, 3, neutral
2324947372,  OttoMa5, 12, 8, 4, yes
701647912686764032,  1972dpi, 31, 10, 21, no
91843058,  manuelaintini, 14, 3, 11, no
54225347,  SaraPri, 20, 17, 3, yes
374763214,  micde58, 12, 12, 0, yes
1013911981,  MeriLolini, 4, 3, 1, yes
3937406775,  VIOLAMARTELLA46, 158, 16, 142, no
418531608,  EneaMelandri, 29, 22, 7, yes
1174274426,  darioesposito26, 71, 17, 54, no
2267787658,  PFrascari, 33, 28, 5, yes
970705082,  Ste_Bussolino, 82, 39, 43, no
2891879657,  coppini_jacopo, 5, 2, 3, no
1057565262,  liberalepenso, 32, 26, 6, yes
2238062646,  sergiubosco, 14, 13, 1, yes
422220675,  carloantobiondo, 4, 3, 1, yes
3291056647,  archam_asylum, 4, 2, 2, neutral
711299618219364354,  Peressita, 484, 18, 466, no
203005397,  Jacob2187, 344, 29, 315, no
797136442774450176,  andros2102, 305, 29, 276, no
4204326923,  AnnaMar55954470, 328, 19, 309, no
2651374166,  ScifoGiuseppe, 104, 27, 77, no
198959588,  Saelvig, 5, 5, 0, yes
710743506520829953,  libersocialdemo, 19, 19, 0, yes
763388821677469696,  prof_sen, 89, 53, 36, yes
210787486,  manig0ldo, 12, 10, 2, yes
562901844,  PinatSixtyNine, 17, 9, 8, yes
131768380,  Davidech61, 12, 11, 1, yes
846309564,  Daniela80150049, 27, 27, 0, yes
768141271701528576,  DavideGirotto1, 1, 1, 0, yes
423280813,  AmbrogioTattolo, 41, 40, 1, yes
2309477786,  Giuint, 3, 3, 0, yes
354210769,  gciprotti, 4, 1, 3, no
1157646044,  goldinwanda, 7, 7, 0, yes
4843412021,  OnestoGiudice, 10, 8, 2, yes
763355777750929408,  fa_beach, 2, 2, 0, yes
4898462849,  ClaudiandCo, 1, 1, 0, yes
537182749,  SILVANAMAZZ, 11, 11, 0, yes
2291180310,  cesaredalessand, 4, 4, 0, yes
703695640782618624,  rampo57, 8, 8, 0, yes
786244023837155328,  enza_venturelli, 10, 4, 6, no
801829953578921984,  SalvatoreMalla5, 2, 2, 0, yes
2648038336,  Pasquino70, 37, 10, 27, no
997752828,  domenicoragnate, 2, 2, 0, yes
4173459970,  MatareseMatteo, 13, 13, 0, yes
54956018,  Tuttogasss, 1, 1, 0, yes
4151528837,  pupillo79, 11, 10, 1, yes
777522958659100673,  RLorgna, 7, 4, 3, yes
1401604591,  wolfbywolf, 8, 3, 5, no
779265942165544960,  RogerGoldKnight, 21, 13, 8, yes
735185380924874752,  Tiziano29232920, 4, 4, 0, yes
215090695,  AlfredoSalvati, 8, 7, 1, yes
793456089769644032,  cicciotto68, 11, 6, 5, yes
517934877,  AurelioToro, 9, 7, 2, yes
1613434417,  PaolaRovi, 2, 2, 0, yes
389110579,  GraziaNaletto, 1, 1, 0, yes
472287812,  OrianaCerbone, 1, 1, 0, yes
731869832430428161,  massimowilfredd, 5, 3, 2, yes
503394897,  CarloSaletta, 3, 3, 0, yes
192640902,  mbw203206, 17, 12, 5, yes
1278624774,  68kikka, 9, 9, 0, yes
1446761334,  p_maleklou, 15, 15, 0, yes
2219706021,  PamokaPaolo, 1, 1, 0, yes
759675705647063040,  ByValerio, 31, 23, 8, yes
1448557296,  microcerotis, 5, 3, 2, yes
757950065466015744,  NatangeliVito, 30, 29, 1, yes
377272505,  CarlaTrudu, 84, 82, 2, yes
799611304101167104,  CarmeloVadala4, 5, 5, 0, yes
4359734896,  alegaro11, 30, 30, 0, yes
2757272345,  gemmapieri, 6, 6, 0, yes
598685083,  BACCHEDIGINEPRO, 1, 1, 0, yes
713009769,  LucBumbolo, 3, 1, 2, no
3986971581,  TheGuardianDVX, 9, 8, 1, yes
264867166,  lorenzob772, 2, 1, 1, neutral
756326148527755264,  Pierant85700162, 13, 9, 4, yes
457622220,  MichaelRooster, 22, 10, 12, no
246731287,  tikal3d, 5, 5, 0, yes
3972000731,  RaffaellaTulip1, 5, 5, 0, yes
1913892218,  VCattivo, 39, 9, 30, no
79196834,  CarlaGommy, 5, 4, 1, yes
1012841208,  Nicomingozzi, 2, 1, 1, neutral
2949317921,  amattioli58, 4, 4, 0, yes
821518610,  ventrigl, 3, 3, 0, yes
796033080335224832,  alruti1109, 21, 21, 0, yes
103130700,  ninopipitone, 1, 1, 0, yes
1419118495,  pasqualesse, 1, 1, 0, yes
51232175,  ManuRontini, 20, 20, 0, yes
1439319032,  fabrydami, 10, 7, 3, yes
710162008180662272,  TeccePericle, 28, 22, 6, yes
2458355676,  GOliari, 2, 2, 0, yes
1879711830,  cberrets, 14, 14, 0, yes
938688090,  farso_poli, 21, 18, 3, yes
25378065,  guidig, 1, 1, 0, yes
264774390,  NatangeloM, 3, 3, 0, yes
793574670171795461,  domevese, 7, 7, 0, yes
1064020076,  ulissedomini, 3, 3, 0, yes
526765918,  BEE_atriX, 31, 8, 23, no
2559922025,  luciano_ola, 6, 6, 0, yes
2803656836,  GGianni72, 5, 5, 0, yes
753173744,  GutenbergLab, 1, 1, 0, yes
581808635,  Alberto4ucci, 7, 7, 0, yes
1270233416,  cosimopompigna, 3, 3, 0, yes
2386031183,  MMinighin, 7, 7, 0, yes
923947808,  ZilloAnto, 65, 58, 7, yes
263037408,  dib309mar, 11, 3, 8, no
453089972,  Orange_dugongo, 3, 3, 0, yes
470382637,  bagigalupo, 2, 1, 1, neutral
3303829486,  OnestiPiuma, 16, 9, 7, yes
965913204,  Dardo70m, 3, 2, 1, yes
428458020,  fittipaldi1964, 2, 1, 1, neutral
48484178,  marcodimaio, 5, 5, 0, yes
931542290,  Tiziano_Dainese, 2, 2, 0, yes
4205262461,  kris3m, 3, 3, 0, yes
313855526,  PdCesena, 1, 1, 0, yes
311056063,  AcK_c_u, 15, 9, 6, yes
1163905178,  AMDF1, 1, 1, 0, yes
2187037682,  gaetano_albergo, 2, 2, 0, yes
202086398,  SteNap68, 4, 4, 0, yes
386741078,  mario_riberi, 4, 4, 0, yes
164346410,  Johncocoz, 2, 2, 0, yes
380535081,  silviabacocco, 2, 2, 0, yes
193271813,  fedpelleriti, 1, 1, 0, yes
143079781,  piergiorgio1968, 12, 11, 1, yes
2273694722,  liberafla, 8, 3, 5, no
370345381,  MarchesiMattia, 29, 29, 0, yes
423372441,  PaoloPappaterra, 23, 22, 1, yes
2929403482,  cugusi1952, 15, 13, 2, yes
1916644034,  PitoniP, 1, 1, 0, yes
281104969,  laurabagnoli, 44, 41, 3, yes
500582673,  GiuseppeMiele5, 33, 32, 1, yes
868671120,  pinosol4, 15, 10, 5, yes
2998311941,  Her_Rorschach, 21, 12, 9, yes
2408772318,  Abacusfirenze, 31, 22, 9, yes
2886599469,  pietrovita2, 5, 5, 0, yes
3192664222,  TentoDavideNgr, 11, 11, 0, yes
1274882076,  CapitaleDe, 44, 24, 20, yes
1078039400,  MonicaMucciconi, 1, 1, 0, yes
717100825026379777,  QuicoS78, 13, 13, 0, yes
851602604,  Fr_Macri, 5, 4, 1, yes
1423876909,  MusFly1984, 11, 9, 2, yes
133692338,  tatjana31, 36, 21, 15, yes
400048079,  enricaghia, 2, 2, 0, yes
1410109662,  mariantodm, 12, 11, 1, yes
821838218,  ZMarco67, 1, 1, 0, yes
540147645,  giuseppevenez11, 6, 2, 4, no
199216783,  lblou, 19, 8, 11, no
2371000552,  texgius, 7, 7, 0, yes
1039603651,  faustomistretta, 1, 1, 0, yes
1095469866,  souleymanejule1, 5, 5, 0, yes
4733150242,  Teofilattodei, 8, 7, 1, yes
391168591,  GiusAmbr, 3, 3, 0, yes
1934261960,  TaccolaAndrea, 13, 11, 2, yes
4384279288,  parloamestessa, 47, 6, 41, no
949546273,  GerardoNardie, 6, 5, 1, yes
1260171894,  ArchCmc, 131, 50, 81, no
2907503735,  lacavaz, 5, 4, 1, yes
85104257,  fabriziodestro, 1, 1, 0, yes
991498111,  RiccardoCorio1, 17, 5, 12, no
31171266,  luccaro1, 4, 4, 0, yes
526622783,  GiuseppeAnnulli, 2, 2, 0, yes
563558852,  k_help, 10, 8, 2, yes
296713660,  arcigiovi, 8, 6, 2, yes
2359426044,  Barbaraus1970, 97, 65, 32, yes
704558982,  SnodiEU, 11, 11, 0, yes
735474541359685632,  SDSH_staff, 2, 2, 0, yes
390622095,  EspositoFilippo, 39, 36, 3, yes
418265647,  leandropiludu, 3, 3, 0, yes
2467497190,  domenicosansov1, 71, 35, 36, no
3489310096,  NascHome, 10, 10, 0, yes
2283534272,  paolocapuani1, 2, 2, 0, yes
470257543,  amiko1963, 205, 168, 37, yes
438336172,  dedato69, 5, 5, 0, yes
490725675,  GGiudiceandrea, 15, 15, 0, yes
707656621795713025,  mariagdellav, 13, 13, 0, yes
764402685617508352,  GeremiaGhiando, 5, 5, 0, yes
2804808647,  dbruno1959, 6, 6, 0, yes
291019658,  Tufin4, 16, 10, 6, yes
104814432,  enrsama, 10, 10, 0, yes
3060987945,  geppoestfolle, 2, 2, 0, yes
730485660570812417,  simonesimone87, 14, 13, 1, yes
2464335277,  antonioomero1, 11, 6, 5, yes
3320285157,  GiovanniColan11, 21, 15, 6, yes
1032696974,  mariobidi, 2, 2, 0, yes
805878452947709952,  aryjoan1, 8, 5, 3, yes
2794449916,  FedeSerra81, 1, 1, 0, yes
1967540029,  lo_meglio, 6, 5, 1, yes
416018070,  DieWelt75, 6, 2, 4, no
2872332023,  Libercolo, 54, 15, 39, no
2216369030,  Antonio90626526, 1, 1, 0, yes
3719207249,  King_Of_Sumer, 41, 22, 19, yes
2244123961,  SuperSamu78, 2, 2, 0, yes
806020907395411969,  AleRaso7, 1, 1, 0, yes
737302189929025537,  sergio224860, 6, 6, 0, yes
2920121374,  Thenewsroom9, 1, 1, 0, yes
805517495541108736,  rubinaalb, 1, 1, 0, yes
788982500907421696,  Luigi080303471, 5, 4, 1, yes
2335336118,  paola_matilo, 2, 2, 0, yes
2339491366,  miamari_a, 6, 5, 1, yes
708429391,  slavina6, 208, 63, 145, no
2962881287,  oris_gigghis, 2, 2, 0, yes
1156611540,  MarcoF_Cirillo, 9, 2, 7, no
1159825830,  Gabriyeats, 17, 12, 5, yes
1633720213,  Lozioalbe, 10, 7, 3, yes
128490421,  Edpa01, 4, 4, 0, yes
2686892396,  paolo_maiellaro, 1, 1, 0, yes
3224618207,  giovanni1noel, 1, 1, 0, yes
798986980159692800,  newmarc67, 7, 7, 0, yes
4228903452,  ChristianVisona, 1, 1, 0, yes
2147638752,  La_Siusy, 16, 6, 10, no
396564186,  andrea__braga, 241, 12, 229, no
733695386846662657,  bastaunsi, 59, 59, 0, yes
900216266,  barlettadino, 2, 2, 0, yes
549451829,  bompresso01, 5, 5, 0, yes
419626195,  Aquilante73, 37, 33, 4, yes
2533287637,  SignorVVolf, 6, 4, 2, yes
368340302,  marcomorbioli, 11, 7, 4, yes
2909504255,  alegio957, 92, 63, 29, yes
775379869215625217,  Teopuccio66, 8, 5, 3, yes
2416229854,  giorgio_rosi, 9, 8, 1, yes
725937762449264641,  912venti, 21, 21, 0, yes
310216032,  luigibruscianes, 3, 1, 2, no
759631470,  nottocsib, 4, 4, 0, yes
2352305154,  giulianocossari, 120, 77, 43, yes
437792860,  mmaristellaa, 59, 34, 25, yes
4221027975,  ROGAPAPER, 1, 1, 0, yes
3404776456,  elvipetretta, 56, 12, 44, no
594659275,  adamohellboy, 2, 2, 0, yes
400630735,  Sofiajeanne, 16, 11, 5, yes
1357812068,  Aquintoc, 40, 9, 31, no
2358573780,  PatriziaBarca, 6, 5, 1, yes
352629296,  EnricoVadora, 1, 1, 0, yes
149609445,  rsimoni62, 97, 94, 3, yes
198640989,  quozientezero, 1, 1, 0, yes
216688489,  Carmniello, 3, 1, 2, no
447863789,  carmenmalmassar, 29, 8, 21, no
489693440,  evavola, 37, 32, 5, yes
3055829144,  valeriarosati55, 8, 8, 0, yes
1385372534,  TonymatAntonio, 4, 4, 0, yes
797431190437380096,  albertoviperino, 1, 1, 0, yes
487738991,  lanzales, 2, 2, 0, yes
2318930618,  blutarsch73, 5, 3, 2, yes
2745749177,  gary_hmjano, 2, 2, 0, yes
490726710,  u_sudista, 7, 6, 1, yes
16379615,  mike671, 1, 1, 0, yes
379030092,  CCKKI, 33, 18, 15, yes
396459358,  City_life69, 66, 45, 21, yes
3023266619,  D55Lampa, 26, 19, 7, yes
2333765223,  ACortellazzoJr, 15, 14, 1, yes
2924337306,  frmeno, 1, 1, 0, yes
32402183,  lorenzoperoni, 48, 48, 0, yes
123903173,  abacaino, 24, 11, 13, no
212019576,  lucadibona, 1, 1, 0, yes
317879179,  ClaudioColo, 9, 9, 0, yes
1387662265,  danielopoli, 11, 11, 0, yes
2311558334,  sciulz66, 23, 12, 11, yes
112805407,  Insidelucart, 61, 60, 1, yes
1456556520,  Gigino51, 12, 3, 9, no
506391579,  CasFabiana, 1, 1, 0, yes
1209547698,  AnnaBCX, 63, 52, 11, yes
917795358,  ManBernie, 2, 2, 0, yes
285745764,  doboiano, 7, 6, 1, yes
469755340,  CGlonfoni, 19, 19, 0, yes
2907953530,  CosimoJois2011, 16, 14, 2, yes
2216436551,  carmen_castel, 1, 1, 0, yes
469755291,  corinnemin, 2, 2, 0, yes
781930651528392704,  Paolo57573718, 16, 10, 6, yes
171902551,  mondorotondo72, 4, 4, 0, yes
2269841777,  matemill, 1, 1, 0, yes
67637870,  GiuseppePortos, 7, 6, 1, yes
868360100,  mfiorantino, 32, 18, 14, yes
49307202,  Fede262, 1, 1, 0, yes
2359142030,  waltergreco65, 15, 13, 2, yes
2548419224,  iaroma3, 19, 12, 7, yes
1562890188,  StefanoCar91, 12, 4, 8, no
2975464317,  Vadab84, 6, 6, 0, yes
210549075,  mister1899, 2, 1, 1, neutral
2211480714,  rcolamatteo, 2, 2, 0, yes
748814836595826688,  mrpietrobarbera, 15, 11, 4, yes
805751697960267776,  bachiko62, 6, 4, 2, yes
2319131287,  kepler196a, 48, 28, 20, yes
54871865,  Matteo_Piras, 7, 6, 1, yes
470583844,  RCappellani, 1, 1, 0, yes
58768691,  fabiochiusi, 9, 8, 1, yes
129967230,  strasal, 5, 3, 2, yes
127480236,  DavideMeazza, 6, 6, 0, yes
3089288838,  giovann72785739, 15, 11, 4, yes
354322711,  dr40653, 3, 2, 1, yes
82960906,  mauro_mersoni, 3, 2, 1, yes
462900837,  flazzeroni29, 1, 1, 0, yes
83180211,  mariocavallaro, 2, 2, 0, yes
4265019316,  scanandmake, 1, 1, 0, yes
2324895959,  ienneve, 3, 2, 1, yes
2713478241,  raffaraffa25, 3, 3, 0, yes
345871224,  Pablo4moors, 7, 4, 3, yes
17864679,  stestra, 1, 1, 0, yes
2817092706,  vallala3, 21, 16, 5, yes
117734700,  kebirr, 5, 5, 0, yes
443975641,  ilpofeta1, 3, 3, 0, yes
4326503175,  robertoberti76, 23, 23, 0, yes
4887827675,  carrarofabio69, 43, 39, 4, yes
418168236,  marcorivello, 8, 8, 0, yes
2755644209,  oliveriragione1, 4, 3, 1, yes
408429600,  lucacusimano2, 2, 2, 0, yes
551347889,  jvandelorenzo, 1, 1, 0, yes
528014582,  cagliaripad, 1, 1, 0, yes
2940240305,  piergrand32, 21, 15, 6, yes
2323626848,  46_klaus, 2, 2, 0, yes
387597747,  mariomottinelli, 29, 29, 0, yes
469645909,  antogea74, 2, 2, 0, yes
3289084404,  c8b27d1a7ab4403, 5, 4, 1, yes
45863946,  ciraolo110, 1, 1, 0, yes
800148156973363200,  orasicambia, 15, 15, 0, yes
1022801072,  Mario34mg, 46, 41, 5, yes
2173027221,  gvalle77, 23, 10, 13, no
771782482387726336,  Lorenzocl5, 3, 3, 0, yes
939768054,  debellis55, 4, 4, 0, yes
26735502,  NicerrrThanThat, 1, 1, 0, yes
878544211,  tfiorentinqb6k, 17, 17, 0, yes
458202024,  LoatoLoato, 5, 5, 0, yes
476976606,  granata948, 3, 2, 1, yes
2358220986,  cosmario2, 1, 1, 0, yes
416607721,  ECeccherini, 10, 10, 0, yes
743608392883769349,  claudioatena56, 43, 32, 11, yes
2852316766,  sardum, 19, 13, 6, yes
485587951,  ugolone84, 3, 3, 0, yes
3405599800,  5StelleOvunque, 29, 10, 19, no
129228198,  annapool83, 3, 3, 0, yes
1728213950,  NeMo87, 19, 17, 2, yes
3096569741,  stefania_pelleg, 25, 21, 4, yes
785533550393192448,  Orizzonte_Nuovo, 28, 13, 15, no
2999909987,  maura_angeli, 4, 4, 0, yes
40701365,  toky12, 2, 2, 0, yes
2318485496,  BubaBubmar, 3, 3, 0, yes
752858490985734144,  bastaunsiReggio, 25, 25, 0, yes
572997879,  lukatro, 11, 9, 2, yes
32324221,  Milazchi, 1, 1, 0, yes
4833429358,  cinasky_h, 36, 35, 1, yes
789897577982529536,  andreaboi_cc, 2, 2, 0, yes
2647766302,  FarineG, 15, 15, 0, yes
50607243,  mamola, 4, 1, 3, no
2597719151,  mele_sebastiano, 8, 8, 0, yes
3364129594,  MarinaGalfetti, 8, 8, 0, yes
88689757,  AlessioQuinta, 7, 7, 0, yes
402795103,  vanitafe, 1, 1, 0, yes
1246808533,  FaenzaperRenzi, 16, 16, 0, yes
2763256746,  Toninominervino, 15, 13, 2, yes
870521268,  MarriStefania, 9, 7, 2, yes
2452148457,  RAnyonio, 17, 14, 3, yes
203070541,  aleamorino, 8, 8, 0, yes
1225400970,  ivan_kanu, 2, 2, 0, yes
81360107,  eulife65, 14, 14, 0, yes
2972417039,  984b06dcb409464, 1, 1, 0, yes
472295572,  meden80, 3, 3, 0, yes
838468238,  StefyZarina, 4, 4, 0, yes
3343031632,  Vernazzaro128, 2, 2, 0, yes
1623855672,  FilippoMaurizio, 1, 1, 0, yes
144585161,  OGGI_online, 2, 2, 0, yes
466780465,  emanuela65k, 5, 5, 0, yes
390324765,  SteCamisasso, 3, 3, 0, yes
469220857,  JohnStokes17, 6, 5, 1, yes
748831224454586368,  fotigoal, 1, 1, 0, yes
3292705354,  vincenzozito9, 1, 1, 0, yes
4821654207,  samu32488656, 1, 1, 0, yes
430775309,  jacklondon_ox, 3, 3, 0, yes
336442306,  OttoVola, 69, 33, 36, no
78863434,  Marianna_7, 2, 2, 0, yes
2984621871,  antondicarlo, 4, 4, 0, yes
1026948296,  uncletomablogZ, 15, 8, 7, yes
712247530709491712,  mattiolitaranto, 25, 22, 3, yes
119802529,  Pejik223, 1, 1, 0, yes
1238881056,  FrancoCoradazzi, 13, 8, 5, yes
96325900,  enzissimo, 22, 8, 14, no
3148753753,  Londi52Paolo, 4, 4, 0, yes
802782433,  pietroschwarz, 7, 5, 2, yes
708755015868006402,  GregorioCorigl1, 47, 40, 7, yes
731906277463457792,  avvocatiNORDEST, 2, 2, 0, yes
2353301002,  atzori_carlo, 1, 1, 0, yes
97526668,  PDPrato, 9, 9, 0, yes
46120689,  Giampaolcarboni, 21, 20, 1, yes
2392944265,  massimo62liv, 2, 2, 0, yes
78971533,  fabiopucello, 44, 30, 14, yes
1171310611,  PaciFranca, 13, 11, 2, yes
2785158801,  FedeTremarco, 13, 3, 10, no
921726217,  FeliceZuppa, 9, 9, 0, yes
754001744808538112,  PaolaScafasci, 1, 1, 0, yes
2319258554,  NanniCatta, 34, 14, 20, no
288286492,  bbbiaggino, 3, 3, 0, yes
2316972126,  TazioMa, 26, 25, 1, yes
157016569,  StefanoMurroni, 2, 1, 1, neutral
2250627476,  vincenzociril16, 16, 16, 0, yes
489368395,  SilvioRossi3, 35, 13, 22, no
9820132,  azeteo, 17, 17, 0, yes
498948393,  FabriceLanfrey, 6, 6, 0, yes
403444000,  danielecina, 72, 51, 21, yes
2557453016,  ilgattonaccio, 32, 32, 0, yes
319630558,  StefyStefyCosta, 10, 10, 0, yes
138800969,  Ozzy77more, 6, 4, 2, yes
281704107,  iosnchiara, 4, 4, 0, yes
96393039,  paternodilucani, 11, 11, 0, yes
1264043076,  gulydepo, 3, 3, 0, yes
4824798082,  PerutaAntonio, 34, 17, 17, neutral
323889720,  PalazzoAntonio, 72, 31, 41, no
2375216695,  mgulivo7, 122, 116, 6, yes
634575700,  claudiamedd, 55, 55, 0, yes
2336360382,  CaterinaLiotti, 5, 5, 0, yes
290512047,  Lidoroma, 22, 22, 0, yes
129973470,  lavedovabianca, 3, 3, 0, yes
159885894,  sevinson, 4, 3, 1, yes
3356485570,  GCappellazz, 173, 55, 118, no
698805851751108609,  Nicolett7Angelo, 26, 22, 4, yes
22609411,  MariannaLentini, 10, 7, 3, yes
2186626514,  fraxxx94, 18, 15, 3, yes
4861807805,  GiuseppeR37, 3, 3, 0, yes
416465127,  BenitaLicata, 37, 37, 0, yes
3225158405,  Sanna43Sanna, 29, 17, 12, yes
397276980,  Anninacio, 15, 6, 9, no
757644418719637504,  PerilRoero, 1, 1, 0, yes
722421795106766848,  RennaNietta, 26, 19, 7, yes
47875351,  Roccossassino, 27, 27, 0, yes
798881018124050432,  MManzotti76, 1, 1, 0, yes
1656352922,  sonolastrega, 1, 1, 0, yes
1054466197,  dpmarc61, 1, 1, 0, yes
1272905017,  andreatesti70, 7, 5, 2, yes
485841317,  Barracciu, 33, 23, 10, yes
774047754834313216,  Andrschr666, 30, 21, 9, yes
1229273522,  marco21967, 56, 44, 12, yes
37769570,  claudiogiudici, 2, 1, 1, neutral
2742349928,  indus661, 1, 1, 0, yes
2497153231,  FuscoRfusco, 2, 1, 1, neutral
322070453,  NoleRulez7, 5, 2, 3, no
3366092747,  Ultor666, 6, 6, 0, yes
2553584834,  auti_80, 8, 8, 0, yes
791781135047127040,  feno_piero, 11, 11, 0, yes
587521626,  Valeri0_Valeri0, 59, 12, 47, no
300148270,  CarloOlb, 23, 14, 9, yes
729294692765081600,  max_silvi, 5, 4, 1, yes
2712331625,  giuseppenardec1, 45, 23, 22, yes
2809704970,  alextartaglia, 2, 2, 0, yes
322715453,  themarquis87, 2, 2, 0, yes
2355249940,  stazi74, 14, 5, 9, no
421736249,  caterinajanara, 5, 5, 0, yes
125374717,  mihirdjin, 1, 1, 0, yes
2481748609,  keeplacalma, 21, 14, 7, yes
2353246647,  DellaDglive, 1, 1, 0, yes
367803116,  JacopoVitali, 1, 1, 0, yes
1040825324,  RubiuSerafino, 1, 1, 0, yes
860015294,  AgenziaVISTA, 1, 1, 0, yes
859694112,  d_gerbino, 16, 9, 7, yes
48047949,  albertocicotto, 4, 4, 0, yes
1074738966,  ugoro82, 3, 3, 0, yes
753986193495293952,  elenavittoria47, 8, 6, 2, yes
436809285,  GianPalc, 10, 2, 8, no
1685826319,  missblueberry97, 1, 1, 0, yes
10285092,  rickythetricky, 3, 3, 0, yes
527812707,  enricorove, 1, 1, 0, yes
51470278,  m_triglia, 1, 1, 0, yes
1519266373,  Cplion87, 6, 6, 0, yes
3247252181,  4eeff1d0b64f437, 3, 2, 1, yes
904333099,  SpadeaDomenico, 2, 2, 0, yes
2974941849,  MattyPln, 35, 20, 15, yes
1040111298,  luigibianco15, 3, 3, 0, yes
431046838,  gilioligmail, 1, 1, 0, yes
141301980,  massimo977, 3, 3, 0, yes
441025617,  lupogdg, 2, 1, 1, neutral
2836840346,  sepilli55, 14, 4, 10, no
783612590,  SacriSacri8, 1, 1, 0, yes
799613492466749440,  RiformistiDem, 4, 4, 0, yes
2853575920,  CagliariSi, 23, 23, 0, yes
15178183,  Zigolo_net, 9, 6, 3, yes
603370313,  CrisMagic81, 6, 6, 0, yes
1030716133,  caputo_lorenzo, 1, 1, 0, yes
1006234656,  Luca_Dieci, 5, 4, 1, yes
64144248,  manuele_a, 72, 34, 38, no
912364518,  LucianoPili, 1, 1, 0, yes
1126330494,  albecage, 6, 6, 0, yes
47708105,  cheru1968, 7, 7, 0, yes
381589283,  Catecarpi, 18, 18, 0, yes
803350148143316992,  MarlonJD1978, 13, 9, 4, yes
987172572,  giofal49, 16, 11, 5, yes
499197851,  arabatur1, 6, 6, 0, yes
723077115428499456,  sviscusi5, 7, 7, 0, yes
191511361,  eptabeta, 3, 3, 0, yes
897918854,  rotovisor, 23, 12, 11, yes
541360302,  cucciolopage7, 5, 5, 0, yes
735185380924874752,  Tiziano1807, 2, 2, 0, yes
799888714075930624,  E_Egorenkova, 1, 1, 0, yes
3197165667,  carlo_thx1138, 8, 7, 1, yes
98131755,  GiusyPiccone, 2, 2, 0, yes
3889028069,  CiroArmenio, 11, 8, 3, yes
788161916246093828,  foreverultimo, 10, 5, 5, neutral
467120641,  strixygio, 1, 1, 0, yes
3021204969,  TerranovaFra, 9, 9, 0, yes
4832898707,  miamotroppo, 1, 1, 0, yes
2186313609,  emilio_solinas, 2, 2, 0, yes
445621349,  alvisemascolo, 4, 3, 1, yes
1960528369,  domenicostrang3, 9, 6, 3, yes
752800121138581504,  izoon2, 106, 51, 55, no
715687585,  macchialberto1, 2, 2, 0, yes
391450948,  gianlucagdc, 20, 16, 4, yes
1474124408,  robenven, 4, 1, 3, no
712037085369266180,  MANDARANCIO11, 1, 1, 0, yes
491345614,  Dany1965M, 2, 2, 0, yes
1715047068,  PD_Torino, 3, 3, 0, yes
804094800282734592,  Pasqual34968419, 9, 7, 2, yes
410300839,  AleAndreis68, 6, 6, 0, yes
384353170,  stefanolepri, 1, 1, 0, yes
331030261,  Erri_SMH, 1, 1, 0, yes
1402708182,  Cilloider, 2, 2, 0, yes
757666869499363329,  plutone_1, 4, 4, 0, yes
240844912,  rinosalvati, 1, 1, 0, yes
1147448544,  paomio17, 24, 21, 3, yes
3042283259,  enrico_silve77, 3, 3, 0, yes
2841016595,  zacoianna, 7, 7, 0, yes
1692220926,  myaleale, 7, 4, 3, yes
319060887,  Leleganjamel8, 19, 6, 13, no
3162195879,  fabriziosilve13, 18, 18, 0, yes
2352984616,  STANCO83, 24, 21, 3, yes
405449394,  ferrero_ale, 1, 1, 0, yes
787718454,  AlfonsoDinamite, 23, 23, 0, yes
415088731,  nicolasslazio, 10, 10, 0, yes
164607309,  cesarienzi, 1, 1, 0, yes
752786587,  el_titosco, 6, 4, 2, yes
373481031,  Gabburger, 12, 12, 0, yes
487367490,  Gabriele_Arcuri, 1, 1, 0, yes
461933196,  gianni_magni, 2, 2, 0, yes
360518583,  AndreaPaciotti, 27, 19, 8, yes
49271778,  paolopinus, 8, 8, 0, yes
2714660159,  SciiKimici, 19, 11, 8, yes
4463441,  ivys83, 7, 5, 2, yes
3121162647,  georgeprogmusic, 3, 2, 1, yes
272531118,  cotiedp, 6, 6, 0, yes
351756292,  riccardoimb, 5, 5, 0, yes
2437309637,  sdalrio, 7, 5, 2, yes
2942230331,  diegorossini46, 1, 1, 0, yes
1063923588,  OVenini, 11, 11, 0, yes
2512354461,  alianobarbini, 5, 5, 0, yes
181469929,  mrcneri, 9, 8, 1, yes
601134365,  LauraRapi1, 24, 24, 0, yes
368950045,  giorgio_gori, 15, 15, 0, yes
23547999,  KickOH, 1, 1, 0, yes
482045811,  MarcoLuchin, 18, 18, 0, yes
2943733317,  MaryEllenBoschi, 9, 9, 0, yes
1249802790,  pizzapiani, 2, 2, 0, yes
791562057183133697,  Collefolle, 11, 11, 0, yes
2352059977,  petruscaA, 23, 21, 2, yes
197763661,  tg1online, 29, 28, 1, yes
2322592224,  monty_walter, 1, 1, 0, yes
3008182149,  giufra555, 4, 4, 0, yes
1380328387,  degiorgi70, 1, 1, 0, yes
396697179,  sandrobaldi, 12, 12, 0, yes
3130035911,  VPuesi, 13, 11, 2, yes
891042680,  paoloalli, 8, 8, 0, yes
413968010,  Ruzzante1968, 5, 5, 0, yes
37892753,  enribar, 11, 9, 2, yes
576433668,  Doctor_Stent, 13, 13, 0, yes
568377117,  totonnotato, 55, 20, 35, no
297548565,  oppiliftw, 12, 8, 4, yes
2585792659,  PaoloBorchia, 6, 5, 1, yes
2282318811,  dedodins, 1, 1, 0, yes
241857339,  Almagesto75, 10, 6, 4, yes
462739617,  Roberto_Borzi, 11, 11, 0, yes
798168259346530304,  ___Loukas___, 3, 3, 0, yes
747147930742755328,  marziamario, 23, 22, 1, yes
2359153168,  VenturaEdoardo, 20, 20, 0, yes
3980680961,  salvatorepereta, 9, 9, 0, yes
700754631438290944,  nello54716800, 1, 1, 0, yes
43335211,  Mossenta, 9, 9, 0, yes
451449745,  danymartini81, 9, 6, 3, yes
742950892786290688,  Cuordileone55V, 31, 20, 11, yes
2342517254,  pentotaldoll, 248, 87, 161, no
2774751706,  mayehmproject, 85, 57, 28, yes
471256911,  michelenicolet, 1, 1, 0, yes
743886413251371008,  martino_mazzoli, 5, 5, 0, yes
3066053129,  alelu47, 2, 2, 0, yes
745033396850692097,  ljemcee, 11, 6, 5, yes
805888767047438336,  Brusss76, 4, 2, 2, neutral
423308449,  gobbo_roma, 4, 1, 3, no
806036756604850176,  sergio19121946, 1, 1, 0, yes
803916997058760704,  erfattaccio, 11, 11, 0, yes
2192427702,  PandaNoLimits, 36, 26, 10, yes
2253757506,  GiuseppedeGioia, 7, 4, 3, yes
1099059128,  marcestruzzo, 11, 10, 1, yes
541494300,  gdeidda57, 4, 4, 0, yes
754368761185046528,  gcla16, 17, 13, 4, yes
151826611,  ILVILE05, 1, 1, 0, yes
56649449,  fbx77, 4, 4, 0, yes
805798846949363718,  leomars84, 6, 6, 0, yes
4393976543,  ManziniAnnalisa, 10, 9, 1, yes
937667064,  LuFra_Ing, 3, 3, 0, yes
2522802620,  Rob_Loi, 3, 2, 1, yes
618099110,  soncosma, 1, 1, 0, yes
952009314,  GianlucaSobrato, 6, 5, 1, yes
746638522539466752,  PieraBelfanti, 10, 9, 1, yes
14177618,  baraldiluciano, 1, 1, 0, yes
987385327,  andre_castorp, 1, 1, 0, yes
92546008,  vikmolinari, 1, 1, 0, yes
2279399816,  _Sentifrux, 47, 17, 30, no
439237901,  AleSala23, 2, 2, 0, yes
506393031,  EnricoIachello, 19, 18, 1, yes
3322548533,  OrnellaVannoni, 19, 10, 9, yes
479645953,  ElisaTognietti, 20, 20, 0, yes
793949758012456960,  ursulabassi, 13, 13, 0, yes
350226442,  DavClem, 14, 8, 6, yes
711499772520218624,  wojcech3, 1, 1, 0, yes
399467811,  mary1966n, 16, 11, 5, yes
1545029150,  DottaIgnoranza, 22, 14, 8, yes
764908550816751617,  zappia_nando, 9, 9, 0, yes
730708867,  francescogugli7, 1, 1, 0, yes
763784342,  andreasso1951, 20, 11, 9, yes
4858595345,  CrisGnesutta, 45, 27, 18, yes
1006344018,  gFirenti, 1, 1, 0, yes
2199804117,  shosholoza74, 7, 3, 4, no
305875384,  elvireadele, 2, 2, 0, yes
4052170222,  EnnioBruxi, 12, 8, 4, yes
866962560,  AlexerimCat, 3, 3, 0, yes
223978952,  sowmyasofia, 4, 4, 0, yes
317117163,  lcontevladl, 20, 15, 5, yes
731357681613721600,  lucianosupus, 4, 4, 0, yes
1175340216,  LAntieroe, 4, 4, 0, yes
702178529,  rafgrazioso1980, 7, 7, 0, yes
794416374131068928,  FabioFriulano, 1, 1, 0, yes
52991934,  cmacina, 2, 2, 0, yes
2322841699,  svirgolao, 9, 9, 0, yes
759488381051174913,  cotechino3, 2, 2, 0, yes
574747359,  AndreaIacovitti, 6, 6, 0, yes
434201728,  benihamin, 3, 3, 0, yes
1715312280,  miguelmartina1, 1, 1, 0, yes
2184969053,  pierosg01, 6, 4, 2, yes
866474910,  LuccaperRenzi, 10, 10, 0, yes
528649172,  aliquofrancesco, 5, 2, 3, no
1175424128,  robertatrucco1, 6, 6, 0, yes
744828787137839104,  cambiotesta, 37, 14, 23, no
753700981,  Marcello_1941, 16, 13, 3, yes
1119007478,  MJmkeynes, 6, 2, 4, no
83920877,  MaxsoMagazine, 13, 12, 1, yes
140629189,  DonatoIannuzzi, 9, 9, 0, yes
3181986675,  donabarone51, 1, 1, 0, yes
4405179137,  429d4dc9174244c, 1, 1, 0, yes
462026678,  salzheimer, 15, 11, 4, yes
4407915867,  MarinellaBerte2, 22, 16, 6, yes
2568440673,  dt_76, 2, 2, 0, yes
1247288606,  AnnaGiacobbe3, 2, 2, 0, yes
429059632,  carmineannik, 1, 1, 0, yes
1667419908,  RosarioLavorgna, 10, 10, 0, yes
594559435,  Minumunfax, 8, 8, 0, yes
401650330,  PeppeMorano, 19, 10, 9, yes
1481960144,  arch_corvino, 80, 53, 27, yes
3996856863,  vaccarino_enri, 4, 2, 2, neutral
783600115604914176,  viaevai, 11, 8, 3, yes
3430544349,  stepellicano, 4, 4, 0, yes
2671785441,  babbodim, 3, 2, 1, yes
2234366108,  andreastabene_, 5, 4, 1, yes
1006399170,  nicolaten28, 1, 1, 0, yes
200035831,  LpEllepi, 5, 5, 0, yes
416327579,  annodavaarte, 2, 2, 0, yes
774766990124802048,  AgguoraAly, 4, 4, 0, yes
322626110,  Brigantessa5, 3, 2, 1, yes
77823743,  aureliomancuso, 19, 7, 12, no
1033544156,  tyus75, 3, 3, 0, yes
9437162,  Alea88, 11, 5, 6, no
2347027613,  NeriPatrizio, 1, 1, 0, yes
780707216156299264,  Leandro12061519, 12, 8, 4, yes
246976552,  CiroPanariello, 44, 15, 29, no
1104789270,  GMuggiri, 2, 1, 1, neutral
756921009882759168,  ElenaRutilli, 13, 13, 0, yes
2426886392,  pinacele, 1, 1, 0, yes
1424778840,  ReamiCarlo, 1, 1, 0, yes
803154851706314752,  ileanadellucci, 1, 1, 0, yes
236794333,  CinqueRighe, 56, 45, 11, yes
445669706,  Gippia, 11, 7, 4, yes
100971180,  AlfonsoDellaCor, 5, 5, 0, yes
298384037,  RudyPadovani, 18, 18, 0, yes
1295101627,  SorrentClaudia, 47, 38, 9, yes
2951253801,  5722c92f26c640b, 1, 1, 0, yes
2353581032,  Certo_Che_Se, 3, 2, 1, yes
1037288737,  AssaissoMarisa, 10, 6, 4, yes
790545956861308928,  paolo_lecchi, 1, 1, 0, yes
1331997265,  PMessali, 7, 1, 6, no
306153104,  marilippa, 3, 2, 1, yes
801536179145424896,  Ivano06238504, 15, 14, 1, yes
92609877,  hopeandspace, 10, 10, 0, yes
2825355747,  Ottaviasoncini, 10, 10, 0, yes
471861275,  sstefani64, 22, 22, 0, yes
57282569,  AndreaMarcucci, 12, 12, 0, yes
200502085,  albertodorazio, 21, 20, 1, yes
2361309233,  stefcafaggi, 5, 5, 0, yes
754282812405084160,  PinoMocciaro, 34, 19, 15, yes
798164626844319747,  SbaccoAndrea, 20, 13, 7, yes
142692876,  soy_govinda, 2, 1, 1, neutral
2986947023,  GabrySSLFCJ, 62, 25, 37, no
35581144,  beacaputo, 1, 1, 0, yes
748179751660052480,  RIZZO_RIZZEO, 24, 17, 7, yes
108592354,  NevioSalimbeni, 2, 2, 0, yes
449183569,  FedericaCarini, 9, 6, 3, yes
394270057,  Ale__1989, 4, 4, 0, yes
2882777914,  fr4nk98, 9, 9, 0, yes
274177707,  SimoneMedei, 22, 15, 7, yes
751725458631327744,  GenerazioneSiTo, 32, 32, 0, yes
263796576,  albertod39emili, 6, 6, 0, yes
864362096,  FedeSavia, 10, 9, 1, yes
800371833363017728,  ColucciDonatoAl, 18, 13, 5, yes
416427349,  SaraColli88, 2, 2, 0, yes
502676366,  ecavalieri62, 2, 2, 0, yes
119522838,  mauriziocerino, 1, 1, 0, yes
4865985639,  laconi_rita, 3, 3, 0, yes
525288931,  ReteNear, 3, 3, 0, yes
763025898736082944,  Cri_Concardi, 14, 6, 8, no
2282434144,  donato51932274, 15, 15, 0, yes
858334032,  korradus, 1, 1, 0, yes
703607966,  perrino72, 11, 11, 0, yes
132107435,  lupoalberto53, 8, 8, 0, yes
401280832,  Carlini92, 3, 3, 0, yes
392552289,  iq_196, 5, 4, 1, yes
791703378434883584,  salvatoreumana5, 1, 1, 0, yes
459631864,  GaetanoCiscato, 25, 25, 0, yes
2839401364,  luiven1, 1, 1, 0, yes
3025616883,  margiubri, 15, 14, 1, yes
738436528263843840,  randazzolinda70, 2, 2, 0, yes
1017667801,  DorellaCianci, 12, 12, 0, yes
4415027475,  Gianfranz100, 10, 10, 0, yes
592489826,  katnip74, 27, 18, 9, yes
387694120,  IvanMatteoFoti, 38, 20, 18, yes
127931750,  Mikeypedia, 18, 10, 8, yes
300798803,  enzolepidi, 8, 7, 1, yes
777585598907441152,  SimoneG04829641, 2, 2, 0, yes
802873752904200192,  Antonio10815324, 1, 1, 0, yes
294535336,  pierluigitondo, 2, 2, 0, yes
549534713,  mariagraziacerr, 5, 5, 0, yes
518743903,  Vito_DeFilippo, 5, 5, 0, yes
398989007,  IVahle, 2, 1, 1, neutral
28080443,  vrussoniello, 6, 6, 0, yes
503564760,  MartaDorio, 1, 1, 0, yes
483725781,  hancock3101, 37, 36, 1, yes
254000967,  himachal87, 2, 1, 1, neutral
579438624,  Lesandroz, 11, 8, 3, yes
618538917,  Kealon__PHD, 1, 1, 0, yes
1122980041,  FrancyMagnelli, 11, 11, 0, yes
3026519279,  LiciaRossi2015, 8, 8, 0, yes
796342662844547072,  ItalyReferendum, 3, 3, 0, yes
2720608185,  marlenecunz2080, 2, 1, 1, neutral
709548392,  NessunoDiretto, 1, 1, 0, yes
747345731992772608,  tinocasiragh, 1, 1, 0, yes
397291200,  kimiko1361, 4, 4, 0, yes
2891814472,  CarraroGuido, 1, 1, 0, yes
2694982606,  elisabettarizz, 20, 13, 7, yes
799315802130358272,  Michela21650717, 1, 1, 0, yes
713628144545230848,  nellaberni, 7, 4, 3, yes
2265610701,  molin_bryan, 1, 1, 0, yes
396146922,  gianniruj, 5, 5, 0, yes
60672327,  scandaglieremo, 4, 1, 3, no
770463936,  nikabruz, 2, 2, 0, yes
1254291416,  catzeri3235, 44, 18, 26, no
797328567436713984,  Sergio20146457, 1, 1, 0, yes
2312781154,  altindoj, 5, 5, 0, yes
2340386652,  LucaEmpoli, 2, 2, 0, yes
3553383737,  manfattone, 10, 4, 6, no
48981619,  tondkar, 19, 9, 10, no
2328765859,  creativitysmart, 12, 10, 2, yes
2180414952,  dentdeliun, 3, 2, 1, yes
798110925828059136,  PasquaAforista, 1, 1, 0, yes
794582375867052036,  Luna_Giandilli, 42, 42, 0, yes
519270696,  BottaAdv, 10, 8, 2, yes
171651905,  marcogulino, 3, 3, 0, yes
750020737407315968,  antoniobenedu14, 4, 3, 1, yes
3064824634,  Nocentrisociali, 142, 72, 70, yes
822157436,  NickZaia, 5, 3, 2, yes
803188604491231241,  FANNYDOGG, 34, 20, 14, yes
4464404368,  M_A_Federici, 23, 23, 0, yes
279211405,  OcchettaF, 9, 9, 0, yes
705358796395319296,  leonardi_mirko, 3, 3, 0, yes
405548207,  AGiambart, 5, 2, 3, no
1325276551,  PatRicciardulli, 7, 7, 0, yes
750422882686296064,  63filippopicci2, 2, 2, 0, yes
515349673,  JONAS_1968, 3, 3, 0, yes
2834381453,  SamuelZallocco, 3, 3, 0, yes
591428790,  posup, 3, 3, 0, yes
14942247,  ragazzodimatera, 31, 22, 9, yes
202559331,  vecchiotac, 1, 1, 0, yes
432524169,  MauGandolfi, 5, 2, 3, no
47961494,  AleGranca, 1, 1, 0, yes
513361890,  maurycasa1981, 2, 2, 0, yes
2890309367,  ArturoF1971, 3, 3, 0, yes
2341995352,  Fra_F_86, 2, 2, 0, yes
455648908,  AndreaDisint, 3, 2, 1, yes
1407557940,  mk_led, 2, 2, 0, yes
2707210018,  ValBazz, 2, 2, 0, yes
1318257126,  xabier2013, 3, 3, 0, yes
200254805,  federainbow, 3, 3, 0, yes
1200249895,  Fil_HM, 5, 5, 0, yes
4872034270,  SilvioBogliari, 3, 3, 0, yes
301460166,  IlconteAlex27, 13, 13, 0, yes
737964567737864192,  ExElettore_PD, 152, 137, 15, yes
1066962283,  paolo3Viso, 6, 4, 2, yes
985284978,  kekkogold, 7, 7, 0, yes
326960437,  er_noir_sfina, 8, 7, 1, yes
546255035,  Francy_Caiazzo, 6, 6, 0, yes
2806019502,  frencybal3, 2, 2, 0, yes
1945087009,  Veronika_Lario, 17, 12, 5, yes
3133337548,  luigirandisi2, 1, 1, 0, yes
418830550,  lucadecarlo72, 2, 2, 0, yes
51757652,  nonleggerlo, 23, 13, 10, yes
17876465,  giovannidicaro, 13, 3, 10, no
4904910009,  ChielloGiulio, 3, 3, 0, yes
3431252014,  carminedm1985, 6, 4, 2, yes
2942909177,  supadense, 1, 1, 0, yes
758584125905375232,  antonioambro63, 1, 1, 0, yes
702063526173667328,  Brucyes, 5, 5, 0, yes
739080163770683392,  EstiqaatsiIii, 4, 4, 0, yes
896347454,  raffaelladifebo, 7, 7, 0, yes
606546950,  SVassalini, 5, 5, 0, yes
2509117751,  marcoallen_, 14, 13, 1, yes
1006198212,  AnnaAielloama, 22, 15, 7, yes
2964012705,  26304f7d95f84d8, 18, 16, 2, yes
501808339,  ValentiTano, 9, 8, 1, yes
380347202,  giovanniall, 1, 1, 0, yes
412887059,  patrizia956, 14, 14, 0, yes
800020664484855809,  ClaudioSe2, 2, 2, 0, yes
3686608235,  antonio0312dem, 3, 1, 2, no
1332270650,  luca_aversano, 2, 2, 0, yes
514161086,  giuno55, 26, 15, 11, yes
4073867722,  InprovRed, 5, 5, 0, yes
312168478,  balcancorneliu, 7, 7, 0, yes
240710359,  NosapaiD, 8, 7, 1, yes
91219268,  mauriziocondore, 1, 1, 0, yes
3413873009,  querelami, 9, 6, 3, yes
38434627,  GioCeselli, 3, 3, 0, yes
389358538,  EdoardoFerraro, 3, 3, 0, yes
2999850586,  RSSMauro, 1, 1, 0, yes
3303635176,  claudiomilani46, 2, 1, 1, neutral
795977260910186496,  hicsuntcojones, 3, 2, 1, yes
411312650,  Francesconip, 14, 14, 0, yes
144117296,  ClaudioMattolin, 11, 11, 0, yes
231445495,  21cristal88, 6, 6, 0, yes
17715444,  magnificosnello, 21, 14, 7, yes
797159309381685248,  enzos58, 2, 2, 0, yes
65937395,  Tina_Olivadoti, 9, 9, 0, yes
760938946956259329,  LuigiFrancavil3, 1, 1, 0, yes
430554250,  Briatore, 2, 2, 0, yes
3590525597,  simonederosa71, 11, 11, 0, yes
433156727,  luigigarini, 14, 14, 0, yes
1974735698,  CarmineMirandaC, 2, 2, 0, yes
449896218,  VittorioSavoia1, 11, 11, 0, yes
1037529548,  fabioderasmo, 5, 5, 0, yes
1324385052,  BertiFederico, 2, 2, 0, yes
606958796,  kuradue, 3, 2, 1, yes
805000214004269058,  italialibera3, 1, 1, 0, yes
414388459,  Pardipall, 10, 8, 2, yes
715543732217626624,  Vanto_italiano, 14, 3, 11, no
804257184536297473,  NEGRIOFSHIT1, 20, 10, 10, neutral
372220527,  EzioMorassutti, 5, 5, 0, yes
3028064043,  mcecchetti2, 1, 1, 0, yes
629952805,  TONYRUSSO60, 2, 2, 0, yes
595372301,  massimopupa, 39, 21, 18, yes
493122905,  lisandro967, 1, 1, 0, yes
4459906041,  DMarcoberard, 24, 7, 17, no
797790505614606336,  papafra61454331, 3, 3, 0, yes
220618416,  Gabriele_Rizzi, 1, 1, 0, yes
2640520959,  AlleGuidettiCOL, 5, 5, 0, yes
4085028641,  Bianchina55, 7, 6, 1, yes
797915787319279616,  Leo99116539, 1, 1, 0, yes
2194894268,  claudiopacini1, 34, 31, 3, yes
2987085395,  chianesef2, 25, 16, 9, yes
853194902,  gargiulo877, 1, 1, 0, yes
432670529,  ghibellino01, 10, 10, 0, yes
973551056,  AMarfuggi, 3, 3, 0, yes
542327855,  _pierini_, 29, 28, 1, yes
173389528,  almeno_penso, 30, 21, 9, yes
326481496,  MimmoMoramarco, 2, 1, 1, neutral
505593566,  furio_serra, 3, 3, 0, yes
535739496,  albertoalbertaz, 2, 2, 0, yes
4472452815,  renato1262, 4, 4, 0, yes
4795701676,  RaccattaPd, 9, 8, 1, yes
796633906606964736,  bumerto, 10, 10, 0, yes
572056299,  cannas_marco, 17, 16, 1, yes
978106428,  EdoardoGandini, 1, 1, 0, yes
367021544,  LuiRispoli, 1, 1, 0, yes
454259670,  AstoJerry, 2, 2, 0, yes
768171685665124352,  OfficialGiampy, 14, 9, 5, yes
428897370,  LucaMiniero, 72, 22, 50, no
4717505775,  giusepp70261720, 6, 6, 0, yes
214901131,  GigiDeMarchis, 2, 2, 0, yes
405192597,  MBattistina, 32, 15, 17, no
2586355176,  ilfuzzo, 4, 4, 0, yes
1077366451,  nausicaa123, 2, 1, 1, neutral
532083239,  SergioMariella, 5, 2, 3, no
729221180985618433,  claudio7373, 51, 40, 11, yes
437389258,  MPiaRandelli, 1, 1, 0, yes
565334533,  eligraziani, 4, 2, 2, neutral
1367973715,  mixc7, 35, 6, 29, no
441649983,  PietroPeluso3, 2, 2, 0, yes
784032977051353089,  Marco181087, 1, 1, 0, yes
1766895644,  loreley_no, 2, 2, 0, yes
6443392,  jmleray, 12, 9, 3, yes
152373257,  busker23, 3, 3, 0, yes
252606578,  sbatori, 2, 2, 0, yes
973456609,  LMuscelli, 24, 20, 4, yes
1085455423,  saveriolakadima, 72, 45, 27, yes
604535803,  PaolinoVeronese, 1, 1, 0, yes
2981217159,  c4f2b38ec1954a3, 1, 1, 0, yes
218923278,  giancarloamodio, 8, 7, 1, yes
4122678207,  lpaoli02, 10, 3, 7, no
425257831,  CilloJN, 2, 2, 0, yes
4782105135,  Melmaa_Luisee11, 3, 2, 1, yes
39488038,  iMarco84, 2, 2, 0, yes
414692154,  Sisto_3, 9, 8, 1, yes
74975802,  matteornati, 1, 1, 0, yes
2788963505,  francesal82, 2, 2, 0, yes
2872974977,  MaristinaG, 34, 17, 17, neutral
101837638,  MicheleCasadei, 1, 1, 0, yes
622780112,  EgonMau, 8, 6, 2, yes
74485176,  Dandy_Dv, 5, 1, 4, no
4260064583,  Giubs511, 2, 2, 0, yes
787745070002868224,  controstrezoa94, 6, 5, 1, yes
3150260316,  PitmanCosta, 22, 16, 6, yes
398048066,  AndreaBiferi, 1, 1, 0, yes
3376006312,  salvatoretoto55, 8, 4, 4, neutral
357004267,  pasqualecalone, 4, 4, 0, yes
790662730432806914,  Heilreich88, 4, 4, 0, yes
458666985,  martinogisolo, 1, 1, 0, yes
2720049676,  CuocciLuca, 2, 2, 0, yes
487822448,  1Zolesi, 3, 3, 0, yes
486928819,  Reeno1981, 2, 2, 0, yes
475956693,  mvpress, 9, 6, 3, yes
3741473963,  stefanovioltv, 3, 2, 1, yes
2507201104,  stefanospiazzi, 6, 5, 1, yes
487401738,  brunomegale1, 6, 5, 1, yes
2652874504,  andrea90de, 28, 14, 14, neutral
118316666,  mancapaolo, 7, 7, 0, yes
2521114569,  Giomuretti, 6, 5, 1, yes
564106387,  alemarino71, 4, 4, 0, yes
3380237045,  AlessioTravers4, 1, 1, 0, yes
2201663641,  pierfrac66, 9, 9, 0, yes
1391491368,  ChiariniAnna, 8, 6, 2, yes
1534316209,  JuanTheWiz, 2, 1, 1, neutral
363616701,  _Annabella_P, 14, 13, 1, yes
711468143768702976,  MattMSC74, 7, 7, 0, yes
617404862,  nicorst, 15, 5, 10, no
531214858,  rinaldoluciani, 2, 2, 0, yes
4908131657,  fineimpeUro, 3, 3, 0, yes
153149370,  icolay, 2, 2, 0, yes
737961477898964992,  ltrsmnnc, 1, 1, 0, yes
457375249,  fabelef, 6, 5, 1, yes
487388733,  AlePez53, 4, 4, 0, yes
3364282811,  ilpede75, 3, 3, 0, yes
1903648940,  AlLambitelli, 21, 18, 3, yes
254247378,  blualessandro, 11, 10, 1, yes
1312048352,  tatti_sandra, 19, 18, 1, yes
470416836,  DaminoMarco, 1, 1, 0, yes
2785020203,  lucamaggio82, 14, 11, 3, yes
1534786369,  ChriNesta13, 15, 2, 13, no
2990367712,  LLlimpe, 1, 1, 0, yes
3695223196,  Crociato_Dentro, 2, 2, 0, yes
1098289812,  Naranmike, 5, 3, 2, yes
438849246,  antonio_bordin, 52, 31, 21, yes
318575239,  ErCandela, 15, 4, 11, no
799115214,  LucaDarsie, 11, 11, 0, yes
3313579126,  BraminiRiccardo, 4, 4, 0, yes
168782371,  Foy84, 10, 6, 4, yes
421914819,  Denise710s, 4, 4, 0, yes
440711185,  redhansock, 1, 1, 0, yes
734015798348484608,  lavoceamedovuta, 1, 1, 0, yes
331818949,  TheDudeHunter, 1, 1, 0, yes
270382626,  JosephJosephDM, 10, 9, 1, yes
22755772,  jonmarco_church, 2, 2, 0, yes
471888854,  KappaRar, 25, 25, 0, yes
3351926470,  Enzo_Bernardini, 51, 36, 15, yes
2351374334,  pesce1964, 4, 3, 1, yes
411668419,  Massimoin140, 1, 1, 0, yes
396547794,  IH870, 16, 16, 0, yes
514599606,  fornasieroa, 1, 1, 0, yes
4197625936,  giannielle1, 24, 17, 7, yes
1170462018,  TheBaffometto, 1, 1, 0, yes
2976167669,  carboni_edoardo, 1, 1, 0, yes
707828793755492356,  romolodario5, 1, 1, 0, yes
359382281,  filippo_durante, 2, 2, 0, yes
1483339591,  AngeloRosano1, 6, 4, 2, yes
2484857381,  FabioBottan, 10, 8, 2, yes
492916204,  SBurbi, 40, 32, 8, yes
104490190,  three0, 1, 1, 0, yes
2997517606,  LucianoRoncada, 2, 2, 0, yes
482028780,  Ophiere, 10, 9, 1, yes
472406787,  MecoScarmoz, 1, 1, 0, yes
393220583,  cplataniaIT, 3, 1, 2, no
3919826775,  Domenico_1968, 2, 2, 0, yes
108262067,  pdvda, 100, 100, 0, yes
606259626,  TeresaBellanova, 19, 19, 0, yes
353811477,  Diamante23, 25, 18, 7, yes
482275881,  tassarottis, 5, 5, 0, yes
714002059,  cimbolano, 16, 12, 4, yes
156652786,  ippoghigno, 5, 5, 0, yes
1694527640,  zananico1890, 1, 1, 0, yes
272479276,  domenicomacchia, 1, 1, 0, yes
575284033,  grotondo1, 3, 3, 0, yes
1667773951,  Leonardourasi, 1, 1, 0, yes
4136582308,  nicolocorrado, 2, 2, 0, yes
1583259805,  maccarimiranda, 60, 3, 57, no
751148634398490624,  Grisaccia, 33, 26, 7, yes
72248630,  Agenzia_Italia, 47, 47, 0, yes
787391210377928704,  MatteoTesorell8, 8, 7, 1, yes
397862266,  chiaromont, 1, 1, 0, yes
68006505,  bisquittieri, 7, 7, 0, yes
137068692,  rubinaxxio, 3, 3, 0, yes
794522828456558592,  Rosellina45, 1, 1, 0, yes
1139845742,  IlMelvin, 3, 3, 0, yes
555183394,  Roberto_66s, 3, 2, 1, yes
2864100616,  Riccadang, 1, 1, 0, yes
2349902485,  pojetti, 4, 2, 2, neutral
2730120155,  brizanna81, 2, 2, 0, yes
993702241,  CantoniPietro, 4, 4, 0, yes
57637533,  alcarboni, 2, 2, 0, yes
3322712915,  Diego10db72, 1, 1, 0, yes
362679253,  vaLoreVita, 3, 3, 0, yes
433435963,  carmenilaria, 21, 21, 0, yes
4824967419,  LauraIlenia, 7, 6, 1, yes
3297842873,  anthos79, 5, 4, 1, yes
3386435099,  gennaroscalea, 4, 2, 2, neutral
478007140,  BarbyGmail, 2, 2, 0, yes
484581614,  el_gianluquinho, 2, 1, 1, neutral
2333745212,  MaurilioVitto, 29, 24, 5, yes
2456663500,  zehir2000, 4, 4, 0, yes
785560131954216960,  Fr4nc35color377, 4, 1, 3, no
740314382824046597,  AntonioLavarra1, 8, 4, 4, neutral
2265249203,  BonaviaDaniele, 10, 10, 0, yes
782574373534392320,  Purga89307134, 20, 10, 10, neutral
516395917,  BeetleJuyce12, 12, 10, 2, yes
57438567,  Finferlo, 2, 2, 0, yes
432646643,  Marghe_rita63, 8, 7, 1, yes
805729955879538688,  albdisparue, 5, 5, 0, yes
22037003,  leonardomaria, 1, 1, 0, yes
199194367,  piergiullare, 1, 1, 0, yes
1300592342,  raffo75, 3, 3, 0, yes
555205930,  MarcoGiorgetti5, 3, 3, 0, yes
397593095,  matisse63, 14, 9, 5, yes
714226829071151104,  Billy56267838, 30, 14, 16, no
793962515935924224,  porsche_online, 2, 2, 0, yes
1251341352,  Grillinotaleban, 12, 12, 0, yes
518334910,  PietroDegliEffe, 4, 4, 0, yes
412557872,  RomanoRomanos, 1, 1, 0, yes
4470683776,  Mhmhmh_88, 2, 2, 0, yes
574316252,  SimoneDiFra, 2, 1, 1, neutral
1165895616,  ennio_sartore, 9, 9, 0, yes
782271812084326401,  Camilla88772069, 3, 2, 1, yes
710477759496200192,  NikolasSwed, 1, 1, 0, yes
2751680561,  ETruja, 6, 6, 0, yes
437775911,  a2hadar, 18, 18, 0, yes
2221083463,  GioDL1, 12, 4, 8, no
485878133,  Cappezoo, 1, 1, 0, yes
36430879,  Lorcam9, 2, 2, 0, yes
427643545,  DiDomenicoGenny, 2, 2, 0, yes
2310261690,  Massimonelli83, 18, 8, 10, no
47705921,  Outsiderman_, 1, 1, 0, yes
384948871,  CalzettaPa, 16, 1, 15, no
386745832,  EffeConTweet, 2, 2, 0, yes
166178835,  JudahMusiq, 3, 3, 0, yes
2826936327,  gabrieledeparis, 1, 1, 0, yes
507966909,  GiammarioDiB, 15, 12, 3, yes
908072113,  RitaCantalink, 1, 1, 0, yes
410026665,  puoti89, 1, 1, 0, yes
3984693435,  67fabio67, 2, 2, 0, yes
862825219,  APortesi, 7, 6, 1, yes
1042252711,  ToscaGhibellina, 13, 7, 6, yes
406367602,  J599, 3, 2, 1, yes
845473334,  fabiosslaziomcm, 2, 2, 0, yes
1000040676,  MisterBarabba, 4, 4, 0, yes
390876101,  Anders967, 2, 1, 1, neutral
814585603,  domingorocca, 17, 14, 3, yes
535670031,  Zighinetto, 5, 4, 1, yes
3392159079,  fox_rino, 36, 18, 18, neutral
394734481,  IlCite, 4, 4, 0, yes
217178397,  Teojackson78, 9, 6, 3, yes
125655107,  mauricapri, 3, 3, 0, yes
2281680027,  AricLorenzo, 2, 2, 0, yes
752810412349988864,  DestraMia, 2, 2, 0, yes
1151426054,  YamahaNapoli, 1, 1, 0, yes
3261467549,  Eagle7982, 10, 4, 6, no
1548188768,  luiginosacchini, 1, 1, 0, yes
138408943,  MinoCardone, 2, 2, 0, yes
4860809993,  RobertoStorari, 1, 1, 0, yes
165532712,  crilucchetta, 24, 15, 9, yes
67734927,  principebras, 6, 5, 1, yes
931377188,  claudio_bellomo, 1, 1, 0, yes
235168992,  filipnet, 1, 1, 0, yes
2204006071,  davidecomotti, 4, 4, 0, yes
1338878742,  fra_stg, 6, 6, 0, yes
4850532357,  LorlanJr, 10, 7, 3, yes
586561743,  Lucanedved, 6, 6, 0, yes
101176038,  Alemor64, 3, 3, 0, yes
2152572284,  GrecOfficial, 21, 20, 1, yes
1028060143,  magistro42, 11, 6, 5, yes
531304353,  Bellantoni74, 6, 5, 1, yes
475887245,  TheRealViruZ, 17, 7, 10, no
3320750027,  RobertoBazzichi, 1, 1, 0, yes
800246184,  BovalinoLorenzo, 4, 3, 1, yes
371814769,  LUCACELESTINO, 8, 6, 2, yes
2543019165,  ApplausoRosalba, 288, 212, 76, yes
3007504107,  leokarre, 33, 17, 16, yes
327510902,  DanieleGiang, 1, 1, 0, yes
219226566,  ferrysfabio, 41, 21, 20, yes
2650582614,  renewableact, 39, 19, 20, no
555869032,  natipanchie, 12, 12, 0, yes
1648058642,  RiccardoSaliola, 1, 1, 0, yes
191059037,  liuis46, 6, 5, 1, yes
324818479,  GDS_it, 17, 16, 1, yes
3001581299,  fruncolo, 10, 8, 2, yes
592622025,  vannab7, 3, 3, 0, yes
585172516,  aprile_25, 17, 13, 4, yes
520492621,  VChiarizia, 1, 1, 0, yes
793249535657205761,  leperledi1pirla, 15, 13, 2, yes
708581628201844736,  corezzimau, 23, 14, 9, yes
4622622557,  BEPPESARNO, 23, 17, 6, yes
768885735290183680,  kristinazvarich, 5, 4, 1, yes
375517350,  crispinoenzo, 7, 1, 6, no
866605699,  MarioCavallarin, 3, 3, 0, yes
59063143,  caoscalmo, 4, 4, 0, yes
2816606222,  alanwake_71, 13, 10, 3, yes
761794543,  PattyVintage, 1, 1, 0, yes
1443830137,  fgiandi82, 40, 25, 15, yes
2331861340,  alecsandordp, 30, 13, 17, no
3044674396,  elenacolusso, 1, 1, 0, yes
368468569,  valeindie6, 5, 5, 0, yes
1150340664,  MacondoZuma, 3, 3, 0, yes
1361726894,  ghezzipier, 3, 3, 0, yes
387294426,  pi_letizia, 5, 4, 1, yes
383531511,  thecervs, 39, 33, 6, yes
993364026,  MichaelSbordoni, 1, 1, 0, yes
70093849,  ann0nae, 1, 1, 0, yes
3339999905,  ilario1900, 20, 15, 5, yes
135167434,  marchiofra, 10, 7, 3, yes
412374390,  corrado_rossi, 8, 8, 0, yes
1268094122,  DFrezet, 1, 1, 0, yes
2925710855,  MassimoTemporin, 2, 2, 0, yes
404919799,  M73Diego, 3, 1, 2, no
470554249,  GiovanniZermani, 10, 8, 2, yes
2224993088,  ciunfri, 2, 2, 0, yes
561391482,  valeryb83, 34, 21, 13, yes
418153325,  GiancarloTrevi2, 22, 18, 4, yes
1271715740,  46Mister, 6, 1, 5, no
832767270,  IreneCurcio, 21, 5, 16, no
2995507655,  arivarriale, 140, 35, 105, no
188687898,  carlocont, 1, 1, 0, yes
334715057,  halisa11, 7, 5, 2, yes
808985599,  NanniBiuglisi, 1, 1, 0, yes
49013512,  AndreaDeMarchi, 1, 1, 0, yes
1635228769,  PaoloRoma1927, 1, 1, 0, yes
4196352201,  H_Every78, 1, 1, 0, yes
292186046,  Vogliadarianuov, 4, 2, 2, neutral
423992369,  mcomanducci, 9, 9, 0, yes
26981754,  frenchitaly, 2, 2, 0, yes
410748684,  LaGrace82, 2, 2, 0, yes
719936001968381952,  _agora24, 9, 7, 2, yes
3165463553,  ela_queen82, 9, 6, 3, yes
273995451,  plongo85, 3, 2, 1, yes
746320588109676544,  181049ec, 3, 3, 0, yes
2307288968,  Valanga11, 7, 7, 0, yes
326079212,  francesala, 5, 4, 1, yes
485101194,  mirkobucci1, 16, 4, 12, no
61778308,  enricosuppo, 4, 3, 1, yes
51520888,  maurocst, 1, 1, 0, yes
3469948852,  AvolioValentina, 1, 1, 0, yes
801858993035612164,  carbottami, 15, 13, 2, yes
727247636080824321,  cristsalis, 6, 5, 1, yes
1887540750,  MADGian, 2, 2, 0, yes
1264930363,  CipMauro, 8, 4, 4, neutral
413194935,  MarianoOucinde, 3, 3, 0, yes
249778050,  teghinho, 1, 1, 0, yes
262634878,  maurizio_fava, 3, 1, 2, no
352370002,  IvanZoppi, 1, 1, 0, yes
108959881,  figuredisfondo, 13, 11, 2, yes
803695405406048256,  Beppe_Bolla, 11, 9, 2, yes
106772715,  qn_lanazione, 1, 1, 0, yes
425303518,  RobertoGerotto, 2, 2, 0, yes
2371186828,  CameraSc25, 3, 2, 1, yes
469182544,  ioscabot, 4, 4, 0, yes
3365743337,  giuliamassoni4, 4, 3, 1, yes
763393541427105792,  orsaminore3, 3, 3, 0, yes
2341872502,  Shlomo_75, 29, 25, 4, yes
2878408107,  emycast1968, 43, 20, 23, no
793765541848682496,  brvnf, 6, 3, 3, neutral
627669651,  alenmatteo, 4, 3, 1, yes
302499677,  Gio72ga, 1, 1, 0, yes
390259533,  AlbertoAlbianna, 8, 8, 0, yes
756364930413129728,  cobra9122, 2, 2, 0, yes
2339922708,  Ma_Anche_Noo, 9, 9, 0, yes
2783991625,  david68io, 1, 1, 0, yes
86351052,  fabrycambriani, 1, 1, 0, yes
1492164349,  fa_cost, 20, 19, 1, yes
199166155,  giufenn, 2, 2, 0, yes
47925074,  corrini, 3, 3, 0, yes
718115948176261120,  Lagartixa86, 3, 3, 0, yes
325564671,  gvecchi, 2, 2, 0, yes
778647667039690752,  SuperSblinda, 35, 23, 12, yes
3233007315,  ivandrudi, 2, 2, 0, yes
485795272,  electropote, 1, 1, 0, yes
1937328956,  saverioted, 1, 1, 0, yes
2344914234,  callloggero, 2, 2, 0, yes
295979023,  GiacomoCagnoli, 1, 1, 0, yes
273429813,  MariellaOttieri, 1, 1, 0, yes
407964674,  AlesVich, 1, 1, 0, yes
403440013,  MicheleFois, 1, 1, 0, yes
66969520,  albertoroscigno, 3, 3, 0, yes
510081353,  NicoloSp, 2, 2, 0, yes
34562441,  RafitaC, 7, 4, 3, yes
1165412916,  RobertoDeLicio, 16, 9, 7, yes
31430845,  virginia_W_, 1, 1, 0, yes
4182262997,  Vendite67, 2, 2, 0, yes
577308753,  _MrOrange_, 12, 11, 1, yes
3329362990,  m_torneo, 2, 2, 0, yes
376145932,  leonardicarmen, 32, 14, 18, no
22118394,  pollo925, 3, 3, 0, yes
774184568433762304,  MGDeQualcosa, 3, 3, 0, yes
735473303876407296,  StefanoBcancer, 4, 4, 0, yes
256435935,  GENGHISKHAN2, 6, 3, 3, neutral
231414854,  filigue78, 17, 16, 1, yes
496745822,  dorico_64, 1, 1, 0, yes
387351136,  giorgiobellac, 1, 1, 0, yes
335343661,  GiaCampaniolo, 3, 3, 0, yes
2813922736,  BiazzoRiccardo, 34, 21, 13, yes
1970633288,  mrossi12754, 1, 1, 0, yes
541071029,  SalvaStef, 14, 8, 6, yes
105165506,  kiyuubi, 2, 2, 0, yes
908126539,  piogene, 37, 34, 3, yes
2873941104,  JattaVetta, 9, 7, 2, yes
1244788844,  Matteo_Tir, 3, 3, 0, yes
784655540874076161,  plmorandini, 5, 3, 2, yes
734421722989010948,  42rosa99, 1, 1, 0, yes
455878828,  MisterGriecus, 1, 1, 0, yes
756309170136031232,  Michael_vee92, 1, 1, 0, yes
793170005672198149,  antonio25904, 8, 4, 4, neutral
1135323564,  rlaporta2010, 8, 8, 0, yes
29237598,  trascendency, 2, 1, 1, neutral
187194155,  Pigaye, 1, 1, 0, yes
20230534,  veroxxx, 3, 3, 0, yes
115439165,  adjbomber, 1, 1, 0, yes
2508603779,  marantofgd, 1, 1, 0, yes
1117253024,  MarinaGandi, 1, 1, 0, yes
2732373033,  sfurius75, 17, 14, 3, yes
1211212620,  gianmaria_s, 1, 1, 0, yes
313956473,  diegomarra1, 2, 2, 0, yes
708587318786007040,  luigipanico66, 110, 43, 67, no
210822189,  999nuvola, 18, 13, 5, yes
706067859550695426,  Mauro5514, 114, 30, 84, no
759853330692616193,  Spaces92Demy, 14, 13, 1, yes
2258080003,  guidaspettacolo, 4, 4, 0, yes
4126991757,  AnnaReds1962, 1, 1, 0, yes
2882255068,  titosofi78, 1, 1, 0, yes
1257520999,  DomenicoAiello_, 3, 3, 0, yes
1204999254,  antoninoporpigl, 23, 14, 9, yes
2748801657,  fuoridallepalle, 31, 28, 3, yes
3102185913,  lelepera1, 1, 1, 0, yes
25110317,  MarcoMenu, 2, 2, 0, yes
713449513088888833,  pm_lagiusy, 35, 7, 28, no
453139074,  guidobellumori, 3, 3, 0, yes
769653263595700224,  volontanaz, 15, 15, 0, yes
526735998,  JoseConsilvio, 37, 33, 4, yes
10382002,  GiadaGiorni, 13, 10, 3, yes
919502593,  Catebarbieri, 17, 4, 13, no
1638122504,  mirosmenil, 1, 1, 0, yes
4180762211,  RenatoOrsini2, 10, 10, 0, yes
3240122307,  14aldo59Aldo, 27, 14, 13, yes
145404573,  pdasti, 3, 3, 0, yes
697707497981870080,  aleandre0212, 2, 2, 0, yes
2697659090,  Gioppino91, 9, 9, 0, yes
217481916,  Lilletterato, 4, 2, 2, neutral
627320497,  dguenza, 5, 5, 0, yes
2889628751,  preciousvliam, 32, 18, 14, yes
454725101,  amelusi, 2, 2, 0, yes
1039809824,  AriannaCensi, 3, 3, 0, yes
3305062853,  mimibanesi, 4, 4, 0, yes
2369487328,  CCaterina61, 8, 7, 1, yes
31499282,  x_Aeris_x, 6, 6, 0, yes
1065330810,  Giampao16412189, 7, 7, 0, yes
728120974223118336,  FlaviaDegreg, 3, 3, 0, yes
802979230409719809,  Riscossaitalia1, 19, 18, 1, yes
850130671,  roccomarone76, 10, 5, 5, neutral
754512084315103232,  oltre64, 6, 3, 3, neutral
320737259,  Vannini2016, 18, 18, 0, yes
778693643976581120,  Viola_mg, 17, 7, 10, no
341422666,  GianPieroCroppo, 3, 2, 1, yes
761232304182333442,  michele1620, 4, 3, 1, yes
521715693,  nene1311961, 4, 1, 3, no
534338579,  FaenzaWebTv, 2, 2, 0, yes
480645077,  valeriafedeli, 7, 5, 2, yes
373384670,  Artefutura, 6, 5, 1, yes
446846363,  Dario55DARIO, 1, 1, 0, yes
3088279515,  pallonerosario, 2, 2, 0, yes
88909974,  grillodistratto, 1, 1, 0, yes
414073475,  davidegenova86, 2, 1, 1, neutral
2228739276,  gdnovara, 19, 19, 0, yes
416923575,  caterinapes, 1, 1, 0, yes
2828396831,  stikystikazz, 30, 19, 11, yes
591223321,  daniele_vitali, 3, 3, 0, yes
63504882,  ruspante, 1, 1, 0, yes
763353589347672064,  PaoloTroia7, 331, 148, 183, no
787371102,  LAnnibali, 1, 1, 0, yes
3064914777,  ClarabellaBest, 4, 4, 0, yes
2421057778,  ArchGarufi, 3, 2, 1, yes
22622878,  carloapostoli, 2, 2, 0, yes
757173570783043585,  ugopavo, 32, 30, 2, yes
713976468,  PinoCalicchia, 1, 1, 0, yes
795300128231985152,  stefanoelpis, 3, 2, 1, yes
3026997358,  lucianobendine1, 3, 3, 0, yes
491495588,  Mambo0295, 2, 2, 0, yes
4775464589,  FondazioneEYU, 3, 3, 0, yes
439883787,  vilmanicolini, 8, 8, 0, yes
1857810883,  nica_maya, 4, 3, 1, yes
1900191667,  PDdelTrentino, 5, 5, 0, yes
771326596452061186,  farecivile, 5, 4, 1, yes
791048239231463424,  darianoumova1, 1, 1, 0, yes
802931774057803776,  RaffaeleDiNard6, 1, 1, 0, yes
3054231435,  ronal_DieCi, 58, 16, 42, no
306201783,  marcopal71, 1, 1, 0, yes
796345646047514624,  stivanelloloris, 1, 1, 0, yes
385952157,  mikymor81, 8, 8, 0, yes
27660447,  alessiodegiorgi, 11, 11, 0, yes
459950359,  DuttoEmanuele, 1, 1, 0, yes
3310852186,  fradg22, 16, 15, 1, yes
2830072450,  fedecolo912, 1, 1, 0, yes
793026146183053312,  SnaidAngelo, 6, 5, 1, yes
394598844,  GennaStefano, 26, 19, 7, yes
4624536622,  Maria70231992, 56, 56, 0, yes
142341891,  antobari62, 3, 3, 0, yes
481429106,  andlic, 1, 1, 0, yes
1464197947,  TronconiMassimo, 17, 12, 5, yes
3122280521,  andrealodovici3, 28, 25, 3, yes
469760654,  wildmariop, 5, 4, 1, yes
257064557,  PdMilano, 70, 70, 0, yes
1140071011,  RRaffone, 19, 15, 4, yes
4866066394,  AlessioPassoni, 2, 2, 0, yes
467729351,  Andrea_Biral, 2, 2, 0, yes
114447994,  giuldigr, 1, 1, 0, yes
225105585,  GaeDeRoberto, 68, 6, 62, no
81707635,  _elvio_, 2, 1, 1, neutral
3401622281,  Donna91120165, 2, 1, 1, neutral
895733684,  RVisini, 5, 5, 0, yes
2360517815,  ghi_ang, 15, 9, 6, yes
1331603618,  FrancescaDiFeli, 3, 3, 0, yes
780061710153617408,  NicolaEugenio, 1, 1, 0, yes
2447769211,  marialibergo, 2, 2, 0, yes
4871676707,  slavinarosanna, 11, 8, 3, yes
852421039,  CarloTromby, 2, 2, 0, yes
2195938336,  AdessoValdaso, 3, 3, 0, yes
2520633616,  fsartori73, 2, 2, 0, yes
2651274657,  fsavorani, 27, 26, 1, yes
1063419002,  pgcarmelita, 1, 1, 0, yes
39212405,  PaoloRibichini, 2, 2, 0, yes
2172507394,  MResidori, 6, 6, 0, yes
365423540,  andreini_cesare, 15, 15, 0, yes
1008729344,  LuigiRanaldi, 1, 1, 0, yes
37611038,  clavolt, 3, 3, 0, yes
1027581487,  MagdaCulotta, 4, 4, 0, yes
58295593,  michele85_1, 2, 2, 0, yes
1019311248,  ValerioPetralia, 3, 3, 0, yes
795964357893046272,  erica82082641, 21, 14, 7, yes
617844082,  MarabottoMP, 1, 1, 0, yes
3296308087,  malezixxx, 3, 2, 1, yes
3198957963,  LaVallonga, 2, 2, 0, yes
2378458508,  MariaTrani2, 1, 1, 0, yes
909935803,  robertobarale63, 32, 6, 26, no
565630731,  BergnaUte, 8, 8, 0, yes
461560547,  castag01, 3, 3, 0, yes
403799808,  MattiaGiorno, 5, 5, 0, yes
435135749,  lastep440, 14, 13, 1, yes
37619931,  alevale90, 13, 9, 4, yes
703215154897485826,  JonnyLassa17, 21, 16, 5, yes
122785870,  fipo972, 3, 2, 1, yes
971971394,  MoniRegazzi, 1, 1, 0, yes
2875231648,  avvocatogiacca, 5, 5, 0, yes
428262591,  GargiuloSara, 9, 9, 0, yes
2734920292,  cicciomellace, 5, 3, 2, yes
749611364,  pietroscarpact, 8, 6, 2, yes
1390233025,  bignerina, 4, 4, 0, yes
2372583034,  mazzotticri, 1, 1, 0, yes
443230830,  EnzoBassman, 12, 11, 1, yes
1732138508,  Gio_Fittante, 2, 2, 0, yes
605695196,  toninosrb, 2, 2, 0, yes
542008895,  davide110373, 1, 1, 0, yes
732976802,  VRoppo, 1, 1, 0, yes
407062660,  paolacaloo, 24, 24, 0, yes
955521362,  simonettapelle1, 4, 4, 0, yes
2760310807,  adele_laudano, 3, 2, 1, yes
778276896215891973,  MeglioUnSi, 5, 5, 0, yes
2377659453,  macleonchen, 4, 4, 0, yes
733519268,  robertosaliola, 6, 6, 0, yes
520206776,  giampietrogiova, 18, 14, 4, yes
753348295,  gualtj, 2, 2, 0, yes
3003451715,  locant76, 5, 4, 1, yes
2895721301,  Capsicum__, 2, 2, 0, yes
26760769,  chiara_meazza, 11, 11, 0, yes
590393555,  veracorso2, 35, 33, 2, yes
829545702,  SalvatoreBranc7, 1, 1, 0, yes
347977926,  paputtina, 3, 3, 0, yes
3253773825,  endorman23, 6, 6, 0, yes
790475358978076672,  PdGhilardotti, 1, 1, 0, yes
102624717,  GabriBerretta, 1, 1, 0, yes
2874413313,  Giusepp31091622, 2, 2, 0, yes
437790954,  CollinaStefano, 5, 4, 1, yes
773277137554079745,  Vooorex1, 1, 1, 0, yes
600395893,  ebelletti63, 1, 1, 0, yes
1374923707,  archflacis, 7, 7, 0, yes
597720862,  logicasbilenca, 12, 12, 0, yes
2884898632,  americomorsini, 2, 2, 0, yes
746297770559012864,  ATuttolani, 7, 7, 0, yes
474640522,  galinovic1000, 3, 3, 0, yes
1640181332,  Lavinia_Ariel, 1, 1, 0, yes
14518092,  alybabafaye, 1, 1, 0, yes
3423827193,  Tonycamion1, 1, 1, 0, yes
1163304648,  DeLuiseAngelo, 3, 2, 1, yes
573986602,  menteveloce, 54, 32, 22, yes
501792745,  agriju, 5, 5, 0, yes
1091722920,  valeriabaglio, 4, 4, 0, yes
1001239345,  GM_Ficara, 27, 17, 10, yes
500034455,  alfsalerno, 29, 23, 6, yes
66631998,  miconsento, 4, 4, 0, yes
581752139,  guarracino1969, 18, 16, 2, yes
504354294,  DidiogGiuseppe, 14, 8, 6, yes
197198251,  freekess, 7, 6, 1, yes
441074956,  pierluigilupi, 4, 4, 0, yes
2456837270,  pier30660198, 19, 8, 11, no
727223148677087236,  cngeologi, 26, 26, 0, yes
2486417223,  DatboyTrlppleD, 3, 3, 0, yes
371643550,  SimoneBenetazzo, 3, 3, 0, yes
28724819,  Reset_Italia, 12, 12, 0, yes
2365807541,  LuccDe, 6, 5, 1, yes
4866822466,  Carlo490317591, 49, 10, 39, no
1594184960,  Catia66Catia, 170, 131, 39, yes
445546968,  Jezabel84, 88, 67, 21, yes
776421220451512320,  PatriziaMarchi6, 70, 35, 35, neutral
3644459056,  d_daddeo, 19, 15, 4, yes
722317619022471168,  giuseppetulone1, 8, 8, 0, yes
4853472419,  positivo311, 152, 117, 35, yes
763094873473945604,  protothaca, 189, 150, 39, yes
754664352855236608,  simona13364697, 62, 57, 5, yes
611454326,  profeta1981, 24, 21, 3, yes
1573078681,  chiccamonopolii, 48, 6, 42, no
910729081,  dimitridue, 11, 11, 0, yes
62756558,  MrErbetta, 3, 2, 1, yes
16246240,  luigicrespi, 19, 11, 8, yes
247505099,  paolavalenti29, 11, 5, 6, no
3304738317,  stefanobiker75, 4, 3, 1, yes
4196122397,  Cybeo66, 27, 10, 17, no
590251970,  Flaviop1972, 3, 3, 0, yes
754316808396701696,  RosamariaCarus1, 47, 44, 3, yes
220808189,  gdb77, 2, 2, 0, yes
236546318,  FraOttaviano, 9, 7, 2, yes
4266998643,  LauraMaggio6, 32, 27, 5, yes
3289645138,  vitapin25, 45, 42, 3, yes
4528485567,  bs_massimiliano, 52, 28, 24, yes
2570433418,  LaSara_SaSa, 19, 10, 9, yes
1116303050,  MassimoWindowc, 7, 7, 0, yes
497880739,  Fede_gir, 23, 10, 13, no
4513314623,  ape_firenze, 20, 11, 9, yes
723448563821244416,  SaraBeltrami, 29, 17, 12, yes
2940999287,  lumaca4377, 79, 24, 55, no
2631647879,  cettabone, 7, 7, 0, yes
2597514174,  PintoVita, 29, 25, 4, yes
407739010,  DeborahGonella, 8, 4, 4, neutral
273113501,  Annalisa_Ape, 23, 10, 13, no
1008958405,  ITTEMOC, 77, 58, 19, yes
479677859,  Alchex89, 48, 41, 7, yes
781240727380619265,  giorgio2354, 8, 8, 0, yes
753720514510815232,  paola_pescatore, 19, 10, 9, yes
754060114886324224,  annagrapagano1, 19, 9, 10, no
1114146019,  vamesa84, 17, 7, 10, no
753884370944004096,  MEsposito1987, 27, 13, 14, no
704773966850867200,  valesq2, 28, 13, 15, no
1344773354,  BRositani, 13, 12, 1, yes
1479802314,  ConversioneOrg, 19, 13, 6, yes
2148135826,  LaFrancaEffe, 28, 23, 5, yes
1118930598,  cuordipietra, 6, 6, 0, yes
754055560895528960,  mariamartino80, 16, 8, 8, neutral
753877865645674496,  CaterinaP10, 27, 11, 16, no
753921440194461696,  Veronic66389936, 13, 5, 8, no
753690812983238656,  Fiona110378, 23, 11, 12, no
4181089545,  Lilil984, 22, 10, 12, no
54918431,  wolf28081968, 16, 14, 2, yes
1112068350,  luigimenta, 7, 7, 0, yes
439131272,  GcColombo, 16, 9, 7, yes
1007560902,  pamy12001, 19, 12, 7, yes
2535866450,  Gino_Autieri, 5, 2, 3, no
481227308,  francescatraldi, 13, 10, 3, yes
14490966,  danilla, 11, 5, 6, no
1275951780,  beamessina, 4, 2, 2, neutral
744514206360281088,  bianca_log, 5, 3, 2, yes
247325957,  alevasce, 4, 2, 2, neutral
151109371,  franco_giovani, 6, 2, 4, no
329024184,  AndreaBozzalla, 6, 3, 3, neutral
2252673458,  cryrho, 11, 5, 6, no
477626282,  TommyPinazzi, 5, 2, 3, no
420548533,  carelliroma, 16, 15, 1, yes
400380929,  MagattiBruno, 2, 2, 0, yes
3610344497,  GiancarloVarot4, 10, 5, 5, neutral
2703729438,  launellGb, 12, 12, 0, yes
432304612,  GToccafondi, 18, 18, 0, yes
418208469,  Redpurpleshire, 5, 5, 0, yes
3041758444,  macrovba, 16, 10, 6, yes
407162151,  caccialinda, 3, 3, 0, yes
191542718,  Tiziana008, 4, 3, 1, yes
1943087478,  Mix24_r24, 35, 25, 10, yes
76615199,  TermometroPol, 29, 20, 9, yes
3413443713,  ScopelliTweet, 10, 10, 0, yes
697822738510147584,  TiberSeptim27, 2, 2, 0, yes
723818739712581633,  esecrable, 41, 40, 1, yes
2838050620,  Farinelli_Eug, 2, 2, 0, yes
454173647,  tizianamaiolo, 16, 12, 4, yes
379874865,  GioeleUrso1, 4, 4, 0, yes
81937838,  sergiosinteg, 5, 4, 1, yes
405792148,  stiuy78, 2, 2, 0, yes
4701923905,  el_maligno_m, 53, 40, 13, yes
943426963,  GiovanniLaMagn2, 6, 4, 2, yes
753351020265218048,  VecchioTobia, 18, 17, 1, yes
388234689,  cav_errante, 4, 4, 0, yes
505202421,  LiveYoucom, 11, 11, 0, yes
188390069,  semingro, 5, 5, 0, yes
596702756,  BepKar, 43, 16, 27, no
1180247125,  afribix, 3, 3, 0, yes
2219606004,  Fabryghe, 2, 2, 0, yes
86347667,  g_alfano, 3, 3, 0, yes
3101569065,  FerranteGonzaga, 3, 3, 0, yes
3930314836,  kissmeluna641, 46, 39, 7, yes
247863643,  convivioblog, 24, 22, 2, yes
584806981,  Ruggio66, 3, 3, 0, yes
89659464,  vmontalto, 3, 3, 0, yes
418639778,  bettabettanesi, 31, 31, 0, yes
2612652422,  italygenocide, 124, 67, 57, yes
400154764,  SperiamoInBene, 4, 4, 0, yes
425180159,  JIMBODOJIBE, 2, 2, 0, yes
522457817,  valentinocossu, 117, 4, 113, no
1011559662,  AriannaFesta1, 29, 5, 24, no
430844411,  eaulierre, 4, 2, 2, neutral
3008526447,  2015blackdog, 16, 13, 3, yes
2243105962,  BPtobia, 29, 4, 25, no
728897876072534016,  elenab1939, 13, 6, 7, no
771382993076252677,  pd_andria, 2, 2, 0, yes
210501383,  Radio1Rai, 36, 26, 10, yes
172444822,  tmariani40, 6, 5, 1, yes
1654904510,  Unbelamico, 2, 2, 0, yes
29269332,  streethawk70, 3, 3, 0, yes
2207852354,  giuseppeadurno, 19, 18, 1, yes
431622091,  mariobianchi18, 31, 21, 10, yes
724303327077502976,  1205fiorella, 49, 28, 21, yes
1076597023,  AIaculli, 34, 8, 26, no
337155946,  IlMattinoFoggia, 93, 13, 80, no
238990492,  Mattiamasini18, 36, 17, 19, no
147543162,  forza_italia, 379, 33, 346, no
2150969605,  IlMattinale, 326, 30, 296, no
413215193,  antonellaiovin7, 34, 5, 29, no
2834332673,  rogerpiton29, 3, 3, 0, yes
2308488378,  CELI_NLP, 2, 1, 1, neutral
2400465787,  teored99, 9, 5, 4, yes
970640923,  SalvatoreHD, 7, 4, 3, yes
752244313875251200,  tiziana75294010, 19, 11, 8, yes
115887435,  Empolitica, 26, 24, 2, yes
801754928356134912,  MariaCr17199245, 4, 3, 1, yes
1199740002,  Francesco_Sarci, 10, 10, 0, yes
2451846485,  fantastilandia, 18, 17, 1, yes
19180235,  andreasbisiach, 2, 2, 0, yes
3342884483,  cangius1962, 32, 8, 24, no
1369521278,  cippolippo_, 2, 2, 0, yes
3038624596,  SPiersantelli, 10, 10, 0, yes
4925341691,  Palomar_CV, 36, 21, 15, yes
2382275202,  LaCnews24, 16, 10, 6, yes
1930118646,  gius_cole, 8, 6, 2, yes
718386886172110848,  ofcs_report, 42, 31, 11, yes
554236154,  5untsu, 10, 9, 1, yes
1201691502,  Marte7983, 48, 30, 18, yes
1192998770,  venerandomonell, 16, 16, 0, yes
588607464,  MicheleInsuranc, 3, 3, 0, yes
1713220644,  milenaboccardo, 4, 2, 2, neutral
2894775544,  picardi65, 13, 6, 7, no
340803178,  fulviogiuliani, 27, 14, 13, yes
276080934,  enrico_salvucci, 4, 2, 2, neutral
1946489059,  jachedeleo, 28, 13, 15, no
856535857,  patlidonni, 4, 3, 1, yes
785129133009494021,  thewaterflea, 38, 15, 23, no
400811586,  MassimoMisiti, 19, 8, 11, no
529639829,  MassimoArc, 3, 2, 1, yes
279067774,  aledavi07, 3, 2, 1, yes
2206549446,  CapitanHarloc13, 48, 19, 29, no
2858833809,  DiTrocc, 8, 8, 0, yes
2991945461,  903d361525e24d4, 9, 7, 2, yes
2365011298,  lavynya2003, 64, 48, 16, yes
406453295,  MPAPA090, 60, 50, 10, yes
804712411,  PeprValeria, 15, 15, 0, yes
700397826824654848,  manuela_natella, 26, 25, 1, yes
1032615842,  a_meluzzi, 25, 13, 12, yes
779306269190553601,  IleanaRiparbel4, 19, 11, 8, yes
142298246,  loverddhh, 5, 1, 4, no
398391979,  CarmenAbbazia, 5, 4, 1, yes
39220730,  Fantasticheria, 3, 3, 0, yes
611617045,  Antonio60849890, 13, 12, 1, yes
2436489082,  ADilaghi, 11, 9, 2, yes
133207676,  Macrida2, 17, 17, 0, yes
1944771061,  kermitt72, 11, 11, 0, yes
373563902,  luchioluli, 6, 6, 0, yes
327799914,  RM_Zanzy, 21, 17, 4, yes
512851889,  FedericoCarboni, 6, 3, 3, neutral
1040508391,  damijanterpin, 2, 2, 0, yes
2369161692,  fabioza7, 3, 3, 0, yes
1059127664,  NereoPieri, 8, 5, 3, yes
2779494825,  caradeIegends, 7, 6, 1, yes
34556545,  giulioricciardi, 38, 20, 18, yes
413181725,  FESMontemaggi, 4, 1, 3, no
525706428,  casagranden, 3, 1, 2, no
621918240,  paola_colella, 3, 3, 0, yes
3315326793,  RighettiTW, 4, 4, 0, yes
2401743697,  stefi1966r, 30, 19, 11, yes
1146147427,  sil_viar0, 12, 9, 3, yes
1118851009,  Danstellina, 27, 10, 17, no
3036997071,  alesco751, 18, 11, 7, yes
593817814,  QuestoTizio, 27, 16, 11, yes
765233673390137344,  silviantrovato, 3, 3, 0, yes
1041804853,  LuciGuenz, 24, 18, 6, yes
72286117,  valeriamanieri, 3, 3, 0, yes
74707629,  RadioRadicale, 51, 38, 13, yes
2194614692,  jeremy_longo, 4, 4, 0, yes
483775933,  AlbertaToschi, 1, 1, 0, yes
50328514,  Ruggero_Po, 3, 3, 0, yes
206122291,  PDlondra, 9, 9, 0, yes
3196161154,  mikesolle, 2, 2, 0, yes
339532820,  IVejvoda, 2, 2, 0, yes
751848609348513794,  Bastaunsi_UK, 1, 1, 0, yes
763044924526825476,  MariaElide5, 11, 10, 1, yes
465471249,  AleMiglioz, 7, 7, 0, yes
2445985513,  SpumonlCafe, 2, 2, 0, yes
484854030,  Walter_Rapetti, 3, 3, 0, yes
2800452793,  acerbosocial, 2, 2, 0, yes
2770486810,  loredanarducci, 1, 1, 0, yes
403028375,  StefanoVaccara, 4, 4, 0, yes
455777345,  rosalinobove, 38, 18, 20, no
590342488,  AsiloinEuropa, 1, 1, 0, yes
3115956339,  Osservatorio_EU, 5, 5, 0, yes
1545193808,  EducazioneD, 2, 2, 0, yes
702574408381153281,  VincenzoBrigug3, 3, 3, 0, yes
1709852983,  UniBasilicata, 1, 1, 0, yes
3044586266,  mg_sassi, 3, 3, 0, yes
383922811,  ewejel, 6, 6, 0, yes
3191220899,  MarcoPiantini, 3, 3, 0, yes
581655284,  d_agosti, 5, 5, 0, yes
2921972553,  FeliceMarcoccia, 2, 2, 0, yes
716188439826329600,  rossageranio, 2, 1, 1, neutral
435152397,  gioianniello, 5, 5, 0, yes
3343856697,  SpeziaEps, 1, 1, 0, yes
26471908,  FedericoTaddia, 2, 2, 0, yes
493891703,  fabrizio_cocco, 2, 2, 0, yes
2356839824,  d_ficola, 5, 4, 1, yes
2432410861,  PD_community, 8, 8, 0, yes
85112085,  gero_ciulla, 5, 5, 0, yes
317061225,  pennililla, 3, 3, 0, yes
50607979,  grimjfoot, 2, 2, 0, yes
461889611,  Calrenet, 2, 2, 0, yes
1966419620,  FlavioB60, 14, 10, 4, yes
2565885655,  BeatriceCovassi, 3, 3, 0, yes
246379326,  TomaszKoguc, 2, 2, 0, yes
2445286363,  SteKastel, 1, 1, 0, yes
633764580,  EuromedCarrefou, 5, 5, 0, yes
1150497067,  FeliciaPelagall, 4, 4, 0, yes
2331847077,  guffanti_marco, 3, 1, 2, no
2370895019,  ElvisOvidioP, 2, 2, 0, yes
789577810637619200,  lauraanno2016, 91, 82, 9, yes
784288703422222337,  uncittadino2, 2, 1, 1, neutral
4381795217,  PDFirenzeMet, 10, 10, 0, yes
52999694,  asgi_it, 5, 3, 2, yes
596364695,  MYPR_, 1, 1, 0, yes
29416653,  LaStampa, 15, 13, 2, yes
2540070350,  tommaso11021989, 12, 10, 2, yes
482919855,  ednuoro, 2, 2, 0, yes
3122737721,  SpazioLavoro, 1, 1, 0, yes
335604422,  novinariurednik, 1, 1, 0, yes
2173240600,  _Profeti, 4, 4, 0, yes
3697986022,  RosaliaUngaro, 5, 0, 5, no
556978533,  UgoVolli, 5, 1, 4, no
424989077,  italmud, 8, 0, 8, no
2951587293,  ParoloPatrizia, 500, 277, 223, yes
2508437306,  MrWhite3556, 25, 6, 19, no
3855759741,  moreno_zl78, 9, 1, 8, no
1256994919,  simonereppucci, 4, 1, 3, no
703037640191451136,  uncittqualsiasi, 9, 3, 6, no
1020439818,  schermoapois, 5, 3, 2, yes
1076080333,  ImpreseEdili, 5, 5, 0, yes
2453025136,  igsammarco, 9, 9, 0, yes
2845018504,  romanoziroldo, 61, 23, 38, no
2823948397,  GiovDefilippis, 3, 3, 0, yes
298586862,  max_gio, 10, 9, 1, yes
3047866432,  MnMick62, 4, 4, 0, yes
1712830392,  eryka_bo, 125, 106, 19, yes
1035460693,  attilioc39, 22, 16, 6, yes
3331059982,  RicBattaglia, 72, 34, 38, no
330554495,  alpardu, 12, 11, 1, yes
2250752450,  CacciaDominioni, 4, 3, 1, yes
1035376896,  MamolkcsMamol, 39, 24, 15, yes
476053480,  vaniacavi, 37, 22, 15, yes
2389687188,  LuigiGuazzoni, 15, 7, 8, no
50746264,  giuseppec78, 7, 7, 0, yes
3432829703,  PdGela, 3, 3, 0, yes
419181815,  enzocarnazza, 12, 10, 2, yes
593523410,  maxi75vr, 14, 11, 3, yes
986244024,  FraLaRosa, 5, 0, 5, no
443484477,  donato_salvator, 5, 1, 4, no
978514940,  francescacapec1, 210, 184, 26, yes
1972410698,  ilariafurfori, 99, 89, 10, yes
782868536083505152,  SilviaCarciofi, 94, 69, 25, yes
2242128824,  FareTurismo, 1, 1, 0, yes
751124618832994306,  beria_giancarla, 7, 5, 2, yes
4859642074,  lagalsi, 18, 10, 8, yes
2345132599,  radiostatale, 1, 1, 0, yes
39021064,  lucadegennaro, 1, 1, 0, yes
3855307522,  Rettore_, 1, 1, 0, yes
1336254342,  SilviaCostaEU, 10, 10, 0, yes
747123888,  parniquotidiani, 22, 6, 16, no
416157197,  CarloAmenta1, 3, 1, 2, no
440247035,  Zampaglion, 93, 20, 73, no
2856598563,  giordano781, 17, 13, 4, yes
2786178562,  simonato_romina, 1, 1, 0, yes
780498491038654469,  mardjana_veld, 1, 1, 0, yes
1298935814,  amanmann15, 1, 1, 0, yes
125070146,  smirnoff1978, 12, 12, 0, yes
1399181432,  mgloreto, 1, 1, 0, yes
275642444,  EnitMadrid, 1, 1, 0, yes
411670414,  SilviaStanhome, 23, 21, 2, yes
1665372661,  SCOPROGIOCANDO, 1, 1, 0, yes
238697794,  manebimus58, 3, 3, 0, yes
81590832,  PaolaMerate, 4, 3, 1, yes
2743096235,  architettoerra1, 3, 1, 2, no
351678178,  Fragatton1, 3, 2, 1, yes
215374702,  raspa90, 15, 11, 4, yes
180797919,  sogno93, 2, 2, 0, yes
125927136,  Arlock965, 1, 1, 0, yes
757863319374032896,  artem_napoli, 1, 1, 0, yes
295181430,  giulio_stumpo, 1, 1, 0, yes
1428407442,  SMartIt_twitt, 1, 1, 0, yes
347549136,  mironzola85, 1, 1, 0, yes
492371310,  Piero_Martino, 1, 1, 0, yes
2160946687,  biagiodimatteo, 38, 15, 23, no
1047889304,  lifeofpi_sto, 1, 1, 0, yes
2424302604,  bronsette, 1, 1, 0, yes
3014148579,  BerniniOrtensi1, 1, 1, 0, yes
474378609,  AndlBerk, 1, 1, 0, yes
2480232105,  LyndaJencks597, 1, 1, 0, yes
725060346776555524,  CorradaPatrizia, 56, 30, 26, yes
181629711,  piccolocafenyc, 6, 6, 0, yes
126049704,  nellina99, 22, 11, 11, neutral
574852251,  angelop71, 1, 1, 0, yes
3123797819,  Moon3White, 2, 1, 1, neutral
2831354135,  mar_cossu, 4, 4, 0, yes
2448698148,  ang7tay, 1, 1, 0, yes
754773415106580481,  heavenlydogz, 1, 1, 0, yes
2168547995,  sider1853, 2, 2, 0, yes
155300542,  87Sary, 11, 5, 6, no
2935579594,  catsfromulthar, 1, 1, 0, yes
87457267,  andpoli, 6, 1, 5, no
4189744097,  EdiDecarolis, 10, 7, 3, yes
3374821605,  argentomaris1, 1, 1, 0, yes
477119535,  melissah777, 1, 1, 0, yes
731710305009582080,  duchessasia, 1, 1, 0, yes
700393601,  AfricanWoman14, 1, 1, 0, yes
3991656856,  MaureenDe2, 1, 1, 0, yes
4195803856,  GretaAstpc, 1, 1, 0, yes
870395221,  anfesibena, 33, 19, 14, yes
2935219756,  drp_anna, 3, 1, 2, no
2466589783,  gabrisorrenti, 43, 14, 29, no
88017073,  andreacatizone, 14, 14, 0, yes
101782488,  Sportygirl73, 1, 1, 0, yes
729124306928676869,  SharonG10647046, 1, 1, 0, yes
2477578395,  995h4faith, 1, 1, 0, yes
715448936333516801,  f_carignani, 1, 1, 0, yes
225334286,  RDelGrosso, 1, 1, 0, yes
382133673,  rofuba, 14, 6, 8, no
37754520,  fimianif, 4, 4, 0, yes
577289341,  CarlettiLisa, 2, 2, 0, yes
306727634,  Pantalaimon83, 1, 1, 0, yes
2332028285,  fran67marcolin, 24, 17, 7, yes
1880498311,  tizianarealini, 2, 2, 0, yes
410984111,  RobertoCervi1, 4, 2, 2, neutral
1249472298,  leodefranceschi, 1, 1, 0, yes
311381225,  paoladelusa, 4, 4, 0, yes
1617753811,  Vieusseux, 2, 2, 0, yes
1876456813,  VelinoCampania, 2, 1, 1, neutral
1202168640,  ArcheoVirtuale, 2, 2, 0, yes
2220106850,  VSurrau, 1, 1, 0, yes
306396502,  ilGazzettinoves, 3, 3, 0, yes
1927339682,  BorsaPaestum, 2, 2, 0, yes
145913387,  fabriziovilla_, 1, 1, 0, yes
973567538,  ClaudiaFiori72, 1, 1, 0, yes
187124848,  PegasoNero, 6, 1, 5, no
933027788,  RossanaGam, 2, 2, 0, yes
547926248,  LonghitanoL, 1, 1, 0, yes
1421646463,  raulfranchi1, 3, 3, 0, yes
3321092054,  loveartmusic123, 1, 1, 0, yes
2534585173,  Cshells33Wells, 1, 1, 0, yes
272783925,  1million4jesus, 1, 1, 0, yes
3098044341,  jayme_hess, 1, 1, 0, yes
743875600352419840,  TerribleTodd9, 1, 1, 0, yes
396805021,  costituzione48, 11, 7, 4, yes
3000400438,  TamaraSka7, 1, 1, 0, yes
4889391088,  PFundrisi, 1, 1, 0, yes
482236124,  alessandra_rand, 1, 1, 0, yes
4592121,  Slowfinger, 1, 1, 0, yes
765074451838955520,  AntoMarrosu78, 3, 3, 0, yes
1446887544,  ValeriaRomanel, 1, 1, 0, yes
2399995393,  VallEtrusca, 1, 1, 0, yes
797894971651162112,  GianfrancoBergh, 2, 2, 0, yes
96109716,  bista92, 16, 11, 5, yes
899952481,  MariaAversano1, 123, 39, 84, no
473659309,  MarioMalangone, 9, 2, 7, no
130510445,  TuriCaggegi, 6, 6, 0, yes
1200759258,  cecchin_stefano, 1, 1, 0, yes
3296752419,  bassotti_g, 5, 2, 3, no
4878317373,  IISLGE, 1, 1, 0, yes
519335913,  RobbieGalante, 4, 3, 1, yes
711661467771207680,  Vintage_Babee, 1, 1, 0, yes
82673876,  ettoremaria, 7, 7, 0, yes
360737479,  GloriaP81, 4, 3, 1, yes
199323838,  lagenziaviaggi, 3, 3, 0, yes
2218697421,  GaiaGaudenzi, 6, 5, 1, yes
209177464,  f_laurelli, 2, 1, 1, neutral
280175586,  nunziapenelope, 22, 7, 15, no
2294256296,  MuseoBarberini, 1, 1, 0, yes
3432995584,  LucyMilano92, 239, 127, 112, yes
2436415936,  _Daniela_F, 1, 1, 0, yes
107198263,  apeindiana, 2, 2, 0, yes
488864885,  BaroneZaza70, 1, 1, 0, yes
746263383473799169,  cinziasams, 29, 12, 17, no
62469494,  ttgitalia, 2, 2, 0, yes
584086024,  TheSaraToscano, 4, 4, 0, yes
4107510682,  Hilaritatis1, 1, 1, 0, yes
1004126912,  olschki, 1, 1, 0, yes
95630884,  GioMelandri, 10, 10, 0, yes
542888208,  ANientedimeno, 3, 3, 0, yes
168796358,  LanoCorio, 28, 12, 16, no
698952953865052166,  434Italo, 1, 1, 0, yes
1136344622,  ciccioetna, 4, 3, 1, yes
80121160,  SavCasal, 1, 1, 0, yes
2798863589,  stefano61t, 34, 23, 11, yes
802899516366196736,  MaurizioMilan2, 1, 1, 0, yes
433775106,  DjMrRogers04, 1, 1, 0, yes
792459889,  beabol75, 1, 1, 0, yes
3104065438,  giraldoacec, 1, 1, 0, yes
4151307737,  gigreca, 3, 2, 1, yes
204883424,  direttortonelli, 1, 1, 0, yes
1095713094,  dmmoli, 1, 1, 0, yes
443868898,  clarinoraf, 1, 1, 0, yes
71009163,  ItaliaaTavola, 3, 3, 0, yes
455544183,  xeriline, 2, 2, 0, yes
222903495,  MarioAvagliano, 6, 6, 0, yes
705693039491223553,  Giuseppealber19, 1, 1, 0, yes
784751473678815233,  a_c_ponti, 1, 1, 0, yes
2667407360,  maatiside, 4, 4, 0, yes
1378987628,  Andrea_Radic, 13, 11, 2, yes
417897223,  Stegosauro, 18, 8, 10, no
739038057479999489,  PolettiOrietta, 2, 2, 0, yes
251554105,  iMith86, 2, 2, 0, yes
594602584,  GuiggianiR, 1, 1, 0, yes
376289454,  CompagniaMaMiMo, 1, 1, 0, yes
894992365,  lorca1973, 14, 9, 5, yes
2219749285,  Woller_7, 1, 1, 0, yes
2149778921,  It_politicaNews, 27, 26, 1, yes
542762392,  katyacastagna, 1, 1, 0, yes
122331177,  LordByronViaggi, 1, 1, 0, yes
2386642032,  199leopoldo, 29, 28, 1, yes
1397232085,  mcacciaglia64, 23, 2, 21, no
2734369037,  GinaMutta, 4, 2, 2, neutral
763971087508004864,  Concett77284565, 1, 1, 0, yes
2412606565,  miryneko, 2, 2, 0, yes
517469921,  ElenaEG4A, 2, 2, 0, yes
364970872,  LAVSediLocali, 4, 3, 1, yes
446393907,  PETASTROSS, 1, 1, 0, yes
116190007,  DuliamoErgassia, 1, 1, 0, yes
1234555272,  jorjaski, 5, 3, 2, yes
2575112347,  simone_eidraghi, 1, 1, 0, yes
1547361486,  agnello_maria, 1, 1, 0, yes
702047704889868288,  Ciccarelli1973, 4, 3, 1, yes
45230032,  lamezzastagione, 7, 7, 0, yes
71204488,  Sara0684, 11, 8, 3, yes
440129638,  SoloCristy, 37, 12, 25, no
328486212,  amaryllide1, 4, 2, 2, neutral
908147456,  feliciagiudice1, 3, 3, 0, yes
483034956,  brunoventura17, 2, 1, 1, neutral
195787575,  LAVonlus, 5, 4, 1, yes
493119606,  VCinollo, 1, 1, 0, yes
993777463,  sara_andreani_, 1, 1, 0, yes
2382772015,  robertotrifilet, 1, 1, 0, yes
4371150255,  aldoadn, 11, 4, 7, no
49322048,  michelega24, 4, 2, 2, neutral
2320276583,  expdnorenzi, 16, 16, 0, yes
220603109,  fracasul, 7, 1, 6, no
2425442529,  PadovanicNicola, 21, 21, 0, yes
777547178516553729,  corteseero, 25, 14, 11, yes
2306163415,  MuseiRealiTo, 1, 1, 0, yes
70209996,  edilportale, 4, 4, 0, yes
2874931755,  FuiScrittori, 1, 1, 0, yes
2346923772,  iFonz87, 3, 2, 1, yes
717452216840429569,  gianstraz, 117, 46, 71, no
1128365564,  Massimo_Caleo, 2, 2, 0, yes
100004676,  m_occammamt, 7, 4, 3, yes
65494640,  marcoprat, 7, 7, 0, yes
149183666,  gentilcristiano, 8, 1, 7, no
418267223,  gabapentino, 7, 5, 2, yes
38150616,  Campaniasuweb, 2, 1, 1, neutral
2339917973,  silviettu, 34, 18, 16, yes
3422769471,  adrimux, 43, 9, 34, no
421155334,  collecasati, 19, 17, 2, yes
575420129,  rpinci, 1, 1, 0, yes
545833909,  LuigiLaloni, 1, 1, 0, yes
487504989,  LuciaBorgonzoni, 8, 6, 2, yes
467597283,  ABartolazzi, 3, 3, 0, yes
231127952,  ferrero_paolo, 7, 7, 0, yes
24184892,  direzioneprc, 7, 7, 0, yes
406947369,  co_crescimbeni, 5, 4, 1, yes
538147915,  Raiofficialnews, 5, 3, 2, yes
55663775,  _trampslikeus, 5, 4, 1, yes
800997096740491264,  fra_primozich, 4, 3, 1, yes
406947360,  albmatano, 4, 3, 1, yes
22000320,  Danton70, 4, 4, 0, yes
44926477,  RaiPlay, 3, 3, 0, yes
720638490766086144,  loconte63, 5, 3, 2, yes
434473804,  castellialessio, 9, 4, 5, no
2231561825,  IngCorsini, 70, 37, 33, yes
1280566146,  mani72012, 111, 68, 43, yes
2273809721,  rossi_adolfo, 4, 2, 2, neutral
132889170,  davlondonct, 4, 2, 2, neutral
3405779049,  ReSaladino1945, 4, 2, 2, neutral
395465609,  LuigiDandi, 4, 2, 2, neutral
169393661,  BarbaFroid, 13, 9, 4, yes
265403238,  tubilando12, 13, 8, 5, yes
98327606,  mottoshop, 6, 2, 4, no
405759929,  ElisaPie_, 6, 4, 2, yes
875207972,  riccardot80, 14, 7, 7, neutral
334234308,  AndrePaind, 4, 2, 2, neutral
2811388466,  LuCaridi90, 14, 7, 7, neutral
1186609874,  Dilulape, 7, 4, 3, yes
217374235,  dagoweb, 17, 11, 6, yes
154967452,  Romarege, 59, 26, 33, no
477654724,  bastianelli_cla, 24, 22, 2, yes
4714539147,  partitoonanista, 13, 7, 6, yes
16344283,  anonimo734, 5, 3, 2, yes
3153491272,  Gi_Scorza, 4, 2, 2, neutral
766032493,  mattia_tambu, 8, 4, 4, neutral
308731088,  max_pandini, 4, 2, 2, neutral
405451598,  rpozzati, 14, 10, 4, yes
2149812819,  panarelli91, 7, 2, 5, no
796643001137250304,  SV_Cerebrale, 8, 4, 4, neutral
608224434,  TheReal3Face, 4, 2, 2, neutral
759830543609442304,  Francy_Pirozzi, 4, 2, 2, neutral
408766685,  luigi_cino, 5, 3, 2, yes
1028897996,  magnagati86, 44, 3, 41, no
460394260,  LeonelliG, 8, 5, 3, yes
1558415174,  FranciCiaba, 10, 5, 5, neutral
1331514499,  loimsmloi, 23, 8, 15, no
428220019,  Massimino1977, 5, 3, 2, yes
24202818,  alepirani, 4, 4, 0, yes
493260423,  alexpinnisi, 34, 15, 19, no
1230470216,  PaoloLeChat, 26, 13, 13, neutral
9017032,  gioganci, 3, 3, 0, yes
4464016355,  creutmann, 40, 12, 28, no
62060285,  66gio, 11, 6, 5, yes
4376544262,  Alexdelargo2015, 17, 9, 8, yes
178364302,  ZioSubo, 3, 3, 0, yes
1275799418,  RosamariaGiu, 32, 23, 9, yes
512049329,  leilascarton, 8, 8, 0, yes
465324149,  SaxSaxina, 3, 3, 0, yes
3682346117,  ToniaTonietta, 5, 5, 0, yes
2863121903,  luca_dore86, 5, 5, 0, yes
2484591623,  NACJTrainlng, 2, 2, 0, yes
2325244646,  sonolucadini, 2, 2, 0, yes
1239672679,  giuliapanchieri, 11, 11, 0, yes
47154019,  stebellentani, 11, 5, 6, no
512664948,  RBallabeni, 37, 28, 9, yes
22031608,  piplaar, 15, 2, 13, no
888531398,  giobettarini, 16, 15, 1, yes
462427721,  alinatede, 60, 38, 22, yes
177937746,  Bordnassela, 8, 5, 3, yes
527270217,  Honus888, 7, 2, 5, no
3007937662,  glaucodaltri61, 2, 2, 0, yes
2381967382,  ManuelaMbramba, 2, 2, 0, yes
17734126,  enricolensi, 3, 3, 0, yes
627128494,  francang1950, 16, 14, 2, yes
304329439,  LupoDiPrateria, 69, 52, 17, yes
164616607,  Paolo_Tamagnini, 10, 10, 0, yes
2994679426,  antonello19692, 15, 4, 11, no
700901262,  AngeloCabr, 19, 12, 7, yes
1230556524,  SimonellaD, 73, 57, 16, yes
2606637891,  onda_di_mare, 17, 8, 9, no
724711989667344384,  marcella_origgi, 6, 6, 0, yes
703386818,  AndreaCerase, 64, 40, 24, yes
4866203493,  eula_torricelli, 3, 2, 1, yes
133485233,  il_Conte78, 5, 2, 3, no
3642908355,  al_inform, 2, 2, 0, yes
426650533,  lucasalici, 9, 9, 0, yes
1315114254,  naponos1970, 2, 1, 1, neutral
801808880955170816,  GIANNI7NOBIS, 8, 8, 0, yes
822184940,  noth2loos, 102, 79, 23, yes
4871837783,  umberto194, 9, 9, 0, yes
774571846989668352,  Milu0095, 232, 6, 226, no
704968903622008832,  Marzian2016, 252, 13, 239, no
14324681,  RoDante, 30, 9, 21, no
1063615682,  MaGiEr69, 8, 4, 4, neutral
1065387764,  FrancescoVolpic, 126, 29, 97, no
787620843320905728,  GiuseppaMarsal2, 6, 1, 5, no
960087626,  ignazioraspant1, 116, 57, 59, no
3033262155,  BalsamoRoberto, 9, 3, 6, no
582622919,  chryduca, 175, 16, 159, no
442225392,  Vito_Cipolla, 5, 2, 3, no
2238011889,  LaMadreBadessa, 23, 4, 19, no
618640479,  Southiandtale, 2, 2, 0, yes
2481684443,  cskyespencer139, 2, 2, 0, yes
1856401896,  PallacordaPD, 12, 12, 0, yes
301991350,  RoccoZen, 4, 4, 0, yes
49303706,  diegocorrado, 13, 9, 4, yes
50981546,  lbaglivo, 8, 8, 0, yes
98633285,  dianacomari, 10, 8, 2, yes
1028521861,  stefaniabariatt, 3, 3, 0, yes
3025519632,  aaamigh, 2, 2, 0, yes
2596945387,  Giustizia47Vera, 56, 10, 46, no
255666406,  tuziorista, 54, 16, 38, no
283636579,  MichelePlatoni, 324, 17, 307, no
1658004026,  dovipe, 7, 4, 3, yes
88650213,  levignette, 7, 1, 6, no
728695134,  jianlucka, 46, 9, 37, no
3387547060,  lobbyingitalia, 15, 4, 11, no
44395683,  mattjrphoto, 30, 14, 16, no
469845313,  antoferito1, 11, 4, 7, no
4864791995,  Frances50147410, 6, 2, 4, no
4266162190,  bordelloamaro, 68, 45, 23, yes
2494551224,  AlbaniniP, 10, 8, 2, yes
381953555,  giannicuzzani, 25, 6, 19, no
1964395448,  Giornalepmi, 3, 3, 0, yes
406885867,  StefanoFirpo, 3, 3, 0, yes
2987907160,  ScardinaGino, 3, 3, 0, yes
786872673037062144,  Massimo6168, 6, 0, 6, no
798834368798072836,  LaCCanale19, 54, 33, 21, yes
537133786,  77OnFilm, 3, 1, 2, no
4927333755,  egemini73, 2, 1, 1, neutral
795968021084913664,  stop_invasione, 5, 4, 1, yes
1895353393,  Max_Tacconi, 11, 6, 5, yes
2358153341,  pietro_manca, 3, 2, 1, yes
3138188655,  01976Debora, 314, 148, 166, no
499571765,  FarignaFarina, 66, 32, 34, no
258861907,  Ettore_Rosato, 6, 4, 2, yes
545888247,  GianniPangallo, 3, 2, 1, yes
2458440060,  ZapparoliTW, 6, 3, 3, neutral
3192285299,  Ikar0n, 48, 25, 23, yes
1426493510,  micomedical, 13, 9, 4, yes
995565133,  a_maggi74, 17, 12, 5, yes
29960852,  Alfredomiraglia, 20, 12, 8, yes
739778677722992640,  Mr_Bleah, 18, 14, 4, yes
1430226211,  Matteo_1391, 4, 3, 1, yes
3140140060,  COISPpolizia, 9, 5, 4, yes
2675356905,  paoletta2869, 81, 43, 38, yes
3121230182,  19Italia68, 9, 7, 2, yes
489551817,  bottari12, 85, 53, 32, yes
725983920,  bomberinho11, 5, 2, 3, no
274915400,  _luigicontu, 9, 6, 3, yes
988701344,  gianluigirestiv, 4, 3, 1, yes
528493399,  emme_roberto, 23, 22, 1, yes
149060372,  angealfa, 15, 14, 1, yes
383888615,  isabeaubless, 18, 5, 13, no
324523414,  marcxmart, 2, 1, 1, neutral
2318598068,  klaus1973_2014, 9, 6, 3, yes
790464906453721088,  Cartabiancarai3, 36, 19, 17, yes
2329195526,  brutiozzo, 4, 1, 3, no
4480184295,  cardinali_v, 4, 1, 3, no
1260037848,  igvania65, 5, 2, 3, no
56874315,  SirRobertgable, 3, 1, 2, no
2377659242,  GIMUSHI, 8, 1, 7, no
2751847457,  TrapellaAngela, 34, 1, 33, no
421753973,  lucalofranco, 5, 1, 4, no
854600858,  roberto25552758, 16, 1, 15, no
774181517224316933,  _digitaLeasy, 4, 4, 0, yes
1168651670,  gmpmari12, 6, 2, 4, no
2533019300,  LonardoOikos, 62, 60, 2, yes
467307839,  BorderKeroro, 42, 33, 9, yes
268994593,  ANGEBRIXIA, 12, 11, 1, yes
703596145411563524,  gdipadania, 21, 14, 7, yes
1676221394,  VariniMarina, 8, 7, 1, yes
770615305,  Kasper_carlo, 10, 4, 6, no
284552966,  SaverioMazza, 3, 3, 0, yes
108718327,  vinsuele, 2, 2, 0, yes
1642282560,  albertoferrara9, 4, 4, 0, yes
219361447,  Yogaolic, 38, 38, 0, yes
851163084,  AngelSerious, 2, 2, 0, yes
924965395,  gengedario, 16, 9, 7, yes
2727207762,  muru_de, 11, 11, 0, yes
1215471452,  SanteinIn, 11, 9, 2, yes
1734308330,  X123Alpha, 1, 1, 0, yes
725797268536852480,  fabiolabina, 1, 1, 0, yes
2386835695,  Giulialaura9, 88, 42, 46, no
2893198595,  CarmelaVampo, 1, 1, 0, yes
132092980,  fifranzo, 24, 10, 14, no
410611483,  M_Landieri, 1, 1, 0, yes
341989260,  gdnazionale, 6, 6, 0, yes
777140031957901312,  IdoneixilNO, 12, 12, 0, yes
329305899,  colle_89, 13, 13, 0, yes
2911280733,  ciopi521, 1, 1, 0, yes
1156641295,  CameriniEdgarda, 1, 1, 0, yes
161967179,  lydiadaye, 1, 1, 0, yes
4384610668,  GioStevenson, 1, 1, 0, yes
369749865,  archi_sergio, 97, 8, 89, no
2463100707,  lentinivince, 132, 42, 90, no
373528809,  magistravulnera, 23, 16, 7, yes
128978964,  radioHAZE, 68, 31, 37, no
430743919,  marcuspascal1, 46, 20, 26, no
52040439,  epbernardo, 1, 1, 0, yes
478010145,  NicoGrieco, 7, 4, 3, yes
3928015222,  lucabertazzo, 52, 29, 23, yes
3014428659,  meso_polis, 1, 1, 0, yes
403951532,  paolettami, 3, 3, 0, yes
1664604020,  Paolo885, 48, 23, 25, no
786828737958535168,  sistema_ti, 51, 43, 8, yes
363677922,  MacMassi44, 3, 2, 1, yes
1345104642,  djecb, 3, 3, 0, yes
501137418,  Hakflak, 4, 3, 1, yes
3295406872,  Prof_Lisanti, 1, 1, 0, yes
804015434718650368,  PomettiGianluca, 1, 1, 0, yes
454050209,  andrea_uff, 23, 18, 5, yes
431084648,  twMec, 127, 46, 81, no
560715196,  marcopenazza, 8, 7, 1, yes
2223323408,  ProfMALaTorre, 1, 1, 0, yes
31580856,  pennaribelle, 8, 5, 3, yes
3331231205,  danielas1981, 1, 1, 0, yes
2432040200,  TaniaPriore, 1, 1, 0, yes
514422812,  giacob_, 22, 7, 15, no
3279978827,  fullb11, 7, 6, 1, yes
222273248,  n9ve2, 1, 1, 0, yes
804080566949859328,  marchesaangely, 43, 19, 24, no
750424089429413889,  Vicker1972, 11, 7, 4, yes
306134369,  PieraldoP, 19, 13, 6, yes
1007282528,  francescatv56, 18, 14, 4, yes
76029658,  derivazione750, 1, 1, 0, yes
267219188,  sebastian579, 9, 4, 5, no
4818612196,  FartFromAmerika, 14, 4, 10, no
147654699,  napolaris_, 13, 3, 10, no
2689440504,  dali74104, 2, 2, 0, yes
2408611964,  PaoloZuccaro27, 1, 1, 0, yes
1606319989,  pesposito2, 3, 1, 2, no
2574452613,  L_o_r_e_n_z_o_, 20, 10, 10, neutral
3305939879,  Testament73, 20, 10, 10, neutral
2938313507,  sangazzurr, 65, 29, 36, no
1363882460,  justcut_thecrap, 9, 5, 4, yes
785472054,  sterassi, 1, 1, 0, yes
845313296,  giek2, 23, 18, 5, yes
1267801106,  notabartolo, 1, 1, 0, yes
3314922196,  FrancescoQuin13, 2, 2, 0, yes
2736117773,  gianluca_bolo, 1, 1, 0, yes
1386793261,  michellesar1, 31, 17, 14, yes
396864261,  darietto92, 26, 20, 6, yes
801520165250887680,  MarianSem64, 28, 11, 17, no
3046015127,  MoniIsi12, 1, 1, 0, yes
718084807,  clodberts, 1, 1, 0, yes
2907520191,  sbaffato, 67, 15, 52, no
257709473,  turgido, 103, 23, 80, no
803115926002532352,  porretti3, 1, 1, 0, yes
1352568188,  NadaAlfano, 10, 2, 8, no
2984559201,  MarziaBuonaroti, 6, 6, 0, yes
388946039,  CesareOrtis, 16, 8, 8, neutral
2456929573,  arrabiatonero, 25, 14, 11, yes
2335367718,  Carlo_Mucci_, 45, 36, 9, yes
147611968,  PaoloScarpelli, 7, 2, 5, no
1216216104,  RioPugliese, 2, 2, 0, yes
998138210,  RomanoRubbi, 13, 9, 4, yes
435706626,  veldalie, 1, 1, 0, yes
1260487207,  fattivostri, 10, 2, 8, no
2321469412,  mauriziobertol7, 3, 3, 0, yes
3064354900,  DVerniere, 8, 7, 1, yes
3300629145,  zanfagniz, 8, 2, 6, no
955721802,  ficiesse, 1, 1, 0, yes
3238808553,  FpCgilPolPen, 1, 1, 0, yes
2537853697,  antnll_24, 17, 11, 6, yes
1241515435,  gianfuffo, 8, 6, 2, yes
470515225,  rossella226, 7, 7, 0, yes
1394277882,  Ori254, 266, 108, 158, no
2837947463,  DettoBen, 2, 1, 1, neutral
586429781,  GiuliaCrivelli, 17, 10, 7, yes
2301960876,  Carmensic, 35, 5, 30, no
303618346,  rinaldoleggi, 9, 4, 5, no
483384295,  LuigiDeTroia, 129, 23, 106, no
127025568,  carlosibilia, 20, 16, 4, yes
515698229,  LaLaura68, 14, 7, 7, neutral
1179962942,  MarracinoD, 104, 22, 82, no
4845999597,  sarasarli, 93, 25, 68, no
1470706141,  MPaperoga, 10, 6, 4, yes
2892534323,  kossacknikko, 13, 12, 1, yes
836237598,  alle_rond, 5, 4, 1, yes
1266649207,  DriverMattia198, 109, 55, 54, yes
1222699580,  mefaivola, 15, 3, 12, no
253540043,  raffybianchi, 5, 2, 3, no
413786539,  aldocorda1, 32, 21, 11, yes
4155844545,  OcchioCritico12, 191, 141, 50, yes
1176131220,  gifran5, 7, 5, 2, yes
2433235432,  fabiocrivel, 7, 3, 4, no
4702970784,  MovPopulistaIta, 108, 14, 94, no
1179464636,  vogio91, 1, 1, 0, yes
2359448190,  ArioPuggioni, 83, 15, 68, no
271838807,  MariCatell, 6, 3, 3, neutral
734705980873789440,  MenelMaria, 9, 3, 6, no
50286652,  Franciscktrue, 28, 14, 14, neutral
457477405,  figliamonti, 10, 5, 5, neutral
100878763,  sotirias, 20, 6, 14, no
1086600416,  giodegattis, 4, 4, 0, yes
1327684639,  meribia90, 14, 6, 8, no
334872165,  danilo_coppola, 2, 1, 1, neutral
211090942,  conteivan, 11, 2, 9, no
447854508,  iasius_1, 17, 8, 9, no
850940348,  melrief, 3, 1, 2, no
1318601540,  grigiestanze, 18, 11, 7, yes
2442669300,  niccmn, 16, 12, 4, yes
446929182,  TotiNoEuro, 10, 6, 4, yes
2467357784,  enzo64363787, 28, 4, 24, no
388480192,  GVignoni, 22, 8, 14, no
708773624,  GFabrygherardi, 35, 18, 17, yes
448335186,  giangoSGV, 21, 12, 9, yes
753661651,  lightburner, 5, 5, 0, yes
3403421475,  rinaldivito871, 16, 9, 7, yes
250080066,  Soldan56, 4, 4, 0, yes
469245700,  carrara_paolo, 6, 5, 1, yes
2351775654,  AGCarta, 92, 25, 67, no
529507807,  achillelaprova, 3, 3, 0, yes
3435148533,  MarcoFinizio74, 11, 2, 9, no
748252291959037952,  umberto_ga, 71, 27, 44, no
2752353844,  flexability68, 17, 7, 10, no
999474469,  ceredaemanuele, 11, 2, 9, no
50249412,  Andreblanz, 2, 2, 0, yes
1424689315,  manduchino, 27, 4, 23, no
735011288644980737,  valetommasino88, 9, 6, 3, yes
1274596976,  andreapagani10, 1, 1, 0, yes
379828154,  jimmyballando, 2, 1, 1, neutral
1444286834,  vasco97273, 264, 16, 248, no
2638291813,  claudia60_di, 3, 2, 1, yes
2524404516,  mdmstesso, 14, 5, 9, no
3002876873,  GinoneCom, 13, 8, 5, yes
242922585,  minuscx, 26, 9, 17, no
706522020016746496,  GildaLemon, 8, 3, 5, no
362432939,  cdolcino, 46, 15, 31, no
587948551,  Paolo_CSGL, 10, 2, 8, no
1259430840,  deltamikeMD, 2, 2, 0, yes
3119071163,  lucillalucio7, 171, 12, 159, no
1261316370,  ororo61, 27, 4, 23, no
433717645,  tiecolino, 21, 8, 13, no
717319878542245888,  rettile11, 59, 11, 48, no
1472290938,  AntonioDiBari85, 50, 3, 47, no
347497240,  calygola, 22, 18, 4, yes
2850135335,  avantinoi, 49, 12, 37, no
2420586324,  ANTEO17, 52, 7, 45, no
3347525428,  SilvioTriulzi, 16, 7, 9, no
1100422622,  beniamino_di, 37, 20, 17, yes
407891527,  checco710, 46, 17, 29, no
2540653035,  Darkmind4ever, 26, 3, 23, no
2904967810,  Libellula51, 174, 47, 127, no
365065358,  francescagorini, 74, 28, 46, no
520617010,  elfadomestica1, 13, 8, 5, yes
526460648,  FEBODIANA, 4, 1, 3, no
2271999013,  ZapponeRoberto, 95, 48, 47, yes
2480323358,  SoqquadroM, 16, 10, 6, yes
257204258,  salvixb, 3, 2, 1, yes
4058624363,  notapiedipagina, 52, 35, 17, yes
272955645,  neuroDNA66, 8, 5, 3, yes
2189633884,  392_ancellotti, 27, 14, 13, yes
731908101750788097,  artioli_giorgia, 15, 8, 7, yes
2999484970,  Licia85l, 124, 66, 58, yes
786432845111635968,  2016Laurabanca, 42, 28, 14, yes
496150631,  GaspareStabile, 12, 11, 1, yes
791665194619592704,  Anto44107680, 6, 3, 3, neutral
3001145196,  frank_robusto, 39, 21, 18, yes
370023281,  Massi_Mai, 2, 2, 0, yes
763983425569034240,  oscar_rafone3, 25, 3, 22, no
760834339160588288,  ritabarbo2, 16, 16, 0, yes
2944052776,  a28dd5948f9941b, 3, 3, 0, yes
49285071,  Cighi, 30, 30, 0, yes
1962674090,  Changement71, 75, 19, 56, no
637292613,  Strapierre, 77, 36, 41, no
1705457276,  FrancescoF06, 3, 3, 0, yes
801146620364685312,  marcusx551, 1, 1, 0, yes
4252198762,  GAlberigo, 8, 4, 4, neutral
1327701390,  DiparteGUELFA, 57, 29, 28, yes
4148271653,  ElenaLeo13, 4, 4, 0, yes
2348566523,  donatellabrusch, 96, 51, 45, yes
3182253213,  lore_mass71, 45, 23, 22, yes
1117576526,  OllaPiero, 122, 67, 55, yes
1063634156,  Isonoire, 16, 13, 3, yes
1707854503,  Francescaeffe3, 54, 29, 25, yes
1428381038,  stefanrocch, 8, 4, 4, neutral
2821366407,  LegaNordVeneta, 14, 11, 3, yes
271407710,  pieropennati, 6, 3, 3, neutral
4867831151,  Fabio10091946, 53, 22, 31, no
1254757129,  twittalalla, 19, 12, 7, yes
917297730,  marcomont90, 3, 3, 0, yes
2844436766,  distefagiorgio, 14, 10, 4, yes
782126365315371008,  Gianni24514253, 54, 17, 37, no
433711652,  luigitortella, 1, 1, 0, yes
1008395305,  Peppumerlo, 11, 5, 6, no
3044614575,  M5SER, 7, 3, 4, no
1083273792,  bianchiremo, 38, 2, 36, no
710311520,  luciastarace1, 23, 19, 4, yes
1037077783,  mbonante, 47, 16, 31, no
2906181117,  fede_bellinazzi, 7, 7, 0, yes
985200140,  Oscar_polli, 2, 2, 0, yes
2242100015,  RubinipPaolo, 25, 23, 2, yes
2872617592,  zeudi_polarti, 2, 2, 0, yes
4081934681,  luca_fanto, 4, 4, 0, yes
500886985,  evilardi, 22, 17, 5, yes
528699157,  eizaghi, 49, 34, 15, yes
1109841932,  Michele_Cantone, 2, 2, 0, yes
1181812454,  g_ventriglia, 2, 2, 0, yes
299398861,  GiuSabat, 9, 9, 0, yes
778900450812764160,  Ciampinovotasi, 87, 79, 8, yes
141260866,  lupisimone, 2, 2, 0, yes
418709964,  pierluigidiaco, 14, 6, 8, no
572426495,  gen_napoli, 17, 8, 9, no
803300175955558400,  Onomatopecora, 31, 11, 20, no
4340888903,  Andrea_V_73, 27, 24, 3, yes
420314574,  MauroRunco, 4, 2, 2, neutral
116749310,  PABLECIDO, 12, 6, 6, neutral
1390413402,  Piconegiov, 10, 6, 4, yes
722315021317980160,  chegiodo, 6, 4, 2, yes
1407173916,  Roberto70Yahoo, 13, 5, 8, no
1189817647,  dimeog, 10, 5, 5, neutral
711433591083941888,  MirkoBfc, 11, 2, 9, no
51997642,  GeMazeltovGaldo, 5, 1, 4, no
529561745,  APretolani, 33, 18, 15, yes
1070885414,  NicoCapuzzo, 2, 2, 0, yes
1118069048,  Lorimao0608, 4, 4, 0, yes
355122344,  scimm77, 76, 32, 44, no
2285114260,  dondino63, 34, 11, 23, no
2206083227,  rita_angelis, 9, 2, 7, no
484982241,  graziano_delrio, 21, 20, 1, yes
2561253733,  tuttorelativo1, 83, 48, 35, yes
142414253,  2tredici, 2, 2, 0, yes
124482859,  DanySangiorgi, 8, 8, 0, yes
2351521726,  growing_moon25, 6, 3, 3, neutral
340573242,  paolo_spano, 8, 2, 6, no
16627700,  petermeyeer, 7, 3, 4, no
1883696546,  s56597686, 10, 4, 6, no
777506688316411904,  IlMondoDiAllie, 12, 6, 6, neutral
2898840951,  Torpedoduke, 2, 2, 0, yes
2572093630,  shevasean, 4, 2, 2, neutral
1916781434,  di_alediste43, 10, 9, 1, yes
328683668,  PatriziaPat1, 2, 2, 0, yes
191933406,  WalterSylarYang, 6, 5, 1, yes
3351745755,  varsalona79, 2, 2, 0, yes
399314100,  liviofiorillo, 10, 3, 7, no
743016612048044032,  11solo11, 35, 22, 13, yes
943155390,  MiglioreMicaela, 7, 5, 2, yes
794920648942489600,  Alfonso02756905, 2, 2, 0, yes
3053055853,  LambiaseTiziana, 9, 2, 7, no
1075391245,  verri_laura, 62, 19, 43, no
1851226928,  Shinichi_Kd, 17, 4, 13, no
1262157433,  63_manu, 14, 5, 9, no
1399271642,  APaciletti, 3, 3, 0, yes
904438754,  chiocchetti_mau, 10, 8, 2, yes
1517788118,  sorellaacqua, 50, 29, 21, yes
2186313922,  AlexJohn_153, 54, 28, 26, yes
2163623162,  NOVLTeNOGRATTIN, 83, 78, 5, yes
753717345512718336,  gabrix76, 24, 22, 2, yes
57358236,  lucabattanta, 16, 9, 7, yes
739886463156912132,  AfaivOnlus, 3, 3, 0, yes
1365281197,  aprildoro, 2, 2, 0, yes
62019002,  X12RED, 34, 34, 0, yes
252124868,  Itinara, 12, 6, 6, neutral
484611860,  DomenicoLeccese, 3, 3, 0, yes
2309860201,  i_Pesci, 3, 2, 1, yes
557076383,  profgsacco, 4, 3, 1, yes
992838702,  pierlui63_volpi, 2, 2, 0, yes
3171592366,  OlAngio, 19, 17, 2, yes
4713684017,  momo_fadda, 9, 9, 0, yes
3220659027,  fi_sanlazzaro, 3, 3, 0, yes
3003876496,  Giam_92, 5, 1, 4, no
1227493782,  ilfattizzo, 9, 4, 5, no
297097891,  JadiMarinai, 3, 1, 2, no
242382767,  Ales_Man, 4, 2, 2, neutral
838223696,  angcapparelli, 31, 7, 24, no
70904144,  mauriziozani, 4, 4, 0, yes
1325348036,  FmMilloch, 58, 1, 57, no
22708002,  ntorquati, 5, 3, 2, yes
1092670394,  spinax64, 68, 30, 38, no
3406854231,  valecastrucci, 5, 3, 2, yes
2948374265,  Salvionardi, 35, 15, 20, no
22025138,  emilioftorsello, 21, 7, 14, no
1219056841,  LoredanaCefalo, 16, 4, 12, no
1284180192,  ago971, 2, 1, 1, neutral
4905744514,  Mauro38066271, 18, 9, 9, neutral
3080451825,  juggernaut21010, 4, 2, 2, neutral
2425941110,  miky070565, 4, 2, 2, neutral
3457068923,  EnzoLoIacono2, 2, 1, 1, neutral
2939550185,  Enpatreviso, 2, 1, 1, neutral
1318760557,  ResistensaV, 7, 4, 3, yes
1008806545,  francaravaz, 8, 4, 4, neutral
325165914,  ing_rogi, 400, 196, 204, no
109578008,  Alberella, 99, 48, 51, no
1035803582,  GustavoGesualdo, 41, 21, 20, yes
541178236,  marcellosantell, 114, 48, 66, no
597787450,  gcftisca, 25, 6, 19, no
1062897289,  GaronLorenzo, 2, 1, 1, neutral
802629811407585280,  BARBARA97459, 2, 1, 1, neutral
4463943215,  AnnaBasso9, 4, 2, 2, neutral
1527761478,  ausoloda, 29, 19, 10, yes
475114541,  stella_claudio, 6, 4, 2, yes
734075227576111104,  LiberoMunaron, 2, 1, 1, neutral
2321483287,  Zdany24, 5, 2, 3, no
1121666197,  Inserandipity, 15, 7, 8, no
529700553,  debertielisa, 2, 1, 1, neutral
2321180143,  francoreds, 20, 12, 8, yes
1873008853,  Mau13pol, 7, 5, 2, yes
2853451763,  topazio_66, 4, 2, 2, neutral
439326726,  Marinella456, 10, 6, 4, yes
2932365645,  AntonioSalituro, 2, 1, 1, neutral
4258420899,  eleonoraspadati, 4, 3, 1, yes
455377234,  GardinNicola, 12, 6, 6, neutral
1006590187,  EliPegEli, 2, 1, 1, neutral
2359406918,  lellinara, 34, 13, 21, no
487630885,  aldoalpegiani, 12, 8, 4, yes
340996459,  emanuele175, 19, 8, 11, no
773775218125012992,  Giusepp32715510, 7, 4, 3, yes
584677870,  alessanFERRON, 11, 6, 5, yes
490736218,  redbus2012, 18, 9, 9, neutral
1109639072,  Alessandrobarix, 38, 20, 18, yes
602018574,  ConfartVeneto, 8, 4, 4, neutral
1668915986,  ElenaMarilynch, 6, 3, 3, neutral
2508896446,  GigiTarzia, 9, 5, 4, yes
345374298,  bepin69, 9, 5, 4, yes
2447246306,  Test_Harness, 2, 1, 1, neutral
919658064,  simoneperviero, 5, 3, 2, yes
950642215,  DrUmbertoVitali, 57, 26, 31, no
705133475737812992,  Albert77896, 2, 1, 1, neutral
2706476465,  nexoslaika, 32, 13, 19, no
1040606185,  ClaudioZerbin, 9, 6, 3, yes
393895340,  Efficance, 5, 2, 3, no
571805138,  ZuccolottoA, 2, 1, 1, neutral
27417914,  noformat54, 12, 7, 5, yes
267623955,  italianist, 2, 1, 1, neutral
194268217,  annacaneva, 11, 9, 2, yes
4204098099,  ct_1957, 6, 2, 4, no
786156516730482688,  DirVenetoAgr, 2, 1, 1, neutral
2781970583,  VagoLoridfbs, 61, 30, 31, no
1272197671,  GiorgioDV49, 2, 1, 1, neutral
469262479,  AlfredoDalFerro, 8, 4, 4, neutral
63800968,  domenico_vecsig, 6, 3, 3, neutral
2343512623,  anninavigneto, 98, 52, 46, yes
343023883,  Marika091, 4, 2, 2, neutral
52784170,  MNitaly, 8, 4, 4, neutral
2386919816,  QuotidianoEnerg, 4, 3, 1, yes
1593579625,  ZucconiPark, 23, 12, 11, yes
472463917,  SamueleMartini1, 18, 9, 9, neutral
4212951118,  Giuseppek17, 25, 12, 13, no
102485345,  lavocedelne, 11, 6, 5, yes
518553053,  FBAssociati, 3, 2, 1, yes
753627017518645248,  Alexandra7691, 42, 21, 21, neutral
148556286,  andtomasella, 10, 5, 5, neutral
444468390,  VitaMimmo, 2, 1, 1, neutral
415525282,  ziofa73, 2, 1, 1, neutral
797138365162389504,  ValentinoSim85, 3, 2, 1, yes
742969014,  vitetta10, 2, 1, 1, neutral
382056971,  sandrafrasson, 4, 2, 2, neutral
1732349316,  DgSparow, 8, 4, 4, neutral
1413094597,  aldo15rita22, 17, 10, 7, yes
2233013752,  GelatoPadova, 2, 1, 1, neutral
1026219187,  persefone900, 24, 4, 20, no
3379436303,  silviabenedet17, 8, 4, 4, neutral
800282029254246400,  fffhh0000, 39, 21, 18, yes
736896977749839872,  Ganbol74, 14, 6, 8, no
488399950,  gigilazzaro, 3, 2, 1, yes
2998053413,  tussa67, 19, 9, 10, no
2218143675,  Ebebeb912, 11, 4, 7, no
756718612426227712,  giovilalla, 2, 1, 1, neutral
393231756,  zioregina, 2, 1, 1, neutral
468738816,  therealgava, 2, 1, 1, neutral
428880267,  renbalt, 9, 3, 6, no
801545224808001538,  Mariapi46355201, 26, 13, 13, neutral
755743415183302658,  Arsenale2022, 20, 10, 10, neutral
485505586,  simo974, 6, 4, 2, yes
69323186,  ZioSlash, 5, 3, 2, yes
58867324,  MissCooper83, 6, 3, 3, neutral
532920941,  Icios007, 11, 5, 6, no
1666859648,  fgrassinibb, 2, 1, 1, neutral
1111515590,  ALESSANDRAZUSSO, 4, 2, 2, neutral
1071260784,  Gottardi95, 6, 1, 5, no
364270497,  giulia2509, 2, 1, 1, neutral
550265670,  EnriLisetto, 4, 2, 2, neutral
292552573,  VittoCeccato, 2, 1, 1, neutral
431916167,  PCagnan, 4, 3, 1, yes
95913190,  mattinodipadova, 3, 2, 1, yes
97189414,  nuova_venezia, 4, 3, 1, yes
429452726,  chiarapegge, 4, 2, 2, neutral
1108586642,  Cultitaly, 3, 2, 1, yes
2808862264,  palmiraprt, 7, 2, 5, no
512506306,  1_basta, 41, 18, 23, no
346734625,  giadadetogni, 10, 5, 5, neutral
2986001711,  CaorleArgentina, 2, 1, 1, neutral
1858960344,  AssoSoatti, 16, 9, 7, yes
1246108381,  alcar70, 2, 1, 1, neutral
334519734,  FrancescaVanzo, 2, 1, 1, neutral
554128271,  dani_ele14, 2, 1, 1, neutral
143143391,  aasjia, 15, 8, 7, yes
1000045820,  AntonellaGrim, 21, 21, 0, yes
2395351240,  GiuTedesco87, 12, 12, 0, yes
2490943567,  PD_PALERMO, 16, 16, 0, yes
422844048,  fefewoelk, 18, 18, 0, yes
154082631,  gennaromigliore, 16, 16, 0, yes
2243869427,  ChrysSombret, 2, 2, 0, yes
368825076,  NickMarsh6, 1, 1, 0, yes
357441684,  Giovannips75, 5, 5, 0, yes
474291386,  k0590, 2, 2, 0, yes
514478368,  LuigiBobba, 8, 8, 0, yes
2983270319,  IvJacenich, 2, 2, 0, yes
3428340375,  Divirgilioale, 17, 17, 0, yes
3153541431,  AleGiammarruto, 1, 1, 0, yes
92973348,  gbandinelli, 5, 5, 0, yes
1006553846,  malpfr, 18, 18, 0, yes
46891993,  estensecom, 7, 6, 1, yes
930101862,  MarzioStornelli, 1, 1, 0, yes
322553215,  NicolaPallante, 1, 1, 0, yes
776076329519292416,  europadeipopoli, 6, 4, 2, yes
2477361829,  ElisaPinu, 12, 9, 3, yes
842063576,  tudor_andrea, 8, 8, 0, yes
6832662,  burde, 3, 3, 0, yes
767596251311407104,  gemmaandrea3, 48, 34, 14, yes
59080390,  IgorDamiani, 1, 1, 0, yes
289214112,  PAOLOCARLESI, 8, 8, 0, yes
1369645070,  francescomiliy, 1, 1, 0, yes
2258671377,  GiuliettaCapri1, 2, 2, 0, yes
696645923766718464,  denisecaruso77, 1, 1, 0, yes
461793260,  fabiopassera1, 1, 1, 0, yes
3131574861,  Ottobre_Luigi, 3, 3, 0, yes
461406688,  JacopoScandella, 1, 1, 0, yes
471499156,  gigi_ditullio, 3, 3, 0, yes
1384260270,  gfrankbert48, 1, 1, 0, yes
401161443,  MaurizioMonina, 4, 4, 0, yes
1106149818,  PD_Veneto, 21, 21, 0, yes
419318448,  GiuseppeNaimo, 19, 14, 5, yes
4339037296,  DiegoCrivellari, 6, 6, 0, yes
2390176060,  boborobo88, 31, 27, 4, yes
49756590,  IvanBarbieri, 4, 2, 2, neutral
516339626,  daniela_hoxgco, 12, 12, 0, yes
45114956,  Alebenatti, 4, 4, 0, yes
3093026266,  93f937ea95ce4f4, 1, 1, 0, yes
518549338,  olindodenapoli, 3, 3, 0, yes
978137395,  Dertizia, 37, 18, 19, no
2586630188,  in_darkness_tru, 7, 7, 0, yes
1385276504,  dedo01_, 1, 1, 0, yes
2162429964,  PDTrastevere, 5, 5, 0, yes
228162663,  simorega, 12, 10, 2, yes
1140596424,  ALBERTINIGabry, 8, 8, 0, yes
775677618997850112,  giubbonari, 4, 4, 0, yes
1563096144,  MoscardelliCla, 1, 1, 0, yes
2468306143,  G_Basilico, 11, 7, 4, yes
83177033,  gionocio, 3, 3, 0, yes
387126602,  FFretta, 2, 2, 0, yes
454888291,  leboliuk, 1, 1, 0, yes
4764768171,  AlfredoFagiani, 2, 2, 0, yes
372245394,  PlacentinoA, 4, 4, 0, yes
32624061,  giuliocavalli, 30, 8, 22, no
1387286844,  SergioMaggio_, 1, 1, 0, yes
425861322,  AntPezzella, 2, 2, 0, yes
482729413,  aorfei, 6, 6, 0, yes
408729237,  lmfalco, 1, 1, 0, yes
437710793,  Cinziamas, 19, 19, 0, yes
268525978,  SalvoCoco, 2, 2, 0, yes
335970126,  BrunoCensore, 4, 4, 0, yes
385851132,  cecchiniluciano, 2, 2, 0, yes
464556427,  LorenzoRoesel, 5, 5, 0, yes
845102904,  MorosiSilvia, 3, 3, 0, yes
1260000139,  AndreaColovini, 1, 1, 0, yes
761441228,  AlJeans1, 1, 1, 0, yes
80583467,  ilsestosanso, 5, 3, 2, yes
951368623,  VisentinAv, 11, 11, 0, yes
708998418031644674,  marinoavvocati, 3, 3, 0, yes
263686293,  mas_gui, 63, 20, 43, no
50579673,  ermejo5, 7, 6, 1, yes
2744895802,  GLapidem, 5, 5, 0, yes
2828057292,  agitpops, 22, 20, 2, yes
365973612,  pdfontenuova, 6, 6, 0, yes
475296617,  AvvGenny, 1, 1, 0, yes
2927018079,  LodiMarialodi, 15, 15, 0, yes
233143444,  gianlucatizzano, 4, 4, 0, yes
1006280564,  VincenzoTerrevo, 3, 3, 0, yes
970153256,  danielebr82, 22, 17, 5, yes
453223584,  VPassantino, 23, 17, 6, yes
576539396,  LorenzoSospiri, 18, 5, 13, no
4010430377,  Norma64417112, 17, 15, 2, yes
280242927,  crislomb, 32, 19, 13, yes
520963383,  FFDelzio, 1, 1, 0, yes
831768450,  PMO_W, 126, 84, 42, yes
2923267265,  lagracchiatrice, 8, 8, 0, yes
711620477,  maxsalve64, 3, 2, 1, yes
730060281670447104,  DragoneSantina, 7, 1, 6, no
472925525,  CristinaAntonu, 1, 1, 0, yes
2275495767,  MarioDallasta, 26, 22, 4, yes
725694507669446656,  borgonovo_cm, 1, 1, 0, yes
601130017,  massimoazzena, 6, 5, 1, yes
420254187,  ERCGIL, 6, 3, 3, neutral
1164336541,  DslLorenzo, 34, 32, 2, yes
310195119,  lctr82, 94, 30, 64, no
422586653,  sono_francesca, 2, 2, 0, yes
23326448,  NumberOne1966, 1, 1, 0, yes
2303644001,  nonsonpago1, 24, 17, 7, yes
2231463645,  AngelaAnpoche, 17, 5, 12, no
2876702231,  Abbesieyes71, 6, 5, 1, yes
730389738323099649,  g_ignazia, 32, 16, 16, neutral
2743096169,  filluvera, 3, 3, 0, yes
1512694826,  ADAPT_LPA, 3, 3, 0, yes
407741779,  RMonicar, 9, 8, 1, yes
755126469827915776,  GiusyPorzio85, 9, 2, 7, no
126016801,  fab75pg, 1, 1, 0, yes
318635439,  Titan488, 19, 12, 7, yes
1652968850,  biecoilluminist, 10, 7, 3, yes
110218135,  Marcello_1979, 22, 14, 8, yes
428418598,  CRISTIANO0711, 55, 28, 27, yes
3355557795,  themax82, 27, 17, 10, yes
492460290,  marikboni, 10, 6, 4, yes
2796229504,  marcobosaia, 1, 1, 0, yes
391241388,  SilviaMoreschi, 1, 1, 0, yes
2415751118,  ValeDellaValle, 14, 13, 1, yes
1448165712,  mikizeta73, 16, 15, 1, yes
1954771934,  SilviaCirami, 7, 4, 3, yes
1018151498,  AliGiuliaSofia, 2, 2, 0, yes
325804266,  rosettyna7, 37, 20, 17, yes
571304184,  SimoneMengoni, 11, 6, 5, yes
2411149982,  Testor80, 12, 12, 0, yes
2412578666,  ValiCavalli, 4, 3, 1, yes
978170695,  giovannapinna1, 6, 4, 2, yes
3020130143,  fedezecchino, 3, 2, 1, yes
2602316978,  Anto7558, 2, 2, 0, yes
1145972851,  mauro_natoli, 5, 5, 0, yes
3940330677,  DaneseLorena, 1, 1, 0, yes
477187357,  pasqualevallari, 43, 8, 35, no
741929531276206080,  CreditoUgl, 1, 1, 0, yes
718423441356021761,  CafCislAbruzzo, 1, 1, 0, yes
4773512475,  ABENGINEERINGIT, 1, 1, 0, yes
2940769763,  SenzaProvince, 27, 10, 17, no
2951613610,  CoCoCoDM66_2001, 7, 7, 0, yes
803360037695537152,  Piergiulio27, 3, 3, 0, yes
2197686876,  AntonellaDanie6, 8, 5, 3, yes
2439338175,  fiorucci_anna, 5, 3, 2, yes
2725223452,  ricot75, 2, 2, 0, yes
2420367649,  vmgiosa, 230, 174, 56, yes
2766606807,  checcacapasso, 5, 4, 1, yes
273384456,  ECOADHOC, 2, 2, 0, yes
764853057909841920,  francy07270267, 26, 16, 10, yes
522221243,  MicScandroglio, 18, 15, 3, yes
306661850,  RosannaBerta, 1, 1, 0, yes
605640205,  StefPierini, 1, 1, 0, yes
136019213,  matteo58, 1, 1, 0, yes
2879403391,  fabriziomessin9, 4, 4, 0, yes
431984773,  FaCremonesi, 2, 2, 0, yes
374233022,  GianniPennesi, 1, 1, 0, yes
3022844337,  ennioalberici1, 4, 4, 0, yes
1910056388,  emacoscia, 3, 3, 0, yes
425031071,  paoloaleandri, 1, 1, 0, yes
795828032,  CamilloLoro, 1, 1, 0, yes
2917603617,  ValentinoC2014, 6, 6, 0, yes
4851430133,  LKynes4, 10, 6, 4, yes
2800724687,  ciocolangelo191, 1, 1, 0, yes
792230731,  RaffaellaTaggi, 13, 11, 2, yes
473967210,  SaraMercurio_, 11, 10, 1, yes
2239285988,  ManfrediTW, 3, 3, 0, yes
401568346,  Massimogazza, 9, 9, 0, yes
1117446373,  pamela_orr, 15, 15, 0, yes
29157481,  mimich58, 4, 4, 0, yes
232590428,  Peppedor, 3, 3, 0, yes
81388715,  lalaferla, 1, 1, 0, yes
952414147,  antodira13, 4, 4, 0, yes
284018827,  marcoliviaroma, 1, 1, 0, yes
93276945,  G_Ferrigno, 1, 1, 0, yes
3629530401,  ale_mancini80, 1, 1, 0, yes
2942625706,  SilviaViglione, 11, 6, 5, yes
1303573562,  antoniozurlo79, 10, 7, 3, yes
540895773,  ale_moretti, 15, 13, 2, yes
2976609286,  maltocortese78, 17, 7, 10, no
724517000060518400,  MLuisa_Rossetto, 3, 3, 0, yes
2182500787,  federic10720556, 1, 1, 0, yes
2507487144,  rossettifp, 4, 3, 1, yes
729313932,  lally_1968, 1, 1, 0, yes
986629687,  Gianluca_19_75, 5, 2, 3, no
2589883234,  arch_giuilio, 5, 5, 0, yes
2562280077,  pugliama67, 2, 2, 0, yes
2510540946,  DeRuFrancesca, 1, 1, 0, yes
2772371265,  GhiniGladys, 1, 1, 0, yes
3222096079,  pujisyukur361, 5, 4, 1, yes
1007334655,  volervolaramar, 6, 6, 0, yes
48967204,  TukultiPD, 26, 26, 0, yes
551104825,  paolalazzoni, 3, 3, 0, yes
856906760,  tosmau, 5, 5, 0, yes
726428495413387265,  EnzoSperanza5, 54, 29, 25, yes
931597488,  carlacarlucci44, 1, 1, 0, yes
2511976193,  Chiardoni, 5, 5, 0, yes
19018243,  PepCook, 5, 3, 2, yes
1947864529,  daja_soni, 1, 1, 0, yes
484993582,  piemac86, 12, 6, 6, neutral
2448777566,  antopesc63, 1, 1, 0, yes
158455570,  Monicattiva, 3, 3, 0, yes
788069672679796737,  GiampyGhirardo, 14, 12, 2, yes
252481530,  RondIla, 3, 2, 1, yes
38444157,  antoscut, 4, 3, 1, yes
1954419870,  UilGenovaeLigur, 1, 1, 0, yes
519600159,  RappelliFed, 1, 1, 0, yes
3320747710,  mariofabianodv, 9, 9, 0, yes
155588864,  Davidebaruffi, 3, 3, 0, yes
868606422,  TizianaGalliani, 1, 1, 0, yes
4807013549,  Realizzareinsie, 16, 7, 9, no
22887971,  Pamaldi, 39, 26, 13, yes
4893474419,  IndiveriR, 13, 13, 0, yes
752918660377870337,  Si_milano_zona4, 1, 1, 0, yes
900598639,  MauroMilano95, 6, 4, 2, yes
543863115,  stefigasparini, 3, 3, 0, yes
425231323,  SimSard, 9, 9, 0, yes
500236905,  Leccezionale, 11, 1, 10, no
342296335,  tildeblonde, 26, 26, 0, yes
568405393,  EmanuelePoli1, 3, 3, 0, yes
4330061833,  maria_da_hunt, 1, 1, 0, yes
716771729,  Luca_91502, 26, 15, 11, yes
515350705,  fazio_nicola, 17, 7, 10, no
2866250985,  AmbrettaM, 25, 20, 5, yes
421822131,  BastrikDorianGr, 6, 3, 3, neutral
553030181,  annannari, 9, 6, 3, yes
3356670165,  LuigiGelli, 51, 7, 44, no
531519847,  brunolupiski, 1, 1, 0, yes
893420989,  salvatorerepett, 3, 3, 0, yes
2999879276,  nicolin_o, 50, 23, 27, no
2444940699,  _massimomauri, 3, 3, 0, yes
4920528677,  NoesiConsulting, 2, 2, 0, yes
135547288,  VMaielli, 33, 26, 7, yes
866547446,  Bonettipartners, 1, 1, 0, yes
982401096,  robertsoana, 66, 24, 42, no
523432889,  MGiangualano, 12, 4, 8, no
461978652,  MattiaSavoia, 4, 3, 1, yes
802052868119416832,  IssOccupato, 8, 8, 0, yes
306058431,  marioddo, 31, 9, 22, no
2895069737,  donato_ales, 4, 4, 0, yes
355402185,  InfoConsapevole, 14, 8, 6, yes
609063074,  Artic99, 1, 1, 0, yes
354747398,  MarcoGro69, 39, 31, 8, yes
3033238948,  Luigi_084, 8, 5, 3, yes
500872821,  PozziPatty, 3, 3, 0, yes
443248991,  RobertoDorini, 8, 8, 0, yes
1278345985,  ChilErminia, 4, 1, 3, no
345321374,  annamariabusia, 4, 3, 1, yes
2320187182,  UrbimanoOrbi, 11, 11, 0, yes
2760142246,  BaldoArci, 18, 14, 4, yes
775415010004701185,  Annamariasimeo7, 3, 3, 0, yes
2470692079,  Majden3, 28, 18, 10, yes
2466390186,  DonatellaDAgati, 3, 1, 2, no
1057930387,  gfdileo, 107, 43, 64, no
426152264,  solounastella, 39, 13, 26, no
794652233258385409,  paolo_rossi81, 8, 6, 2, yes
3892626509,  Vincitori_Ripam, 2, 2, 0, yes
784566367395741700,  RobySerf, 4, 4, 0, yes
1145608902,  pipop63, 11, 8, 3, yes
3639353537,  kariuki74, 38, 21, 17, yes
136971453,  HORASDESIGN, 14, 13, 1, yes
2375936782,  Emma__74, 1, 1, 0, yes
418210914,  MarioAlvermann, 23, 20, 3, yes
53234289,  SteIarda, 14, 10, 4, yes
1845950018,  katokatone, 8, 8, 0, yes
1125109992,  piras_zia, 31, 12, 19, no
4714431627,  PieroTaddei83, 1, 1, 0, yes
487942243,  Andrea060273, 1, 1, 0, yes
152061057,  Oriella_SA, 1, 1, 0, yes
435791610,  DaniloCason, 18, 8, 10, no
239806365,  Pcaterisano, 5, 4, 1, yes
440738520,  GiampietroD, 2, 1, 1, neutral
284268143,  EmanueleVecchi, 2, 2, 0, yes
2353092296,  af458zf, 20, 14, 6, yes
248447553,  ArtemisiaGe, 4, 4, 0, yes
2693917236,  vittorioavesan2, 6, 6, 0, yes
195792208,  GLucas71, 26, 13, 13, neutral
4892218558,  nino_pitrone, 22, 6, 16, no
4860111165,  MCristinaSarto2, 6, 6, 0, yes
1544093054,  contu_f, 83, 82, 1, yes
420656128,  Lele_Cocco, 4, 4, 0, yes
442675224,  danieletonini1, 16, 16, 0, yes
54207415,  GalassiaReti, 1, 1, 0, yes
156621995,  AngelaCreta, 3, 3, 0, yes
417827591,  ZeroViolenza, 1, 1, 0, yes
2359628135,  AVincenti74, 1, 1, 0, yes
6477792,  LuisB, 2, 1, 1, neutral
563981334,  zak_says, 1, 1, 0, yes
463963,  lorello, 1, 1, 0, yes
1907363449,  AnnalisaBruchi, 1, 1, 0, yes
926181096,  cidrimcidrim, 2, 2, 0, yes
370895961,  suitetti, 9, 6, 3, yes
1219594640,  PrisRobledo, 2, 2, 0, yes
492167371,  DatiGovIT, 2, 2, 0, yes
1502429862,  transparency_it, 3, 3, 0, yes
745880802047758336,  MGarau, 51, 42, 9, yes
768405804604993537,  rubino50203, 2, 1, 1, neutral
3132941576,  CodiceCUP, 4, 4, 0, yes
794866037028253697,  fpcgilmarche, 1, 1, 0, yes
390850122,  MarcoMenegotto, 5, 5, 0, yes
199717852,  ___A_L_E___, 8, 8, 0, yes
100855011,  ggallia, 5, 5, 0, yes
577859582,  rivistamadre, 3, 3, 0, yes
800888789753282560,  frarotond, 2, 2, 0, yes
391721080,  giampierodetti, 9, 8, 1, yes
488785798,  mattiacv, 3, 3, 0, yes
33321705,  A_Ambrogetti, 5, 5, 0, yes
775767378076524545,  Irenedavenezia1, 9, 7, 2, yes
474400956,  ed_espos, 6, 6, 0, yes
2373340799,  giusepp26770710, 19, 19, 0, yes
419543607,  AntonioCastald7, 4, 4, 0, yes
129564058,  nic2000bo, 1, 1, 0, yes
134559413,  trescazza, 9, 8, 1, yes
4822257778,  addantefrancsco, 2, 2, 0, yes
317424889,  g_lamberti, 10, 10, 0, yes
1879973286,  caterino_teresa, 1, 1, 0, yes
53773490,  Straccia2, 29, 5, 24, no
2966428425,  troilo_federico, 1, 1, 0, yes
385923471,  bragachiara, 5, 5, 0, yes
61765111,  sbonaccini, 25, 25, 0, yes
2936705943,  DipePcm, 3, 3, 0, yes
50590345,  Maceaster, 72, 52, 20, yes
70380540,  marcogy, 1, 1, 0, yes
97485734,  MAXBET1973, 1, 1, 0, yes
281446446,  cosimosorino, 1, 1, 0, yes
1266792668,  AntoGiuntoli, 10, 9, 1, yes
2808481293,  MariaMrmaria, 1, 1, 0, yes
123908308,  davidmezzo, 2, 2, 0, yes
788070635356422145,  Valeria34139524, 2, 2, 0, yes
760552902297546752,  Alessan74531858, 11, 11, 0, yes
594409446,  TeodoroVetrugno, 2, 2, 0, yes
23919805,  luca___romeo, 6, 6, 0, yes
633259530,  cicalaroberto, 9, 6, 3, yes
3398698065,  TraniElia1, 2, 1, 1, neutral
2443860315,  donyamo, 5, 3, 2, yes
513021525,  ignaziopucci, 1, 1, 0, yes
1053270936,  larizza1950, 5, 4, 1, yes
1687467302,  leo19631963, 2, 2, 0, yes
395259413,  scheggia1980, 4, 4, 0, yes
703968845724295169,  maranigiacomo1, 1, 1, 0, yes
3053511803,  ange_caliendo, 2, 2, 0, yes
843770665,  stefanochilleri, 4, 4, 0, yes
1390254751,  gugolo71, 2, 2, 0, yes
3027189140,  carletti_roby, 3, 3, 0, yes
483368442,  CisterninoAndre, 29, 29, 0, yes
264753679,  rob_sab, 5, 5, 0, yes
493931905,  AlfafeAlf, 1, 1, 0, yes
412094285,  dolomiti19, 22, 22, 0, yes
2792814315,  BelpassiJessica, 13, 13, 0, yes
2173240600,  Silvia_Profeti, 1, 1, 0, yes
14233886,  ptrapani, 6, 6, 0, yes
435740653,  ElenaCarnevali, 1, 1, 0, yes
315846635,  simonaercolani, 6, 6, 0, yes
3369172816,  stefaninilucia1, 22, 15, 7, yes
2945491781,  AugustoSabatel1, 71, 15, 56, no
27636956,  aldorosati, 6, 4, 2, yes
490373717,  boccadutri, 37, 31, 6, yes
38205384,  lucafalc1, 15, 12, 3, yes
2294460956,  enricobbbb, 1, 1, 0, yes
381567713,  itaferd, 3, 2, 1, yes
2533038962,  nickbarzibol, 3, 3, 0, yes
1031528454,  LexAlimentaria, 10, 5, 5, neutral
753878412981374976,  Paolo44716751, 10, 7, 3, yes
39259372,  MGLorenzo, 4, 4, 0, yes
179568411,  RobertoGrassi, 23, 18, 5, yes
41391760,  davidefaraone, 22, 22, 0, yes
418534314,  fortunatomaio, 1, 1, 0, yes
446433527,  LapoScatizzi, 1, 1, 0, yes
4195341903,  villaal71, 1, 1, 0, yes
2352954268,  helty_87, 5, 3, 2, yes
3408538193,  Hawana91, 2, 2, 0, yes
407685623,  MonicaLuisi, 46, 46, 0, yes
958086128,  moky_tocchi, 1, 1, 0, yes
38846888,  faornano, 9, 8, 1, yes
425699152,  ChiaraMicheli86, 4, 4, 0, yes
1057225326,  CCristina65, 1, 1, 0, yes
2313205890,  AngoriMassi, 5, 5, 0, yes
2311916317,  ivanoravasio, 17, 4, 13, no
715658933,  siniElena82, 1, 1, 0, yes
1055582876,  Massimoarati, 4, 4, 0, yes
4148198415,  DonatellaTurli, 1, 1, 0, yes
1029226392,  DebiasiDe, 11, 7, 4, yes
403997300,  francescospanu7, 9, 6, 3, yes
802174224228085760,  ADigiammarco, 5, 5, 0, yes
516664834,  nicoceccarini, 1, 1, 0, yes
787954994171506689,  Giuseppe140310, 51, 3, 48, no
3224084433,  GiuMonni79, 3, 3, 0, yes
2207063824,  auletta_vito, 1, 1, 0, yes
518077571,  selenetea, 5, 3, 2, yes
1067992664,  pierantod3, 5, 5, 0, yes
2495695665,  wilmetti54, 1, 1, 0, yes
253164055,  sandroalone, 36, 28, 8, yes
1047167726,  suevoz, 1, 1, 0, yes
748764531455762432,  IseNaeEsterni, 17, 8, 9, no
807361466,  MarcoDantuoni, 5, 3, 2, yes
773444545342234625,  Max23Baldo69, 2, 2, 0, yes
2424020059,  ObservingVotoNO, 81, 2, 79, no
401407144,  PortaKittePare, 8, 5, 3, yes
2707414594,  MazzeoGianna, 1, 1, 0, yes
564038388,  PrimettaMiglior, 18, 18, 0, yes
77437422,  lorenavilla, 3, 3, 0, yes
2901351995,  methenian, 3, 2, 1, yes
2720461125,  maxdimax69, 1, 1, 0, yes
483816390,  Paoloannigoni, 3, 2, 1, yes
1025012509,  StePic62, 12, 12, 0, yes
315895880,  AIannamorelli, 4, 4, 0, yes
135673716,  AcquaPubblicaTO, 1, 1, 0, yes
215187433,  LauraCavPR, 10, 5, 5, neutral
214579928,  dariovioli, 2, 1, 1, neutral
798456927600734208,  GiuseppeIta91, 4, 4, 0, yes
453851050,  gufolibero, 141, 87, 54, yes
334388234,  Ottavio_romano, 7, 7, 0, yes
3348017975,  GGirosante, 1, 1, 0, yes
358808488,  Giovanni_Nappi, 10, 5, 5, neutral
732317340092780545,  sadape54, 79, 18, 61, no
1108369927,  mimmoderasmo, 1, 1, 0, yes
2933713509,  ing_alfonsosga, 2, 2, 0, yes
323133173,  LorenzoPaliaga, 3, 3, 0, yes
45514913,  giampodda, 51, 37, 14, yes
451651175,  Luana_Rosa65, 1, 1, 0, yes
553445487,  aale_pasca, 22, 11, 11, neutral
1080257646,  PignoneG, 3, 3, 0, yes
227749617,  falcho61, 10, 10, 0, yes
130103067,  FilippoVignali, 3, 3, 0, yes
104960470,  nomfup, 12, 12, 0, yes
426515004,  ally_cu, 18, 16, 2, yes
29171103,  raimoal, 3, 3, 0, yes
734800573023850496,  bastaunSIsalute, 6, 6, 0, yes
765631835086917633,  giuseppe_monta, 52, 12, 40, no
83126449,  ieffe, 3, 2, 1, yes
4878708910,  amoilsud, 9, 2, 7, no
546715205,  fernandoprincip, 2, 2, 0, yes
246410918,  StefanoMinnucci, 1, 1, 0, yes
808945040,  FreRuozzi, 10, 10, 0, yes
2856983111,  michelecippone, 8, 8, 0, yes
2574560504,  M_P_8, 30, 9, 21, no
19605785,  grillotalpa, 7, 7, 0, yes
381221179,  theo_grey, 4, 3, 1, yes
1031432587,  PSartore, 4, 2, 2, neutral
2520868692,  silvano73068906, 21, 7, 14, no
317305371,  katenever, 10, 9, 1, yes
3346552000,  Giuliapavesereg, 5, 5, 0, yes
409474239,  ItaliaMillennio, 15, 15, 0, yes
259594142,  kenponzio, 1, 1, 0, yes
739378759086804993,  andreamagro74, 2, 2, 0, yes
751554408,  OreficeSimona, 2, 2, 0, yes
353660574,  simo_gio, 1, 1, 0, yes
929354545,  AngeloRughetti, 8, 5, 3, yes
797833478,  bozzanca, 1, 1, 0, yes
3226068767,  MorgiaCarmen, 2, 2, 0, yes
399404980,  mario_sechi, 2, 2, 0, yes
2527431917,  chiara_menato, 2, 2, 0, yes
3293831915,  marcociarafoni, 9, 8, 1, yes
3300878565,  giulioaveta, 10, 10, 0, yes
1072129524,  GLG2705, 22, 22, 0, yes
492325083,  AnnaAscani, 17, 13, 4, yes
743746226454028289,  fillom71, 3, 3, 0, yes
2243345902,  carmelo_pirrone, 4, 2, 2, neutral
505070430,  AnjaRiceputi, 1, 1, 0, yes
2826544688,  francescolbs, 8, 8, 0, yes
432684759,  paolobonaretti, 7, 7, 0, yes
927074624,  tglrsr, 6, 6, 0, yes
1454875051,  AloiaMap, 2, 2, 0, yes
1935291096,  ICariani, 6, 6, 0, yes
2508257327,  Jianko_, 13, 12, 1, yes
3417536049,  Andreasangiorg9, 11, 8, 3, yes
399010858,  patriziaprestip, 9, 5, 4, yes
532545883,  Tetovaccari, 21, 20, 1, yes
4876627103,  _Clarissa26, 11, 10, 1, yes
1170127518,  pieravertecchi, 1, 1, 0, yes
483199277,  CiroCierro, 5, 5, 0, yes
184425554,  sysmedia68, 43, 22, 21, yes
251125230,  mimmomaiorano, 2, 2, 0, yes
318939643,  DAntognazza, 4, 4, 0, yes
2922945611,  maxfound77, 3, 2, 1, yes
782987100127985665,  gianlucavichi96, 6, 6, 0, yes
3880191809,  attilieni, 3, 3, 0, yes
1568078233,  francescobelve6, 1, 1, 0, yes
429683173,  MartaLeonori, 1, 1, 0, yes
837129073,  luciaperiss, 15, 14, 1, yes
110190828,  frapuzzu, 25, 17, 8, yes
400286971,  DavideLastrina, 4, 3, 1, yes
1350107509,  troianosalvo, 7, 7, 0, yes
415107191,  Salvo1Di, 7, 7, 0, yes
2281381593,  ChiaraDaneluzzi, 16, 8, 8, neutral
1052210108,  AGuaragna, 11, 11, 0, yes
329059297,  Paolo_Brescia_, 4, 4, 0, yes
800630640,  giorg201, 6, 6, 0, yes
789562622479835136,  matildepisis, 6, 4, 2, yes
4920828160,  daruni04, 34, 3, 31, no
1028499156,  f_crimi, 4, 4, 0, yes
1651093716,  pdpesarourbino, 11, 11, 0, yes
1219944530,  Samira1577, 33, 17, 16, yes
51412488,  ALBERTOENNA, 6, 4, 2, yes
1140098112,  taddei76, 18, 18, 0, yes
527311309,  sgagio, 2, 2, 0, yes
2560173527,  DelluomoVanda, 3, 1, 2, no
2911535435,  VolleyFranco, 7, 2, 5, no
386222471,  ema_pd, 9, 6, 3, yes
880274702,  angelovital, 2, 2, 0, yes
2246961171,  ItSonnina, 2, 2, 0, yes
2966174320,  Vittaox, 3, 3, 0, yes
1476948512,  SandraM_Tcon0, 12, 6, 6, neutral
199348405,  juancar80, 21, 16, 5, yes
2837297105,  albymorandi, 2, 2, 0, yes
365918287,  robyponti, 1, 1, 0, yes
106373557,  CristinaStorchi, 1, 1, 0, yes
1107573558,  mario_deiosso, 1, 1, 0, yes
479735780,  gabrielebit, 1, 1, 0, yes
738722778,  valecos57, 1, 1, 0, yes
8820222,  zacris, 8, 7, 1, yes
972414750,  simonettatomass, 25, 19, 6, yes
423631055,  Andrea_Alemanni, 2, 2, 0, yes
3342710915,  azzurrabito, 1, 1, 0, yes
422858171,  universopoesia, 20, 15, 5, yes
3481946428,  zozzumm, 45, 8, 37, no
803204175370784768,  Enric0Chessa, 10, 10, 0, yes
411702181,  ninobizzintino, 25, 16, 9, yes
513450320,  luiveceli, 9, 7, 2, yes
272475335,  FrancescoPigno, 7, 7, 0, yes
1134622500,  CassFabio, 2, 2, 0, yes
498295715,  lapricena, 1, 1, 0, yes
363091341,  xstuckwitharry, 3, 3, 0, yes
2436692908,  emilydel94, 1, 1, 0, yes
2201819716,  VeroDeRomanis, 1, 1, 0, yes
379224837,  egimazzon, 8, 7, 1, yes
418218972,  dsmarenostrum, 1, 1, 0, yes
89014481,  marketingpmi, 1, 1, 0, yes
1308910549,  nicololagrosa, 6, 6, 0, yes
211471014,  frsabatini62, 3, 3, 0, yes
1038136346,  diegocusumano1, 2, 2, 0, yes
2358132044,  AFrancaviglia, 5, 5, 0, yes
44136364,  MarcoLamperti, 1, 1, 0, yes
407134896,  giuliofbagnale, 7, 5, 2, yes
1223798888,  PrcBrescia, 2, 2, 0, yes
728295648,  GianluigiDotti, 56, 15, 41, no
144968778,  giankap, 4, 4, 0, yes
988334522,  CarloPellegri14, 14, 12, 2, yes
833489594,  GSRomeHub, 2, 2, 0, yes
2191000136,  ANTONIOSICONOL3, 5, 5, 0, yes
561204740,  AntonioMattiol1, 3, 1, 2, no
1060544983,  yanez_2006, 27, 20, 7, yes
60577301,  cislfp, 9, 8, 1, yes
326226399,  000120o, 257, 68, 189, no
710448678801166336,  FabrizioSpinet2, 1, 1, 0, yes
2720679460,  llutor53, 1, 1, 0, yes
1303959097,  LauraAluisi, 3, 2, 1, yes
3086634161,  sciarsi, 3, 3, 0, yes
934436456,  erosdavide, 6, 4, 2, yes
14394318,  FabioMontale, 36, 23, 13, yes
1876212612,  erretti42, 118, 75, 43, yes
490733693,  FRANCESCOCARDE3, 58, 15, 43, no
365419926,  AlexPiace, 1, 1, 0, yes
2488588980,  twitteventi, 48, 31, 17, yes
428915501,  PaoloBrandi, 61, 18, 43, no
1063948892,  MarnaSilimbani, 1, 1, 0, yes
534822090,  strata_gemma, 2, 2, 0, yes
3629322863,  JesterA380, 17, 5, 12, no
4405181775,  claudio09103870, 41, 3, 38, no
401362474,  AMPDEttorre, 11, 11, 0, yes
350256698,  Caffe_Graziella, 23, 11, 12, no
837667106,  Giannitori, 2, 1, 1, neutral
1518581960,  AndreaPiani82, 2, 2, 0, yes
798881423650328576,  C_XXVIIOttobre, 4, 3, 1, yes
467232496,  Da421954, 85, 63, 22, yes
725439723565670401,  Francesco_Burgo, 3, 3, 0, yes
2855662803,  iperione72, 1, 1, 0, yes
202256562,  AARomita, 27, 9, 18, no
788046798896201729,  BuildingScarl, 1, 1, 0, yes
2779739962,  loredanadisomma, 130, 96, 34, yes
776513859456790528,  Laura_83_x, 22, 16, 6, yes
728229998918811649,  Daniele37703331, 3, 3, 0, yes
534904479,  GioGioRosolia, 1, 1, 0, yes
769102852564381696,  stefani66149155, 8, 8, 0, yes
2436045041,  DonnDonnini, 10, 10, 0, yes
137273382,  capellone77, 1, 1, 0, yes
857767297,  AngeloBorella1, 1, 1, 0, yes
1493326248,  consigliererc, 1, 1, 0, yes
1678709946,  SAstigiano, 1, 1, 0, yes
2719487690,  carluccia72, 1, 1, 0, yes
407202862,  francescoVerbar, 1, 1, 0, yes
296475664,  MatzeuAle, 24, 10, 14, no
454014787,  simonafollement, 1, 1, 0, yes
2981706863,  ToscanaProvUni, 22, 9, 13, no
229587251,  Paolasimpatia, 5, 2, 3, no
2811134706,  GiPistelli, 1, 1, 0, yes
1283249520,  Massy2013, 21, 18, 3, yes
377444324,  VBalzametti, 1, 1, 0, yes
715888011146371072,  i_dati, 1, 1, 0, yes
302869256,  pacrodgon, 1, 1, 0, yes
376372455,  MASSIMOBERETTA, 3, 2, 1, yes
584513372,  AttacTorino, 1, 1, 0, yes
585289498,  MarioPescatori, 2, 2, 0, yes
1369853450,  giusfiore, 3, 2, 1, yes
3036745805,  Lucio_Apuleio, 49, 28, 21, yes
3010138109,  marc_corti, 22, 8, 14, no
3432685894,  ale_cccz, 1, 1, 0, yes
3391775794,  marjoskj75, 1, 1, 0, yes
3057893184,  alexpa6970, 2, 2, 0, yes
2150701203,  mariarosariamal, 2, 2, 0, yes
1551053264,  Alberto_Zoratti, 6, 6, 0, yes
419021368,  annaattajanese, 9, 4, 5, no
91789302,  sandrap09, 3, 3, 0, yes
2821237936,  RZZFPP, 1, 1, 0, yes
124528185,  radiondadurto, 4, 4, 0, yes
619383561,  SimonaBombieri, 1, 1, 0, yes
361373768,  FedericaDaga, 3, 2, 1, yes
3032909475,  bumerangselli, 12, 1, 11, no
521525028,  grimafil, 1, 1, 0, yes
2914562626,  freschi_paola, 23, 8, 15, no
1474822591,  LucaZizo, 9, 1, 8, no
323676734,  CMdiFirenze, 20, 7, 13, no
621230485,  CheGuevaraRoma, 6, 4, 2, yes
4416648267,  leodelgiudice7, 11, 11, 0, yes
1907744952,  indipendentieu, 3, 3, 0, yes
448761968,  giovi_bi, 14, 4, 10, no
89518361,  global_project, 2, 1, 1, neutral
2948909175,  agostinibis, 2, 2, 0, yes
431706859,  maricadipierri, 1, 1, 0, yes
22407920,  allcolours, 1, 1, 0, yes
60283424,  Ollipaz, 1, 1, 0, yes
3169131753,  lorenzocolav, 17, 16, 1, yes
16162692,  Elisheba, 12, 2, 10, no
602216944,  gurulku, 15, 5, 10, no
2360803296,  succodilimone1, 3, 1, 2, no
390850145,  GiuliaBuc, 1, 1, 0, yes
936592027,  cuoreeacciaio, 4, 3, 1, yes
980910583,  Gigidifr, 6, 1, 5, no
252184604,  M_J_Motta, 9, 5, 4, yes
4705505042,  AzzurroLibero, 108, 21, 87, no
4714030515,  Madeflo_Ce, 146, 29, 117, no
2338003979,  bolo_lo, 41, 31, 10, yes
1299140534,  giactoricelli, 8, 5, 3, yes
221090492,  MarNubium, 2, 2, 0, yes
34883730,  sillacellino, 21, 18, 3, yes
377429760,  giovcarrosio, 28, 28, 0, yes
52482015,  Giagina, 4, 4, 0, yes
2495549258,  MartinaOrlandi8, 29, 29, 0, yes
4174063036,  GiancontieriGi1, 61, 24, 37, no
12490782,  Augm_Italy, 21, 14, 7, yes
532499775,  francop1980, 4, 2, 2, neutral
2851968971,  HegelFriedrich, 21, 16, 5, yes
2839679883,  Fogagnoli5, 9, 9, 0, yes
2446659040,  GiabeaMura, 4, 4, 0, yes
86209782,  DanielaPF75, 38, 12, 26, no
763394561968177152,  berab78, 16, 15, 1, yes
3063222927,  LucaBarberini, 1, 1, 0, yes
1513046844,  Smacchi_Andrea, 1, 1, 0, yes
721432104396025857,  chiara_dipa, 74, 57, 17, yes
102117663,  AlexBertozzi, 1, 1, 0, yes
173789578,  devism76, 4, 1, 3, no
109652224,  Caronte1979, 11, 3, 8, no
79385667,  eurodeputatipd, 59, 53, 6, yes
188787298,  tidema81, 45, 41, 4, yes
712647058709155841,  RenatoVenditti1, 70, 43, 27, yes
796070566885289984,  MarcoMacchini65, 4, 3, 1, yes
1065146798,  roberto_scalia, 8, 6, 2, yes
1538890382,  NoiSiamoPronti, 2, 2, 0, yes
603612465,  agotwitts, 45, 19, 26, no
3873999737,  ErminioY, 8, 4, 4, neutral
263619418,  ricettedifulvio, 15, 7, 8, no
2663921790,  vittoria281073, 6, 0, 6, no
813055092,  manuela417, 32, 13, 19, no
2158966523,  Olivieri1Nicola, 41, 12, 29, no
308905321,  Luca4nrgs, 36, 13, 23, no
482783302,  vitellion, 17, 15, 2, yes
540184053,  MircoMastrorosa, 4, 3, 1, yes
192165373,  nonnomischa, 20, 3, 17, no
128216246,  antonaz1, 8, 0, 8, no
475127858,  sonoiolore, 31, 11, 20, no
25499078,  pitbum, 12, 2, 10, no
458268610,  luigi_pelerin, 7, 1, 6, no
481945340,  GiovanniZannola, 4, 4, 0, yes
472998662,  ChiaraCalace, 11, 11, 0, yes
55218593,  Jarluc, 6, 4, 2, yes
82578103,  Ominonero, 7, 2, 5, no
422665114,  didon76, 6, 0, 6, no
1130420497,  cocchi2a, 137, 44, 93, no
765647763442896896,  Vasco35481906, 83, 11, 72, no
1064422592,  FrMarenco, 11, 3, 8, no
2910801435,  MickySalomone, 4, 1, 3, no
24528997,  fabcelestini, 60, 23, 37, no
66739125,  giadalocatelli, 16, 14, 2, yes
3408637281,  lorenzo7514, 10, 7, 3, yes
208642171,  ManlioDS, 5, 3, 2, yes
265576861,  kasparroist, 9, 6, 3, yes
2921836294,  rterzaghi13, 2, 2, 0, yes
540669424,  antonioheinzl, 7, 4, 3, yes
2320321929,  MariaAdelfina_, 16, 10, 6, yes
715436925767782401,  giovanni101075, 5, 4, 1, yes
426774983,  corradomontaggi, 5, 5, 0, yes
763314544345219072,  albesnow85, 5, 3, 2, yes
2155767706,  CapitanBuggy, 19, 3, 16, no
1085677224,  SLeone76, 3, 3, 0, yes
244053999,  alesixties, 20, 4, 16, no
3023835220,  viceserva, 6, 6, 0, yes
757514581044498432,  Fils2Psy, 2, 2, 0, yes
802448379762667520,  antopapalia85, 13, 13, 0, yes
1728972326,  LoleLuis, 3, 3, 0, yes
418271962,  toni_sammarco, 3, 3, 0, yes
767783947220713472,  TRez5678, 230, 127, 103, yes
141529750,  LauraCarrese, 460, 208, 252, no
2716904270,  invalicabile, 4, 3, 1, yes
4818751077,  SicilianiLiberi, 8, 8, 0, yes
381369966,  SteAlbamonte, 8, 8, 0, yes
751814461690900480,  __Cersei__, 52, 26, 26, neutral
363528043,  donchi06, 3, 3, 0, yes
923270436,  el_gato112, 2, 2, 0, yes
231736009,  s1lv1ap, 2, 2, 0, yes
138832949,  lucafasolo, 2, 2, 0, yes
1546218236,  JessyRelly, 12, 5, 7, no
2476818032,  Enorazza, 2, 2, 0, yes
1664743039,  toroazul73, 13, 7, 6, yes
58016005,  martamacbeal, 46, 21, 25, no
537290044,  IsidoroGottardo, 26, 23, 3, yes
3944712676,  Claudio25463850, 4, 2, 2, neutral
317975293,  Massimo_Masini, 62, 33, 29, yes
1244272134,  ato_ucci, 2, 2, 0, yes
2296153657,  CarloAlterego, 62, 37, 25, yes
4860590037,  keiserarmagedon, 9, 5, 4, yes
2437403432,  rickyriga11, 46, 16, 30, no
3064138162,  shumann78, 9, 9, 0, yes
452350565,  GiorgioVaccaro, 21, 13, 8, yes
561880720,  drachenmadness, 3, 2, 1, yes
511673388,  L_Theseaderry, 5, 4, 1, yes
3259602153,  ChristiAthleta, 5, 5, 0, yes
628183914,  vincbrn69, 8, 7, 1, yes
456878624,  Floberge71, 2, 2, 0, yes
952399856,  danielapapa71, 4, 3, 1, yes
3327805900,  WYXYOVANNI55, 3, 3, 0, yes
588310965,  F1r3st0rm1979, 9, 6, 3, yes
4857980363,  AFerraioli96, 8, 8, 0, yes
757989565600858112,  Mick2117, 312, 158, 154, yes
100152848,  UomoZucca, 9, 8, 1, yes
362952577,  arianna_nastro, 2, 2, 0, yes
2996792386,  CampaniaPopol, 2, 2, 0, yes
1064357792,  suertefinal, 35, 20, 15, yes
1015149367,  Se23rex, 17, 11, 6, yes
784461318531215360,  uomodelloyeti, 3, 3, 0, yes
32935187,  Ale_De_Chirico, 4, 4, 0, yes
2917621780,  robertadamato37, 3, 3, 0, yes
3018648407,  piero7912, 3, 3, 0, yes
346518147,  Coccynella500, 34, 10, 24, no
437573164,  1962Grazia, 13, 8, 5, yes
863232396,  ChiriPiero, 31, 20, 11, yes
359892760,  sovrappeso, 2, 1, 1, neutral
528673372,  Dave_P_90, 10, 5, 5, neutral
2268903785,  FedPDTerni, 3, 3, 0, yes
1394460469,  faisala08513623, 6, 6, 0, yes
3377613693,  dr_alk68, 18, 13, 5, yes
979023937,  abrancaleone971, 21, 12, 9, yes
332921113,  bastaCasta, 59, 25, 34, no
42378175,  eirgiannara, 4, 4, 0, yes
2533217510,  2014Monaco, 40, 31, 9, yes
274703138,  marina_catucci, 4, 4, 0, yes
1447003466,  StefducFi, 28, 4, 24, no
1088806153,  misspassinella1, 47, 3, 44, no
22495783,  NiccoloVecchia, 10, 10, 0, yes
1694641429,  ancoraiopp, 16, 11, 5, yes
21328138,  martinaronchi, 11, 11, 0, yes
2465871252,  carlinacontini, 6, 6, 0, yes
766065,  doracalva, 4, 4, 0, yes
589007815,  LudoSaltamonti, 7, 7, 0, yes
353735007,  SimoneSilvi_, 4, 4, 0, yes
630961397,  RobertoGranai, 15, 7, 8, no
390754622,  robertosterza, 8, 1, 7, no
791741544831315968,  IOVOTONOO, 2, 1, 1, neutral
829507466,  danieleonori1, 22, 3, 19, no
2256453579,  pelli54, 38, 18, 20, no
2792119504,  DomenicoCarbon, 8, 4, 4, neutral
2163227033,  DottBellavia, 202, 29, 173, no
576946442,  RomualdoLuca, 10, 4, 6, no
310944185,  parsifalcinque, 3, 1, 2, no
805119209588006912,  difendolacasta, 43, 16, 27, no
1003031718,  MapiRocco, 5, 1, 4, no
3904145790,  Ereda_V, 51, 18, 33, no
1080249439,  pasqualemilly, 8, 3, 5, no
2358632181,  rafhp71, 11, 4, 7, no
252192394,  magrondo, 7, 3, 4, no
83631984,  mauri1709, 5, 1, 4, no
4818228771,  ErnePusceddu, 5, 1, 4, no
519596424,  annaluiseII, 10, 4, 6, no
719226699003609090,  simona_riccardo, 8, 6, 2, yes
2990246674,  DeriuRegina, 15, 8, 7, yes
395548966,  MatteoPuppi, 8, 6, 2, yes
481170386,  riccagalli, 4, 3, 1, yes
3042356055,  roppo_vale, 15, 13, 2, yes
1221983672,  vitominerva, 5, 3, 2, yes
502816187,  giankaleone, 4, 3, 1, yes
163899788,  andreacatalano, 28, 10, 18, no
2315538860,  loriana34406751, 43, 6, 37, no
788719661391159296,  Raburnato, 20, 12, 8, yes
1618648122,  enzuccioleone, 5, 3, 2, yes
2183704091,  l_borrelli, 4, 4, 0, yes
1322376432,  zanoni_giorgio, 106, 71, 35, yes
2848116069,  TeodoraTrevisan, 2, 2, 0, yes
3235436783,  held_andrea, 4, 4, 0, yes
1122896984,  MaurizioTrombin, 5, 5, 0, yes
2345467323,  AntonioSlk, 4, 4, 0, yes
2182009663,  NoiNotizie, 37, 24, 13, yes
2267174346,  Massimo_Ceru59, 23, 16, 7, yes
104551882,  virgiliomecca, 7, 4, 3, yes
1089391746,  Giulianodalcin1, 44, 43, 1, yes
1153719110,  anica__, 2, 2, 0, yes
1919282989,  Crakjack21, 2, 2, 0, yes
270844902,  roberto_lamela, 17, 16, 1, yes
3131027463,  fpruneri0, 7, 2, 5, no
489178186,  DgSilvia, 3, 2, 1, yes
1949046042,  subarubaracca, 2, 1, 1, neutral
312572813,  figliodeifiori, 70, 56, 14, yes
445704958,  giuseppeumile, 1, 1, 0, yes
1013772607,  MaDesanctis, 4, 2, 2, neutral
969698839,  AngelaMeoni, 14, 10, 4, yes
4039287245,  LindaPci, 23, 14, 9, yes
1480266476,  TommasinoB, 6, 5, 1, yes
195754877,  rtomartini, 5, 5, 0, yes
109232037,  andreacoccioli, 3, 3, 0, yes
1068648510,  MRossettidiVald, 49, 39, 10, yes
1298552276,  martinoro3, 1, 1, 0, yes
1139368074,  Paolacipciop, 5, 5, 0, yes
173377254,  lmanfron, 3, 2, 1, yes
437399075,  PierfraFrosini, 1, 1, 0, yes
408397798,  FabioAbrescia, 1, 1, 0, yes
4102866201,  eliserra54, 5, 4, 1, yes
543230090,  Michele_Caval, 1, 1, 0, yes
506363508,  il_brace, 1, 1, 0, yes
562440912,  AlvaroschAlvaro, 16, 12, 4, yes
2648971987,  gabrivisi, 1, 1, 0, yes
86342681,  loguerto, 13, 3, 10, no
340778097,  APizzamiglio, 5, 5, 0, yes
3079676979,  FilmDePaura, 6, 6, 0, yes
246804879,  mar_gagliardi, 3, 2, 1, yes
471859605,  egos23, 17, 6, 11, no
4358642595,  LiaColombo1, 27, 7, 20, no
264229851,  fstellini, 2, 2, 0, yes
1167348620,  angelacipi, 2, 2, 0, yes
410904136,  Miktroisi, 3, 3, 0, yes
255506193,  marcocappa_, 8, 8, 0, yes
113667004,  jacbas90, 20, 15, 5, yes
476109357,  DomenicoLococo1, 3, 2, 1, yes
1870961815,  aristogitone1, 49, 12, 37, no
3231071968,  zza66_na, 19, 18, 1, yes
417101186,  nocciolone, 35, 21, 14, yes
781389132216107009,  albertomarottax, 13, 10, 3, yes
2607072282,  NinniRaffy, 9, 4, 5, no
426755550,  enricopaoli1, 23, 19, 4, yes
2194307234,  francolabella1, 7, 7, 0, yes
744518687617593344,  franceccoy, 27, 11, 16, no
52354638,  _MatteoRoselli_, 3, 3, 0, yes
1258981104,  ErnestoLanzer, 7, 5, 2, yes
371335893,  rbSpezia, 1, 1, 0, yes
431658112,  settimo771, 37, 23, 14, yes
41544005,  fabiovalenza, 11, 4, 7, no
164841529,  vuotoarendere, 1, 1, 0, yes
16027813,  keown, 1, 1, 0, yes
1090175304,  FGengarelli, 7, 4, 3, yes
261912438,  kero____, 1, 1, 0, yes
119067790,  ArgoTone, 54, 22, 32, no
131926981,  socratesmarino, 3, 3, 0, yes
169112670,  margymo, 8, 8, 0, yes
782585681990279168,  stema963, 8, 7, 1, yes
4047428260,  sorradilesu, 6, 5, 1, yes
324254835,  zonaila, 4, 3, 1, yes
255239233,  astuz, 1, 1, 0, yes
440129895,  Rom_Lisa, 35, 27, 8, yes
750847152,  539th, 6, 2, 4, no
385088302,  FrancescoRapone, 33, 21, 12, yes
74157617,  stefanozacutti, 6, 1, 5, no
722067507679535104,  pontealto63, 8, 8, 0, yes
400182687,  Ales891, 1, 1, 0, yes
435206684,  salvyjo1, 4, 3, 1, yes
1030215193,  giorgiociamp, 2, 2, 0, yes
1121594502,  gsucchielli, 6, 3, 3, neutral
391531110,  sabsacc, 5, 1, 4, no
439357588,  TulliSergio, 13, 7, 6, yes
339101730,  anmorett, 5, 5, 0, yes
265025787,  Marcopochetti, 4, 3, 1, yes
3305976862,  vaglica61, 27, 12, 15, no
3000601366,  MammaNunmat64, 13, 8, 5, yes
1082674782,  CarlaFavilli, 1, 1, 0, yes
434736878,  RobertoDiRenzo1, 11, 6, 5, yes
4203250139,  Antonel31876143, 2, 2, 0, yes
405094298,  matteo_difiore, 7, 5, 2, yes
1291022089,  GScardanelli, 4, 2, 2, neutral
331105395,  Massimo_Lokard, 7, 2, 5, no
451705799,  Lucatt_, 10, 6, 4, yes
888075391,  RenatoBenvenuto, 11, 7, 4, yes
912822728,  maurodiez5, 2, 2, 0, yes
1365505080,  Pasquale_Mar, 4, 3, 1, yes
482807298,  F_bonazzi, 2, 1, 1, neutral
154551775,  Luca_Merico, 4, 4, 0, yes
206121956,  uomodlamansarda, 1, 1, 0, yes
70922978,  StefyLattanzi, 1, 1, 0, yes
2842679807,  FaremaF, 4, 4, 0, yes
166308250,  gianpieroegizi, 1, 1, 0, yes
67300621,  Giudaska, 11, 8, 3, yes
409311997,  ginevrasotirovi, 3, 3, 0, yes
2316274661,  stefanorusso60, 12, 8, 4, yes
36176128,  Mariunsen, 6, 1, 5, no
2645807629,  zerofama, 1, 1, 0, yes
812715367,  cecconeurale, 1, 1, 0, yes
30213564,  mtonino, 1, 1, 0, yes
2289394911,  sandrinomazzula, 2, 2, 0, yes
559513996,  GiuseppeSavino5, 10, 10, 0, yes
140435282,  CiroNelCuore, 3, 2, 1, yes
797008582822821888,  robx86990172, 12, 7, 5, yes
804008103222054912,  salvino_mattei, 58, 20, 38, no
2257121711,  LuciaTassan, 27, 25, 2, yes
1037749440,  002luigif, 3, 1, 2, no
3026875199,  susinamorta, 1, 1, 0, yes
985159742,  gabuchanTW, 1, 1, 0, yes
39744088,  ipanice, 2, 2, 0, yes
891474049,  sassusalvatore, 2, 2, 0, yes
984608412,  mtasinato, 26, 23, 3, yes
1641218742,  iervo18, 1, 1, 0, yes
52061182,  carloz75, 1, 1, 0, yes
780796503774236672,  tuttaroma, 3, 3, 0, yes
955323307,  lorenzabaroncel, 1, 1, 0, yes
708279385342795776,  MariaRonchiLugo, 1, 1, 0, yes
414047561,  LValentinis, 1, 1, 0, yes
396772006,  AlbertoBiondi1, 2, 2, 0, yes
375526258,  GegenLB, 2, 2, 0, yes
317209595,  zetappi, 4, 4, 0, yes
790836272478711808,  ManuelToscano77, 2, 2, 0, yes
1137389269,  LinaMercantile, 11, 11, 0, yes
961048572,  Tarantola46, 8, 8, 0, yes
991988197,  Barbara1234M, 5, 5, 0, yes
619258906,  riccardosozio, 4, 1, 3, no
1062937651,  giuseppetp55, 10, 5, 5, neutral
587281863,  raelmc1, 8, 7, 1, yes
237741775,  MarcoS141914, 3, 3, 0, yes
159505982,  Patty3685, 1, 1, 0, yes
182745707,  Green1059, 6, 2, 4, no
436005961,  Iclemyer_16, 1, 1, 0, yes
2655855700,  FerronettiMa, 10, 6, 4, yes
733377494078922752,  elche844, 2, 1, 1, neutral
490820347,  PaolaTassi, 6, 6, 0, yes
2258041135,  pdmarconiroma, 13, 13, 0, yes
1162582322,  MassySessa31, 11, 7, 4, yes
3405485543,  YodaSergio57, 5, 5, 0, yes
101445331,  EffeScudata, 14, 13, 1, yes
51792460,  giorgiomeletti, 11, 4, 7, no
3096956789,  zerofanzine2, 11, 11, 0, yes
254475889,  ettoreluttazi, 1, 1, 0, yes
919425433,  PaolaVincenti3, 6, 6, 0, yes
573632887,  lorenzom1996, 1, 1, 0, yes
584717759,  marideluca8, 5, 4, 1, yes
1112182046,  mdinoi1971, 1, 1, 0, yes
355775633,  alzatigianni, 2, 2, 0, yes
2316506476,  BoksXV, 1, 1, 0, yes
1334551939,  muviciannel, 2, 2, 0, yes
45099617,  alicapu, 2, 1, 1, neutral
782243428923011072,  SilvyBerly, 1, 1, 0, yes
229421085,  pmacry, 2, 2, 0, yes
1546547437,  nicola1691, 8, 7, 1, yes
776686108289667072,  Schiforma, 8, 8, 0, yes
3008007621,  frances80351746, 8, 8, 0, yes
453071336,  gabriellacoron, 3, 3, 0, yes
547807884,  Claudietto1983, 4, 4, 0, yes
2301319673,  Vitorchiano69, 2, 2, 0, yes
311539656,  antoniopolito1, 1, 1, 0, yes
418552934,  AntonioMoschet, 11, 8, 3, yes
2462444372,  mauriziomauri89, 9, 9, 0, yes
1636528548,  69_CLINT_69, 37, 30, 7, yes
58165167,  RavazzaniGuido, 9, 6, 3, yes
2363220615,  Riccardocbec, 2, 1, 1, neutral
36992050,  mlwadham, 3, 3, 0, yes
2350390728,  lucacovarelli, 4, 4, 0, yes
425317597,  werbond, 6, 6, 0, yes
3068648261,  stranoroberto1, 1, 1, 0, yes
703230721440223232,  3washibk, 1, 1, 0, yes
802895740922171392,  jgubbjj, 1, 1, 0, yes
802888116369551360,  auggjnb, 1, 1, 0, yes
802889139154780160,  bgohmn, 1, 1, 0, yes
802887783580844032,  KokoSkyinh, 1, 1, 0, yes
1382274499,  CiPintus, 15, 12, 3, yes
306384715,  DavidOLestrangE, 4, 1, 3, no
393519608,  luigiangelozzi, 6, 5, 1, yes
297923898,  marcoforletta, 5, 5, 0, yes
400040189,  danio_2401, 1, 1, 0, yes
2311967105,  nicoyatta, 6, 4, 2, yes
467642898,  michelacervoni, 5, 5, 0, yes
411066978,  mauri_a60, 2, 2, 0, yes
3399848795,  ___pietro___, 64, 61, 3, yes
803300349956198400,  HarryStockle, 1, 1, 0, yes
802931276705628166,  colalight_dade, 1, 1, 0, yes
771106587037532160,  esmplatt, 1, 1, 0, yes
802983365322403840,  gigig12121212, 1, 1, 0, yes
802909615495282688,  weswes12121212, 1, 1, 0, yes
1904586948,  UnSweetRouge, 1, 1, 0, yes
1631944412,  NouillesFr, 1, 1, 0, yes
1624328838,  BiuDreamOFF, 1, 1, 0, yes
1327500834,  LordiGeek, 1, 1, 0, yes
2314126375,  NLDGifts, 1, 1, 0, yes
1917907675,  MachinTVnew, 1, 1, 0, yes
1688892974,  WinWithWe, 1, 1, 0, yes
2479634919,  MeShadoww, 1, 1, 0, yes
711565996,  BiubleP, 1, 1, 0, yes
1350270674,  HeIpFox, 1, 1, 0, yes
1644927055,  Blu3play, 1, 1, 0, yes
714071409614594048,  UnPandaa_, 1, 1, 0, yes
1633087430,  WebySite, 1, 1, 0, yes
752065315379376128,  Opaxio, 1, 1, 0, yes
2364869654,  RapDegree_, 1, 1, 0, yes
171857278,  24enrico, 9, 2, 7, no
2353298806,  efel61, 3, 2, 1, yes
1692004472,  CremascoV, 13, 4, 9, no
302576693,  Sarasg1309, 2, 2, 0, yes
1394225527,  Fabio17Fiore, 5, 5, 0, yes
768427028487995396,  zwe_ig, 2, 1, 1, neutral
334291518,  Rooob1, 3, 3, 0, yes
293560915,  GMazzarano, 12, 12, 0, yes
4737088221,  SergioPandolfi2, 3, 3, 0, yes
754778209862942720,  centannidi, 1, 1, 0, yes
584610988,  dolcecoco88, 1, 1, 0, yes
778238719878987776,  GianBandi, 7, 6, 1, yes
3421640121,  laCecyCorti, 4, 2, 2, neutral
451148670,  GAbrusci, 5, 5, 0, yes
45413247,  FJdeAC, 3, 3, 0, yes
229082336,  massimonigi, 16, 5, 11, no
624543149,  sandro_bertini, 17, 17, 0, yes
2948863234,  paolacorrenti, 14, 6, 8, no
507777679,  nicolaCEFALI, 7, 5, 2, yes
3875305217,  SpaceMonkeyrx, 1, 1, 0, yes
404409239,  FerraroGiuliano, 6, 4, 2, yes
2510064032,  melgundogan1, 1, 1, 0, yes
627798394,  LeoneDentro, 3, 3, 0, yes
1372137114,  CesareTeutonico, 1, 1, 0, yes
400687617,  dpadvide, 2, 2, 0, yes
2484989746,  michemontre, 1, 1, 0, yes
102200819,  enrisav, 34, 15, 19, no
421681339,  luca994casoni, 2, 2, 0, yes
1093651303,  Zeta_IT, 2, 2, 0, yes
2637537674,  schierhangl, 6, 2, 4, no
2454267414,  Reginoverginell, 1, 1, 0, yes
1544149513,  YanishaMarie_, 1, 1, 0, yes
719991106591662082,  AleCatte92, 1, 1, 0, yes
819912974,  SilviaColla1, 1, 1, 0, yes
1911974670,  GiuseppBonanno, 7, 7, 0, yes
847114458,  intelligonews, 8, 4, 4, neutral
802926949723209729,  diegodeste4, 3, 3, 0, yes
2184362212,  titoborsa, 1, 1, 0, yes
518420028,  GPignolo, 1, 1, 0, yes
553490335,  argiovi, 2, 1, 1, neutral
391379955,  scingolo, 3, 3, 0, yes
366182644,  Jacop83, 8, 5, 3, yes
3457493836,  Taxy_Driver, 6, 4, 2, yes
50382610,  enricotiengo, 2, 2, 0, yes
67006079,  1giornodapecora, 79, 49, 30, yes
421171946,  SergioCaselli1, 1, 1, 0, yes
386574852,  stefanodirusso1, 3, 2, 1, yes
529255988,  CASTALDIGIOVANN, 2, 1, 1, neutral
2756379766,  frenks8, 4, 4, 0, yes
2689665578,  1282Ugo, 23, 13, 10, yes
427760301,  AndreaLazzarin3, 1, 1, 0, yes
618297054,  LSiravo, 3, 3, 0, yes
2480352662,  ErPirofila, 42, 18, 24, no
2173403836,  PaoloTrombin, 2, 2, 0, yes
472118555,  FilippinRosanna, 4, 3, 1, yes
151996735,  dolafasol, 4, 4, 0, yes
299837277,  andrealatino, 3, 3, 0, yes
28667984,  GothicPsyche, 7, 6, 1, yes
133697656,  2811scoop, 2, 1, 1, neutral
595356862,  CarbonFrank, 10, 8, 2, yes
141976292,  enricovergoni, 1, 1, 0, yes
433433668,  GiulioTermite, 1, 1, 0, yes
105172955,  Lizzina84, 1, 1, 0, yes
317661217,  Charlzit, 2, 2, 0, yes
606549225,  MartinoFiorenzo, 3, 1, 2, no
178091598,  Lorenzo_Fabrizi, 4, 4, 0, yes
887576396,  g_dimarzo, 1, 1, 0, yes
265438050,  gianfrancomanco, 2, 1, 1, neutral
1402803522,  1Haribo, 11, 6, 5, yes
326786526,  maurodl85, 1, 1, 0, yes
2180127219,  CesareMenon, 1, 1, 0, yes
630783289,  SimonePnacciah, 2, 2, 0, yes
1136163114,  falcomarzano, 1, 1, 0, yes
2951637958,  OstuniE, 3, 2, 1, yes
568621322,  Roberto6600, 5, 3, 2, yes
869898174,  MarcoLovisolo, 1, 1, 0, yes
934610184,  IsaMassafra, 2, 1, 1, neutral
2845402469,  Vimauba, 2, 2, 0, yes
419518532,  BennyFerraro, 8, 8, 0, yes
710589026840002561,  dominique82677, 17, 9, 8, yes
1357864352,  SimoCian7, 4, 4, 0, yes
2193133820,  massibisca, 2, 2, 0, yes
1245794678,  CARRIEROGIAMPIE, 1, 1, 0, yes
801870151549419520,  JanisJo628, 44, 31, 13, yes
2846403071,  piovesana_elio, 1, 1, 0, yes
1444734901,  Massimi92120067, 31, 10, 21, no
136205033,  antonioscacc, 11, 4, 7, no
2248959421,  JUREGRANDE, 3, 3, 0, yes
201744608,  AquilinoAQ, 3, 2, 1, yes
3001539066,  MyBusarello, 2, 2, 0, yes
2644058262,  NLantschner, 2, 2, 0, yes
191814638,  FabioSavelli, 4, 4, 0, yes
69874682,  massimoguerrini, 2, 2, 0, yes
2353208327,  npl_open, 2, 2, 0, yes
3294292911,  ccarchitetto, 3, 3, 0, yes
1192571306,  Rumenta_76, 3, 2, 1, yes
314413850,  mysonicnation, 2, 2, 0, yes
426548970,  ECostagli, 8, 7, 1, yes
1213722042,  madmakko, 6, 5, 1, yes
1342623084,  giuliomangosi, 3, 3, 0, yes
3344602462,  pinomuscost, 11, 10, 1, yes
379828012,  salvo311, 4, 4, 0, yes
496477841,  ostruzionista, 51, 28, 23, yes
566142199,  kenesoio, 21, 21, 0, yes
17777533,  amerberg, 5, 5, 0, yes
326316197,  BluDiChina, 40, 34, 6, yes
700412768730619905,  valerianom1948, 14, 3, 11, no
993159811,  MarcoMgp89, 4, 1, 3, no
894946183,  ilcavaliere54, 33, 17, 16, yes
434310171,  GiuseppeMammola, 6, 3, 3, neutral
2751078489,  cygnet601, 5, 2, 3, no
2597549564,  jimmyuforta, 15, 6, 9, no
17757501,  womenomics, 1, 1, 0, yes
41557680,  PoisonPrince81, 1, 1, 0, yes
2460461574,  Turismopassione, 1, 1, 0, yes
781781049328054272,  pylaimenes_, 1, 1, 0, yes
544670018,  ClapFormae, 5, 5, 0, yes
31233554,  fabriziogaias, 2, 1, 1, neutral
1083018577,  sara_turetta, 2, 2, 0, yes
2249785528,  doformichelli, 1, 1, 0, yes
1177930416,  andrea_dusio, 1, 1, 0, yes
270283748,  UrbanfileTwit, 1, 1, 0, yes
747634158357323777,  federlor111, 15, 10, 5, yes
2521185076,  federicanegri3, 2, 2, 0, yes
729912370798137344,  sabaplig, 1, 1, 0, yes
66678933,  ElisaTriolo, 1, 1, 0, yes
2283563834,  archeoliguria, 1, 1, 0, yes
801821131233705984,  innova_cambia, 1, 1, 0, yes
706570552031444992,  Anti_Globalist_, 9, 4, 5, no
1490509230,  alelomi, 1, 1, 0, yes
8032202,  umanesimo, 118, 54, 64, no
2262951296,  TerraMareCoop, 1, 1, 0, yes
4110208667,  commediaidioti, 10, 5, 5, neutral
1713750878,  il_massone, 3, 2, 1, yes
550355511,  FraPisaeLucca, 1, 1, 0, yes
795585541,  RobertoReggi, 8, 7, 1, yes
2289505911,  romi_andrio, 26, 17, 9, yes
2373178498,  festeggiantina, 3, 2, 1, yes
3020649220,  Danielilsa_, 6, 5, 1, yes
1700700151,  YOUPAVIA, 2, 2, 0, yes
434505068,  DarioNardella, 12, 12, 0, yes
99702635,  scarpettavenere, 31, 13, 18, no
4844733082,  opusdigitalis, 13, 7, 6, yes
2348203520,  CultureLover_it, 2, 2, 0, yes
4924594492,  dominiquezero, 82, 41, 41, neutral
2397328413,  rosaria_marano, 2, 1, 1, neutral
337024187,  carloghielmetti, 1, 1, 0, yes
1633830932,  SimonaeLuciano, 3, 3, 0, yes
569974381,  indivanados, 1, 1, 0, yes
195347585,  Meamusic, 1, 1, 0, yes
96106430,  rogerspa984, 3, 2, 1, yes
487724415,  donninilau, 1, 1, 0, yes
2635373185,  Acec_SdC, 1, 1, 0, yes
2635236188,  AcecBrescia, 1, 1, 0, yes
444807091,  removangelista, 2, 2, 0, yes
85568796,  ClaudioBocci, 1, 1, 0, yes
800442726,  Ladegustazione1, 1, 1, 0, yes
497879349,  anna_corcione, 2, 2, 0, yes
405514067,  mixborghi, 3, 2, 1, yes
2343390020,  ChiatanteEnrico, 19, 8, 11, no
392677681,  rep_napoli, 1, 1, 0, yes
189651787,  marcoforc, 1, 1, 0, yes
126269904,  Riminifieraspa, 2, 2, 0, yes
700711798454898689,  Something_Hap, 1, 1, 0, yes
131278936,  NicoFa71, 1, 1, 0, yes
334874985,  luca_melloni, 2, 2, 0, yes
2344018723,  ElenaGaiardoni, 15, 14, 1, yes
346421096,  RosaPolacco, 1, 1, 0, yes
455703414,  GiuliaDiCamillo, 1, 1, 0, yes
2282226151,  elenaritalaselv, 1, 1, 0, yes
792743364106002432,  SarahSilsby25, 1, 1, 0, yes
801980813210505216,  HLoma2015, 1, 1, 0, yes
1666482032,  nydiafinol, 1, 1, 0, yes
356159314,  giannetti_marco, 23, 13, 10, yes
492173396,  Culturalab, 3, 3, 0, yes
808924015,  sitathecheetah, 7, 5, 2, yes
3072848181,  terzofilo, 2, 2, 0, yes
804631560976732160,  2Mecenatismo, 2, 2, 0, yes
1348547088,  panuccimar, 1, 1, 0, yes
2792709256,  elendigiovanni, 1, 1, 0, yes
426557047,  GvLive, 1, 1, 0, yes
833575614,  laura_dominici, 5, 5, 0, yes
3154268397,  MaryCatalano7, 1, 1, 0, yes
797425320102137856,  katiolina72, 1, 1, 0, yes
29079049,  marinavalensise, 1, 1, 0, yes
44667538,  angelofallico, 3, 3, 0, yes
288768288,  katiaDaros, 1, 1, 0, yes
378212883,  alebratti, 39, 39, 0, yes
4857399178,  tv2000docfilm, 2, 2, 0, yes
387121961,  giannirossipres, 5, 5, 0, yes
715080807916912642,  pd_calice, 8, 8, 0, yes
967615364,  AntonioCiontoli, 18, 16, 2, yes
60624433,  fmusolino, 1, 1, 0, yes
1918247922,  1511maxi, 67, 4, 63, no
371751749,  ferrante_franc, 3, 1, 2, no
1050697136,  arnj40, 23, 11, 12, no
719652067934081024,  cristoferstyle, 3, 2, 1, yes
249099263,  italicmrwolf, 8, 4, 4, neutral
4200887327,  Patriota___, 8, 8, 0, yes
534135497,  AleLodi81, 24, 7, 17, no
892707241,  TaiBure, 17, 4, 13, no
280653259,  EugenioNicotra, 4, 1, 3, no
279975795,  marcoprex, 12, 6, 6, neutral
332299735,  Robecho1, 4, 1, 3, no
629781012,  d_aledegidio, 5, 2, 3, no
401644924,  GabrieleTeodosi, 4, 1, 3, no
557803659,  CuccaroGiuseppe, 61, 58, 3, yes
473328375,  eli_valli, 5, 3, 2, yes
804396764925140996,  MassimoilG, 18, 1, 17, no
995189316,  AUlacco, 28, 4, 24, no
1116398478,  FTedeschini, 15, 2, 13, no
4891433775,  ProvFigAQ, 19, 2, 17, no
22129679,  emanuelecarioti, 30, 11, 19, no
696658225157029888,  Fig_AQ, 18, 3, 15, no
460275730,  Fra0283, 165, 6, 159, no
276497372,  Gianni_Elia, 16, 15, 1, yes
2518805059,  Effegilo, 54, 22, 32, no
178330203,  mp_MarcoB, 14, 8, 6, yes
331496903,  Mene015, 14, 4, 10, no
827078815,  Rooscolt, 3, 3, 0, yes
431804232,  Maxim1114, 9, 6, 3, yes
474175425,  EnricoBorghi1, 15, 14, 1, yes
4404458955,  benito290783, 12, 12, 0, yes
1022538426,  Rolfi39, 11, 6, 5, yes
2189941508,  SorienteSara, 3, 3, 0, yes
321313255,  LCiocchetti, 4, 4, 0, yes
414676913,  f_parisi, 6, 6, 0, yes
108686966,  Ornx, 1, 1, 0, yes
2873406084,  sbanchi1, 1, 1, 0, yes
797157146521698305,  chiara_morandin, 3, 3, 0, yes
1713096900,  giadabazzurri, 2, 2, 0, yes
3124013698,  misiagentiles, 25, 23, 2, yes
2357331353,  ElisaGrande2, 1, 1, 0, yes
1389549614,  LBastianetto, 1, 1, 0, yes
448270129,  MariaIovine, 3, 1, 2, no
470476105,  fdetommasi, 1, 1, 0, yes
468295758,  TestaFilippo, 2, 2, 0, yes
2347290581,  DiRibot58, 40, 27, 13, yes
1166432604,  Andrethejukebox, 3, 3, 0, yes
779870528,  nicola_atlante, 11, 6, 5, yes
388718346,  maxsmeriglio, 4, 4, 0, yes
872652049,  MovimentoSEL, 3, 3, 0, yes
2794274979,  Mdefelice66, 4, 2, 2, neutral
1086442256,  CAvenali, 11, 11, 0, yes
460176241,  cislfproma, 14, 13, 1, yes
107517248,  BarillariM5S, 23, 6, 17, no
400258163,  LorellaCamerini, 4, 4, 0, yes
2900717633,  BrunoAstorre, 5, 5, 0, yes
74407666,  patrizietto, 1, 1, 0, yes
400363156,  Frankie8bcn, 2, 1, 1, neutral
742002390929444864,  MauroBat32, 4, 4, 0, yes
837483788,  ffabrr, 5, 5, 0, yes
1580487818,  UlAndrew, 1, 1, 0, yes
533172194,  LUKReale, 1, 1, 0, yes
602771351,  coopcorida, 3, 2, 1, yes
2789236959,  CarmiEsposito, 4, 4, 0, yes
67445228,  VCacciarella, 2, 2, 0, yes
451305585,  LelloForlini, 6, 4, 2, yes
397931865,  enrico_pagano, 3, 3, 0, yes
3891330923,  UnciNazionale, 1, 1, 0, yes
378096106,  Cuccello, 3, 3, 0, yes
119403625,  abaferx, 4, 4, 0, yes
1449586740,  TWM_Mag, 9, 9, 0, yes
478458166,  AlessioBuzzanca, 1, 1, 0, yes
2978233996,  cisl_fplazio, 13, 13, 0, yes
781483367434969088,  dpa52p, 11, 7, 4, yes
466920481,  GiorgiaGasbarri, 1, 1, 0, yes
58868395,  mywave76, 61, 22, 39, no
3430477522,  MosssyMossy, 3, 3, 0, yes
788777407662678016,  DemoS_Roma, 1, 1, 0, yes
391493436,  Paolo_Iannini, 3, 3, 0, yes
3768512055,  RobertaMonaco10, 15, 15, 0, yes
755720283445661696,  BussoneSergio, 2, 2, 0, yes
929354702,  PendolariRMNord, 32, 25, 7, yes
464675744,  semisconosciuto, 22, 4, 18, no
3294568690,  UnaManuACaso, 1, 1, 0, yes
35472464,  Alecorrias, 1, 1, 0, yes
395519589,  normaferrar, 2, 2, 0, yes
2175721850,  MassimoDiCave, 3, 3, 0, yes
58619489,  matvela, 7, 7, 0, yes
2319005124,  samataxi065551, 1, 1, 0, yes
1086395671,  martabonafoni, 3, 3, 0, yes
846790633,  evangelista1951, 2, 2, 0, yes
305648916,  GianlucaGarro, 7, 6, 1, yes
2862871654,  comunicacity, 2, 2, 0, yes
4830432723,  CNSNotify, 4, 4, 0, yes
1063009350,  UgoQuinzi, 26, 22, 4, yes
1045628209,  antogiaqui, 1, 1, 0, yes
411498237,  pino_pinot2001, 3, 2, 1, yes
1272471145,  PULERAGIOVANNI, 4, 3, 1, yes
110707837,  paoloferrari148, 1, 1, 0, yes
753510446800535552,  CristinaLiburdi, 4, 2, 2, neutral
127189314,  sangiuit, 9, 9, 0, yes
2455569297,  FeliciLory, 39, 37, 2, yes
432970985,  mariliabonadies, 1, 1, 0, yes
489300199,  LorenzoCapanna, 1, 1, 0, yes
267439693,  tepetrangolini, 4, 4, 0, yes
838513578,  NellaDalBen, 11, 11, 0, yes
1220358794,  FilippoBuccella, 1, 1, 0, yes
461501385,  menica2, 3, 3, 0, yes
461163988,  io_mny, 2, 2, 0, yes
29411470,  unmondodentro, 8, 4, 4, neutral
404774640,  sebavenneri, 3, 3, 0, yes
803339497190686721,  ninajeje240825, 16, 10, 6, yes
539997390,  Mau_Gubbiotti, 13, 13, 0, yes
479016805,  f3d3r1ko, 2, 2, 0, yes
3137085627,  066b059f2231460, 1, 1, 0, yes
620115817,  amatricenews, 1, 1, 0, yes
393421247,  MarzioMozzetti, 1, 1, 0, yes
376399556,  ceciliadelia, 1, 1, 0, yes
702051239710879744,  breast_imaging, 1, 1, 0, yes
413088593,  GPManzella, 1, 1, 0, yes
701723329,  edoannucci, 6, 5, 1, yes
164643911,  valepieru, 4, 4, 0, yes
4403955207,  annascarpa4, 8, 6, 2, yes
2259040253,  _redmoleskine_, 3, 2, 1, yes
1056095046,  RIETIUILT, 4, 4, 0, yes
360537015,  metallopensante, 1, 1, 0, yes
735872985396051969,  anapolitano709, 1, 1, 0, yes
2871347159,  laurenzi_luca, 30, 16, 14, yes
2531731314,  mauro_salvatori, 2, 2, 0, yes
1578645427,  Claugod82, 1, 1, 0, yes
1885687531,  patriziarutigl1, 11, 7, 4, yes
63431013,  marcolatini, 15, 8, 7, yes
1259549544,  michelevecchio2, 10, 7, 3, yes
441643347,  antoniobucellar, 10, 10, 0, yes
444020042,  MaxMicacchi, 3, 3, 0, yes
735357868837359616,  stefano_foresta, 6, 6, 0, yes
2745777701,  1ab0bc13e035466, 2, 2, 0, yes
78133415,  robertotavani, 2, 2, 0, yes
3341458427,  1_P_M_S, 5, 3, 2, yes
2338719661,  annamaria_ff, 40, 28, 12, yes
791561946827001856,  And7Cler, 4, 4, 0, yes
2447686987,  PezoneNatalia, 1, 1, 0, yes
957519266,  fsilvia67, 7, 5, 2, yes
2344469201,  letz73, 1, 1, 0, yes
2387987256,  Progetto_ABC, 3, 3, 0, yes
792356221684740096,  Garofita5, 1, 1, 0, yes
510430173,  DomenicoMoselli, 6, 5, 1, yes
481359440,  RomanOsservator, 13, 5, 8, no
1640728190,  GigsMaria, 1, 1, 0, yes
487465768,  cristianamarcon, 2, 1, 1, neutral
217939114,  marinofardelli, 5, 5, 0, yes
1228058216,  thequenne, 4, 4, 0, yes
405792460,  1ettoreb, 73, 35, 38, no
4875798496,  ClaudioGioserio, 1, 1, 0, yes
2470612327,  mmastropietri, 2, 2, 0, yes
727818198,  PaoneFlavia, 1, 1, 0, yes
4459166907,  liberadidonna1, 19, 14, 5, yes
939030506,  Mimmo_Interista, 2, 2, 0, yes
222040871,  DiregiovaniWeb, 2, 2, 0, yes
318388729,  AntonioNaddeo, 2, 1, 1, neutral
870445994,  LidiaRavera, 5, 5, 0, yes
1020770970,  pierpaolo_116, 2, 1, 1, neutral
1117316768,  giulio2007, 1, 1, 0, yes
914490302,  AntoliniRaoul, 5, 4, 1, yes
420466103,  adaloisi, 1, 1, 0, yes
290055520,  lsantini76, 1, 1, 0, yes
1168919390,  iGianpaolo, 2, 2, 0, yes
366643529,  AlexMarlboro83, 3, 3, 0, yes
712640848,  GiovannaPug, 1, 1, 0, yes
229089974,  SilvanaDenicolo, 25, 10, 15, no
463062191,  agneseciocia, 2, 2, 0, yes
193373862,  Bandini83, 5, 4, 1, yes
740255320023441412,  consuelita_yo, 5, 5, 0, yes
2439711755,  emocionycambio, 1, 1, 0, yes
2181742851,  MdSabini, 1, 1, 0, yes
3006375111,  hotvideotweets, 8, 6, 2, yes
1883127770,  marco_wp, 2, 2, 0, yes
3397587807,  ElvinaGjoni, 4, 3, 1, yes
772179521084809216,  mariacolapinto2, 1, 1, 0, yes
232221555,  jarna68, 2, 2, 0, yes
764182411563368448,  frajuris69, 1, 1, 0, yes
2374250211,  CostArtino, 2, 2, 0, yes
65872385,  MariaConversano, 7, 2, 5, no
802804935242944513,  fededigregorio, 3, 2, 1, yes
1655828119,  NQuadraro, 5, 4, 1, yes
4745507902,  socialcittadino, 1, 1, 0, yes
1464925662,  pierinaavorio, 1, 1, 0, yes
705395206368174084,  Guide_Rep, 3, 3, 0, yes
790447127637987328,  paogiardino, 10, 6, 4, yes
738120330129113089,  V_SostenibileRM, 1, 1, 0, yes
4290335187,  CZomparelli, 2, 2, 0, yes
2635714649,  a_ermetico, 93, 4, 89, no
428304452,  Lori_dg, 1, 1, 0, yes
272940016,  D_Etrusca, 28, 10, 18, no
434203166,  fondazionegc6, 1, 1, 0, yes
154103665,  Luca_2, 4, 2, 2, neutral
316939559,  er_professore, 2, 2, 0, yes
2780021099,  lisieux69, 1, 1, 0, yes
2927010322,  lippos73, 7, 4, 3, yes
465587507,  emmelleu, 5, 4, 1, yes
405400711,  GCDileo, 7, 4, 3, yes
2943808887,  dececcoenrico, 12, 2, 10, no
2459731620,  blelvilli, 8, 5, 3, yes
415564172,  adriano____, 14, 12, 2, yes
799562367323480064,  giulicose, 6, 6, 0, yes
771696450484994048,  MarcoNicastro5, 5, 5, 0, yes
990630679,  LuigiBerlinguer, 6, 6, 0, yes
1238996869,  RapoMarco, 27, 14, 13, yes
290669539,  Piero_Gallina, 11, 2, 9, no
87467449,  grotondi, 87, 8, 79, no
3297456253,  erikaleciancio, 51, 1, 50, no
4242565703,  laurapingitore2, 16, 0, 16, no
1565366160,  FedericaRanise, 12, 0, 12, no
3385872369,  massimoluigico2, 12, 0, 12, no
2192271144,  FI_Online_, 390, 29, 361, no
1344131071,  GruppoFICamera, 375, 27, 348, no
2494320428,  Nightmaresud, 19, 3, 16, no
461567074,  taxydriver66, 24, 16, 8, yes
804232112555651072,  kionz62, 11, 5, 6, no
745339531566661632,  raffaellamucci1, 122, 33, 89, no
97768554,  Simona_Aquino, 6, 6, 0, yes
730811617,  LiberoPetrucci, 21, 18, 3, yes
96582995,  smxworld, 2, 2, 0, yes
605280351,  NandoBocchetti, 8, 4, 4, neutral
91201238,  kudablog, 6, 4, 2, yes
1020814244,  DanielaArnoldi, 5, 5, 0, yes
437442344,  GraziaSco, 2, 2, 0, yes
138616135,  toniobernardini, 1, 1, 0, yes
229801419,  Flavio_Lembi, 4, 4, 0, yes
46372795,  ricchiardic, 2, 2, 0, yes
2830250113,  RenataCinosi, 1, 1, 0, yes
576934973,  lisanoja, 1, 1, 0, yes
866679978,  fede2_4, 7, 7, 0, yes
929334312,  gerri24giugno, 4, 4, 0, yes
515500184,  LuigiPizzoruss, 1, 1, 0, yes
2606389745,  isamiccoli52, 3, 3, 0, yes
775450302120071168,  Kluna76, 2, 2, 0, yes
2348946608,  marcobachechi, 2, 2, 0, yes
605720129,  jannuzzig, 2, 2, 0, yes
2282422430,  Ali_answers, 1, 1, 0, yes
16377508,  gala81, 7, 2, 5, no
1333730431,  rapatrax, 4, 4, 0, yes
2726948745,  michele_pala, 4, 4, 0, yes
2850074284,  karypant, 52, 36, 16, yes
1004781943,  zenoerre, 17, 12, 5, yes
779685782235783168,  Al_Quanto, 6, 5, 1, yes
3404259215,  Africa24it, 3, 3, 0, yes
2483727075,  Sillysally587, 1, 1, 0, yes
292366987,  MorandiManuel, 1, 1, 0, yes
874365966,  la_fra78, 6, 5, 1, yes
2446566024,  sfassad524, 1, 1, 0, yes
722684492,  gabrielepx, 46, 30, 16, yes
735485321727508483,  AlbertoCostagl1, 4, 4, 0, yes
2484454589,  VergzOner901, 2, 2, 0, yes
17062107,  EMarchiafava, 12, 11, 1, yes
20373953,  IleP, 15, 15, 0, yes
47161489,  Giam_Liuzzi, 8, 7, 1, yes
705457003116765186,  PeruzzoEugenio, 1, 1, 0, yes
2475563657,  Mayhemthellon, 2, 2, 0, yes
87136437,  SACEgroup, 2, 2, 0, yes
3345251087,  OrtygiaBS, 1, 1, 0, yes
1549242308,  RonaldMenti, 12, 10, 2, yes
1597871846,  AfricaeAffari, 2, 2, 0, yes
1236577764,  arzambo, 17, 13, 4, yes
425695309,  24paoladezza, 8, 7, 1, yes
617158049,  samirhamzah642, 1, 1, 0, yes
2486572277,  rksoldlnhouston, 1, 1, 0, yes
394870816,  erducaconte, 2, 2, 0, yes
4708740167,  antoniettampa, 3, 3, 0, yes
2172567591,  CristinaGuarise, 4, 4, 0, yes
474026222,  pino_nostro, 17, 13, 4, yes
3376276635,  fr_pepper, 2, 2, 0, yes
961184737,  ffranpeve, 9, 9, 0, yes
1618316666,  gabrielerampiun, 2, 1, 1, neutral
382358973,  giusi_nicolini, 5, 5, 0, yes
438476133,  trepazia, 45, 18, 27, no
3378319665,  DifonzoPdf, 1, 1, 0, yes
795590799736078336,  MassimoVolpi6, 5, 5, 0, yes
4922654369,  Viktorv042, 2, 2, 0, yes
491596404,  PLopalco, 1, 1, 0, yes
922711819,  binottofranco, 78, 27, 51, no
725422192046039040,  Ombrettapinco, 8, 4, 4, neutral
265445410,  chiara2612, 2, 2, 0, yes
407636372,  DrKrisKelvin, 9, 6, 3, yes
433236253,  fabioachille, 9, 6, 3, yes
2752533784,  CarelliElder, 4, 4, 0, yes
277932088,  Dis_Incantata, 4, 3, 1, yes
315970979,  nicola_liguori, 4, 1, 3, no
469603992,  marco_scopigno, 1, 1, 0, yes
1052509542,  AndreaChiarotto, 1, 1, 0, yes
2323955682,  MancoUnEuro, 10, 9, 1, yes
185991911,  elina975, 3, 2, 1, yes
1139825378,  l_talamonti, 8, 7, 1, yes
234445362,  democratici, 5, 5, 0, yes
51434936,  gianlucacaruso, 8, 7, 1, yes
799012662550155265,  pedisonstar, 3, 2, 1, yes
1103842022,  crstnsp, 1, 1, 0, yes
318615150,  GhiottoEnrico, 11, 6, 5, yes
802960255147773952,  tunmiraten1987, 1, 1, 0, yes
43888814,  ilariadecarolis, 1, 1, 0, yes
2921143773,  MonicaMoniqye, 12, 6, 6, neutral
521564908,  MuratoreNico, 10, 5, 5, neutral
47057507,  Laurcos, 1, 1, 0, yes
925874496,  StefanoNistri, 3, 2, 1, yes
1134483002,  pdcapitanata, 9, 6, 3, yes
1148304355,  camillasgambato, 5, 5, 0, yes
923427594,  DavidBorzi, 5, 3, 2, yes
35804051,  ernestocarbone, 15, 15, 0, yes
4603979663,  patmammagatta, 13, 11, 2, yes
771020626903572484,  JuliaoZanellato, 4, 4, 0, yes
1373138137,  Daniele_Branca, 20, 3, 17, no
2480790371,  mrsdk87, 1, 1, 0, yes
784101368646819840,  Jpolemica666, 3, 1, 2, no
477744348,  robertoracc, 7, 7, 0, yes
565354789,  Chiara_Pax, 29, 13, 16, no
434558035,  l_patrizia, 18, 10, 8, yes
580789807,  Paolaaa81, 3, 1, 2, no
514714806,  RobertoTatankaa, 43, 24, 19, yes
425629947,  rpzuff, 3, 3, 0, yes
482200286,  ginocantante, 3, 2, 1, yes
358794756,  pietrone82, 3, 2, 1, yes
30218895,  FrancisBegbie, 1, 1, 0, yes
906668004,  granchiagata, 4, 4, 0, yes
26492009,  wavebass, 11, 11, 0, yes
718791150325403649,  mariella2giugno, 15, 3, 12, no
1854191378,  LeggioCasa, 1, 1, 0, yes
239572279,  fgambarini, 1, 1, 0, yes
3329401258,  spacciapietre, 2, 1, 1, neutral
47606389,  biassonda, 3, 3, 0, yes
419396501,  LucaTorchia, 2, 2, 0, yes
282643059,  jacopogiliberto, 22, 15, 7, yes
63650287,  TommasoTriberti, 11, 11, 0, yes
379069526,  MarcoSchipani, 1, 1, 0, yes
940963134,  labillina, 1, 1, 0, yes
3295906144,  Earl_Decker, 1, 1, 0, yes
778517398991364097,  UovoPrimitivo, 1, 1, 0, yes
386226952,  ilamarinaci, 2, 2, 0, yes
1157043744,  gsaggese84, 34, 20, 14, yes
859867832,  GabrieleGrax, 2, 1, 1, neutral
2178536571,  IsabellaLell, 10, 3, 7, no
435935449,  AmbraChi, 4, 2, 2, neutral
1171395356,  Leggilenuvole, 34, 16, 18, no
2323867147,  gigicimanchi, 12, 11, 1, yes
291157825,  lupiluc, 1, 1, 0, yes
595401077,  FrancescaToxiri, 5, 5, 0, yes
238296764,  antontix, 4, 4, 0, yes
2166570035,  AcattaAngelo, 1, 1, 0, yes
802569490324193280,  ocrasi, 1, 1, 0, yes
47948395,  crisfachet, 1, 1, 0, yes
2256191381,  tonino_cellini, 1, 1, 0, yes
69241041,  alecommy, 1, 1, 0, yes
131849009,  mvilla84, 2, 2, 0, yes
481409710,  Bart1705, 14, 4, 10, no
18728003,  mventuriniTg2, 1, 1, 0, yes
1527062406,  pd_noi, 13, 13, 0, yes
422042010,  annalisatani, 3, 3, 0, yes
1061060934,  francecaminiti, 10, 5, 5, neutral
510439689,  Ciavarda, 3, 1, 2, no
2582071238,  antonietta_ae, 1, 1, 0, yes
2601125506,  poti_f, 1, 1, 0, yes
798570804086763524,  sjcarjo1, 83, 13, 70, no
771495594695294976,  GiuseppMorgante, 4, 4, 0, yes
1418015090,  EdoardoPrestant, 6, 6, 0, yes
136923043,  mapicar, 6, 6, 0, yes
1207502412,  GerardoBiancofi, 1, 1, 0, yes
401753108,  S4Giv, 5, 4, 1, yes
569345469,  BrandoBolis, 1, 1, 0, yes
775304806332243968,  Maria_Intermite, 6, 6, 0, yes
193269654,  MRLINO84, 2, 2, 0, yes
16213811,  orenove, 25, 23, 2, yes
1150846033,  PR_Lorenzo, 1, 1, 0, yes
406996560,  PortaL127, 4, 3, 1, yes
198234611,  TitaBart, 17, 14, 3, yes
731191159352135682,  KizniF, 1, 1, 0, yes
425353753,  Mic_Pp, 1, 1, 0, yes
310873435,  marco_pavanelli, 5, 5, 0, yes
4050739455,  pontecorvoste, 9, 9, 0, yes
749984254923243525,  MilanoBastaUnSi, 20, 19, 1, yes
925569967,  RLevantesi, 3, 3, 0, yes
2202172361,  LucaStellin, 8, 7, 1, yes
3040108465,  DiegoTomba, 1, 1, 0, yes
2361116313,  Andrea92Sardi, 1, 1, 0, yes
184538647,  fspegni, 2, 2, 0, yes
880920558,  esedra80, 5, 3, 2, yes
68492512,  GraziaDigi, 5, 3, 2, yes
488884383,  AndrucciIvan, 1, 1, 0, yes
371205092,  alessandradecol, 2, 2, 0, yes
3001670111,  MolestaProposta, 3, 3, 0, yes
2464168508,  ginorusso76, 4, 4, 0, yes
2360900988,  andrea_lallero, 4, 2, 2, neutral
589911268,  Federiko_Teramo, 4, 4, 0, yes
62022464,  massimomarini, 3, 3, 0, yes
3104344534,  marcotrocu, 27, 12, 15, no
56424287,  dodobotti, 1, 1, 0, yes
433532650,  anto_pelle, 2, 1, 1, neutral
92807485,  antonioromeo51, 1, 1, 0, yes
2201613873,  GPerioli, 26, 5, 21, no
4885373164,  giovadimarino1, 3, 3, 0, yes
541824556,  MichelaRoi, 15, 11, 4, yes
584529887,  Sntgvn, 19, 16, 3, yes
3569863816,  vassilinez, 4, 4, 0, yes
1572554311,  r_lukas2, 3, 3, 0, yes
85525364,  AndreaFabbri76, 3, 3, 0, yes
3157875893,  cherubriella, 28, 27, 1, yes
471763431,  francopavoni1, 6, 5, 1, yes
122016493,  senzasinistra, 54, 43, 11, yes
151246430,  pakywood, 10, 4, 6, no
9046922,  alebegoli, 5, 4, 1, yes
520610672,  StefaniaCastel7, 4, 3, 1, yes
277166478,  ilarialivigni, 4, 4, 0, yes
397954508,  muftiakeel, 1, 1, 0, yes
406948594,  Francesco_Morra, 8, 8, 0, yes
2449553318,  MzzAshley75, 1, 1, 0, yes
11061452,  csarmento, 1, 1, 0, yes
23424732,  pinopao, 3, 2, 1, yes
47373547,  stebaraz, 5, 5, 0, yes
400872094,  dhobyghaut1, 1, 1, 0, yes
2412391183,  EMANUELEFERRERO, 2, 2, 0, yes
24150879,  SimoneAlliva, 11, 7, 4, yes
423831266,  clemgin, 3, 2, 1, yes
503176063,  emimatite, 11, 9, 2, yes
1334810558,  LucioTrevi, 2, 2, 0, yes
47438785,  chamberlainn, 6, 1, 5, no
1462020710,  s_lospalluto, 1, 1, 0, yes
9806412,  gipuntoe, 7, 7, 0, yes
56330720,  sgriccio1001, 1, 1, 0, yes
144210805,  Capezzone, 1, 1, 0, yes
574547398,  TommasoPitacco, 8, 5, 3, yes
3092514273,  pulce_mm, 2, 1, 1, neutral
40708908,  MaxCharmed, 27, 19, 8, yes
50606585,  R_Reventlov_G, 8, 7, 1, yes
2612367034,  m_quarto, 2, 2, 0, yes
2449452788,  oracion876, 1, 1, 0, yes
2720848557,  GiovanGiuliano, 1, 1, 0, yes
35186130,  GianPaoloCrasta, 1, 1, 0, yes
2823678166,  paoletta956, 7, 7, 0, yes
2400347005,  marcofelici14, 22, 13, 9, yes
713448101785288708,  Archifabrizio, 14, 14, 0, yes
2965770017,  alessandro_adl, 15, 15, 0, yes
255752744,  Valente_Alfredo, 16, 11, 5, yes
634756844,  massimil_perna, 1, 1, 0, yes
533311301,  BuratoM, 2, 2, 0, yes
38174037,  Fabio_MP, 1, 1, 0, yes
1639783585,  SisterSuzie64, 1, 1, 0, yes
3331413322,  MassimoTenesmo, 22, 11, 11, neutral
2479999514,  oltrelidea, 12, 6, 6, neutral
1215938191,  KiccaE, 6, 3, 3, neutral
2420100298,  tonyo1969, 11, 6, 5, yes
2449822573,  ClayHaskeil, 2, 2, 0, yes
2486332769,  Amanda_J0_, 2, 2, 0, yes
30619402,  Jacopopo, 1, 1, 0, yes
520789750,  pernambucano83, 12, 11, 1, yes
701046240788803584,  chiovaro9, 3, 3, 0, yes
718036012,  roberto_palo, 3, 3, 0, yes
518616174,  FondazioneAVSI, 1, 1, 0, yes
599144874,  LegacoopRomagna, 1, 1, 0, yes
746354834329182209,  valyfalz, 5, 5, 0, yes
28073305,  ItalyinUK, 1, 1, 0, yes
1061317800,  francescagraz1, 9, 9, 0, yes
1072429142,  elirov71, 4, 4, 0, yes
2163514121,  nappi43, 26, 11, 15, no
74208164,  spippolo, 2, 2, 0, yes
65896059,  CBorneoSindaco, 4, 4, 0, yes
3034643483,  DettoGinoPanino, 82, 33, 49, no
2224962167,  DiniMillo986, 98, 10, 88, no
436870309,  REN1pz, 63, 42, 21, yes
2250751981,  LuGi60, 9, 9, 0, yes
564584652,  AndreaDominijan, 5, 5, 0, yes
62316892,  mariahgravity, 2, 1, 1, neutral
702432335078285312,  NewsComunaliRM, 27, 13, 14, no
795963213724663808,  marcobal99, 7, 3, 4, no
61225083,  LNDC_NAZIONALE, 4, 2, 2, neutral
475134082,  GerryPickford, 72, 2, 70, no
193008820,  mariellademarco, 3, 1, 2, no
700388922430504960,  Marti_Mussi, 31, 20, 11, yes
370690455,  InfoAtac, 10, 2, 8, no
384198953,  Simone_Lovegod, 4, 2, 2, neutral
1082473454,  Official_zanzi, 3, 1, 2, no
3194879351,  Citizensforair, 2, 1, 1, neutral
489437535,  FiannaccaGio, 4, 3, 1, yes
300775565,  l_indro, 5, 4, 1, yes
968512015,  marcoGdb, 4, 3, 1, yes
96617396,  IAmPaoloMathieu, 5, 4, 1, yes
352576987,  leoquartana, 9, 5, 4, yes
2430519857,  markspa80, 7, 5, 2, yes
1025054731,  pattyperr, 30, 12, 18, no
62940685,  MorbiduZz, 17, 0, 17, no
1068702612,  Fuxino89, 51, 4, 47, no
715121732110172160,  M_A_imperator, 12, 1, 11, no
3238853314,  Heidibrucia, 11, 3, 8, no
2267448493,  nico_pelizzari, 5, 3, 2, yes
1079858408,  martingrassi1, 19, 18, 1, yes
454209425,  AntCampisi, 7, 5, 2, yes
164385252,  PinkLadyVe, 3, 2, 1, yes
1214826468,  bob_brizio, 5, 3, 2, yes
1673265012,  FCristofanelli, 5, 4, 1, yes
2958464458,  fibbi_martina, 11, 6, 5, yes
1275308629,  elenina_CC, 35, 20, 15, yes
68402631,  radiolombardia, 14, 11, 3, yes
925695715,  vedoliberal, 17, 16, 1, yes
2266033014,  marinacorinna, 11, 8, 3, yes
249910566,  truleely, 13, 10, 3, yes
414624461,  ElenaCrista, 7, 5, 2, yes
1388488790,  battagliafab, 18, 10, 8, yes
741541393496199169,  StoConSalviniM, 10, 5, 5, neutral
703927942192173056,  AlexSv85, 471, 233, 238, no
1128256520,  XianoRock73, 6, 4, 2, yes
2307333362,  StefanoVaccari_, 17, 9, 8, yes
281358271,  sirmalo, 38, 33, 5, yes
4414211859,  fioramontiFN, 12, 6, 6, neutral
757899059399131136,  sarapesenti87, 12, 9, 3, yes
97306503,  giuseppepafundi, 3, 2, 1, yes
108869321,  PatryDon, 9, 7, 2, yes
460496380,  clama1963, 19, 11, 8, yes
179121927,  AtzSv, 3, 2, 1, yes
3039628433,  GianluLover, 54, 28, 26, yes
1521664754,  Beca8686, 5, 3, 2, yes
796233468837527552,  riccardo_nunzio, 8, 5, 3, yes
470174685,  comearturo, 4, 3, 1, yes
3185042662,  SolianiMs, 5, 3, 2, yes
3043540575,  syusy1, 31, 14, 17, no
2641812921,  Marzia92Marzia, 3, 2, 1, yes
469587652,  FedericoDotto, 4, 3, 1, yes
513341924,  Stenofilius_13, 3, 2, 1, yes
112158044,  fedetrade, 10, 8, 2, yes
797430048945008640,  eggsbaconblog, 18, 12, 6, yes
438290574,  AnSalvati, 5, 4, 1, yes
2438848524,  Fra_Tapperi, 5, 4, 1, yes
315281049,  etincelle89, 3, 2, 1, yes
2882472476,  ErrataConiuge, 3, 2, 1, yes
291314569,  EsseSimone, 9, 5, 4, yes
557950729,  AltriMondiGazza, 10, 7, 3, yes
73971750,  riotta, 37, 30, 7, yes
2592758547,  lapapera50, 34, 22, 12, yes
1181544271,  MMoocher, 18, 5, 13, no
737408193014435840,  eemmeci, 8, 7, 1, yes
425273199,  FrancescoRuss42, 3, 2, 1, yes
331727335,  moodub, 3, 2, 1, yes
464158257,  Steve_Torvalds, 5, 3, 2, yes
1025496186,  Darioddj90, 3, 2, 1, yes
403308180,  zaninello_denis, 9, 7, 2, yes
332928374,  sLexyi, 3, 2, 1, yes
1360582447,  ANNABASSI6, 54, 22, 32, no
434409748,  PietroCherchi, 3, 2, 1, yes
819397051,  CucinaconStile, 5, 3, 2, yes
488351232,  Iredhel, 3, 2, 1, yes
3432756729,  andreavetto97, 4, 3, 1, yes
550410227,  marsandr01, 7, 3, 4, no
697888828955168768,  nicoscrema, 11, 6, 5, yes
791302394864959488,  LixFede, 10, 9, 1, yes
2360335217,  sa_ambro, 18, 12, 6, yes
2785334697,  AlessiaMarck, 57, 28, 29, no
402352368,  BartLeo, 25, 22, 3, yes
595231747,  PABaracus, 16, 11, 5, yes
2236338761,  il_Franci_Coc, 3, 2, 1, yes
4923500123,  EdoardoSatuto, 38, 11, 27, no
3034434386,  alegoliato, 29, 2, 27, no
536225770,  ValeNaldi89, 8, 3, 5, no
1655253469,  DrAntoniaPagani, 3, 1, 2, no
242339687,  arteletteratura, 68, 18, 50, no
854310253,  CasafinaGennaro, 59, 30, 29, yes
1114019642,  BresciaFacile, 20, 6, 14, no
1118923172,  CarMineVitale90, 8, 4, 4, neutral
1051389715,  MariucciaMarras, 48, 7, 41, no
314059678,  gianfranco_fini, 46, 6, 40, no
528855195,  RobertoReimondi, 6, 1, 5, no
527710207,  AlbertRugy, 5, 1, 4, no
762274877806084096,  GiulianaBozzol1, 15, 2, 13, no
793166155112386560,  cioenelsenso, 43, 14, 29, no
1272047413,  CasolinoAntonio, 3, 1, 2, no
500655700,  _MonicaBonatti, 6, 3, 3, neutral
35298549,  serracchiani, 4, 3, 1, yes
112454772,  ernestdematteis, 9, 4, 5, no
637015768,  simosimotw, 36, 24, 12, yes
464825869,  robertobarani, 4, 2, 2, neutral
337333658,  SemGio, 5, 2, 3, no
247222140,  robertomenia, 10, 1, 9, no
49654941,  TommasoMignini, 2, 1, 1, neutral
1098262302,  BlobRai3, 18, 12, 6, yes
541692979,  annoupanoux, 10, 9, 1, yes
1098245892,  papoblob, 4, 2, 2, neutral
431157210,  GiuseppeCascon3, 26, 4, 22, no
2832177977,  fumolapippa, 13, 7, 6, yes
2656955561,  lellokata, 8, 7, 1, yes
470359977,  StefanoFugazzi, 39, 19, 20, no
138868693,  carlopaolicelli, 20, 6, 14, no
813659052,  Maraccorsi, 11, 9, 2, yes
133246377,  RadioPikaza, 8, 7, 1, yes
514552306,  lanzi53, 16, 10, 6, yes
44856884,  cittadelcapo, 5, 5, 0, yes
2827734168,  decan491, 8, 5, 3, yes
79813277,  zebowsky, 7, 7, 0, yes
800798359430696960,  Leuroteista, 25, 24, 1, yes
774874962700238848,  Bannata2, 17, 3, 14, no
167085694,  CalogeroCastald, 7, 6, 1, yes
602982217,  ransielupesku, 7, 6, 1, yes
20940320,  pierpa2, 21, 10, 11, no
1036547636,  RinaPesucci, 1, 1, 0, yes
203000387,  alessiopost, 4, 4, 0, yes
407051453,  saurokursk, 9, 4, 5, no
2767316247,  linda_mancino, 9, 1, 8, no
3074030826,  Pro_TETTO, 2, 2, 0, yes
418611833,  ReporterNuovo, 4, 4, 0, yes
903551454,  oniizip10, 5, 1, 4, no
447383607,  giov4you, 4, 2, 2, neutral
467246076,  massimosimini, 2, 2, 0, yes
3026213409,  ELETORTE, 2, 2, 0, yes
3586852035,  ilnostroSINDACO, 2, 2, 0, yes
509873976,  ScheggeMilano, 1, 1, 0, yes
2301153684,  MatrixEsiste, 2, 2, 0, yes
855180290,  iomedesimame, 28, 14, 14, neutral
1274855814,  braveheartmmt, 11, 5, 6, no
54122393,  WellnessGourmet, 3, 2, 1, yes
146738509,  Noninfluente, 5, 2, 3, no
2491534261,  KimfoxRoby, 15, 9, 6, yes
3232946595,  ASSOVOLOLIBERO, 2, 2, 0, yes
1043255768,  FedericoANevola, 3, 2, 1, yes
50246502,  littleboypc, 7, 5, 2, yes
485521993,  ZanettiFausto, 63, 36, 27, yes
1270339064,  RiccardoDeias, 21, 20, 1, yes
368595599,  fiore976, 5, 3, 2, yes
577169108,  FabrizioFiorina, 12, 9, 3, yes
532163319,  Nessuno2012, 13, 6, 7, no
2363670784,  ernluccar, 42, 19, 23, no
701650211391848450,  Francostrag, 18, 10, 8, yes
581203955,  GenniPelliccia, 5, 3, 2, yes
2527331874,  AlessioAntani, 6, 4, 2, yes
1220743790,  SteGiango, 1, 1, 0, yes
42579697,  RiccardoSussi, 2, 1, 1, neutral
885303356,  rekotc, 15, 8, 7, yes
3326844719,  francisgiuli, 4, 3, 1, yes
2862461084,  Alcofibras77, 26, 10, 16, no
945141198,  ElenaBaloi, 8, 5, 3, yes
514280693,  raffaelespedic1, 19, 6, 13, no
1099276674,  luigialbanese79, 1, 1, 0, yes
1890955496,  DIOMosler, 8, 6, 2, yes
99973010,  VaiMimmo, 8, 7, 1, yes
1260275882,  FUJIKORITA, 8, 7, 1, yes
20447747,  LiaGhilardi, 7, 5, 2, yes
3332293899,  stanco65, 9, 8, 1, yes
49939284,  mbonessa, 1, 1, 0, yes
2780624860,  eagle52253, 2, 1, 1, neutral
14060262,  RaiNews, 17, 11, 6, yes
467350010,  MargheritaFusa1, 2, 1, 1, neutral
4275767177,  RickyTuttaBirra, 2, 1, 1, neutral
3105750287,  melody_1159, 9, 7, 2, yes
3014477295,  pavia_valentina, 15, 9, 6, yes
1375491199,  varazzevillage, 1, 1, 0, yes
3241512717,  AdrianoVeneto, 9, 9, 0, yes
557632715,  PKlavzar, 7, 3, 4, no
356727248,  alfolama, 2, 1, 1, neutral
2865678533,  650AAPdS_2014, 1, 1, 0, yes
241912051,  pierpalmariggi, 5, 5, 0, yes
801974236315340805,  devylalys, 15, 9, 6, yes
581185063,  maurizio1249, 8, 3, 5, no
2418350499,  CiaDomenico, 27, 19, 8, yes
220740268,  Magico_if, 3, 3, 0, yes
1092508782,  salvojk, 8, 5, 3, yes
325771154,  guidobemporad, 6, 5, 1, yes
2758638762,  ElelnaGio, 3, 3, 0, yes
390161953,  errepinna, 45, 5, 40, no
791365228839723008,  DanielaAVivoli, 7, 3, 4, no
2732213699,  SbBertele, 5, 3, 2, yes
519506055,  ACavFilmaker, 9, 4, 5, no
378467099,  Marco_Cooper, 12, 6, 6, neutral
313160816,  BroFlavia, 5, 5, 0, yes
1452474535,  lustemax, 17, 12, 5, yes
872579222,  pennetts, 18, 14, 4, yes
1244642113,  FerrariG2, 5, 5, 0, yes
1176193080,  SoAlvista, 21, 17, 4, yes
182499021,  LucailCobra, 2, 2, 0, yes
374941410,  franic_twi, 26, 10, 16, no
2281441785,  CanoviElio, 2, 2, 0, yes
4640857347,  LoneJoe14, 2, 2, 0, yes
2978832886,  renatoilgemello, 7, 5, 2, yes
713498795347218432,  Nessuno01333091, 8, 8, 0, yes
895313262,  givefivelove, 8, 7, 1, yes
1372944860,  laremi_guido, 29, 10, 19, no
788112120,  roberto16774, 2, 2, 0, yes
2595842591,  monaco7982, 4, 4, 0, yes
710375589,  carsapio, 8, 4, 4, neutral
767772101503836161,  crusader_ita, 183, 161, 22, yes
797123652487696384,  texwillerwest, 46, 31, 15, yes
3341745526,  GGiorgiomacri, 6, 6, 0, yes
930776294,  CioppaLeonardo, 22, 8, 14, no
1360099448,  PasquinoSalento, 11, 11, 0, yes
792810525533044736,  GufoReale1, 15, 10, 5, yes
803736666045378561,  justalittleof, 3, 3, 0, yes
805501965023186944,  Patriziapeppe, 5, 3, 2, yes
2471509468,  kenzo2780, 12, 12, 0, yes
441149399,  GinoScardina, 12, 4, 8, no
792177757,  OttavioFabrizi, 2, 2, 0, yes
280068726,  panterax1963, 4, 4, 0, yes
434394574,  pinobici, 22, 17, 5, yes
1225968722,  pasqual16963196, 8, 6, 2, yes
790269417603162118,  asterwill, 35, 14, 21, no
370787704,  Tullio_Avoledo, 8, 8, 0, yes
3087248931,  an_fromthetower, 5, 4, 1, yes
1434279086,  salvagnoivan, 5, 2, 3, no
386450799,  1812Pucci, 20, 16, 4, yes
937279710,  CLAUDIO6210, 25, 10, 15, no
81837035,  giopge, 52, 14, 38, no
2753154182,  cris_cersei, 8, 4, 4, neutral
1106140585,  FortunatoRomeo4, 5, 4, 1, yes
269449767,  AndreaEvangeli, 7, 7, 0, yes
450587852,  riforme_info, 11, 11, 0, yes
1166877775,  dstVoid, 69, 27, 42, no
15532171,  cernaia, 11, 4, 7, no
717334646405611525,  pigherino, 109, 12, 97, no
725370452210794497,  angelapandimig1, 46, 27, 19, yes
2319777925,  SalvoDiBetta, 24, 2, 22, no
4344819670,  erikarando11, 3, 1, 2, no
3300962806,  Fabio84V, 6, 3, 3, neutral
2834394167,  Elenakele, 6, 4, 2, yes
1145972966,  rossella123456, 26, 12, 14, no
465082146,  perniciaropietr, 6, 2, 4, no
2644998883,  MaleficoRojo, 110, 12, 98, no
2250169853,  GincosMm, 7, 1, 6, no
1006906356,  alfredo_zivvo, 7, 2, 5, no
395327805,  Nicknock82, 13, 2, 11, no
200657994,  griffi007, 10, 2, 8, no
799992817007345664,  fedetrip1, 91, 91, 0, yes
788794627042205696,  AntonellaTrich2, 755, 755, 0, yes
716370134651310080,  Angela94097772, 560, 559, 1, yes
790584598816256000,  chiara_p13, 170, 169, 1, yes
789104165167529984,  francesca_t8, 180, 179, 1, yes
716637363099869184,  poli13137517, 440, 439, 1, yes
784137711561109505,  Teresa67514791, 352, 350, 2, yes
472003825,  giusichiara1, 89, 88, 1, yes
729744231066120192,  giovannalala3, 49, 49, 0, yes
4860992891,  domenicascanca1, 348, 346, 2, yes
788808477686820864,  Giorgio777778, 33, 33, 0, yes
788447717521498112,  eliana251179, 60, 59, 1, yes
508816846,  carmen_lucci, 136, 136, 0, yes
788742242219520000,  GioPalermo77, 189, 189, 0, yes
4823965924,  Gaetano_Silvano, 16, 16, 0, yes
798917787452403712,  CapolongoMaria, 55, 55, 0, yes
709268747010314240,  SilviaTricaric5, 105, 105, 0, yes
717367103532240896,  carmela220968, 49, 48, 1, yes
419589451,  LombardiSilvia, 99, 98, 1, yes
729294897891676161,  loredan00563907, 88, 88, 0, yes
788723015089524736,  rosario1971ivan, 126, 125, 1, yes
788788458848477184,  GambuzzaRosita, 32, 32, 0, yes
712020146282307584,  MariaRosaMaraz3, 172, 171, 1, yes
753990621971480576,  angelo29269869, 33, 33, 0, yes
788739391908970496,  NunziaFerraiol4, 22, 21, 1, yes
773563444750589957,  ErikaVNicastro, 232, 231, 1, yes
799906643815317504,  AMorenaTafuro, 17, 16, 1, yes
783257684971773952,  giovanna_delfa, 79, 79, 0, yes
725066954394980353,  michelalopiano5, 275, 274, 1, yes
789001282514198528,  roburso3, 358, 357, 1, yes
789842195775971328,  mauriziodimajo, 103, 103, 0, yes
794538327085084672,  loredan26111817, 197, 197, 0, yes
722918044880805888,  annamosca04, 222, 222, 0, yes
788458787032170496,  michela_baldari, 145, 145, 0, yes
2233113344,  dcusat, 13, 13, 0, yes
788748356185120768,  EDangelico, 56, 56, 0, yes
788432145161256961,  LuciaTurco8, 24, 24, 0, yes
4824188417,  Lucicampa1, 38, 38, 0, yes
749570773321474048,  Mariangelacamp8, 24, 23, 1, yes
4861559277,  RitaMannetta, 236, 236, 0, yes
1222677294,  lasghina, 68, 67, 1, yes
822269940,  GiusyScicchitan, 26, 25, 1, yes
728573094806364160,  GiulianaRando, 56, 56, 0, yes
789482134532751360,  stilly976, 41, 41, 0, yes
214551930,  luchimaz, 18, 4, 14, no
923195227,  D__Abbate, 9, 4, 5, no
234339579,  valfromrome, 72, 43, 29, yes
103294424,  alexmanj, 4, 1, 3, no
1055931559,  AntoninoMi, 70, 8, 62, no
385252844,  czroma54, 18, 7, 11, no
345591693,  ramdoria, 17, 9, 8, yes
727418955074293764,  MCinzia83, 5, 5, 0, yes
3317586231,  vonhoeneim, 20, 0, 20, no
2897960823,  GhellaOnTheRoad, 15, 0, 15, no
1078134512,  agenziademanio, 14, 12, 2, yes
465950531,  badalamenti3, 11, 10, 1, yes
606494426,  Coninews, 2, 2, 0, yes
196337046,  lorenzotucci_rm, 2, 2, 0, yes
2363886035,  DaniloAloe, 63, 19, 44, no
1879889592,  Rosifregnan, 19, 9, 10, no
3101946463,  RueraRebelot, 38, 21, 17, yes
2577527823,  Aidan2Ng, 10, 5, 5, neutral
912833226,  osannacremonesi, 52, 4, 48, no
970760323,  Danielcuba72, 16, 6, 10, no
694638444807610368,  jesusdore97, 131, 30, 101, no
1010820098,  LupoMail, 52, 10, 42, no
418221631,  doloresebasta, 119, 21, 98, no
541527026,  lucialeone70, 78, 14, 64, no
497084997,  MtBertazzo, 5, 3, 2, yes
788474975422443520,  nadiasannino, 9, 2, 7, no
2438650607,  BortesiBortesi, 48, 19, 29, no
210820445,  Macalla231059, 16, 7, 9, no
875178422,  actarus1070, 26, 4, 22, no
2328504149,  M5Scalcinato, 2, 1, 1, neutral
3291044750,  scrittricedony, 6, 2, 4, no
419339559,  radioanchio, 32, 16, 16, neutral
225198604,  maxmarzoli, 5, 5, 0, yes
775935934596427776,  donatwitting, 1, 1, 0, yes
1392039763,  ubeneb, 20, 13, 7, yes
455094599,  pierluigi56, 31, 23, 8, yes
701742252,  marco_corrao, 2, 2, 0, yes
772848384961044483,  MarottaMarilisa, 25, 12, 13, no
2821297900,  SpazioEconomia, 2, 2, 0, yes
747885089812525056,  luisamattina39, 13, 7, 6, yes
1384446301,  mgdbertelli, 2, 2, 0, yes
983007608,  nulliper, 2, 2, 0, yes
341996757,  danilodebiasio, 8, 6, 2, yes
26206149,  aconoscitore, 5, 4, 1, yes
386196967,  paola_izzo, 1, 1, 0, yes
468777277,  t65lang, 4, 4, 0, yes
1040332778,  RosaPerrone61, 4, 4, 0, yes
2986141805,  CislSociale, 4, 4, 0, yes
808531951,  Pippo_Moscuzza, 29, 28, 1, yes
787781541967585285,  giusy_tomasello, 1, 1, 0, yes
2197080899,  lcnloris, 55, 24, 31, no
2816690467,  antoniolar1, 1, 1, 0, yes
29969564,  Mightymite_67, 4, 2, 2, neutral
705782474627010560,  laretedeisi, 4, 4, 0, yes
702214839045910539,  SienaAntonino, 7, 7, 0, yes
2615396394,  AmorosoCisl, 1, 1, 0, yes
253586434,  cislscuola, 2, 2, 0, yes
507989496,  mgpenna, 2, 2, 0, yes
1376992518,  CiardiCarlo, 3, 2, 1, yes
3341975913,  samontalbano49, 7, 7, 0, yes
796090291358932992,  Salvato07298530, 2, 2, 0, yes
3195984844,  GiosaFrancesca, 1, 1, 0, yes
1218862927,  SAPAFER, 3, 1, 2, no
3003737465,  mingrone75, 1, 1, 0, yes
2346440818,  AntoPitto, 2, 2, 0, yes
614400280,  adinacelona, 1, 1, 0, yes
1183242804,  FisarVenice, 1, 1, 0, yes
2951739670,  4445b41b443f453, 2, 2, 0, yes
1453384430,  DavDeAlex, 2, 2, 0, yes
541110896,  _3nike, 5, 3, 2, yes
745614706891710464,  MariaAndreacch2, 8, 7, 1, yes
2375316746,  cislcampania, 1, 1, 0, yes
2865435733,  cislcagliari, 2, 2, 0, yes
400946488,  MicheleBuonerba, 1, 1, 0, yes
154924260,  scelfo, 16, 16, 0, yes
2405149593,  orianaputzolu, 3, 3, 0, yes
77737902,  federicocenci, 1, 1, 0, yes
2588802520,  chierchiar, 12, 12, 0, yes
2356114958,  RaffaBuonaguro, 1, 1, 0, yes
2492670019,  FitCisl_Liguria, 1, 1, 0, yes
217513723,  ElaniaZ, 2, 2, 0, yes
2544388753,  FisascatTaranto, 3, 1, 2, no
731422732257230849,  michelecavo71, 4, 4, 0, yes
2153201398,  60gepy, 1, 1, 0, yes
2408795996,  ConcorsoneRoma, 3, 2, 1, yes
2893175255,  concettinacupa1, 2, 2, 0, yes
558661103,  PPolicy_News, 3, 3, 0, yes
1212948840,  robertocalienno, 1, 1, 0, yes
3439230363,  ltallarico1, 1, 1, 0, yes
915382844,  frances40261341, 1, 1, 0, yes
928115474,  IvanaBarbacci, 3, 3, 0, yes
493046156,  fircisl, 1, 1, 0, yes
2809935741,  FP_CISLFIPO, 5, 5, 0, yes
1099520954,  oliva1961, 1, 1, 0, yes
28355287,  VioC, 2, 2, 0, yes
2382702080,  FrancoBerardi6, 1, 1, 0, yes
1423665996,  Zenone73, 3, 3, 0, yes
575451587,  GiuseppeBrando, 2, 2, 0, yes
1724559264,  CislPiemonte, 1, 1, 0, yes
244443250,  A_Graniero, 1, 1, 0, yes
2903656685,  giuseppemistr10, 2, 2, 0, yes
2878015269,  CislLiguria, 1, 1, 0, yes
526915612,  cislcatania, 1, 1, 0, yes
2350521307,  ArmandoCoco3, 1, 1, 0, yes
1104665330,  orexis61, 1, 1, 0, yes
1871175972,  CISL_FNS, 1, 1, 0, yes
2304599724,  WBallotta, 2, 2, 0, yes
2256861644,  romagna66, 6, 4, 2, yes
1891604736,  boccuzzibeppe, 3, 1, 2, no
357375143,  Env_Ep, 5, 5, 0, yes
939421976,  PaoloScilinguo, 14, 13, 1, yes
310183103,  AntonioCuozzo, 4, 4, 0, yes
2821520249,  marika_kwater, 1, 1, 0, yes
1580100704,  lorenzodabosco, 2, 1, 1, neutral
768545345223753728,  aferraricislit2, 3, 2, 1, yes
748897867583086592,  MimMartino, 1, 1, 0, yes
152336863,  giuliocolecchia, 4, 4, 0, yes
2589832160,  graziagirmena, 1, 1, 0, yes
271890712,  FilcaCisl, 7, 7, 0, yes
754289348770689025,  liviaderiggi, 11, 6, 5, yes
522122019,  CislLombardia, 1, 1, 0, yes
537353861,  CislPaTp, 2, 2, 0, yes
1885969158,  Camertes55, 1, 1, 0, yes
2800186939,  dancapaolo, 1, 1, 0, yes
2867756445,  GiorgioSpelat, 1, 1, 0, yes
2153367934,  GiglioEspedito, 2, 2, 0, yes
3771913815,  CislMilano, 1, 1, 0, yes
375276889,  Danginny007, 1, 1, 0, yes
2215404901,  CislRomaRieti, 5, 5, 0, yes
538302788,  Cisl_ER, 2, 2, 0, yes
533073973,  grazianigio, 2, 2, 0, yes
2589277552,  Bellia68, 2, 2, 0, yes
4781710275,  scuola_cisl, 1, 1, 0, yes
2359746495,  tp_pa, 1, 1, 0, yes
364188004,  CislEmiCentrale, 1, 1, 0, yes
535892418,  francescapagan7, 2, 2, 0, yes
1103368728,  borrybo, 1, 1, 0, yes
557642784,  GalatiPietro, 5, 5, 0, yes
405675387,  plmanca, 1, 1, 0, yes
490369053,  happibird18, 2, 1, 1, neutral
291621829,  Essevix, 3, 2, 1, yes
731258681506009088,  1marcomolinari, 2, 2, 0, yes
801871756160024576,  maximvincenzi, 4, 4, 0, yes
732835893892030464,  viterbo_cisl, 1, 1, 0, yes
3168904809,  marcyo_m, 17, 15, 2, yes
3342978617,  AriannaFabbiani, 4, 3, 1, yes
735700882981982215,  cristianofiore3, 1, 1, 0, yes
3237012287,  spatresano, 87, 42, 45, no
1042228705,  modym601, 15, 9, 6, yes
1200369865,  coscienzavigile, 1, 1, 0, yes
915969295,  SensoDiNausea, 32, 28, 4, yes
135117869,  peppetriolo, 3, 3, 0, yes
2532744429,  nichele56, 2, 2, 0, yes
3179961507,  esset64, 21, 14, 7, yes
29186265,  benvenauta, 1, 1, 0, yes
2478033566,  ValterSaporiti, 8, 8, 0, yes
2874742024,  GerardoOropallo, 7, 3, 4, no
3298987965,  danz_olina, 1, 1, 0, yes
402135565,  LorellaBraganti, 1, 1, 0, yes
132605370,  sirnolimit, 1, 1, 0, yes
493147902,  LSN55, 1, 1, 0, yes
752481682511564801,  Barbararsi, 1, 1, 0, yes
633968103,  andreadevivo69, 5, 4, 1, yes
734554602,  vinales1, 1, 1, 0, yes
1662096157,  pippodenaro, 2, 2, 0, yes
561196931,  EnnioMacaluso, 1, 1, 0, yes
2957021637,  cegra2003, 10, 10, 0, yes
753933800929955840,  Carmela_isenae, 8, 4, 4, neutral
771413293068128256,  minacercino, 17, 6, 11, no
780748114600669186,  annalisacitro7, 6, 3, 3, neutral
52337911,  papel61, 13, 13, 0, yes
407632922,  PeppeVicino, 1, 1, 0, yes
4866901048,  biondof73, 1, 1, 0, yes
1911330024,  serandrello, 1, 1, 0, yes
117847962,  skappalee, 3, 3, 0, yes
465123403,  FrancescoGatti1, 16, 8, 8, neutral
4095450675,  elipenn2501, 7, 5, 2, yes
16823683,  aluas, 18, 5, 13, no
2938158003,  stefspina, 5, 5, 0, yes
2285119171,  teoird, 1, 1, 0, yes
55793308,  Scacciavillani, 3, 3, 0, yes
2174707564,  MarmugiMarmugi, 1, 1, 0, yes
475096024,  gselvaggia, 24, 22, 2, yes
1058200926,  ferrucciogaspar, 36, 27, 9, yes
46479124,  dark_images, 5, 4, 1, yes
503303414,  MIMIGIO, 115, 22, 93, no
1259813197,  andreazivelli, 1, 1, 0, yes
772854489573359616,  MariastellaDi, 6, 3, 3, neutral
278503793,  damicod, 1, 1, 0, yes
888908046,  lauraconegian, 3, 1, 2, no
287379444,  virgiliopaolo, 4, 2, 2, neutral
796397923856568320,  Viktor222717, 1, 1, 0, yes
3437777866,  Vale221076, 1, 1, 0, yes
429981335,  PierLuigiMiglio, 1, 1, 0, yes
780430313218596864,  rossab66, 3, 1, 2, no
486713414,  VirnaBottarelli, 3, 1, 2, no
382052646,  maria_adamo, 6, 3, 3, neutral
463046207,  agamennoni, 2, 2, 0, yes
771404187074699264,  melaniabosso87, 11, 5, 6, no
3228211917,  MarisaPanizza, 4, 4, 0, yes
800001302,  fuscjan, 4, 4, 0, yes
773143613073137666,  Enza28196515, 11, 6, 5, yes
312692915,  TataFossati, 1, 1, 0, yes
4899340798,  nadiagranito, 11, 6, 5, yes
780760650079285248,  SimonaCarpinie1, 23, 9, 14, no
745524200916426752,  davidetilocca, 1, 1, 0, yes
494301334,  RosariaOliva, 6, 3, 3, neutral
1520277540,  DavideFuschi, 1, 1, 0, yes
2358984893,  lprunella, 2, 2, 0, yes
12780642,  stefano_roma, 1, 1, 0, yes
14703893,  alessio_88, 5, 4, 1, yes
2484678735,  AlfredoZaragoz0, 1, 1, 0, yes
444118187,  EfremGa, 1, 1, 0, yes
2150341105,  filcacislpatp, 1, 1, 0, yes
2487616528,  mrsj0sephj, 1, 1, 0, yes
29226134,  martaserafini, 1, 1, 0, yes
701513839989358592,  alfonsomontana5, 17, 8, 9, no
501233082,  basilischi, 2, 2, 0, yes
796310620543078400,  loredanafabri4, 1, 1, 0, yes
707205388081430528,  er_inas, 1, 1, 0, yes
741201329541009409,  gabry_brunetti, 1, 1, 0, yes
757811518566117377,  DaliaGianfranco, 1, 1, 0, yes
745195751769247744,  NapoliStartup, 2, 2, 0, yes
1015736996,  virca48, 2, 2, 0, yes
2358236856,  francescavellis, 2, 2, 0, yes
38676577,  Valeboss, 3, 3, 0, yes
342681065,  ceg62, 86, 22, 64, no
2493861660,  boccininocisl, 1, 1, 0, yes
845142936,  MarcyMarr, 1, 1, 0, yes
3110710618,  marcolombardi55, 1, 1, 0, yes
1333864027,  Cittadinireatti, 3, 3, 0, yes
443563578,  AChiriatti, 1, 1, 0, yes
425773398,  mariuzzo_one, 13, 9, 4, yes
236765969,  giorgiovanoli, 1, 1, 0, yes
3070728863,  dvolpato1, 3, 3, 0, yes
517581277,  Piero_LG, 1, 1, 0, yes
317792814,  carlomolinari1, 2, 1, 1, neutral
1277669408,  francescavenez2, 1, 1, 0, yes
1259921263,  TIRONENICOLA, 4, 4, 0, yes
1076119734,  Alessandro02088, 11, 11, 0, yes
794959506581098500,  silviapochettin, 2, 2, 0, yes
756485488278704128,  GiannaGuglielm1, 4, 4, 0, yes
2355931500,  Antonioserra25, 2, 2, 0, yes
742754767500349441,  pinaagostino1, 9, 9, 0, yes
261825571,  cicciolore, 1, 1, 0, yes
4872050638,  carenzagiuseppe, 50, 3, 47, no
2735797127,  ZamperiniGianni, 20, 7, 13, no
3197336860,  23484c271fde41a, 1, 1, 0, yes
2858398438,  carlopenati, 1, 1, 0, yes
1037602873,  pietro734, 7, 5, 2, yes
3121456870,  BarberisBruna, 7, 7, 0, yes
623602877,  tania1278, 48, 5, 43, no
773567374167506944,  lucadea1964, 3, 3, 0, yes
838499514,  graziafly, 4, 4, 0, yes
2863719849,  damauropa, 1, 1, 0, yes
1183225614,  IreIree, 2, 2, 0, yes
772364221636026368,  robyosso, 6, 3, 3, neutral
45389601,  ovalina, 1, 1, 0, yes
270372295,  dadeluc, 1, 1, 0, yes
1864799155,  CorradoGriffa, 2, 2, 0, yes
2566531287,  MariaSev63, 1, 1, 0, yes
716567598620667904,  giovan_fusco, 5, 5, 0, yes
615625790,  DrummerTW366, 1, 1, 0, yes
2482398371,  ajnorthcarollna, 1, 1, 0, yes
717101325121691648,  UsbIstat, 1, 1, 0, yes
51752908,  denapolo, 3, 3, 0, yes
3678651555,  SuranoFranco, 1, 1, 0, yes
747327163,  CesareGerbino, 1, 1, 0, yes
452082534,  VolterraniS, 5, 5, 0, yes
2948698869,  CiuottoVs, 34, 2, 32, no
775737901812416512,  AdaJasmine2016, 13, 7, 6, yes
773136946696708096,  LuciaSaler, 9, 4, 5, no
753985699163074561,  intocciaannali2, 6, 3, 3, neutral
754754187104292864,  fabyfa86, 11, 5, 6, no
771406367471112192,  Mariataranto6, 22, 11, 11, neutral
780480247439450112,  Martynaron, 13, 7, 6, yes
751363025920294913,  bianchi_rino, 3, 3, 0, yes
547517425,  Castellana_Alex, 2, 2, 0, yes
613892412,  RacqueiJohn, 1, 1, 0, yes
758612977926959104,  INarratore, 4, 3, 1, yes
481385426,  AndreaSirianni3, 1, 1, 0, yes
1039581457,  DiRosadipietro, 22, 12, 10, yes
2274963017,  WilliamMancinel, 1, 1, 0, yes
83337484,  betterdoc, 1, 1, 0, yes
246756973,  andreamaurino, 3, 3, 0, yes
3349228901,  catiaboboc, 1, 1, 0, yes
394907886,  vinmup63, 2, 2, 0, yes
2444362003,  trapanibiagio, 4, 4, 0, yes
1222622413,  sasabarone1, 6, 6, 0, yes
243798737,  cesaredp78, 1, 1, 0, yes
1120164536,  enotequeasti, 3, 2, 1, yes
2965035839,  francescoacqu11, 5, 5, 0, yes
88633593,  NickIron57, 2, 2, 0, yes
3971957740,  maxbelv83, 5, 5, 0, yes
419474598,  gribbio, 11, 5, 6, no
2914144864,  USITA_forum, 5, 3, 2, yes
2270552779,  lebuone_notizie, 2, 2, 0, yes
535352103,  ecmosea, 10, 10, 0, yes
382906147,  LuciaMontanino, 4, 4, 0, yes
1860383658,  FrancescoMurat8, 4, 1, 3, no
2402482187,  ragazzini_p, 1, 1, 0, yes
2338483821,  NaccarellaProf, 8, 6, 2, yes
2489888254,  VetanKaopr0, 1, 1, 0, yes
432918462,  stomigrando, 39, 10, 29, no
3184142063,  Cate_Corrao, 1, 1, 0, yes
3431700219,  rossmasp1960, 8, 6, 2, yes
526838409,  elenaruggeri2, 47, 11, 36, no
460896995,  tgelao, 1, 1, 0, yes
2170644741,  bricco70, 1, 1, 0, yes
167355636,  michelemarocco, 9, 8, 1, yes
1601332874,  LavezzoBarbara, 1, 1, 0, yes
232354583,  JunqueiroFI, 5, 4, 1, yes
1187629285,  Fedegab23, 2, 2, 0, yes
425126522,  EttoreCapuani, 1, 1, 0, yes
2543754356,  DanFumarola, 4, 1, 3, no
944269080,  DavideMazza10, 31, 11, 20, no
2376747126,  LazzaroPapi, 19, 4, 15, no
491699221,  historiaq91, 1, 1, 0, yes
976243140,  FrancescoBasani, 36, 13, 23, no
339750542,  SGInnovazione, 1, 1, 0, yes
2480098378,  ABCRoyaisxdmm, 1, 1, 0, yes
14278162,  maxgreco, 2, 2, 0, yes
727052295687512064,  CislFpTorino, 1, 1, 0, yes
2184758851,  danielepassanis, 1, 1, 0, yes
455225314,  KevinPonzuoli, 1, 1, 0, yes
2350350043,  HopRnRParty, 1, 1, 0, yes
244169740,  santinobarbera, 2, 2, 0, yes
430193635,  MaurizioARicci, 11, 8, 3, yes
709764820078297088,  85_TorriDiego, 2, 1, 1, neutral
2438207351,  kellyznellus, 1, 1, 0, yes
1205265828,  DdACit, 2, 2, 0, yes
448806588,  artza1967, 6, 5, 1, yes
866268462,  AGodone, 1, 1, 0, yes
563948994,  giamiglio, 3, 2, 1, yes
3235522120,  FalloRoberto, 1, 1, 0, yes
2992056261,  cosentinogianca, 9, 9, 0, yes
3248666871,  sacchero, 1, 1, 0, yes
2538948477,  f4239fdf3d0d4ed, 1, 1, 0, yes
797171228092100608,  TVdoge, 14, 12, 2, yes
3300431854,  renzieakasa, 10, 7, 3, yes
2927287965,  CislMolise, 1, 1, 0, yes
155743931,  ItaliaCamp, 1, 1, 0, yes
771388686319677440,  rosagreca, 17, 8, 9, no
753983674652196864,  linacascella, 17, 7, 10, no
1066765249,  betty1600, 5, 4, 1, yes
1097739445,  bollettinoADAPT, 1, 1, 0, yes
604009725,  stefano_baroni, 5, 5, 0, yes
3051697142,  Nico_Dimion, 1, 1, 0, yes
798969608971681792,  prioraint, 1, 1, 0, yes
4582648600,  musumeci1946, 2, 2, 0, yes
960916548,  DeBlasioDaniela, 3, 2, 1, yes
761229724685307904,  maritaexe, 11, 5, 6, no
771422498097430528,  NancyLaStrega81, 22, 11, 11, neutral
2701310119,  artvenezia1, 7, 7, 0, yes
771404383263289344,  a__lisa, 11, 5, 6, no
215915420,  albertoesposito, 6, 3, 3, neutral
753880591205040128,  DelPreteEnza1, 15, 5, 10, no
166058038,  MCinzia, 1, 1, 0, yes
754014552308801536,  StabileAnna8, 29, 14, 15, no
778312959734976512,  Stella20470381, 15, 8, 7, yes
747187674,  AndreaMaggio76, 5, 4, 1, yes
719247245892259841,  IranoAngelo, 1, 1, 0, yes
1036901706,  gabriellachiap2, 2, 2, 0, yes
394293884,  marcymarcy17, 11, 3, 8, no
728525487656587264,  _Anastasia_DG_, 7, 7, 0, yes
1536854442,  francomastrod, 2, 2, 0, yes
772078777295855620,  Imma__Esposito, 5, 2, 3, no
2497163614,  nadiagiorgi66, 13, 13, 0, yes
754269868896219136,  HanaAmemiya, 7, 2, 5, no
594436794,  FrascellaPaolo, 1, 1, 0, yes
290608259,  armandogoglia, 1, 1, 0, yes
2847905415,  pontaccio1965, 3, 3, 0, yes
2564838466,  EmanuelaFloris1, 3, 3, 0, yes
799330041117245440,  lalea_85, 5, 2, 3, no
711833597980835840,  MurMichela, 20, 7, 13, no
804423601,  NicolaBux1, 1, 1, 0, yes
2230108075,  fabersantelli, 5, 5, 0, yes
485820574,  floriana_russo, 1, 1, 0, yes
709129971395129345,  WebRadio_IusLaw, 1, 1, 0, yes
493347883,  FAICISLSicilia, 1, 1, 0, yes
1706945118,  pinobollet, 3, 3, 0, yes
3854006068,  daniel87blues, 1, 1, 0, yes
474116537,  Simone_Vazzana, 10, 7, 3, yes
3433360601,  GDino72, 6, 6, 0, yes
1323111596,  EmiliaCiccia1, 5, 5, 0, yes
510923375,  AndreaDinotto, 12, 10, 2, yes
577226307,  gretelforever, 25, 16, 9, yes
459084453,  NicolaBergonzi, 6, 4, 2, yes
4102577157,  Nicola51728552, 7, 4, 3, yes
2961761943,  clriolo, 8, 5, 3, yes
703835565938991104,  TotaroGabriella, 5, 3, 2, yes
4181864187,  Urbaniguglielmi, 6, 4, 2, yes
784854175,  maggtor, 20, 18, 2, yes
1619917472,  NicoViscomi, 17, 7, 10, no
740922692774301701,  leoguer74045306, 10, 4, 6, no
404335163,  Ssteeee, 9, 5, 4, yes
701333596943081473,  capoEsticaz, 4, 2, 2, neutral
497871877,  emiliopettiti, 5, 5, 0, yes
422068908,  RGiammario, 3, 2, 1, yes
86719842,  toiapatrizia, 5, 4, 1, yes
407267448,  Alex69V, 4, 4, 0, yes
1346574637,  screzia, 40, 15, 25, no
2436261898,  paolamleone, 8, 8, 0, yes
2228813671,  viplat, 21, 12, 9, yes
55187309,  MicheleRusso, 9, 2, 7, no
748240006867730432,  Piera99486051, 21, 3, 18, no
2428907830,  LG_1974, 7, 4, 3, yes
515619177,  SARRIfumettista, 3, 3, 0, yes
467272402,  AgostinoRiitano, 5, 5, 0, yes
967843051,  MBPellegrini, 9, 3, 6, no
798161037442895873,  marina85706327, 1, 1, 0, yes
12230682,  antoniobenforte, 1, 1, 0, yes
3248511540,  giove_luna, 7, 7, 0, yes
59188073,  entius84, 1, 1, 0, yes
482501631,  Polonapoli, 1, 1, 0, yes
788057909850701824,  antonella31079, 1, 1, 0, yes
3494653335,  HaHaijime, 1, 1, 0, yes
3049218455,  jojuventino1, 2, 1, 1, neutral
1642380530,  stbit77, 1, 1, 0, yes
763080808420806656,  SuperRomu, 1, 1, 0, yes
493328137,  shanidar4, 1, 1, 0, yes
162686234,  gcomin, 1, 1, 0, yes
721375437230878722,  AnnalisaDIntro1, 20, 17, 3, yes
712003376477646849,  Aletof82, 19, 17, 2, yes
437786863,  EnricoPianetta, 2, 1, 1, neutral
1348851210,  SimyFrant, 185, 156, 29, yes
3130737011,  rete4, 9, 6, 3, yes
949878890,  puck976, 25, 19, 6, yes
7435572,  paolodi, 6, 5, 1, yes
742705128533299200,  PADANO_LIBERO, 27, 25, 2, yes
1901331644,  CarloMIRRI, 11, 6, 5, yes
418572307,  LuigiEllegi8762, 4, 3, 1, yes
4909543941,  GianlucaVnt, 72, 4, 68, no
3823074077,  PinoCostanzo, 89, 9, 80, no
2761183186,  teorema57m, 8, 2, 6, no
372273460,  myrtamerlino, 9, 2, 7, no
293739484,  mariafabrizi, 4, 2, 2, neutral
1039838694,  SilvanSimone74, 6, 4, 2, yes
801747385949028354,  Gaetano38397120, 19, 9, 10, no
724627244879065088,  MikiCinalli75, 7, 5, 2, yes
499028570,  Ziograna, 3, 1, 2, no
1213759908,  GIUSEPPEBALDASC, 12, 5, 7, no
2323802093,  lauracasali23, 3, 1, 2, no
2345773460,  ninafadda, 24, 9, 15, no
2731905976,  matita20145, 38, 11, 27, no
2523347460,  iosonoBea, 16, 6, 10, no
757693715305619456,  marcofrb, 5, 5, 0, yes
336889324,  aghidipino, 4, 4, 0, yes
2729452277,  84Incoronato, 3, 3, 0, yes
900247297,  vrwestperrenzi, 24, 18, 6, yes
419544191,  SIMONEMESCHISI, 10, 3, 7, no
434993776,  MANUELROTUNDO1, 5, 2, 3, no
225452143,  robnuar, 31, 16, 15, yes
2845221227,  MazzacuratiFI, 39, 5, 34, no
1632825432,  tuccaplozio, 55, 7, 48, no
2767302037,  PietroRotbart, 9, 6, 3, yes
1393825116,  YujumuzhUnGux, 13, 11, 2, yes
2200331127,  SchiavoneRaffy, 27, 14, 13, yes
4834916637,  DAVIDE_ZILIANI, 6, 5, 1, yes
791652252331147264,  SantisArnaldo, 10, 7, 3, yes
558101743,  GianniColacione, 7, 5, 2, yes
558651454,  danoris2110, 30, 3, 27, no
2256478862,  Spingidisco, 4, 2, 2, neutral
2560586103,  DonnySbrocca, 5, 5, 0, yes
2866061393,  petronillarusso, 20, 11, 9, yes
233546601,  gdt62, 29, 0, 29, no
1168160534,  pelton2013, 78, 2, 76, no
2809762856,  boccajaw, 24, 3, 21, no
3299490593,  Pimpinella1928, 51, 15, 36, no
206330375,  EloisaCovelli, 3, 1, 2, no
588587293,  VincinoWeb, 5, 2, 3, no
281848832,  ShopAnHour, 3, 2, 1, yes
798412789916303361,  AldoResega, 6, 6, 0, yes
746323192835411968,  lutiscali, 12, 11, 1, yes
1492549380,  El_Flagelo, 9, 3, 6, no
1364215868,  ercazzaronero, 5, 1, 4, no
1709866242,  RETWITTATORc, 8, 5, 3, yes
29428344,  marodri, 8, 8, 0, yes
2915667713,  DbBenvenuti, 4, 4, 0, yes
1672302936,  antoninobill, 60, 29, 31, no
2515219286,  BELLOBllfnc, 2, 1, 1, neutral
1310928253,  Carantonio49, 1, 1, 0, yes
4736768123,  lusomaca, 1, 1, 0, yes
765884647498735616,  Bastaunsilugo, 7, 7, 0, yes
1455497731,  SimoneSolaroli, 1, 1, 0, yes
2490104707,  sabrimondini, 4, 4, 0, yes
3599911995,  58_raffaella, 1, 1, 0, yes
4879045263,  aa_barbi, 12, 5, 7, no
416269140,  cosmopolita10, 3, 3, 0, yes
715083557581033472,  PaoloRigoni5, 62, 19, 43, no
510652108,  ceccasud, 26, 7, 19, no
394305101,  MircoBagnari, 3, 3, 0, yes
2394684582,  metaanto, 41, 26, 15, yes
802561370445217792,  d085ba357e874d0, 8, 5, 3, yes
303937763,  crazyvolley, 12, 10, 2, yes
2214539367,  GraziaAmelia, 8, 6, 2, yes
456171865,  controbuio, 3, 2, 1, yes
798914841712979968,  kuku7te, 1, 1, 0, yes
2979805078,  momelaricordo, 1, 1, 0, yes
88008523,  emiliobi, 4, 2, 2, neutral
2517301839,  AlessandroGasb1, 126, 28, 98, no
938103654,  CogrossiMarco, 1, 1, 0, yes
397572858,  EnricoPietro, 9, 8, 1, yes
789567191708565505,  LiberiSi_PADOVA, 18, 18, 0, yes
234748368,  MirkoFreschi, 1, 1, 0, yes
3002875031,  lodagiuseppe41, 17, 9, 8, yes
62486236,  ciocapiatti, 2, 1, 1, neutral
442767427,  ChiaraBannella, 1, 1, 0, yes
1511107916,  pogboom100, 5, 3, 2, yes
785763689345363968,  GiuseppeDelll, 32, 14, 18, no
3016981881,  AcorsiniAndrea, 8, 8, 0, yes
3309670823,  gaejimmy, 65, 34, 31, yes
197389394,  stefano_gi, 6, 6, 0, yes
3327095829,  Justice4Chico, 11, 10, 1, yes
517694182,  marifausti55, 2, 1, 1, neutral
409512109,  tommidodo, 17, 11, 6, yes
1059881101,  MauroBeltramo, 59, 26, 33, no
115523877,  giampca, 13, 8, 5, yes
291951565,  nicappnews, 13, 9, 4, yes
843043616,  EzioBussoletti, 4, 2, 2, neutral
252161195,  spindavid, 13, 6, 7, no
1004482429,  CapitoloLuciana, 13, 5, 8, no
469267629,  AntonellaColoru, 77, 38, 39, no
342118728,  Denianto70, 11, 4, 7, no
1334546508,  Ste_Mazzu, 3, 3, 0, yes
531505166,  FrancoRe4, 12, 11, 1, yes
411073767,  pinogag, 5, 2, 3, no
2434259958,  RobETurkE, 1, 1, 0, yes
2674680536,  fabioblotta, 17, 5, 12, no
722514964095889408,  dall1612, 12, 11, 1, yes
253533898,  manliosonoio, 8, 6, 2, yes
401438300,  marcocf69, 52, 33, 19, yes
2398378464,  FABRISABELFI, 6, 5, 1, yes
337171830,  AngeloTofalo, 13, 2, 11, no
801915618182234112,  IBisturi, 2, 2, 0, yes
802500554077405185,  lilith_667, 1, 1, 0, yes
116517401,  AlanPoll, 33, 8, 25, no
1223037354,  esisley, 196, 29, 167, no
727628624740888576,  abertolucci6, 2, 2, 0, yes
2864243287,  silvy91936941, 4, 2, 2, neutral
766471224,  IsFrago, 80, 23, 57, no
100298925,  MrETP, 3, 3, 0, yes
2360744315,  tessirkuler, 13, 4, 9, no
14561296,  batmar, 12, 5, 7, no
1003998769,  francapecorini, 4, 2, 2, neutral
1070392579,  BeppeSama, 28, 25, 3, yes
942307356,  susannaricciar1, 11, 11, 0, yes
389473754,  Gauro5, 12, 7, 5, yes
309178760,  PLANETHOTEL_NET, 26, 18, 8, yes
3139793645,  rmassari29, 1, 1, 0, yes
422512736,  vfishkia, 4, 4, 0, yes
712273849,  megrovi1962, 1, 1, 0, yes
146765988,  Miss1897, 2, 2, 0, yes
586398719,  pierovalvecchia, 3, 2, 1, yes
3201928624,  nmingardi, 21, 11, 10, yes
307026014,  lupoalberto1960, 10, 4, 6, no
2447803388,  dalbertiv, 5, 5, 0, yes
4249591816,  circoloalmirant, 25, 13, 12, yes
888815552,  frineblue, 2, 2, 0, yes
590833841,  massimogiorgi5, 51, 25, 26, no
426987849,  MontinDavide, 2, 2, 0, yes
514440497,  bull43may, 10, 5, 5, neutral
2728402871,  umbydux, 66, 24, 42, no
2726112076,  Gabeluca85, 6, 3, 3, neutral
3395014151,  GioChiAmoRe, 19, 6, 13, no
946620907,  FrancescoPrest7, 33, 8, 25, no
264941030,  Vito_Trecarichi, 24, 15, 9, yes
4878244774,  Manu57371839, 6, 4, 2, yes
2344799433,  OneBadLuca, 63, 36, 27, yes
467389922,  NDecristofaro, 120, 29, 91, no
4264978996,  Pava_Loriginale, 6, 6, 0, yes
250085208,  incaxxatonero, 21, 7, 14, no
852595651,  rossanafra, 19, 3, 16, no
151087202,  frondacarolina, 13, 11, 2, yes
1267779690,  Marika15Marika, 2, 2, 0, yes
19036104,  nicolabonci, 9, 2, 7, no
22005584,  Marinamas, 12, 11, 1, yes
3555782356,  FlavioPicolli, 41, 13, 28, no
1006905228,  TTenzinpema, 3, 2, 1, yes
139765259,  giuseppelacara, 32, 15, 17, no
746305585642110978,  fuoridallaue, 18, 15, 3, yes
151020019,  carlocarlo6, 1, 1, 0, yes
609404111,  len6165, 9, 5, 4, yes
893289350,  luca_logi, 5, 5, 0, yes
778206259145244672,  Alessan97526423, 14, 8, 6, yes
2706574363,  valhoell, 27, 3, 24, no
110654085,  luigibagnato, 22, 9, 13, no
469354495,  vistullo, 12, 4, 8, no
3151825048,  benq_antonio, 63, 31, 32, no
329152979,  alvariis, 13, 7, 6, yes
219995423,  fiakketto, 22, 11, 11, neutral
2978007322,  CarneseMaria, 21, 10, 11, no
825953293,  alcetriste, 10, 7, 3, yes
489722273,  s_dellavedova, 15, 9, 6, yes
2473312438,  nadia_stocco, 8, 4, 4, neutral
1248307267,  SorryNs, 11, 7, 4, yes
796821388023754753,  chiara_ciaba, 13, 6, 7, no
446371601,  guidig11, 12, 5, 7, no
541759113,  trcucconi, 27, 22, 5, yes
378489654,  RobertoScolla, 16, 7, 9, no
777531818933452804,  RobertaFrattin2, 5, 5, 0, yes
576702177,  maurorizzi_mr, 2, 2, 0, yes
201789369,  afderas, 25, 22, 3, yes
2753018300,  IannaceCarlo, 4, 4, 0, yes
882708728,  barisi_gbarisi, 9, 5, 4, yes
584056092,  catnoir3, 13, 8, 5, yes
26772461,  francexca, 4, 2, 2, neutral
245960120,  Rog_2, 18, 14, 4, yes
908380926,  RoVincipi, 2, 2, 0, yes
397867387,  andremorga22, 8, 5, 3, yes
453550902,  elviomarchetti, 1, 1, 0, yes
991699441,  sabrinavarroni, 7, 6, 1, yes
489380422,  bftallarico, 4, 3, 1, yes
131534556,  E_Marchionni87, 4, 4, 0, yes
855271164,  FiammaFrancesca, 7, 2, 5, no
317879495,  Varco001, 7, 3, 4, no
30431415,  LuxGandi, 2, 1, 1, neutral
1244609569,  adapallai, 3, 2, 1, yes
245328223,  yppi2011, 17, 10, 7, yes
1092846918,  andreamusashi69, 47, 5, 42, no
780100421536849920,  Stucazzo1, 76, 35, 41, no
415832180,  Cinquantenni, 8, 8, 0, yes
1069206085,  PaoloBaldo3, 31, 12, 19, no
131846946,  sherpa60, 10, 8, 2, yes
135175666,  Piolosuperpiolo, 1, 1, 0, yes
26502440,  MyliusMylius, 9, 9, 0, yes
4194094995,  fingerstones, 7, 4, 3, yes
83818953,  gnokko21, 1, 1, 0, yes
1079226488,  warsteiner_SF, 61, 21, 40, no
794587894145052672,  eli_cortina, 9, 9, 0, yes
279899496,  svtsgr, 4, 4, 0, yes
281422377,  Valfabb, 8, 2, 6, no
715215739557437441,  matteodeliguori, 1, 1, 0, yes
728804562,  elisabettamass3, 4, 3, 1, yes
9113092,  cod_eht, 9, 7, 2, yes
1460451570,  punto_effe, 29, 4, 25, no
49060410,  dottomore, 3, 1, 2, no
389386670,  vinoodles, 1, 1, 0, yes
3044930101,  Lauragalimba, 4, 4, 0, yes
2375736855,  cristina_ilardo, 14, 6, 8, no
2723369673,  antomos5589, 4, 3, 1, yes
493239048,  tony6tony8, 46, 5, 41, no
4824031401,  Mario22426580, 113, 16, 97, no
1249365224,  G_ianluc_a, 48, 8, 40, no
492273305,  FortunaRoberto1, 4, 2, 2, neutral
329710075,  robgast69, 17, 10, 7, yes
796637487204536320,  miowid53, 1, 1, 0, yes
710520401735057409,  AntonelloZedda, 2, 1, 1, neutral
2893910086,  andreina_maisto, 4, 3, 1, yes
477582182,  MatteoGiaccone, 19, 11, 8, yes
1339546009,  EnricoCardillo_, 10, 4, 6, no
2230228079,  Gimcstgv, 16, 4, 12, no
1875163214,  TaccoilMarco, 6, 5, 1, yes
3355297455,  silvanaventrici, 3, 2, 1, yes
2999932538,  intoccabile_l, 63, 11, 52, no
725291215026032640,  barbara_figari, 8, 4, 4, neutral
186221116,  Master2001_3, 46, 18, 28, no
435138644,  filippods68, 16, 14, 2, yes
426478144,  osvaldoberlina, 1, 1, 0, yes
1379900528,  rosariocurcio, 7, 5, 2, yes
790099830,  FabyCony1, 47, 34, 13, yes
780085194317557760,  Clouseau_again, 6, 3, 3, neutral
305812698,  manithu75, 6, 6, 0, yes
3058454202,  antonioorsolini, 12, 7, 5, yes
925110174,  mirkocantore, 10, 10, 0, yes
400798557,  StefanoFirenze2, 57, 23, 34, no
463192964,  socialmiliac, 3, 1, 2, no
4037654691,  itpiernet_piero, 2, 2, 0, yes
10438412,  gfrisoli, 31, 21, 10, yes
211153302,  Francesco_Pirri, 4, 3, 1, yes
350999577,  Pizbadile, 3, 2, 1, yes
761205835565522945,  MauriFranksson, 4, 2, 2, neutral
2889874553,  LaMelusina, 4, 4, 0, yes
728733122695725057,  GProietti76, 35, 6, 29, no
718196234712911872,  artfederica, 26, 16, 10, yes
131873545,  davidmaltese, 1, 1, 0, yes
301676560,  shampo64, 12, 10, 2, yes
15108909,  c_lupo, 29, 18, 11, yes
760806683564240896,  DelioScognamig1, 94, 15, 79, no
544660124,  Desmo_FCIM, 2, 2, 0, yes
2334565378,  IevaLicia, 3, 2, 1, yes
310845038,  LisiFrancesco, 21, 5, 16, no
1848219511,  rafraffac, 11, 10, 1, yes
1257641191,  che_stefano, 3, 2, 1, yes
939484063,  BettainChin, 43, 21, 22, no
2518713866,  Margher02, 4, 3, 1, yes
292417838,  GASPARECARLINI, 18, 4, 14, no
4069758477,  Ivancir68, 55, 5, 50, no
3192457810,  roberto_rroby1, 3, 1, 2, no
506547572,  nero1979, 4, 4, 0, yes
2328166991,  gigicoz, 59, 5, 54, no
716756039580958720,  LeottaVi, 9, 9, 0, yes
1219977643,  giudy51, 72, 17, 55, no
2413327976,  Frangit2000, 1, 1, 0, yes
408437002,  clapr71, 14, 6, 8, no
1359299438,  AnnaLVenegoni, 20, 6, 14, no
378831710,  elpme10, 73, 43, 30, yes
2215399657,  GiulianaTambaro, 5, 3, 2, yes
1414076593,  collecorte, 22, 8, 14, no
399585033,  rafortrafort, 6, 4, 2, yes
628606443,  zaccheodavide, 9, 5, 4, yes
962439266,  paoloferrarelli, 20, 14, 6, yes
2187516904,  BonnieandLana, 15, 11, 4, yes
389500881,  rufy4623, 26, 6, 20, no
1067982564,  alvarofiucci1, 31, 8, 23, no
353640576,  mauriziodalpra, 58, 17, 41, no
2162439406,  pietrorinaldi16, 5, 5, 0, yes
1922484493,  maximilianjoker, 5, 5, 0, yes
429203153,  donatellaR2, 28, 19, 9, yes
714553962599464960,  pirro_n, 66, 13, 53, no
4609193302,  Debby1861, 45, 26, 19, yes
3839534729,  BicchiBrunella, 2, 2, 0, yes
2509301951,  Rota5Rota, 78, 18, 60, no
318887216,  DavideToro77, 4, 3, 1, yes
132811097,  camar07, 15, 1, 14, no
798935970586488833,  macco_pagi, 8, 8, 0, yes
1221792162,  tilt61, 8, 6, 2, yes
632742781,  pa__rm, 40, 13, 27, no
1183534806,  Nath67Lic, 26, 16, 10, yes
133038458,  massimo3651, 25, 17, 8, yes
2230782069,  CEroscincidda, 33, 5, 28, no
1438986181,  PCovili, 14, 12, 2, yes
2986885877,  LeonebonCettina, 59, 55, 4, yes
2827084763,  TOPPCATE, 28, 18, 10, yes
368458366,  giuvalentina, 5, 5, 0, yes
777478419424608257,  David_David_P, 6, 6, 0, yes
2327680994,  dome_pietro, 2, 2, 0, yes
2953019709,  SanzioPazzo, 13, 5, 8, no
803628976593772544,  CHIPSocial, 17, 9, 8, yes
2154746892,  ster67e, 99, 22, 77, no
134126917,  alexmanica, 3, 3, 0, yes
506387757,  squopellediluna, 25, 13, 12, yes
3053723635,  BanfiTiziana, 77, 22, 55, no
1194951343,  IULGIO, 20, 9, 11, no
1101446990,  LelloConso, 91, 25, 66, no
2512454838,  TizBenedetti, 12, 7, 5, yes
480617106,  PSTOCK75, 3, 3, 0, yes
3298985147,  annamariabeatr6, 11, 7, 4, yes
417443916,  luigirubino75, 1, 1, 0, yes
4128308115,  Katia53196935, 1, 1, 0, yes
883065655,  RPRESTIPINO, 76, 4, 72, no
953542285,  RussoMu, 26, 3, 23, no
1413220182,  piani_a, 79, 16, 63, no
1250295715,  IgorMalnatt, 1, 1, 0, yes
290963421,  germanodefrance, 8, 5, 3, yes
283932101,  orsomik, 12, 7, 5, yes
400159240,  NicolaMobilio, 1, 1, 0, yes
475788416,  LucaGugio, 7, 4, 3, yes
2979676497,  carloru86340284, 2, 2, 0, yes
3126770075,  GioTri71, 43, 13, 30, no
712973139215564800,  Maddalena_d, 1, 1, 0, yes
3776006296,  MSantariga, 30, 11, 19, no
383318692,  ManilaIlari, 1, 1, 0, yes
574396225,  sguglielm0, 29, 14, 15, no
104540988,  sogno09, 13, 7, 6, yes
1337596044,  brichiel, 29, 8, 21, no
818183167,  CARONTEII, 55, 12, 43, no
2907601252,  giosescordo1, 1, 1, 0, yes
1946899837,  MirkoZucca, 80, 23, 57, no
492087627,  renatamiorali, 8, 6, 2, yes
2656984642,  ribelle51, 95, 10, 85, no
2391309921,  71af31a3d7b1488, 1, 1, 0, yes
231883306,  Silvia_Bonatto, 1, 1, 0, yes
2998343315,  martinesdavid75, 1, 1, 0, yes
1127618904,  ppfois, 25, 10, 15, no
2241657341,  masciabrio, 2, 2, 0, yes
364329324,  DicrescenzoG, 1, 1, 0, yes
1314367554,  salvamenick, 31, 9, 22, no
128948359,  angelo_ambro, 10, 5, 5, neutral
961953667,  remoscnd, 3, 2, 1, yes
1111162884,  MichelaRostan, 4, 4, 0, yes
259404312,  Effeci1967, 1, 1, 0, yes
399624734,  cccricri, 11, 11, 0, yes
802950826754969600,  babomacir1975, 1, 1, 0, yes
2975144398,  stefan1062, 56, 13, 43, no
1188872131,  RobertoRosset11, 8, 6, 2, yes
1120206308,  andrea_gazza, 167, 19, 148, no
2209975810,  farinella_l, 1, 1, 0, yes
1919132101,  vilmaparenti, 195, 20, 175, no
794581992759300100,  robbeantonelli, 16, 14, 2, yes
2330768437,  AldoLecci, 5, 2, 3, no
634301484,  RigonatNicola, 12, 9, 3, yes
2909491005,  Sanlio2, 2, 2, 0, yes
2359413432,  OttoemezzoTW, 5, 3, 2, yes
105210939,  DarioTagliabue, 3, 1, 2, no
1372497578,  antonioguido58, 35, 9, 26, no
1418786191,  LilianaAmerise, 24, 6, 18, no
37873722,  marcocarlini, 1, 1, 0, yes
3342623991,  GiorgioDeSi64, 1, 1, 0, yes
436671461,  adrigigli, 14, 2, 12, no
294267488,  PalermoWebNews, 1, 1, 0, yes
221707969,  Digicontact, 11, 5, 6, no
3257187621,  NLorenzo97, 17, 10, 7, yes
4807034535,  GilliIvana, 1, 1, 0, yes
460226131,  gpellarin84, 54, 22, 32, no
831981618,  62rosse, 20, 11, 9, yes
2765683785,  rumpeltweet, 1, 1, 0, yes
513129501,  PietropaoloR, 1, 1, 0, yes
795199918017130496,  GiuliaMarbonini, 5, 5, 0, yes
586375300,  andreagransasso, 3, 2, 1, yes
2318283220,  JohnnyUtah_77, 64, 16, 48, no
281970743,  MyiesWT, 1, 1, 0, yes
2480654968,  itz__mikeii, 1, 1, 0, yes
153565754,  unfintofake, 5, 4, 1, yes
194275021,  tomaurora1, 133, 12, 121, no
132484911,  sergiolinix, 2, 2, 0, yes
3401430430,  magdulka64, 2, 2, 0, yes
451267515,  alessandra_esse, 1, 1, 0, yes
738311371255906304,  insiemebasta1si, 38, 36, 2, yes
411332075,  Sacarunz, 17, 11, 6, yes
3374562363,  fabiodezorzi1, 4, 3, 1, yes
2472017715,  roxycafe123, 23, 2, 21, no
357374751,  micios68, 8, 7, 1, yes
492136342,  AldoMotzo, 5, 4, 1, yes
2191894196,  Rikjard76, 6, 2, 4, no
811565292,  indipendentetw, 5, 4, 1, yes
722338412762697729,  casedalto, 1, 1, 0, yes
453287155,  Mauro_Boccia, 16, 6, 10, no
805875930388426752,  Luis37641915, 1, 1, 0, yes
479575055,  einblauer, 10, 6, 4, yes
2374899158,  LuigiBertin, 8, 1, 7, no
2182739120,  ClaudioFossa, 10, 6, 4, yes
369200086,  xbici, 99, 37, 62, no
366053697,  2009Daria, 11, 6, 5, yes
2980878029,  GianusSicanus, 11, 6, 5, yes
459452891,  carlomannaro, 15, 8, 7, yes
2768874429,  verzellino80, 2, 2, 0, yes
2197175103,  grecale66, 42, 16, 26, no
2884126876,  EFFEBUTTINA, 27, 16, 11, yes
448842961,  RolandCezanne, 7, 1, 6, no
74735060,  pasinaroberto, 3, 1, 2, no
2606297856,  AvanguardiaDem, 4, 4, 0, yes
964810638,  Pasquale_Mereu, 31, 11, 20, no
857051744,  FedericoSarri, 1, 1, 0, yes
63812610,  ferrogiova, 4, 4, 0, yes
220996437,  DorianaDori, 88, 50, 38, yes
760240948488044544,  AntonioABarcaro, 15, 7, 8, no
60995609,  frarai2003, 19, 10, 9, yes
210477610,  DavideGemmiti, 5, 5, 0, yes
558981012,  geoxgiuseppe, 23, 2, 21, no
410977365,  rosamundadesie, 3, 3, 0, yes
208130207,  King___N, 13, 4, 9, no
1216455108,  william27a, 9, 5, 4, yes
2421745238,  Dr_CiroAmendola, 4, 4, 0, yes
4664853389,  teresa90175867, 54, 22, 32, no
434411738,  FrncscPltn, 14, 9, 5, yes
1267065014,  Gaby55Gabriele, 34, 18, 16, yes
2367102656,  arbiter46664, 10, 9, 1, yes
560883286,  IvanaTanzi, 15, 13, 2, yes
4254101320,  mpiacenonaver1, 35, 29, 6, yes
950270718,  cogitativus, 1, 1, 0, yes
452327968,  arcobalenietnei, 15, 8, 7, yes
856629102,  vatenacttencass, 2, 2, 0, yes
181695000,  iperkrusty, 1, 1, 0, yes
543866562,  ilnibbioalto, 10, 9, 1, yes
2221404476,  SaraBencini, 209, 38, 171, no
746774248715345920,  LogLady_, 18, 15, 3, yes
4204183834,  Patty_Rose_LN, 75, 36, 39, no
82388042,  walterandreotti, 1, 1, 0, yes
2835053495,  notabile4, 4, 3, 1, yes
2376928902,  adolfoebasta, 36, 26, 10, yes
491223559,  PrimaPaginaOL, 4, 2, 2, neutral
801867970603601920,  Astolfo1968, 16, 11, 5, yes
402341164,  plasto1tweet, 5, 5, 0, yes
776867281880178688,  SilviaSavigni, 33, 12, 21, no
1063011624,  PatriziaFincato, 20, 11, 9, yes
3028985566,  giovannini1964, 5, 5, 0, yes
1169506849,  MaurizioTorchi2, 20, 10, 10, neutral
1357713108,  paoloraffaldi, 4, 4, 0, yes
731370864709636096,  saracanast, 3, 1, 2, no
96446959,  maxbunker, 5, 2, 3, no
463969453,  teovitamia, 171, 82, 89, no
4865359611,  Natasha_fly82, 8, 6, 2, yes
3306842937,  NataleBeniamino, 13, 4, 9, no
113446660,  Tyrian3, 6, 3, 3, neutral
326896586,  JacopoCalle, 3, 3, 0, yes
1203674574,  Stefano_mrc, 87, 55, 32, yes
2367849601,  dolcealbi, 10, 2, 8, no
2226893086,  BrusatiLoriana, 4, 3, 1, yes
1626983246,  scippator8, 3, 2, 1, yes
456907209,  manuvegha, 8, 6, 2, yes
2852272811,  claudiantin, 4, 3, 1, yes
227606688,  Why_So_Syrius, 6, 5, 1, yes
404210491,  StellaSpotlight, 1, 1, 0, yes
747062212347461636,  susanette31, 10, 2, 8, no
2356806462,  BertRoug, 9, 4, 5, no
385037966,  lelemarket, 1, 1, 0, yes
1217799007,  annamariaora, 64, 55, 9, yes
407584537,  DanielaRampini, 7, 5, 2, yes
3301722796,  YamashitaClub, 1, 1, 0, yes
758178577909153796,  Claudiowellphon, 25, 15, 10, yes
431480206,  Cheru65, 15, 8, 7, yes
273546344,  RMSerrao, 1, 1, 0, yes
1852391984,  annaviz1, 29, 24, 5, yes
2548634808,  lidiarosc, 9, 8, 1, yes
720736547826503682,  MaryHellenWoods, 1, 1, 0, yes
421858761,  ClaudiaOrgantin, 4, 4, 0, yes
3251588698,  panibbi, 30, 14, 16, no
761203827806789632,  Jos94Gprovazza, 13, 8, 5, yes
4708550595,  Maz67Salvo, 10, 7, 3, yes
4602580341,  viky_chessa, 24, 7, 17, no
538341709,  mirinisupermiri, 8, 3, 5, no
60994363,  mazzucarlo, 3, 3, 0, yes
2345481387,  arte1106, 77, 54, 23, yes
917261006,  Lentamentemuor, 2, 2, 0, yes
2523203476,  yanez_72, 14, 10, 4, yes
2987686264,  marturano51sm, 48, 30, 18, yes
492021780,  giampavis, 1, 1, 0, yes
1330185060,  ObiettivoT, 3, 2, 1, yes
1248451705,  CostaLuciano95, 1, 1, 0, yes
3613300157,  Chicco33333, 11, 6, 5, yes
1012961892,  francesco_colla, 5, 2, 3, no
1548872300,  MU231u231, 14, 6, 8, no
3430185532,  hemingway29956, 15, 6, 9, no
734456397824430081,  pijay_00, 6, 3, 3, neutral
2494635800,  LigorioRaff, 5, 3, 2, yes
1046310979,  NCapogreco, 1, 1, 0, yes
821568271,  BLUE_LOLY, 2, 1, 1, neutral
2484303523,  giusepp35269877, 20, 8, 12, no
254402535,  mariapiatrento, 4, 2, 2, neutral
4787048363,  alessan02272876, 11, 2, 9, no
1213170632,  sirtaura, 5, 2, 3, no
926290832,  cristianox1973, 8, 4, 4, neutral
484914037,  Alberico10k, 25, 3, 22, no
141571252,  paolaleo88, 1, 1, 0, yes
2391598947,  SSalogni, 23, 13, 10, yes
1045560134,  MarcoGranziero1, 2, 2, 0, yes
401399952,  GVerazzo, 11, 6, 5, yes
2336431904,  marisavillani, 57, 43, 14, yes
796970107503251456,  SPIDERMARZIANUS, 277, 23, 254, no
445414490,  AgnoMarco, 2, 2, 0, yes
1474297879,  Fabiopolso, 5, 5, 0, yes
72502360,  Elena_1977, 1, 1, 0, yes
1216071834,  gattitwit, 1, 1, 0, yes
22757909,  mariposa034, 29, 17, 12, yes
3245319177,  Olivieri2Va, 4, 1, 3, no
2916512591,  Grazia___55, 12, 6, 6, neutral
464615450,  mottagiuseppe1, 23, 3, 20, no
262078275,  fTataranni, 1, 1, 0, yes
2412507160,  FantaScooby, 32, 24, 8, yes
598279585,  skelligmicheal, 20, 14, 6, yes
336508593,  Charles_Indie, 2, 2, 0, yes
2296443458,  luca_pisti, 4, 2, 2, neutral
749398034774196224,  deadlyvacuum, 5, 3, 2, yes
1635529807,  Dibi_Dania, 43, 3, 40, no
44098068,  Joe911S, 2, 2, 0, yes
439034220,  GTJlove1897, 94, 50, 44, yes
340717082,  giusimarrosu, 9, 8, 1, yes
3131533467,  CarolinaFR81, 2, 2, 0, yes
178685251,  iltoscano65, 17, 12, 5, yes
1064862210,  chiccoassa, 2, 2, 0, yes
1169608560,  TonyZar5, 2, 2, 0, yes
16863408,  mastrobardo, 5, 5, 0, yes
376778181,  albertomarroni, 20, 15, 5, yes
1310811456,  stegian67, 3, 2, 1, yes
1492509740,  OBonomi, 78, 8, 70, no
1076089766,  LorenziLo, 11, 10, 1, yes
142731535,  alba90yt, 20, 4, 16, no
707605903328075777,  nuncepossocrede, 17, 9, 8, yes
3103748006,  peppiniellopz, 166, 89, 77, yes
736596690,  andr900, 32, 16, 16, neutral
792667994,  noiselord, 1, 1, 0, yes
420538698,  StefaniaT1, 15, 3, 12, no
2763778095,  annnappi62, 2, 2, 0, yes
1912361346,  hivolto, 3, 3, 0, yes
3108844089,  ilFabios, 2, 2, 0, yes
1077736116,  quintoprimo1, 28, 16, 12, yes
595517608,  gabiravanelli, 28, 15, 13, yes
2748304043,  Niccoli1Niccoli, 25, 25, 0, yes
405658810,  c_dorsi, 21, 19, 2, yes
25851958,  Yattaran, 7, 4, 3, yes
2680617799,  giusy696, 2, 2, 0, yes
3306426130,  Adanto4Adelaide, 58, 54, 4, yes
72379041,  antopirodda, 2, 1, 1, neutral
2275249630,  CapetoLodovico, 19, 16, 3, yes
1926516720,  enricomontibell, 26, 6, 20, no
3308327224,  Davidarmela, 2, 2, 0, yes
1667596609,  ines_morra, 8, 7, 1, yes
433479599,  OpenNapoli, 3, 3, 0, yes
1046200910,  TetiMontagna, 2, 2, 0, yes
3052641775,  F7Federica, 4, 2, 2, neutral
444837039,  Loestestest, 4, 3, 1, yes
1849672393,  nellylamorte, 12, 6, 6, neutral
1160746200,  simocasca, 1, 1, 0, yes
2330181981,  AdrianoMontana3, 3, 2, 1, yes
796704659834552321,  pippobello67, 3, 2, 1, yes
755862007656640512,  flemish2006, 2, 2, 0, yes
3368018859,  Bobbio65M, 453, 215, 238, no
293484907,  arde75, 41, 40, 1, yes
1154519022,  simo8322, 14, 11, 3, yes
875752152,  ANFAMEEE, 2, 1, 1, neutral
1341261416,  NLongobardo, 3, 1, 2, no
3045361705,  ObserveWithMind, 25, 25, 0, yes
104450083,  Romantico59, 6, 6, 0, yes
2208172767,  no_uber, 62, 31, 31, neutral
2168716042,  ubernograzie, 45, 24, 21, yes
603901912,  Chiarasmb, 3, 3, 0, yes
67126408,  Manupoggi, 1, 1, 0, yes
44950877,  tizicap, 2, 2, 0, yes
420419717,  MarcoPic12, 15, 6, 9, no
705041923,  ErikaTurbati, 1, 1, 0, yes
3310499086,  PsycologyPrimit, 7, 6, 1, yes
500243289,  oruamg, 19, 11, 8, yes
472186470,  Mauri1321, 10, 8, 2, yes
747906736930037764,  matteoremzi, 3, 2, 1, yes
845887279,  TancrediSalina, 1, 1, 0, yes
424572542,  lorenzorosati4, 1, 1, 0, yes
229804443,  pieropalmo, 41, 18, 23, no
774293964987957286,  SoundOld, 5, 4, 1, yes
160700352,  CesareMasola, 3, 2, 1, yes
801070091131584513,  enithevov1976, 1, 1, 0, yes
2833760769,  oldmanandsea1, 33, 14, 19, no
215305385,  mr_occhetti, 1, 1, 0, yes
467359617,  pbrex668, 15, 10, 5, yes
783015635181789187,  Il_Populista_, 9, 6, 3, yes
63665281,  danbergh, 1, 1, 0, yes
701294435720687617,  mhlbisogno, 1, 1, 0, yes
730396590230413312,  DeVerdinis, 24, 13, 11, yes
790948562,  VINCEVACIRCA, 30, 3, 27, no
723094218734862336,  ComitatoDelNO, 346, 34, 312, no
2883671135,  francescocasa9, 18, 2, 16, no
3036352179,  mameli54, 66, 24, 42, no
2182923351,  Gioco_falso, 10, 5, 5, neutral
420533831,  P10paola, 22, 10, 12, no
1672667984,  VirnaLuoni, 1, 1, 0, yes
791986391454511104,  guamari7, 24, 14, 10, yes
2339382066,  maurilio970, 31, 17, 14, yes
4027612270,  jonhonn, 1, 1, 0, yes
3104457562,  ncd_mn, 4, 4, 0, yes
789723402,  RositaAmoruso, 1, 1, 0, yes
366258436,  Indignati, 41, 25, 16, yes
2262991946,  vito22222, 24, 8, 16, no
607857182,  manzorob, 2, 2, 0, yes
405482706,  Lucaarggh, 32, 17, 15, yes
791598579307651072,  Donneperilsiro1, 1, 1, 0, yes
428235056,  MircoLacchini, 2, 2, 0, yes
1104275185,  NicolettaFavero, 6, 6, 0, yes
1726668865,  tommasistefano2, 12, 5, 7, no
3030866752,  luigigrz67, 3, 2, 1, yes
4164038717,  elybartolini79, 130, 117, 13, yes
797374091959406592,  2piedi, 88, 41, 47, no
1141399129,  lexmonetae, 2, 2, 0, yes
3121661467,  b3a660127297477, 8, 4, 4, neutral
2269417069,  SabriBenetazzo, 9, 9, 0, yes
123687106,  saramaestrelli, 5, 5, 0, yes
881002346,  rockapasso, 6, 5, 1, yes
2708071882,  s_mendolia, 16, 9, 7, yes
606332054,  Gi_Gi_TO, 1, 1, 0, yes
393342562,  KousNet, 36, 8, 28, no
285477625,  ivanulas, 1, 1, 0, yes
720160136468279296,  donatelliparis, 25, 16, 9, yes
3373955686,  Mirko_Becattini, 14, 7, 7, neutral
2176387748,  sabrinaekira, 1, 1, 0, yes
2591825288,  michelone34, 8, 8, 0, yes
710234922489876480,  DJLENIN61, 3, 2, 1, yes
238520291,  Oldgenoa, 11, 8, 3, yes
174249848,  avvocato2punto0, 7, 4, 3, yes
791390109333647362,  politicane, 1, 1, 0, yes
286307579,  mauromaudanros, 14, 12, 2, yes
2480550906,  ProfetiGIan, 2, 2, 0, yes
158288741,  loren_ch, 29, 18, 11, yes
51733848,  Davide33, 24, 10, 14, no
2376465507,  sprekel70, 13, 10, 3, yes
524545909,  silvia8542, 3, 1, 2, no
84141700,  giovanni_lesa, 2, 2, 0, yes
61046134,  pizzicarino, 7, 6, 1, yes
2239479319,  olgazouva, 1, 1, 0, yes
2339054926,  CesareBotero, 2, 2, 0, yes
748995130548424704,  fabrirud, 3, 2, 1, yes
575468669,  ritafoti1, 2, 2, 0, yes
478565327,  RSTN888, 21, 12, 9, yes
2204128029,  annietayler3, 35, 9, 26, no
607981040,  BCarazzolo, 29, 11, 18, no
785397318,  ValterRimini, 13, 5, 8, no
563075522,  SerenaNicora, 2, 2, 0, yes
4876950923,  FabioBussoleni, 7, 7, 0, yes
765195398587805696,  LaLestofante, 4, 1, 3, no
2207984680,  MbCodone, 1, 1, 0, yes
351555225,  laltraguanciama, 77, 29, 48, no
951863408,  federicobetti90, 3, 3, 0, yes
770711257892749312,  paolo_tarantino, 2, 2, 0, yes
83554278,  apeacox, 3, 3, 0, yes
413923650,  Salvoins, 6, 5, 1, yes
226678158,  HamsterNet, 8, 7, 1, yes
131105980,  dislanders, 13, 11, 2, yes
4822072721,  Daniele55582375, 3, 3, 0, yes
38878380,  cekipa, 10, 9, 1, yes
4155749909,  aldabelgrano, 10, 4, 6, no
2481790633,  walter7809, 1, 1, 0, yes
2869181698,  MomoRasiti, 6, 6, 0, yes
250697308,  glfrancomano, 28, 12, 16, no
4549605137,  leone150872, 8, 5, 3, yes
238501588,  ettorescafuro, 5, 2, 3, no
891681714,  carlofiorini61, 2, 2, 0, yes
2871036920,  LorenzoRaz51, 7, 6, 1, yes
299780153,  Godsent072011, 17, 6, 11, no
772498157636820993,  seiosenoi, 41, 22, 19, yes
572596576,  M_Manuel80, 2, 2, 0, yes
2850373275,  frspla, 4, 3, 1, yes
3360251476,  5bc32772e3fb467, 33, 9, 24, no
471150852,  Vertigine76, 7, 5, 2, yes
63732939,  Highlander_Ro, 20, 7, 13, no
451003130,  mgmariella, 27, 15, 12, yes
2312169774,  giorgiorosi1, 84, 20, 64, no
706097800040357889,  maryfagi, 57, 20, 37, no
237241091,  giangio87, 11, 6, 5, yes
1335942066,  ADA_1976_ITALIA, 14, 9, 5, yes
292570387,  tamargozi, 1, 1, 0, yes
2176575594,  LaTvNonDiceChe, 12, 5, 7, no
444048705,  ginop38, 10, 9, 1, yes
803115926002532352,  AndreaPorretti3, 5, 5, 0, yes
190742111,  MatteoBilli72, 6, 6, 0, yes
4832053377,  SimoneDolcimas1, 20, 11, 9, yes
2360647972,  GhinoDiTacco70, 26, 15, 11, yes
721746953114120192,  EnzoVeroli, 2, 2, 0, yes
1893025346,  BONECHIF, 8, 6, 2, yes
292487530,  RedStar000, 3, 3, 0, yes
50251798,  nevermeet82, 15, 15, 0, yes
4184943027,  AzzVrraSD, 10, 6, 4, yes
767689615713206272,  LiutoGiusto, 5, 5, 0, yes
751379826024583168,  MarcoBogna, 32, 17, 15, yes
710514446435815424,  GenoveffRacchia, 2, 1, 1, neutral
539110707,  pheiticeira, 1, 1, 0, yes
776125290624016384,  Imbarazzotweet, 4, 3, 1, yes
3023541567,  apomar00, 9, 9, 0, yes
801361825,  FrancoCoia, 12, 7, 5, yes
702957764260327424,  debys81280, 3, 2, 1, yes
1314735973,  DegrandinGrandi, 19, 3, 16, no
3352429948,  trilussimis, 4, 2, 2, neutral
303783071,  alex_asr, 1, 1, 0, yes
2845737279,  baloi361, 62, 24, 38, no
187541091,  emme1963, 1, 1, 0, yes
730131019957993473,  Giulio68857453, 1, 1, 0, yes
4859931532,  UgoCutilliPhoto, 25, 8, 17, no
1291622634,  S_Vaccari4, 47, 29, 18, yes
1062799087,  ErasmoPartenope, 21, 16, 5, yes
507746291,  AnnaMariaS6, 7, 4, 3, yes
2887237090,  francesco_laera, 3, 3, 0, yes
712961271776169984,  CrissRunfolo, 6, 4, 2, yes
408681712,  PaoloRieux, 24, 8, 16, no
552916732,  michelesantor16, 1, 1, 0, yes
4188604709,  Virginia_Roma, 31, 14, 17, no
2745585660,  Mister_onemore, 14, 11, 3, yes
328556088,  Carolus730, 1, 1, 0, yes
1339960975,  sgralady, 3, 1, 2, no
1267569816,  Fabbb231, 3, 3, 0, yes
760930917204590592,  BoiSergio1971, 27, 18, 9, yes
3018922948,  Stefano339, 9, 7, 2, yes
712169550687633408,  CarloPassoni81, 1, 1, 0, yes
1407198973,  giannidanieli, 8, 7, 1, yes
318988340,  BlackOutTotale, 17, 6, 11, no
1310209976,  Ecatetriformis, 13, 5, 8, no
712940094,  fedebassano, 1, 1, 0, yes
790372009,  sa_radice, 10, 10, 0, yes
1063348129,  Luixfor, 3, 3, 0, yes
214047668,  MatteoCorreani, 9, 4, 5, no
146215776,  Infinity_999, 20, 3, 17, no
4570489414,  sgnakbud, 9, 6, 3, yes
17709747,  c_digiangiacomo, 14, 2, 12, no
744731250,  BenedettaSerin1, 8, 4, 4, neutral
1640144880,  silviett_, 8, 7, 1, yes
261119105,  michele150381, 6, 6, 0, yes
1275298856,  stefani1960, 6, 3, 3, neutral
531839676,  DemyIaria, 1, 1, 0, yes
545458489,  VPicariello, 1, 1, 0, yes
2354462598,  nicmax25, 19, 12, 7, yes
406841197,  LorenzoPitzalis, 12, 2, 10, no
50233016,  CommentoRimosso, 48, 13, 35, no
2896183330,  alby13712, 2, 2, 0, yes
224246660,  chainsless, 1, 1, 0, yes
390394542,  BrambillaLuca, 1, 1, 0, yes
1058696390,  liafriggi, 2, 2, 0, yes
1347511531,  AgataGrimaldi, 3, 3, 0, yes
29507504,  marcocanestrari, 3, 1, 2, no
1889822017,  SmilerForYou, 1, 1, 0, yes
812774677,  Gildvanz, 10, 5, 5, neutral
1142172775,  aldogiacob, 3, 3, 0, yes
2962599197,  impiegopubblico, 35, 26, 9, yes
404088514,  DimitriDeVita, 24, 2, 22, no
2432948813,  fabioferrero71, 29, 20, 9, yes
3363987292,  maciampi1789, 25, 17, 8, yes
278425671,  afrodite1969, 26, 18, 8, yes
1167206024,  Matrix7Ste, 10, 9, 1, yes
2205416773,  siculgrigio, 1, 1, 0, yes
727928106489614336,  SalCirillo79, 2, 2, 0, yes
472946369,  ValeGentile11, 6, 6, 0, yes
337228975,  antoniobifulco, 2, 2, 0, yes
760986919891271680,  Salvo46583835, 4, 2, 2, neutral
803051187704623104,  madre_deputa, 9, 3, 6, no
801218820086108160,  lady_retweet, 9, 3, 6, no
799574305935921153,  RtNon, 10, 4, 6, no
803012949157773313,  RtInferno, 9, 3, 6, no
802662799734427648,  ParadisertRt, 10, 3, 7, no
798129911240261632,  Musica_RT, 9, 3, 6, no
800508684254126080,  maniacretweet1, 9, 3, 6, no
1190504383,  lepasquinate, 10, 10, 0, yes
2188528301,  camosuper, 1, 1, 0, yes
2786870739,  PerainoDiego, 7, 3, 4, no
2938273510,  frasem6617, 8, 1, 7, no
458803186,  LucianoLezza, 1, 1, 0, yes
70951142,  Ale_Mussolini_, 24, 9, 15, no
136275685,  AvvBrosisky, 2, 1, 1, neutral
585288950,  g_de_dionigi, 5, 3, 2, yes
2601961486,  pinogalione, 16, 4, 12, no
2245698050,  noemijbra, 6, 3, 3, neutral
236364144,  robertoman2, 2, 1, 1, neutral
2768367785,  serantonio1983, 27, 18, 9, yes
4419765201,  gabrybine59, 4, 3, 1, yes
2231399720,  sigrazie1, 5, 5, 0, yes
2987755703,  KenLingenfelter, 2, 2, 0, yes
444589610,  Gozzillo777, 1, 1, 0, yes
762595238452006912,  GiovanniMorgan9, 3, 1, 2, no
1142900882,  meschini_nito, 1, 1, 0, yes
151482583,  funaija, 19, 10, 9, yes
2584060242,  Livero10, 1, 1, 0, yes
136622333,  AleRampiconi, 1, 1, 0, yes
495205889,  PicciStrix, 1, 1, 0, yes
343482492,  NicoLaterza, 1, 1, 0, yes
1038092534,  zanilan, 10, 6, 4, yes
1735338012,  emanuel_80, 2, 2, 0, yes
483304757,  stefanococcia60, 3, 2, 1, yes
1553447190,  70Ciabatti, 9, 4, 5, no
1109724397,  galvasshop, 1, 1, 0, yes
735550795,  bterra04, 1, 1, 0, yes
804573803527491584,  Fabionolimits, 4, 3, 1, yes
3299269745,  picciva, 2, 2, 0, yes
1031209770,  StefanoSonlieti, 3, 2, 1, yes
387345110,  AlbertodaSomma, 12, 5, 7, no
3056250186,  ChiossiLaura, 13, 9, 4, yes
448732675,  giuliabottini, 30, 20, 10, yes
736529876656771073,  TinaGesuele, 8, 6, 2, yes
2475022843,  igorlorenzo0, 12, 7, 5, yes
2385281611,  Biagio8six, 3, 3, 0, yes
3399738400,  Baby_stella43, 1, 1, 0, yes
1729125788,  FabioVaio, 7, 3, 4, no
731342369430327296,  CogoniPiero, 12, 8, 4, yes
426445823,  saveriolorusso, 1, 1, 0, yes
2369008892,  StefanoTeo73, 5, 2, 3, no
3062395409,  d10ae9f9b5e544a, 1, 1, 0, yes
2948677775,  DLaraspata, 1, 1, 0, yes
621220399,  mortileo, 16, 15, 1, yes
397233824,  giuseppedonati, 2, 2, 0, yes
424397362,  Lorenzo_Bagnoli, 5, 4, 1, yes
2432146794,  karlkamus, 10, 10, 0, yes
1386808813,  angelo_ra_, 56, 37, 19, yes
3945035751,  pizziol_enrico, 2, 2, 0, yes
257654410,  maxivasco79, 5, 4, 1, yes
3309458867,  giovannicola73, 11, 4, 7, no
1009225098,  antonellazacca4, 8, 4, 4, neutral
318467812,  lafrench95, 2, 1, 1, neutral
805550015510958081,  Enri_75, 2, 2, 0, yes
432882729,  fabiogerbino, 3, 3, 0, yes
1127560747,  GraziaTalia89, 1, 1, 0, yes
245419980,  Th3Zer0, 2, 2, 0, yes
4698614858,  pier_to, 3, 3, 0, yes
167933227,  Monialustri, 12, 7, 5, yes
727770559107485696,  AlexRota65, 61, 26, 35, no
3431610221,  cpiovascorondo, 3, 2, 1, yes
794167228530823168,  mikericciardell, 4, 4, 0, yes
861520394,  Chiara_Fil, 1, 1, 0, yes
917243564,  DemetrioPecora, 5, 5, 0, yes
555019079,  DiegoDiSopra, 4, 2, 2, neutral
985314588,  Freedom_610, 10, 10, 0, yes
454833164,  EC034, 7, 7, 0, yes
2813529980,  Frank201410, 4, 4, 0, yes
3360665303,  erlindo_ronco, 1, 1, 0, yes
2355945550,  Taibi52Taibi, 31, 24, 7, yes
422794585,  dmjr_p, 1, 1, 0, yes
140945344,  alexande88, 6, 6, 0, yes
1467807296,  matematico65, 15, 4, 11, no
3254165183,  skywalker5005, 4, 3, 1, yes
82572788,  ciampy73, 3, 3, 0, yes
3400063569,  MaxButty82, 9, 6, 3, yes
574343995,  tinoneb, 3, 3, 0, yes
804759689707847680,  carognabastada, 28, 18, 10, yes
2157254871,  Lukagentili, 3, 3, 0, yes
1108966327,  gennrinocaldero, 12, 10, 2, yes
535447658,  jom5s, 74, 12, 62, no
490933406,  rabugento2100, 8, 4, 4, neutral
181921336,  marioRSM1, 3, 2, 1, yes
704078981591646208,  LaSalisP, 23, 6, 17, no
1496349728,  falcao64it, 3, 3, 0, yes
34257738,  CyberRoby, 29, 2, 27, no
1679375545,  Ronin_ribelle, 51, 3, 48, no
2199539758,  antodursoct, 18, 10, 8, yes
2913058996,  maryinstones, 3, 3, 0, yes
433664513,  DiamanteGiallo, 20, 7, 13, no
2400560849,  PintonTiziana, 36, 8, 28, no
323856523,  IlarioVaccaro, 1, 1, 0, yes
106724705,  Cuoredifango, 5, 2, 3, no
1041823142,  nonhosoldi, 36, 24, 12, yes
109962743,  gioacchinobelli, 3, 3, 0, yes
802829264,  marco_gmlavolpe, 10, 6, 4, yes
2225039966,  paola_chiarore, 7, 3, 4, no
1385085271,  VitoAntonio46, 9, 9, 0, yes
836504312,  Inverno_72, 9, 6, 3, yes
189265027,  Veta76, 13, 5, 8, no
792731002900709376,  Gigadesires, 19, 11, 8, yes
107488386,  FrancescaTibo, 24, 10, 14, no
711681123559014400,  antonio_cilento, 5, 2, 3, no
617201169,  skito_o, 40, 26, 14, yes
4076357194,  Mambolas, 46, 9, 37, no
1055382594,  billa_silvia, 8, 5, 3, yes
1315995308,  Solegiallorosso, 15, 10, 5, yes
497249239,  ale_barabino, 6, 2, 4, no
4506822040,  Paolo96535986, 6, 5, 1, yes
594846876,  ENRICORIZZIVEG, 4, 3, 1, yes
121096234,  GianpieroCasu, 1, 1, 0, yes
3243909749,  antonardelli, 37, 6, 31, no
2891116426,  Marco_B_86, 7, 3, 4, no
1214348959,  lu_zero_, 1, 1, 0, yes
1020931404,  73rv, 14, 6, 8, no
1228748084,  Nevada_Gaz, 2, 1, 1, neutral
435844281,  Patrizia_punto, 4, 1, 3, no
3171167135,  capri3patri, 18, 12, 6, yes
589418956,  giuslit, 33, 8, 25, no
787296414695092224,  CorayAnita, 3, 2, 1, yes
1469982290,  MaxxMono, 9, 6, 3, yes
51906999,  bmark85, 4, 4, 0, yes
2952740961,  gianni_gressani, 5, 5, 0, yes
1095955831,  martipiesco, 4, 4, 0, yes
3160030421,  caputi55, 5, 5, 0, yes
725663887555715072,  hz_carla, 1, 1, 0, yes
390906063,  DelCesidio, 8, 5, 3, yes
150433238,  seipreciso, 5, 3, 2, yes
429274652,  wblake64, 3, 3, 0, yes
237278320,  andreacasagrand, 2, 2, 0, yes
1412675324,  luca_ottavi, 8, 1, 7, no
566361704,  merimascherpa, 56, 13, 43, no
704584631631409152,  Claudio24041974, 3, 2, 1, yes
396151080,  mocettast, 83, 20, 63, no
433192015,  EmilianoBrollo, 13, 12, 1, yes
1310591124,  mariaDeNadie2, 15, 7, 8, no
79511997,  Nanoalto, 10, 10, 0, yes
784105196070854657,  oinot49, 167, 53, 114, no
802200796368687105,  desyraf70, 12, 6, 6, neutral
775275218172510208,  Franca91632485, 12, 2, 10, no
1169515040,  morgana661, 5, 4, 1, yes
738310503664111616,  francoeffe1964, 1, 1, 0, yes
1276203865,  AuraLuna1, 2, 2, 0, yes
392117332,  ato_s, 8, 7, 1, yes
3431302787,  Cridagostino79, 3, 3, 0, yes
3434577971,  roby8993, 16, 11, 5, yes
1097807131,  OttoOssaMosse, 1, 1, 0, yes
3075318569,  ExOpgJesopazzo, 2, 2, 0, yes
592269529,  AgnelloMistico, 4, 3, 1, yes
296732220,  PinoRaspante, 9, 5, 4, yes
1259041459,  leoberthi, 13, 3, 10, no
730702691425456128,  genno03, 6, 4, 2, yes
357768740,  giomur_62, 19, 3, 16, no
4318680568,  Antonio84496827, 29, 10, 19, no
2366082457,  maretegge, 21, 5, 16, no
1234419373,  lagritti67, 8, 8, 0, yes
804829171235127296,  Stefano82905346, 1, 1, 0, yes
4838046849,  TgrPiemonte, 10, 7, 3, yes
702845775617912832,  miskin7777, 11, 11, 0, yes
430565411,  AlessandraSerr1, 5, 5, 0, yes
155523130,  EnricaBorrelli, 1, 1, 0, yes
743869096324927488,  fabiosabatino85, 10, 10, 0, yes
60655447,  ivanagiuluc, 1, 1, 0, yes
1063725991,  fabio_moret, 11, 10, 1, yes
567306134,  MASURISIBERIAN, 9, 4, 5, no
2800128455,  edda06061979, 160, 160, 0, yes
246840871,  bobpelu, 19, 16, 3, yes
4408706445,  Antogra65, 2, 2, 0, yes
499218258,  amicizia63, 2, 2, 0, yes
450937091,  empousa1, 20, 20, 0, yes
4724490358,  Pucci_mg, 13, 12, 1, yes
452117960,  PPicerni, 6, 3, 3, neutral
718523969939369990,  BriguglioSara, 54, 54, 0, yes
717997888526270465,  RitaRaiti1, 58, 58, 0, yes
3173819499,  PatoOsko, 46, 17, 29, no
405426716,  sarracinus, 53, 16, 37, no
1192856120,  MaximoVise, 14, 10, 4, yes
1163037217,  fabriziofastell, 1, 1, 0, yes
3102184491,  ParzialePaolo, 1, 1, 0, yes
773553530296754176,  FuoriRomaRai3, 2, 2, 0, yes
405384428,  concitadeg, 10, 7, 3, yes
719072026447781888,  giobilello80, 52, 52, 0, yes
4437711454,  Barbara6719, 3, 3, 0, yes
477031696,  LorenzoPlumari, 1, 1, 0, yes
1053466591,  dldiversi, 1, 1, 0, yes
271654618,  AndreaH501, 7, 1, 6, no
721957168015126528,  Miziok67, 12, 2, 10, no
1368007123,  graziellagrazi2, 16, 9, 7, yes
763737673613840384,  GiDal_randagio, 20, 12, 8, yes
2160731013,  ecostantino73, 31, 12, 19, no
4342639457,  pierluigisabat1, 4, 1, 3, no
781539111052115968,  Tomraybans, 27, 21, 6, yes
457442858,  FREDDYVERRENGIA, 20, 7, 13, no
895702736,  PaolaMecali, 26, 17, 9, yes
269345936,  paolabocci, 4, 4, 0, yes
113962014,  PietroBussolati, 4, 4, 0, yes
494169487,  atreide65, 15, 10, 5, yes
451991982,  WalterRizzotti, 9, 2, 7, no
2334131475,  poggetti75, 11, 6, 5, yes
72129328,  max_shining, 2, 1, 1, neutral
838517388,  BrugnaraMichele, 1, 1, 0, yes
474223861,  FastFerroVieER, 1, 1, 0, yes
108628699,  prampolo, 2, 2, 0, yes
393647707,  paolafreschini, 6, 6, 0, yes
349810156,  GalloBelmax, 14, 13, 1, yes
393679170,  MauVaci, 1, 1, 0, yes
1077176911,  vajovalasit, 2, 2, 0, yes
2438190453,  sparola72, 1, 1, 0, yes
793805935609339904,  DeviMaddalena, 5, 5, 0, yes
585405745,  MarcoDomenicali, 3, 3, 0, yes
52731955,  la_pippi, 7, 7, 0, yes
937081645,  BaldassareG, 1, 1, 0, yes
138530001,  gabygermino, 11, 9, 2, yes
298758103,  wonkadevi, 9, 8, 1, yes
2174129414,  AntonioResta62, 1, 1, 0, yes
800692744230309889,  cesare01041955, 2, 2, 0, yes
568860199,  AArdicci, 8, 6, 2, yes
716469300295573506,  TwittaRitwitta, 3, 3, 0, yes
2170527625,  sampericoncetta, 19, 8, 11, no
4038240796,  thedrumsofmuzak, 11, 5, 6, no
2341635078,  eschinir, 1, 1, 0, yes
579999373,  DerresAraia, 2, 2, 0, yes
204791100,  ergio78, 33, 15, 18, no
1580557566,  paolonegro73, 3, 3, 0, yes
4920069233,  Giocucci, 3, 3, 0, yes
1718349908,  Costantinojr, 1, 1, 0, yes
1204596733,  LuigiPerissich, 1, 1, 0, yes
480531196,  DussinLuciano, 35, 31, 4, yes
63419089,  meditelegraph, 6, 6, 0, yes
104135821,  adling64, 62, 37, 25, yes
469483334,  ferrariant, 2, 2, 0, yes
324568388,  Donatello19, 2, 2, 0, yes
2191221171,  ALafronte, 7, 2, 5, no
445626690,  DarioGiuffrida1, 13, 11, 2, yes
284289661,  CaterinaBalacco, 1, 1, 0, yes
493416891,  EdoXD96, 1, 1, 0, yes
1243637227,  PdVitulazio, 2, 2, 0, yes
263595524,  tore7310, 6, 6, 0, yes
1037286848,  mgmalacrida, 9, 8, 1, yes
3348796875,  fareprogressi, 3, 1, 2, no
302083852,  Franzkok, 1, 1, 0, yes
2810679525,  NNorPa, 18, 12, 6, yes
1218912360,  mlecampo, 1, 1, 0, yes
469548100,  Lapenna92, 3, 3, 0, yes
230254846,  condorbox, 8, 6, 2, yes
1005609122,  Fransisco931, 2, 2, 0, yes
423797452,  fulmine72k, 8, 5, 3, yes
1222851368,  MarineseSergio, 2, 2, 0, yes
477022797,  lorenamalagoli, 1, 1, 0, yes
442871486,  ert_rob, 1, 1, 0, yes
531259552,  antociara, 1, 1, 0, yes
2365586773,  frances05116363, 4, 4, 0, yes
1722899785,  sale635, 12, 11, 1, yes
2330406031,  CIAOornella, 2, 1, 1, neutral
1008426596,  SDilberto, 1, 1, 0, yes
556865205,  1953_roberto, 4, 4, 0, yes
1213547995,  unsaltoevengo, 2, 1, 1, neutral
52549356,  claudiolub, 1, 1, 0, yes
214240583,  MatteoDome, 12, 11, 1, yes
937257134,  SignorelliMario, 4, 3, 1, yes
158367488,  Biagio71To, 9, 3, 6, no
554381582,  Giordy1985, 1, 1, 0, yes
793395119533719552,  massimolegacoop, 4, 4, 0, yes
1357827044,  scastelas, 8, 3, 5, no
2528932253,  BovaOrnella, 5, 4, 1, yes
1270536486,  V_Man_V, 1, 1, 0, yes
216696645,  framass88, 2, 2, 0, yes
142590818,  bollicine1977, 6, 5, 1, yes
67842903,  AleBin, 1, 1, 0, yes
2530704138,  FedesimoFs, 1, 1, 0, yes
50700504,  nandacremascoli, 5, 5, 0, yes
2570997037,  QuiNewsArezzo, 1, 1, 0, yes
2322781029,  KCarnasciali, 25, 18, 7, yes
4355636235,  Domenic58111911, 2, 2, 0, yes
1199928846,  PedalandoUniti, 2, 1, 1, neutral
799313616302440449,  ElenaperilSi, 12, 12, 0, yes
183405973,  brmario57, 5, 5, 0, yes
222864179,  sandrotwitte, 1, 1, 0, yes
939425341,  AlbertoVeroli, 10, 8, 2, yes
3768498155,  muv_app, 2, 2, 0, yes
498181776,  Fra_Mataluni, 2, 2, 0, yes
22612393,  aleghio, 2, 2, 0, yes
269283115,  mck33it, 1, 1, 0, yes
1600397972,  NapoliBorbonica, 5, 3, 2, yes
932814966,  paoltafu, 4, 3, 1, yes
760349481158189056,  stefchir, 2, 2, 0, yes
391937038,  AndreaHarten, 13, 13, 0, yes
3222700497,  lorena_cambiano, 15, 12, 3, yes
2695436575,  diMartedi, 20, 8, 12, no
418658147,  AlessandraBrafa, 1, 1, 0, yes
1360149344,  Beoctis, 1, 1, 0, yes
1320741330,  FerrettiTamara, 2, 2, 0, yes
802732238,  PietroSpirito1, 1, 1, 0, yes
469172342,  IvanoTognassi, 1, 1, 0, yes
263244860,  2937652, 7, 5, 2, yes
524489307,  caprino_paolo, 2, 1, 1, neutral
66635426,  powisle16, 9, 6, 3, yes
2773693479,  agr_mario, 3, 3, 0, yes
801314293031510017,  sinafa52, 24, 15, 9, yes
1171761254,  mitgov, 9, 9, 0, yes
318418814,  claudioberta, 1, 1, 0, yes
1332277860,  LadyVenezia, 2, 2, 0, yes
799587629977190401,  DylanReds, 18, 11, 7, yes
397567225,  SaaidiSabrine, 1, 1, 0, yes
564920609,  pepeprecaria, 2, 2, 0, yes
1163226570,  flavionoro, 1, 1, 0, yes
1852173686,  _giovannimanna, 3, 3, 0, yes
2590167691,  umberto633, 2, 2, 0, yes
1024281818,  think_max, 2, 2, 0, yes
3246056727,  gielisTs, 1, 1, 0, yes
2394145762,  CarmelaMarzocco, 15, 13, 2, yes
356397156,  Paolo_degli, 7, 6, 1, yes
443832737,  barbaradiamanti, 11, 9, 2, yes
192329243,  JoLawrence3, 3, 3, 0, yes
228307719,  matteobarion, 5, 4, 1, yes
425365839,  ItaliaDGIovani, 24, 13, 11, yes
266643415,  Ocram87, 1, 1, 0, yes
82301438,  damendola, 2, 2, 0, yes
2779111695,  BerioRoberto, 1, 1, 0, yes
176015580,  AlketCecaj, 10, 10, 0, yes
384240252,  VincenzoPalm69, 7, 4, 3, yes
3873875115,  MohamedSouf3, 8, 8, 0, yes
1370769932,  antlan1, 8, 1, 7, no
2350089883,  giocar_nu, 5, 5, 0, yes
411708151,  evafromeo, 2, 2, 0, yes
496716258,  lollobi70, 2, 1, 1, neutral
789866400332611584,  Adesposto, 123, 8, 115, no
1231624994,  davidtavano, 18, 15, 3, yes
388690319,  FraenzaP, 2, 2, 0, yes
3239222661,  Ale49973863, 1, 1, 0, yes
726770253645135873,  realgdm, 22, 20, 2, yes
541538081,  forsenoforsesi, 3, 2, 1, yes
917754055,  francitobia, 4, 4, 0, yes
2980207475,  BenedettiMeza, 13, 13, 0, yes
3301460381,  leon_diantonio, 1, 1, 0, yes
170303091,  Marco_Taglia, 1, 1, 0, yes
433697780,  SimoBenedettini, 1, 1, 0, yes
69834006,  albertomelloni, 8, 8, 0, yes
372722117,  RavennaDintorni, 1, 1, 0, yes
55619032,  damienlanfrey, 2, 2, 0, yes
417292578,  FabioPaparelli, 2, 2, 0, yes
2913027023,  a_scanca, 1, 1, 0, yes
1264056133,  MassimoCannas1, 3, 1, 2, no
391896780,  Sergio_Cava, 17, 15, 2, yes
245054440,  Danzadeliranza, 7, 4, 3, yes
703510405809872896,  HurlerInfo, 6, 6, 0, yes
801753787920711680,  lucasaclivolsi, 2, 2, 0, yes
2880746019,  CosmobikeVR, 2, 2, 0, yes
944685488,  _Stay_Foolish_, 1, 1, 0, yes
1101913508,  Barbara_Goi, 130, 25, 105, no
4858595038,  economiadelmare, 1, 1, 0, yes
583980924,  francescoge07, 23, 19, 4, yes
1128505124,  Stopdeclino, 6, 6, 0, yes
2356057472,  RobertoTaiola, 3, 3, 0, yes
429177293,  BIFIANU, 2, 1, 1, neutral
303365029,  D_scarparo, 10, 10, 0, yes
2452755261,  GianpaoloMascia, 1, 1, 0, yes
3664903823,  annettagala, 2, 2, 0, yes
2891880335,  NikiCottone, 2, 2, 0, yes
4834895315,  pimnag0, 2, 2, 0, yes
569131534,  SmartCity4Italy, 2, 2, 0, yes
527221660,  guidocapitanio, 7, 2, 5, no
234825585,  D4n1l010, 1, 1, 0, yes
418989912,  Nello_Moccia, 4, 4, 0, yes
2832566926,  PDconversano, 3, 3, 0, yes
1035274488,  francibedetti, 2, 2, 0, yes
783679588677353472,  JackSayan2, 3, 3, 0, yes
144556859,  edoalb, 2, 2, 0, yes
486015426,  luisagabbi, 28, 28, 0, yes
802660850490281984,  Jimboydog, 1, 1, 0, yes
731040814143553536,  Michele201171, 4, 3, 1, yes
2612229665,  nicolettabatta1, 2, 2, 0, yes
484570274,  pendolaria, 8, 2, 6, no
712259639866486784,  PaoloLupin, 2, 2, 0, yes
61470955,  icostreet, 2, 2, 0, yes
413364881,  SalvTomaselli, 5, 5, 0, yes
2343337932,  RuggieroCrudele, 5, 5, 0, yes
571082591,  JosephMasAzure, 1, 1, 0, yes
457526317,  RaffaeleZunino, 1, 1, 0, yes
301472434,  StefanoFassina, 2, 2, 0, yes
1365056664,  FSolieri, 6, 4, 2, yes
334768369,  MeMeEsposito, 4, 2, 2, neutral
134036554,  ljahier, 8, 8, 0, yes
494273497,  aptlombardi, 2, 2, 0, yes
2340131659,  furioserra, 19, 19, 0, yes
2435522304,  AIPASpace, 1, 1, 0, yes
4919378483,  Marco53075172, 7, 5, 2, yes
23223078,  andj1967, 3, 2, 1, yes
1109728674,  sciarrettagl, 3, 2, 1, yes
3016707491,  TirendiF, 8, 7, 1, yes
229441189,  GianniJJ, 4, 1, 3, no
538044261,  EPavone, 4, 4, 0, yes
405516333,  AndreaGiuricin, 1, 1, 0, yes
1876743998,  gdigiovanni2, 2, 2, 0, yes
191828460,  ccorcella, 3, 2, 1, yes
1945057555,  aldomastria1, 2, 2, 0, yes
381745360,  p_lamattina, 1, 1, 0, yes
168648058,  AntonioNigr, 2, 2, 0, yes
726833262241439745,  khamisnagi11, 1, 1, 0, yes
455349760,  GigiCortese, 1, 1, 0, yes
2423933670,  TachController, 1, 1, 0, yes
345475530,  f_ragusa, 14, 7, 7, neutral
362418587,  pimmovilli, 2, 2, 0, yes
1011151154,  Andrea84it, 23, 10, 13, no
6827962,  antoniopalmieri, 38, 11, 27, no
502106655,  Rosario_Carello, 2, 2, 0, yes
812800302,  puccy0511, 1, 1, 0, yes
503353225,  AlfredoOnesti1, 4, 4, 0, yes
597408853,  mimmomunno, 4, 4, 0, yes
2195525920,  PatriziaPalotta, 1, 1, 0, yes
1116674660,  AS3691, 27, 24, 3, yes
484071732,  aspano60, 2, 2, 0, yes
132519914,  danife75, 1, 1, 0, yes
2840979093,  AOppicelli, 1, 1, 0, yes
788001483954483200,  TorinoLioneBOT, 1, 1, 0, yes
1359282018,  vantoniani, 7, 6, 1, yes
412183823,  ErbertoFrieri, 6, 3, 3, neutral
864703938,  dambrosiopat, 3, 2, 1, yes
373277341,  NoTav_Rivalta, 22, 5, 17, no
573046530,  CoscarellaMaria, 4, 4, 0, yes
2803431199,  telt_tunnel, 1, 1, 0, yes
798505651928465409,  salva594, 5, 2, 3, no
2355077193,  Menico81, 3, 3, 0, yes
88014506,  enzabrunobossio, 16, 16, 0, yes
384220760,  a_ambrogio, 6, 6, 0, yes
134780699,  marcellot94, 1, 1, 0, yes
22010247,  carlocosta, 1, 1, 0, yes
1252900878,  alep_1972, 4, 4, 0, yes
2279189432,  RizzoEdoardo, 2, 2, 0, yes
2288157877,  MaurizioSeri1, 9, 9, 0, yes
706796463045656576,  LFItrasporti, 1, 1, 0, yes
114706508,  Cangaceir0, 4, 4, 0, yes
779917675,  madeco62, 5, 4, 1, yes
108341155,  elianto78, 1, 1, 0, yes
618382051,  ReMito90, 1, 1, 0, yes
415420559,  panisa56, 1, 1, 0, yes
936876583,  rinoteodoro, 3, 2, 1, yes
3055322696,  GiusiZarra, 7, 7, 0, yes
1219824060,  me06101972, 4, 4, 0, yes
3248002781,  roccocarrozzino, 4, 4, 0, yes
22014556,  tailerd, 1, 1, 0, yes
823550983,  giacomomatera1, 4, 4, 0, yes
954042031,  F_Gorre, 1, 1, 0, yes
35183135,  quatrelle, 1, 1, 0, yes
794343306,  librellula, 1, 1, 0, yes
389395835,  1970Germano, 22, 21, 1, yes
934188559,  RCazzagon, 9, 5, 4, yes
3345500818,  L_Castrignano, 2, 2, 0, yes
768979276804874240,  emaceste95, 3, 1, 2, no
2983707267,  LaNotiziaTweet, 4, 2, 2, neutral
2819648452,  d77omenico, 4, 4, 0, yes
17335447,  simonelongo, 1, 1, 0, yes
2328579068,  BRIE1M, 3, 2, 1, yes
1037942274,  riccamara, 18, 15, 3, yes
133681200,  Joris_87, 1, 1, 0, yes
1323227604,  SpadoneGiuseppe, 1, 1, 0, yes
498964636,  AlessiaFragassi, 14, 14, 0, yes
52142001,  lucadegasper, 1, 1, 0, yes
439076197,  MarziaPicciano, 1, 1, 0, yes
3147597048,  m_scaglia, 5, 1, 4, no
454865505,  romolie, 1, 1, 0, yes
520404945,  AngeloAmmendola, 12, 11, 1, yes
2256723448,  SocciGianluca, 22, 10, 12, no
2288451561,  rpepe89, 1, 1, 0, yes
796321293452898304,  marepratokc264w, 15, 7, 8, no
962989620,  Silvestro52, 4, 2, 2, neutral
2173032754,  scetata, 4, 4, 0, yes
881890537,  Lucanene89, 4, 2, 2, neutral
253289367,  PietroLegnani, 19, 11, 8, yes
543650888,  andy72pd, 2, 2, 0, yes
1019814889,  susanna_barina, 10, 8, 2, yes
1066757623,  tommituit, 2, 2, 0, yes
709302944,  EAgrimi, 1, 1, 0, yes
460196865,  petrignanis, 5, 5, 0, yes
3178037561,  Rss1971M, 1, 1, 0, yes
472542406,  amico_blog, 3, 2, 1, yes
989340356,  teoago72, 25, 7, 18, no
142431133,  ClaudioVigolo, 3, 3, 0, yes
2532582778,  emanueleerba74, 1, 1, 0, yes
1581104934,  kikileo72, 2, 2, 0, yes
1597917860,  SpintaDalBass, 5, 4, 1, yes
1361634884,  trendinaliaIT, 15, 4, 11, no
1913370296,  trendinalios, 8, 2, 6, no
622842157,  ElvioBertoletti, 1, 1, 0, yes
922796137,  mrblonde93, 3, 3, 0, yes
2342856875,  simo2791, 53, 4, 49, no
474688076,  VeliaMLapadula, 6, 6, 0, yes
232625504,  TWENTYREX, 3, 1, 2, no
298588711,  AlexGiack, 3, 1, 2, no
1226128195,  antonio_miazzo, 6, 5, 1, yes
421822495,  FlaviaTamborini, 1, 1, 0, yes
614654143,  crystal46ryan, 1, 1, 0, yes
1300290379,  colomauro, 2, 1, 1, neutral
588431132,  FraMaFusco, 1, 1, 0, yes
1937318108,  adriano_spada, 1, 1, 0, yes
802633773036797952,  iambarnaba, 1, 1, 0, yes
589938233,  MasssimoDiPietr, 1, 1, 0, yes
1712653148,  FFiordispini, 3, 3, 0, yes
351760968,  PaoloZanetto, 3, 3, 0, yes
843617216,  Giovannagalli4, 1, 1, 0, yes
2945972459,  BennyDelmastro, 2, 2, 0, yes
3431703052,  liviomarsico, 2, 2, 0, yes
3402774227,  GioDonati99, 12, 12, 0, yes
3986253868,  prendiposizione, 5, 5, 0, yes
1560410052,  easyJetItalia, 3, 3, 0, yes
2841380837,  valepetrucci, 3, 2, 1, yes
471922221,  fraspo89, 1, 1, 0, yes
3130775135,  giuselli1389, 4, 4, 0, yes
22073087,  albertomaio, 2, 2, 0, yes
1126411814,  FrancoBassanini, 5, 5, 0, yes
498878932,  Ally_starlight, 13, 13, 0, yes
418623470,  aronafederica, 1, 1, 0, yes
509098508,  rfumagalli2, 2, 2, 0, yes
428068433,  alfredospara, 1, 1, 0, yes
2393979222,  net_carloni, 7, 4, 3, yes
1343245195,  villaalbe, 4, 4, 0, yes
2438776736,  VEL0Love, 4, 3, 1, yes
2243958403,  Info_Ricambi, 1, 1, 0, yes
1342114820,  Legambici, 3, 2, 1, yes
1262560531,  mobilitanuova, 3, 2, 1, yes
547520336,  fioreabc, 4, 3, 1, yes
4846038599,  TgrBasilicata, 1, 1, 0, yes
263125418,  Giov_nuccio, 5, 5, 0, yes
783005159232241664,  EnergybyOSCAR, 1, 1, 0, yes
3339012755,  vince1_5, 1, 1, 0, yes
3191859046,  Pier_Spadone, 1, 1, 0, yes
317413018,  Mario_Mantovani, 5, 5, 0, yes
463489461,  damiano77a, 2, 2, 0, yes
410719288,  limecb, 11, 11, 0, yes
2314342300,  eva1967cb, 6, 3, 3, neutral
802800142571237376,  cromaapapa, 1, 1, 0, yes
2209486779,  niccolopoletto, 27, 17, 10, yes
81230367,  radioalfa, 1, 1, 0, yes
1128044090,  _fdm1, 26, 12, 14, no
2369954001,  mfilpa, 2, 2, 0, yes
1643542148,  pino_scali, 2, 1, 1, neutral
742317666015285249,  GiuliaBarbati1, 1, 1, 0, yes
744598818365255681,  lafaremopassare, 14, 6, 8, no
487564934,  Menna_Andrea, 9, 2, 7, no
1022698446,  tony70bri, 1, 1, 0, yes
895560445,  camurril, 1, 1, 0, yes
2448581509,  dstew3704, 2, 2, 0, yes
2480796040,  Plazaj97, 1, 1, 0, yes
2276701689,  ettoreramb, 16, 16, 0, yes
1019758290,  LGSalvatore, 6, 1, 5, no
708278449270628352,  elebikerome, 1, 1, 0, yes
712622569996886016,  villa__v, 2, 2, 0, yes
96364334,  michele_rillo, 1, 1, 0, yes
961773410,  MarcoPizzi14, 4, 4, 0, yes
1260838507,  DelcietT, 1, 1, 0, yes
454706789,  leaf_0, 2, 2, 0, yes
803502325029605376,  Plinius80, 15, 9, 6, yes
764870336894603264,  Larchpresident, 16, 9, 7, yes
2477274604,  Autumn__Magalla, 1, 1, 0, yes
528880530,  RIkTempesti, 7, 6, 1, yes
716593256499453953,  AFiorenza54, 1, 1, 0, yes
520562780,  AndroFra, 1, 1, 0, yes
301283324,  71locatelli, 2, 2, 0, yes
185274610,  pierandrea1965, 18, 8, 10, no
460507111,  MBorcio, 77, 73, 4, yes
146545986,  carmelo_pnt, 2, 2, 0, yes
532245930,  AnnachiaraStef, 1, 1, 0, yes
735374918892806145,  Redantw, 3, 1, 2, no
4222479693,  AlfredSerle0, 8, 5, 3, yes
709468465531322370,  FrancescalGin, 62, 30, 32, no
420437976,  espositoluci, 5, 5, 0, yes
76893624,  renatosartini, 4, 4, 0, yes
1282562017,  DeGedepas, 3, 3, 0, yes
991342170,  OMadonia, 4, 3, 1, yes
523331583,  MikyPaola, 25, 19, 6, yes
2469186961,  Moneta_Sovrana_, 75, 26, 49, no
2995540995,  Adriano_Gir, 15, 11, 4, yes
725664950,  LaTorreNormanna, 7, 3, 4, no
483198813,  angydist, 15, 13, 2, yes
3018518855,  rosagiuby, 4, 3, 1, yes
3399214563,  smiliziano, 6, 6, 0, yes
522195863,  MimmoBruni, 16, 2, 14, no
238718282,  clifflorenz, 43, 26, 17, yes
46791559,  ematum, 5, 3, 2, yes
1855275732,  TaptaClip, 13, 5, 8, no
763658919042551808,  CostantinoRover, 25, 23, 2, yes
1913933982,  geministe, 5, 4, 1, yes
1283811182,  BracaliM, 56, 4, 52, no
391486485,  guastoman, 15, 4, 11, no
803115076672700418,  salvatore1666, 499, 140, 359, no
971840395,  monicacongiu2, 10, 0, 10, no
15709507,  fighen, 2, 1, 1, neutral
129135649,  michelekaraboue, 17, 8, 9, no
773428955214995456,  8607_329, 10, 4, 6, no
800613462741110786,  FI_Spagna, 11, 2, 9, no
702614277472034818,  rosydandrea1, 22, 6, 16, no
1090249998,  mrecchia70, 99, 44, 55, no
796334964342194178,  Italiabrucia, 140, 68, 72, no
3107458432,  Carla51C, 22, 5, 17, no
2842468841,  flyingfuck, 7, 3, 4, no
33223473,  Blowersdaughter, 3, 3, 0, yes
592688115,  gia161170, 27, 9, 18, no
2958168039,  sacchiflavio, 25, 14, 11, yes
1039694618,  enrymi, 2, 2, 0, yes
731093380151803904,  Ale_giannini61, 4, 3, 1, yes
287851930,  antonioclli, 7, 7, 0, yes
799248233981759488,  MirkoPiccinini2, 22, 8, 14, no
233489435,  CogoniDaniele, 9, 5, 4, yes
51849223,  antomaranga, 3, 3, 0, yes
2291700139,  Berlusconia9, 46, 15, 31, no
504661653,  LauraPuppato, 9, 5, 4, yes
2935393875,  LISibariPollino, 1, 1, 0, yes
614694618,  marcati_piero, 13, 13, 0, yes
1236592296,  FabriFitzgerald, 3, 2, 1, yes
94082890,  ghirardinicola, 1, 1, 0, yes
42662635,  LucioLuci, 5, 5, 0, yes
976652664,  GiaSilvestrini, 6, 5, 1, yes
1012989822,  MarinaGalluzzo, 2, 2, 0, yes
720335994449457152,  SandroS96, 15, 11, 4, yes
62300002,  Zio_Tom, 3, 1, 2, no
624096392,  gpazzaglia71, 25, 21, 4, yes
474274879,  MagrettiMarco, 2, 2, 0, yes
258562609,  orfeobossini, 14, 2, 12, no
7799352,  Minerva84, 4, 3, 1, yes
1470343742,  patpiergentili, 20, 20, 0, yes
1638143131,  CorrPetrocelli, 19, 2, 17, no
83449728,  marcocobianchi, 22, 22, 0, yes
390949967,  PaolaLoCascio, 1, 1, 0, yes
2219829524,  parmadem, 1, 1, 0, yes
499813451,  GianluSaccomani, 14, 12, 2, yes
267335558,  gabpojer, 19, 8, 11, no
427657093,  andrea_bellino, 5, 5, 0, yes
78553388,  zingaros76, 15, 15, 0, yes
3433647837,  FortitudeMP, 1, 1, 0, yes
14788200,  demartin, 2, 1, 1, neutral
2410604455,  francesco_rand1, 6, 1, 5, no
1667977860,  AndreaBonaveri, 5, 5, 0, yes
1069272026,  FranceskoFloris, 2, 1, 1, neutral
1066067515,  ferdinandocorte, 1, 1, 0, yes
2355246666,  Eleda59, 3, 3, 0, yes
753838071875981312,  martin_eden1980, 7, 7, 0, yes
3873606135,  MadeinJapan2015, 3, 1, 2, no
624900435,  gepporuggeri, 3, 3, 0, yes
253728666,  grandesse, 5, 2, 3, no
2258870403,  BignamiBignami, 10, 8, 2, yes
575630070,  matbroso, 3, 3, 0, yes
2369514974,  ascenzapisoni, 15, 14, 1, yes
1407748796,  necro_tweet, 3, 2, 1, yes
1334417106,  CiancioFilace, 14, 14, 0, yes
906475094,  clodici1, 4, 4, 0, yes
433812103,  fuochi_fatui, 1, 1, 0, yes
214892045,  jamesluis87, 4, 1, 3, no
312644183,  LucaCominassi, 5, 5, 0, yes
395849453,  IcoFrancavilla, 2, 2, 0, yes
1386296514,  ocsecnarf1, 4, 4, 0, yes
510738833,  Carpinone74, 8, 7, 1, yes
551300107,  Gregscaffardi, 2, 2, 0, yes
54918199,  larrywashjet, 2, 2, 0, yes
22043779,  emanuelearmeni, 4, 4, 0, yes
2817271640,  anto6627, 2, 2, 0, yes
45401932,  Ida_Leone, 2, 2, 0, yes
3065332473,  a10449014, 1, 1, 0, yes
527503039,  al_pellegrino, 2, 2, 0, yes
737028317002539009,  AngGiord, 1, 1, 0, yes
2221045375,  MagliePD, 2, 2, 0, yes
120831721,  Davidec1977, 1, 1, 0, yes
336584606,  MonastraA, 1, 1, 0, yes
524597055,  hagakure_jfp, 16, 10, 6, yes
1961251566,  FiDMontebelluna, 8, 6, 2, yes
950513972,  beolo66, 11, 11, 0, yes
546956225,  EsterPerifano, 22, 22, 0, yes
438210358,  rossidoria, 1, 1, 0, yes
2351364017,  alex_urbinati, 11, 10, 1, yes
22674272,  Lippa64, 6, 2, 4, no
1191157380,  SimoneBucaioni, 4, 3, 1, yes
407000028,  angelovo1, 5, 4, 1, yes
798197702,  amerigo1966, 1, 1, 0, yes
131572341,  Eviandare, 2, 1, 1, neutral
977867604,  taripa30, 3, 2, 1, yes
382569653,  mariastefaniama, 2, 2, 0, yes
40198677,  Perelaa, 1, 1, 0, yes
370639956,  PillaPaladini, 76, 51, 25, yes
16324030,  cormarch, 1, 1, 0, yes
1063745202,  wilmascampini, 5, 3, 2, yes
1975163550,  BarbieriMarco3, 12, 11, 1, yes
1949663004,  _Napolitano_, 4, 3, 1, yes
410810169,  CarmineOrazzo, 16, 13, 3, yes
118417856,  micaecilia, 1, 1, 0, yes
1272617672,  marcofra63, 1, 1, 0, yes
150363160,  tabu12, 1, 1, 0, yes
488864211,  fabioquatraro_, 1, 1, 0, yes
313461907,  danipolverini, 1, 1, 0, yes
200932330,  fdellacava, 8, 5, 3, yes
553595607,  Frallalleru, 1, 1, 0, yes
1028662526,  fillypollinzi, 219, 12, 207, no
1562681005,  FabrizioTesseri, 3, 3, 0, yes
2310410500,  rosaeglantyne, 11, 10, 1, yes
469270228,  _TheRatRace_, 4, 4, 0, yes
982860596,  francicannata, 1, 1, 0, yes
874348255,  lucianotw20, 6, 6, 0, yes
1251213175,  armandazzo, 3, 2, 1, yes
527445407,  gfrancomilani, 1, 1, 0, yes
565475307,  RobertoSerpieri, 10, 5, 5, neutral
4256781189,  ITINERARIARural, 1, 1, 0, yes
4220172382,  GraziaC5, 23, 23, 0, yes
973589256,  AleDilaghi, 2, 2, 0, yes
416975680,  Saruzzella, 1, 1, 0, yes
1209220231,  VittoriaInfo, 1, 1, 0, yes
416825993,  Trelune, 8, 6, 2, yes
493947848,  martafana, 6, 6, 0, yes
382590107,  alessandropazza, 11, 11, 0, yes
124836934,  albertomarti, 5, 3, 2, yes
68631041,  Raffael_Mandis, 3, 1, 2, no
1318656132,  carlo_spreafico, 1, 1, 0, yes
792512449845092352,  62Annamacaluso, 1, 1, 0, yes
2305217011,  JacopoBencini, 1, 1, 0, yes
114254592,  sergiofrigo, 2, 2, 0, yes
2333218958,  petrellismo, 6, 6, 0, yes
443464237,  GiorgioPugliese, 1, 1, 0, yes
2392982702,  marypat1949, 3, 2, 1, yes
1234825501,  gricalc, 7, 4, 3, yes
1296820435,  giac61cris, 2, 2, 0, yes
12041042,  roxelloo, 6, 5, 1, yes
456698668,  PietroGhio, 1, 1, 0, yes
1270403142,  maumal69, 8, 7, 1, yes
2555751045,  DidoMonica, 11, 10, 1, yes
539466892,  fmlabate, 1, 1, 0, yes
1006162669,  DomizianaGiorg1, 1, 1, 0, yes
302474022,  DavideDila, 1, 1, 0, yes
453048017,  graziafagnani, 1, 1, 0, yes
369400663,  SalernoSal, 1, 1, 0, yes
294819169,  asaggioro, 1, 1, 0, yes
847193448,  Annaemmebi, 1, 1, 0, yes
154890155,  GiacomoGuido, 1, 1, 0, yes
408704922,  ValeriaColibri, 13, 6, 7, no
243580454,  CriCan80, 1, 1, 0, yes
258953511,  Francesca_DP75, 1, 1, 0, yes
498316348,  LauraCapelli3, 1, 1, 0, yes
134799784,  ancientrose, 1, 1, 0, yes
255054094,  dicofilo, 1, 1, 0, yes
3143511939,  brandoandry, 5, 4, 1, yes
472920798,  paolamasi1, 1, 1, 0, yes
1053096115,  angeladileo2013, 6, 6, 0, yes
416524255,  CleoLiCalzi, 2, 2, 0, yes
2873213276,  gioroman_romano, 1, 1, 0, yes
198606842,  angelagalasso, 9, 9, 0, yes
28433379,  Il_Vitruviano, 39, 31, 8, yes
515380651,  GiovaValentini, 6, 4, 2, yes
463841107,  CltOff, 17, 13, 4, yes
2338806398,  burattino14, 30, 24, 6, yes
4328992043,  dbgiovanna, 2, 2, 0, yes
358629847,  s_baldolini, 2, 2, 0, yes
416165363,  kryptondaddy, 58, 40, 18, yes
2589503250,  KamikazenRoma, 12, 1, 11, no
970095434,  DiElleTi, 35, 32, 3, yes
955750106,  Giancar36923409, 31, 30, 1, yes
451525866,  GregoriRita, 2, 2, 0, yes
106366981,  tweetelex, 6, 6, 0, yes
9804322,  mauroferri, 1, 1, 0, yes
800370605572820992,  EsinoCdf, 1, 1, 0, yes
534826529,  giovannidalloli, 7, 7, 0, yes
64192042,  luigireggi, 1, 1, 0, yes
35701966,  Eugenia_65, 1, 1, 0, yes
703338796826365952,  Carlo314159, 4, 3, 1, yes
435329079,  robysanna1, 4, 3, 1, yes
1006641553,  gercardillo, 2, 2, 0, yes
401680400,  MonicaSarra, 9, 8, 1, yes
2360804515,  MontagnaUncem, 1, 1, 0, yes
46626285,  Editormanque, 2, 2, 0, yes
486457867,  FonderiaMercury, 2, 2, 0, yes
1346390533,  ContrattodiFOCE, 5, 5, 0, yes
439885110,  DomenicoLiotto, 1, 1, 0, yes
1254077960,  beppefranzini, 3, 2, 1, yes
498658028,  iosheva, 4, 4, 0, yes
189853406,  maxim691, 2, 2, 0, yes
2365824275,  silviakille, 1, 1, 0, yes
205276406,  21lettere, 10, 2, 8, no
1230607256,  antoniorizzo61, 1, 1, 0, yes
992686250,  MariaStellabra, 3, 3, 0, yes
61081513,  alexdelprete, 37, 26, 11, yes
365375902,  ValerioCalvelli, 4, 2, 2, neutral
202675420,  davideracconta, 8, 2, 6, no
2263697361,  s_petecchia, 1, 1, 0, yes
551374959,  MartaEcca, 18, 7, 11, no
13382082,  hyperbros, 33, 22, 11, yes
517708388,  ECalvitti, 1, 1, 0, yes
17118582,  giannico, 2, 2, 0, yes
2886230794,  enricoferri614, 2, 2, 0, yes
1084044583,  BiagioSimonett2, 5, 5, 0, yes
1236619230,  Marcy58Coresi, 1, 1, 0, yes
1389351938,  mcattur, 1, 1, 0, yes
2373222249,  GiampaoloBaldi, 41, 8, 33, no
110421890,  _SiD___, 1, 1, 0, yes
4900814871,  adf_amedeo, 4, 4, 0, yes
45094324,  MarcoDePonte, 7, 6, 1, yes
1257538070,  carlo_bertelli, 2, 2, 0, yes
1140048444,  pupiforever72, 1, 1, 0, yes
825307926,  aldo_gatti, 1, 1, 0, yes
494360036,  missgibbi, 3, 2, 1, yes
1047094759,  MassimoAragona, 3, 3, 0, yes
1491470516,  chojin00, 12, 6, 6, neutral
1665027356,  GP_ArieteRosso, 4, 4, 0, yes
383436876,  mariocoi, 1, 1, 0, yes
2958805145,  carlo_mari1, 1, 1, 0, yes
3291022076,  assipuleo, 1, 1, 0, yes
537284474,  GianGranero, 1, 1, 0, yes
255583705,  LegacoopLiguria, 1, 1, 0, yes
709437969241866240,  Giuseppinamum11, 4, 4, 0, yes
893923597,  mini_andrea93, 3, 3, 0, yes
1285333410,  PontiBenedetto, 8, 7, 1, yes
67423279,  giorgia_titti, 3, 3, 0, yes
386987725,  laura_iskra72, 3, 3, 0, yes
75502517,  marioliso, 1, 1, 0, yes
1201745270,  Pinella_pdg, 1, 1, 0, yes
1280187702,  spree_prof, 3, 1, 2, no
512360124,  salvolamacchia, 3, 3, 0, yes
424241865,  MichailBulgakov, 20, 10, 10, neutral
970577154,  GennaroF74, 5, 1, 4, no
2242479691,  Ferranti78, 3, 3, 0, yes
2982582215,  abbattilo, 1, 1, 0, yes
3001964055,  salutavosempre, 11, 6, 5, yes
447370939,  mar__bru, 5, 4, 1, yes
342569184,  ManuelaCroatto, 19, 15, 4, yes
967653985,  mc7528, 3, 3, 0, yes
455127016,  antonellamarsal, 1, 1, 0, yes
1924664406,  GraziaGiannetti, 1, 1, 0, yes
3328297725,  SalottiMirko, 1, 1, 0, yes
201654791,  JosephFranz, 10, 2, 8, no
305476350,  __dummy, 4, 3, 1, yes
2939747495,  GioMas77, 3, 2, 1, yes
402253156,  SimTulum, 15, 12, 3, yes
356203219,  paopratico, 1, 1, 0, yes
438353555,  AdolfoRossi1, 1, 1, 0, yes
2884242309,  navigatrum, 8, 4, 4, neutral
1180449408,  DOnofrioGiusepp, 1, 1, 0, yes
491212220,  venegunden, 3, 2, 1, yes
3021734555,  giovicenturione, 2, 1, 1, neutral
325433879,  GCDeFiorenze, 1, 1, 0, yes
310792458,  ANITACAROLI1, 1, 1, 0, yes
14273660,  seneghe, 4, 4, 0, yes
1311736615,  americancarpy, 21, 16, 5, yes
588426612,  P_Bellini, 12, 9, 3, yes
1013925972,  AlfieroBagnesi, 8, 6, 2, yes
404961989,  FrancescoPonzin, 14, 12, 2, yes
732566732,  MassimoMarra2, 14, 14, 0, yes
358013349,  Sandr_1776, 2, 2, 0, yes
84824255,  Lux72, 1, 1, 0, yes
484947954,  carlo_magnani, 7, 5, 2, yes
569680694,  SimonaSelene, 50, 24, 26, no
406917194,  RBrezza, 5, 5, 0, yes
1586159210,  SirWilliamBl, 28, 9, 19, no
401280955,  70RoK, 2, 2, 0, yes
365110885,  MauBurlando, 1, 1, 0, yes
138044681,  Rainbow_Uapa, 5, 4, 1, yes
1382601224,  mazzeo_m, 1, 1, 0, yes
3034280366,  gambettino, 11, 6, 5, yes
796804571125469184,  sXm_Municipio2, 1, 1, 0, yes
389582647,  ritacastellani, 1, 1, 0, yes
59560776,  barbaracadeddu, 1, 1, 0, yes
1186365476,  dino_mad, 1, 1, 0, yes
3431969470,  adgiornalaio, 4, 3, 1, yes
1009689127,  stefanscauzilli, 73, 47, 26, yes
2841136744,  SimonaArletti, 4, 4, 0, yes
621038509,  miloxandreax, 11, 5, 6, no
48303285,  carms1984, 1, 1, 0, yes
211090466,  simonegenius, 1, 1, 0, yes
978277717,  domenicoarbues, 1, 1, 0, yes
1363855172,  vaniaped, 31, 23, 8, yes
232020769,  PaginaNuovaTV, 2, 2, 0, yes
226627338,  lprestia, 53, 46, 7, yes
252255936,  pruckler, 13, 11, 2, yes
18108933,  PaginaNuova, 2, 2, 0, yes
339161564,  themaninhavana, 7, 7, 0, yes
445817762,  RobiDiMa, 9, 9, 0, yes
322163202,  carla111148, 1, 1, 0, yes
1025143716,  etventadv, 44, 22, 22, neutral
11080682,  madez, 14, 2, 12, no
52022562,  gwdavide, 1, 1, 0, yes
480663852,  fedejohnbaldo, 2, 2, 0, yes
1002351,  AlbertoNardelli, 3, 2, 1, yes
129471858,  andy_reds, 4, 3, 1, yes
726546977853444097,  pasquillace, 1, 1, 0, yes
1223031440,  UnipaVM, 4, 3, 1, yes
2205027585,  Siqqua, 3, 3, 0, yes
767034005795508224,  sorpacinotto, 1, 1, 0, yes
484283282,  claudiafusani, 3, 2, 1, yes
52038043,  fRa_gAv, 2, 2, 0, yes
940778610,  toniballarini, 1, 1, 0, yes
810651440,  a_silves, 1, 1, 0, yes
2965116405,  ManuelLieta, 2, 1, 1, neutral
1247360977,  andvaccaro, 8, 8, 0, yes
4893192004,  SiAiVitalizi, 3, 1, 2, no
477835402,  guidobuzzati, 3, 3, 0, yes
1015790436,  berardi_c, 1, 1, 0, yes
391237371,  demofiliaco, 14, 5, 9, no
515619608,  eleonora_sira, 1, 1, 0, yes
132326725,  Armgiordano, 1, 1, 0, yes
574021716,  pat67195138, 1, 1, 0, yes
1106530849,  PSTachella, 8, 8, 0, yes
1704862878,  ClaudiaClalenz, 3, 3, 0, yes
165325349,  tegustal, 3, 2, 1, yes
52073856,  lacarlizz, 1, 1, 0, yes
511750340,  AndreaZeoli, 7, 5, 2, yes
972582380,  john_it_, 20, 7, 13, no
1327333460,  marini_valerio, 4, 4, 0, yes
306433583,  andysalvatori, 3, 1, 2, no
801895595237670912,  carlodesdorides, 1, 1, 0, yes
1372852370,  Gimes01, 2, 2, 0, yes
804425424969367552,  scalfi_nico, 2, 2, 0, yes
27199106,  VincenzoNovari, 6, 6, 0, yes
565382686,  Fulvio0312, 3, 3, 0, yes
585538460,  napelli, 1, 1, 0, yes
946249914,  bianchi_ennio, 42, 18, 24, no
2874818752,  AliceDeAmbrogi, 2, 2, 0, yes
1563173221,  fradelliq, 3, 2, 1, yes
488782758,  passeroinquieto, 1, 1, 0, yes
466378912,  antonellocapor2, 3, 3, 0, yes
2979821813,  gandolfi_luigi, 1, 1, 0, yes
1219331695,  Ste_Mal_11, 2, 2, 0, yes
17496032,  cbaffe, 2, 2, 0, yes
427568761,  simonetta_bisi, 1, 1, 0, yes
539942362,  fangiovanna, 19, 9, 10, no
1333341758,  TittiGiorgi, 4, 3, 1, yes
468585900,  allegra134, 7, 7, 0, yes
1066733142,  GiodiLembo, 1, 1, 0, yes
750645206224076801,  drangelocapone, 4, 4, 0, yes
1084399818,  GiovanniPrearo, 2, 1, 1, neutral
2229154276,  SimonettaAli, 3, 3, 0, yes
102488547,  dipego, 6, 4, 2, yes
1377932563,  PepePeposky, 6, 3, 3, neutral
490606378,  billotwit, 1, 1, 0, yes
2403957681,  Alce1954Z, 3, 1, 2, no
468628926,  jaissdelraiss, 1, 1, 0, yes
968087256,  patriziagirotti, 1, 1, 0, yes
480242083,  ZoffoliClaudio, 1, 1, 0, yes
109940040,  gcarapella, 4, 4, 0, yes
420427133,  diodatopirone, 1, 1, 0, yes
479898364,  cian_1706, 1, 1, 0, yes
44847173,  buforoby, 2, 1, 1, neutral
587577342,  FrKt41, 1, 1, 0, yes
218657372,  iosonoleo, 1, 1, 0, yes
598457898,  Lentaconbrio, 17, 12, 5, yes
805801467802226689,  niccolo_polo1, 2, 1, 1, neutral
539157045,  stdara3, 45, 13, 32, no
738092501853216768,  danilosantini65, 32, 9, 23, no
493657627,  gmarkou2011, 2, 2, 0, yes
729277064147275776,  daniela10492, 73, 72, 1, yes
1380350532,  S4raM1, 20, 20, 0, yes
740204367400337408,  Donatel52378513, 314, 312, 2, yes
788797759965032448,  Antonio44474949, 29, 29, 0, yes
972804156,  RutaSilvia, 26, 25, 1, yes
709479074029240320,  nellyfronterre, 91, 90, 1, yes
788368573471293445,  Simona85319863, 236, 236, 0, yes
790264879735304193,  lisa23377, 102, 102, 0, yes
729775229598351361,  morelloangela77, 203, 202, 1, yes
753706268024565760,  Antonel90455295, 212, 212, 0, yes
788859641082089473,  scaliatonino, 215, 214, 1, yes
788796021153337344,  DelfaAntonella, 36, 36, 0, yes
788472720036073472,  AntonellaDelfa, 102, 102, 0, yes
458624906,  GiaFontanarosa, 51, 50, 1, yes
724245672434765825,  gisellagraci1, 63, 62, 1, yes
788617257404497924,  donabasile, 97, 96, 1, yes
786545828299173888,  mariagreco74, 44, 43, 1, yes
788474103334338560,  maria_depl, 30, 29, 1, yes
789480289944866817,  demysaso, 31, 31, 0, yes
517986135,  paoolo706, 413, 412, 1, yes
788875940575215620,  AneisFar, 67, 66, 1, yes
1721405378,  MaggioreEnza, 29, 29, 0, yes
724811216183562240,  claudiasciolti, 35, 34, 1, yes
797805423122350081,  TizianaSoraci, 122, 121, 1, yes
780828728230195200,  PaolaDeMasi5, 72, 71, 1, yes
790625241856937984,  MariaGrazBonvi1, 87, 86, 1, yes
711672840559464448,  elisa_776, 174, 174, 0, yes
788675050992009216,  lucianagamb1981, 240, 240, 0, yes
725051865159884802,  caterina1510, 144, 143, 1, yes
735175269695115266,  PatriziaPeda, 197, 197, 0, yes
728166959427268608,  Uldericosix, 43, 42, 1, yes
735201639674454016,  e_tirino, 37, 36, 1, yes
705101567838588931,  MariaMaione3, 34, 34, 0, yes
788472799803367428,  nadianicoletti_, 101, 101, 0, yes
715960962159931392,  arianna776, 78, 78, 0, yes
426598968,  RobertaCutrona, 38, 37, 1, yes
799653873338224640,  antonio120962, 74, 74, 0, yes
801009914546188288,  rostellina87, 67, 59, 8, yes
192688721,  giulicast, 1, 1, 0, yes
9055772,  buzzico, 17, 16, 1, yes
2364107448,  MauroPeddis, 34, 17, 17, neutral
3971136089,  matteo1770, 2, 2, 0, yes
117853133,  vitore54, 4, 4, 0, yes
783346443138502657,  edutoma48, 4, 2, 2, neutral
53341481,  FedericoCerra, 2, 1, 1, neutral
2776509252,  ForzaCerea, 4, 0, 4, no
723843735482720256,  MarcoCattoni, 16, 0, 16, no
406980942,  AngelaniDoriano, 23, 13, 10, yes
2478734790,  EUPEACEPARTY, 7, 7, 0, yes
1351360772,  SpideyPeter1, 8, 8, 0, yes
865163786,  d_carella, 35, 35, 0, yes
3927085403,  alextala72, 2, 2, 0, yes
763479233146580993,  Angelida10, 2, 1, 1, neutral
421839918,  francescodelu11, 27, 24, 3, yes
738047163633139712,  Mary32483855, 1, 1, 0, yes
140810792,  AndreaNickBosio, 15, 12, 3, yes
11064442,  killermedia, 2, 2, 0, yes
2973535553,  giuliafestuccia, 4, 4, 0, yes
4840451669,  LocatelliCrys, 4, 4, 0, yes
1114098782,  paolocristallo, 35, 6, 29, no
117754821,  iavvocato, 2, 2, 0, yes
2388500216,  CampaniaStartUp, 1, 1, 0, yes
618787400,  ashofslght, 1, 1, 0, yes
2333470118,  NAStartUp, 1, 1, 0, yes
559029876,  clacesarano, 1, 1, 0, yes
323818704,  MSpacagna, 1, 1, 0, yes
768899789136072704,  gianrobertomag, 3, 1, 2, no
761971314781487105,  Stocazz61709837, 30, 7, 23, no
4054106297,  pgreco72, 18, 17, 1, yes
885170298,  GraziaGiosa, 2, 2, 0, yes
2451076081,  BenedettaBerna3, 2, 2, 0, yes
587808438,  ChiaraGuillaro, 3, 3, 0, yes
286608996,  MiminoRICCIARDI, 11, 11, 0, yes
3413211538,  EnzoVmattina, 2, 2, 0, yes
586620795,  PIETROSCARTEZZI, 20, 7, 13, no
464835038,  RoccoPanettaIT, 8, 6, 2, yes
387128059,  emazzoldi, 4, 4, 0, yes
265557908,  camigila, 2, 2, 0, yes
719817768690786304,  pinina3946, 5, 5, 0, yes
19287037,  TheProgressives, 5, 5, 0, yes
3824253808,  UTuttlies, 4, 4, 0, yes
622389282,  francygiri, 2, 2, 0, yes
276547520,  monteroraya, 2, 2, 0, yes
586387991,  ROCCOLICASTRO, 4, 3, 1, yes
1058355732,  GiovaDes, 14, 14, 0, yes
805086967742525440,  RosyBroccio, 3, 3, 0, yes
4159734094,  NapolitanoElia, 3, 3, 0, yes
144213581,  carloscatozza, 7, 7, 0, yes
363067985,  antoniosalice, 3, 3, 0, yes
113981849,  guglielmoenrico, 5, 1, 4, no
1635242966,  PucaStefano, 8, 2, 6, no
374178936,  iarots, 6, 4, 2, yes
2823910739,  PirandellaG, 9, 7, 2, yes
719190663502426112,  RAFFAEL07976412, 9, 2, 7, no
2450147531,  BettoGigliola, 58, 27, 31, no
1053176233,  albertamanzoni, 15, 3, 12, no
430092847,  atominobipbip, 6, 1, 5, no
2517110586,  tommi_cardini, 17, 16, 1, yes
2675073532,  blankaut, 22, 11, 11, neutral
843223866,  ColombaLuigi, 5, 1, 4, no
2405837416,  nieddupierpaolo, 20, 10, 10, neutral
3970231937,  ettore_falcini, 2, 1, 1, neutral
852301178,  caragli1, 42, 23, 19, yes
1958640014,  SandriAl18, 16, 13, 3, yes
554257940,  PeppeBrasa, 4, 1, 3, no
3319406075,  cappellodibarba, 3, 0, 3, no
392217780,  antoniosti, 5, 1, 4, no
1063955917,  Tshovel_, 73, 20, 53, no
14420623,  donatotesta, 12, 6, 6, neutral
451610877,  calicetig, 32, 25, 7, yes
493025647,  fabiorampelli, 15, 1, 14, no
380243566,  sabrinafantauzz, 18, 1, 17, no
1552494224,  FraBen80, 4, 0, 4, no
2329178833,  romana1110, 4, 4, 0, yes
1015440260,  carutig, 23, 18, 5, yes
1422764864,  renzocrosa, 3, 2, 1, yes
11258252,  ldibartolomei, 4, 4, 0, yes
1014870637,  renatastortini, 83, 24, 59, no
455859309,  gorgosprizza, 9, 4, 5, no
3385597569,  Lelejuve87, 14, 8, 6, yes
123374948,  sergiotambo, 4, 2, 2, neutral
2404216681,  cronistiinmovim, 2, 1, 1, neutral
1546005109,  29giugno77, 5, 1, 4, no
2260378864,  gabriellucky186, 9, 5, 4, yes
4016772868,  Francycassano2, 8, 4, 4, neutral
425296360,  steccoglu, 18, 10, 8, yes
527485570,  critofi, 3, 2, 1, yes
598242321,  simonatrombett1, 5, 4, 1, yes
749757178530164737,  ElyMagicamagica, 10, 4, 6, no
578236348,  LucaLevati1, 5, 4, 1, yes
429009401,  fulgebat_sol, 12, 7, 5, yes
2820455714,  Tiffany78Miss, 10, 2, 8, no
446415130,  GiovanniAttena, 6, 5, 1, yes
491375018,  antoniorecchiut, 3, 2, 1, yes
323737885,  FerGalanti, 6, 5, 1, yes
488966133,  Aleamatotim, 3, 2, 1, yes
803617893464215556,  Anonimous_999, 184, 91, 93, no
589407736,  Fidel_partizan, 35, 15, 20, no
4264298260,  ugas_fabrizio, 53, 27, 26, yes
3074122662,  jackcr70, 598, 303, 295, yes
497798126,  ronnyrossi2, 594, 301, 293, yes
3031672891,  l_cremona, 594, 301, 293, yes
2501851306,  CaspaniStefania, 368, 183, 185, no
769478656498466820,  mirtaromatp, 103, 52, 51, yes
2957157748,  FabioPiombo, 71, 38, 33, yes
4910051933,  alessia269111, 18, 10, 8, yes
991671421,  giornalisteTV, 4, 3, 1, yes
589261384,  marzia_notari, 21, 11, 10, yes
4897360193,  alessandro7177, 93, 48, 45, yes
371348246,  Lukebullo, 8, 5, 3, yes
711250614995558400,  John51019592, 597, 302, 295, yes
3061662743,  AntonNello1979, 7, 4, 3, yes
51510339,  fulvioabbate, 3, 2, 1, yes
3319210179,  friedgorgo, 4, 2, 2, neutral
4909671616,  uggNp6MXLo8Zedo, 6, 4, 2, yes
2197952929,  LaVerit7, 3, 2, 1, yes
595755590,  Galois73, 3, 2, 1, yes
245927595,  EFFEttoEFFE, 4, 3, 1, yes
1249222590,  ToniaCuomo, 4, 3, 1, yes
584739670,  Mariaritaleoni, 69, 52, 17, yes
368929485,  Rocco_Morgani, 5, 4, 1, yes
1666144496,  ConTeoSalvini, 93, 47, 46, yes
1231366670,  LucianoDAlessa6, 11, 5, 6, no
2482305961,  LisadaCa, 399, 201, 198, yes
792094850908839936,  JustDom27, 4, 3, 1, yes
804031502229110794,  GasparriPerson, 42, 7, 35, no
738095532166553604,  ermellino1806, 37, 18, 19, no
4459087695,  Salvato18946554, 75, 32, 43, no
259898941,  sBertoletti81, 6, 4, 2, yes
3169206307,  nelsongatto, 20, 17, 3, yes
722731347526201344,  Gianluca168, 14, 8, 6, yes
548457267,  RobertoPRATO3, 5, 3, 2, yes
558053080,  ConzDenis, 90, 43, 47, no
3338622107,  irascema75, 314, 153, 161, no
756726681122004992,  Marinel84683170, 19, 9, 10, no
740672271619084288,  Simone091299, 67, 34, 33, yes
303219287,  Mauri3575, 259, 132, 127, yes
2679377412,  gPublic31, 144, 51, 93, no
715624015,  PersonalChefCC, 139, 71, 68, yes
300505340,  andreassangalbi, 4, 3, 1, yes
629281834,  Messapia1, 13, 12, 1, yes
398595735,  mariocontetv, 10, 6, 4, yes
801700087525216256,  leghisti, 599, 303, 296, yes
776553725603307524,  Salvett85009943, 636, 322, 314, yes
716653596654313474,  despera55037058, 48, 25, 23, yes
4283645596,  Mauri0662, 8, 5, 3, yes
164780237,  IsmaeleRognoni, 574, 286, 288, no
439454528,  Unstoppable__94, 8, 5, 3, yes
794961451194712064,  GattusoAlberto, 109, 55, 54, yes
2716446892,  LGiambo, 298, 146, 152, no
791583592799404032,  VotaSalvini, 165, 82, 83, no
4200346649,  raffamurgo, 3, 2, 1, yes
4060369233,  Diego56605415, 268, 133, 135, no
555921843,  84Sandroneee, 5, 3, 2, yes
792329915228127232,  EsssE1976, 26, 18, 8, yes
2190915769,  RaoulPx, 308, 157, 151, yes
3448617916,  clau_perl, 417, 208, 209, no
51759517,  fdragoni, 10, 3, 7, no
427735067,  marco1sostegni, 5, 3, 2, yes
4047633629,  micsan61, 7, 6, 1, yes
1196616440,  Ema_Cosenza, 3, 2, 1, yes
2569037141,  marcodipaolo96, 5, 3, 2, yes
1140565105,  Gustavoben86, 10, 6, 4, yes
985259430,  LoredanaSensi, 9, 6, 3, yes
302516872,  rob93c, 3, 2, 1, yes
56326516,  secolourbano, 5, 4, 1, yes
148787137,  stagatocle, 33, 30, 3, yes
27855027,  nerosunero, 3, 2, 1, yes
44384123,  mattia823, 4, 3, 1, yes
1063032426,  RiccardoConsuma, 19, 10, 9, yes
3243464967,  Steu72, 3, 2, 1, yes
705939772007714816,  cvjhnsn, 9, 8, 1, yes
315847248,  VieriCapretta, 3, 2, 1, yes
473938490,  FraSchett, 20, 9, 11, no
708911881,  bi_esse_bi, 3, 2, 1, yes
863339647,  debmac1968, 17, 6, 11, no
1316131556,  russ_alexx, 5, 2, 3, no
485762114,  PoetaAbruzzese, 25, 17, 8, yes
48317081,  ilpinz, 4, 3, 1, yes
3079419837,  Willis18Pol, 3, 2, 1, yes
406177195,  oranges_oranges, 14, 10, 4, yes
84937377,  SabrinaAnte, 9, 6, 3, yes
592771212,  SoniaZeroli, 7, 3, 4, no
733320875156606976,  LadyCignala, 4, 3, 1, yes
2201928828,  SeNonPassa, 9, 6, 3, yes
2422907883,  rock_robb, 3, 2, 1, yes
803336895820341249,  IOVotoNoM5S, 16, 3, 13, no
754060203868426240,  leomasini83, 4, 3, 1, yes
582904239,  RobertoSteck, 9, 6, 3, yes
713021589886005248,  verde_stef, 7, 5, 2, yes
85318357,  andreacorno, 4, 2, 2, neutral
704594335317278720,  cappelli_fra, 27, 18, 9, yes
373878543,  Il_M3ri, 11, 8, 3, yes
700406264937971712,  matteo_gianne, 37, 20, 17, yes
2902922074,  onda07_elio, 101, 52, 49, yes
1149303008,  angelo_tino, 3, 2, 1, yes
2609688214,  mondolugosi, 14, 11, 3, yes
748815242835075073,  RiusoFondazione, 2, 2, 0, yes
600638391,  giorgio_ruffini, 12, 10, 2, yes
632115448,  RosaChiarini, 3, 3, 0, yes
2378868702,  IovotoPicchi, 16, 3, 13, no
985140906,  iostoconPicchi, 17, 3, 14, no
2394225674,  PisaconPicchi, 84, 7, 77, no
2448071614,  griottisilvana, 12, 4, 8, no
40851070,  ARNALDIFERO, 8, 1, 7, no
89212874,  CSilvagni, 95, 6, 89, no
778950791361167360,  marcello_747, 3, 1, 2, no
2337395271,  LZavater, 121, 84, 37, yes
717761771226968066,  MalefikoDentro, 50, 38, 12, yes
4866412145,  monicakalos, 13, 9, 4, yes
2876372645,  MuseoMontefalco, 1, 1, 0, yes
211061112,  tenshi355, 12, 3, 9, no
50265477,  desimonem, 5, 3, 2, yes
3018112143,  ItalyinARG, 1, 1, 0, yes
554237109,  CompGaribaldino, 1, 1, 0, yes
28333557,  tourismcafe, 1, 1, 0, yes
3004054431,  bussolacinema, 1, 1, 0, yes
3351211565,  gustabruzzo_it, 1, 1, 0, yes
784446493939884032,  fraGiuseppe_, 1, 1, 0, yes
109608945,  beltra72, 4, 4, 0, yes
759012860118786048,  AlbertoAperuz, 1, 1, 0, yes
480023608,  Antonellogiac, 5, 5, 0, yes
2425890542,  MemorialeGariba, 1, 1, 0, yes
122665594,  FrancoLaratta, 6, 6, 0, yes
1598750419,  Glover406P, 20, 5, 15, no
4076045092,  marinosebastia6, 4, 2, 2, neutral
393289136,  MarcoGalligher, 25, 5, 20, no
2305446516,  pesapesp, 7, 3, 4, no
2299916972,  igolmar, 18, 18, 0, yes
1245578418,  nuccioviscosi, 2, 1, 1, neutral
793079724088131584,  lupantre, 24, 16, 8, yes
2980016638,  coach557, 9, 8, 1, yes
304945509,  mediafinancial, 3, 2, 1, yes
412481648,  inarotondo, 3, 2, 1, yes
38398195,  gicvd, 20, 3, 17, no
1037543545,  Red19581966, 9, 3, 6, no
227391193,  curvaiolo, 1, 1, 0, yes
278915300,  valecastaldini, 13, 10, 3, yes
477809305,  GiovanniGiulia6, 1, 1, 0, yes
782574639704834048,  TriesteSIcambia, 6, 5, 1, yes
780826146883592192,  barbara_degani, 3, 3, 0, yes
1552786279,  carlo_scano, 8, 7, 1, yes
4881271245,  Sara42606433, 7, 3, 4, no
27448416,  ReginaCatrambon, 2, 2, 0, yes
3401651157,  TgrCalabria, 2, 2, 0, yes
481304796,  Lucia7910, 22, 21, 1, yes
484665449,  dario_nard, 25, 25, 0, yes
481355521,  liapollicino, 23, 23, 0, yes
2346899992,  giangilenza, 14, 12, 2, yes
802560596830986240,  TestardoSardo, 3, 3, 0, yes
3543674897,  AkyMela, 1, 1, 0, yes
1123116956,  fuser1979, 1, 1, 0, yes
176075973,  LucreziaChermaz, 31, 29, 2, yes
2388839437,  tintinatintina8, 1, 1, 0, yes
534964524,  SipalaS, 1, 1, 0, yes
898312652,  luigipa15, 3, 2, 1, yes
2355256140,  Alfonso0070, 10, 4, 6, no
1182937591,  m_melfi, 1, 1, 0, yes
2364355467,  giancarloiacomi, 2, 2, 0, yes
782360828,  marco0269, 3, 3, 0, yes
2396698549,  baazaouiabdella, 15, 15, 0, yes
779407172832821248,  Maverik10766, 7, 7, 0, yes
1601235282,  LucaTheFlight, 6, 4, 2, yes
1522374991,  63Rotcosimo, 1, 1, 0, yes
1068080984,  Mudovia, 2, 1, 1, neutral
2402143808,  PorcusMaSapiens, 5, 4, 1, yes
29199408,  AMarchettiT, 1, 1, 0, yes
805121880583766017,  Princypessa912, 21, 17, 4, yes
768898726895185920,  Francesco260669, 28, 9, 19, no
804364379701542913,  Giohrgiah, 2, 2, 0, yes
718527884055474176,  Fiorcatt, 6, 6, 0, yes
3130699919,  e91e545b6bfa47f, 6, 4, 2, yes
279171038,  AlSamengo, 8, 8, 0, yes
1076496552,  LuisaAntonini, 7, 7, 0, yes
901142910,  PascucciDavide, 2, 1, 1, neutral
743064037626417152,  SinaLuca85, 1, 1, 0, yes
367114874,  GiuseppeGaliero, 4, 4, 0, yes
4813403428,  albertocionco13, 1, 1, 0, yes
4889054428,  Marcus_DSM, 6, 5, 1, yes
491471672,  TizianadeFeo, 2, 2, 0, yes
2340110677,  acquodario, 44, 8, 36, no
757649527197339648,  gattoluo, 8, 8, 0, yes
768522633340223493,  SolomonKisskiss, 2, 2, 0, yes
803867606788743168,  RoccoSansonetti, 8, 4, 4, neutral
58052287,  SteMariotto, 35, 18, 17, yes
1671155881,  FiorenzoMarzial, 12, 10, 2, yes
3758089649,  santarellimarco, 1, 1, 0, yes
408503503,  cristina_sanna, 2, 2, 0, yes
577337366,  lello2089, 9, 5, 4, yes
1511040457,  DILIRICAMBI, 1, 1, 0, yes
2834785259,  minocaciola, 2, 2, 0, yes
762189331062726656,  Giordan20402913, 1, 1, 0, yes
4735890017,  stefano_donne, 55, 34, 21, yes
2873630517,  pieropastis, 32, 24, 8, yes
18396815,  StefanoLaguzzi, 3, 3, 0, yes
431547715,  luisellacost, 1, 1, 0, yes
587537801,  rudymotors, 2, 1, 1, neutral
2497394346,  FrankyLas, 2, 2, 0, yes
429940243,  SarziAmade, 3, 3, 0, yes
432626793,  spiritudi, 3, 2, 1, yes
1137576668,  cocaermada, 1, 1, 0, yes
778708770545295361,  ernestoalfano90, 1, 1, 0, yes
4827636455,  Carolinamanfre6, 47, 21, 26, no
3102288245,  giors40, 12, 4, 8, no
1024748460,  sono_Sentenza, 1, 1, 0, yes
402963843,  fstevanon, 4, 4, 0, yes
1206011900,  73_dba, 4, 3, 1, yes
109082696,  lucabiondi90, 2, 2, 0, yes
145439895,  Lescavatore, 2, 2, 0, yes
97732629,  stefanocugini, 1, 1, 0, yes
430127505,  Cesare_Damiano, 1, 1, 0, yes
3381701969,  ilSicilia, 3, 2, 1, yes
104430215,  cuorenoir, 13, 7, 6, yes
2365603015,  orlandoterin, 3, 2, 1, yes
4921089406,  angela_garbini_, 1, 1, 0, yes
776733136881352705,  napolitano62, 1, 1, 0, yes
1067960048,  JaneDonnini, 1, 1, 0, yes
3541337895,  livadia1912, 9, 9, 0, yes
3199592356,  fabio_re85, 2, 2, 0, yes
497068404,  ChiaraPinnavaia, 1, 1, 0, yes
281547031,  nicolabranda, 2, 1, 1, neutral
754765457459146753,  delucadav, 8, 4, 4, neutral
2375471990,  bertocchifede, 4, 4, 0, yes
3004002945,  CarieriF, 2, 1, 1, neutral
3091025023,  daddario_paolo, 1, 1, 0, yes
706823258990055425,  ElisabettaPamp3, 10, 7, 3, yes
3067467537,  silvio230652, 10, 8, 2, yes
156239686,  Condizionata, 17, 12, 5, yes
417947467,  AndCappe, 86, 79, 7, yes
3120793481,  GianniSartor, 3, 1, 2, no
1623490123,  alexbrambi, 3, 2, 1, yes
114311004,  caliddru, 6, 6, 0, yes
215899420,  LazzaroFantasia, 6, 6, 0, yes
3048101109,  GENKY112, 7, 7, 0, yes
785818049483907072,  paolodifra4, 3, 3, 0, yes
741657723075461120,  gustavodandolo5, 2, 2, 0, yes
800433175679803392,  luiginok41, 1, 1, 0, yes
3179240423,  stefanvisivo, 11, 11, 0, yes
1039524522,  Bssfba, 6, 6, 0, yes
2885121955,  GiacintoTorchio, 10, 10, 0, yes
789431766591340544,  Andrea652232211, 9, 2, 7, no
2483784853,  AzzurraLib, 6, 6, 0, yes
93822447,  ventu75, 1, 1, 0, yes
783067495582359552,  CarducciEvelin, 1, 1, 0, yes
1287327732,  trotta_roberto, 10, 8, 2, yes
476835728,  fulleraser, 4, 4, 0, yes
801157617653518336,  Stefano0601, 2, 2, 0, yes
1927559616,  blenbebene, 2, 2, 0, yes
1062812390,  ACaldinelli, 1, 1, 0, yes
397162728,  mimmopanuccio, 3, 2, 1, yes
2374899391,  Adalberto1944, 8, 4, 4, neutral
2161648892,  VeraDestrasocia, 25, 15, 10, yes
2492097985,  clvpng, 1, 1, 0, yes
54531191,  RiccardoFavero, 4, 4, 0, yes
2973349187,  sydJaner, 3, 3, 0, yes
614101601,  fabiocastelli_, 7, 7, 0, yes
1112704358,  BoniniPa, 2, 2, 0, yes
4850243843,  ciro_sinatra, 1, 1, 0, yes
2801667790,  AnnaBrondinoAP, 8, 6, 2, yes
4371674836,  l_istrice, 2, 2, 0, yes
489233306,  gabriella_melis, 1, 1, 0, yes
47885026,  raimondm, 2, 2, 0, yes
1318978092,  rosycarponi74, 2, 2, 0, yes
1179885114,  ConvertinoPiero, 2, 2, 0, yes
1063917386,  amm_tpasqualin, 2, 2, 0, yes
805522849461108737,  Gaetano230859, 1, 1, 0, yes
3228177251,  Colantoni_tweet, 8, 8, 0, yes
413314779,  GiuseppeTricas1, 3, 2, 1, yes
1591945410,  FedericoClaps, 110, 67, 43, yes
347427153,  g1968c, 1, 1, 0, yes
188426908,  nicolafrigerio, 1, 1, 0, yes
364165033,  Lraax, 3, 3, 0, yes
2664981444,  bobobizzo, 7, 4, 3, yes
99358086,  TizianoVagnoni, 1, 1, 0, yes
411610129,  VBartolom, 4, 4, 0, yes
107064765,  Anaslele, 30, 13, 17, no
476072457,  wolfpiccoli, 1, 1, 0, yes
347202597,  __lo_ste__, 1, 1, 0, yes
704418409723904001,  CupiniMassimo, 13, 7, 6, yes
20300000,  serenabortone, 1, 1, 0, yes
3355372709,  Birnbaumchen, 10, 10, 0, yes
1013246078,  MarcySportelli, 2, 2, 0, yes
1180406000,  alfonsodurante, 1, 1, 0, yes
217900142,  alessiogrillini, 1, 1, 0, yes
713625460878483456,  ggarzen, 28, 26, 2, yes
2995672642,  martinamilani74, 9, 5, 4, yes
17880873,  paoloross, 26, 13, 13, neutral
418200938,  FcFiorentino, 3, 3, 0, yes
172329261,  Forlaj, 1, 1, 0, yes
132175075,  JulieParfaits, 1, 1, 0, yes
82188323,  ozfot, 1, 1, 0, yes
453905728,  bottaro_andrea, 3, 3, 0, yes
1050667999,  cristicri74, 3, 3, 0, yes
131843843,  stefanozzo78, 1, 1, 0, yes
416570761,  Gerapicarella, 2, 2, 0, yes
126315515,  menaarmi, 9, 7, 2, yes
430995991,  NicolaTagliani, 5, 3, 2, yes
545821255,  SimoneCibin, 9, 7, 2, yes
60624922,  silviablu, 11, 7, 4, yes
2728993463,  FebbraroAl, 1, 1, 0, yes
258237482,  yamagata72, 1, 1, 0, yes
766596641885478912,  Fulcrum1985, 5, 5, 0, yes
4631600495,  romano_anonimo, 10, 10, 0, yes
496842486,  glaguar, 1, 1, 0, yes
1395104083,  AleMinisini, 5, 5, 0, yes
2178030123,  giovannilanfra5, 7, 6, 1, yes
537300588,  dance_tommy, 7, 6, 1, yes
258694076,  Hal9017, 1, 1, 0, yes
2467519995,  LucaMaestri10, 1, 1, 0, yes
2267355079,  roby73fox, 6, 4, 2, yes
723406713924116482,  CostRefer, 7, 7, 0, yes
1093276411,  roberto_grandis, 2, 2, 0, yes
778134198,  milkoborio, 1, 1, 0, yes
550922171,  gigicost2001, 4, 4, 0, yes
559901924,  Narimencardia, 5, 3, 2, yes
794092015634051073,  lollo1963lollo, 77, 44, 33, yes
365985745,  siby88, 2, 1, 1, neutral
332776295,  Zfgrell, 8, 8, 0, yes
761320610324774912,  KevinFabozzi, 1, 1, 0, yes
2227116203,  0684Kekko, 4, 4, 0, yes
517397005,  annamariacostel, 3, 2, 1, yes
337228742,  stefano267, 17, 9, 8, yes
390573861,  Boborius, 8, 7, 1, yes
783041518374445056,  coluichedivide, 2, 1, 1, neutral
487090163,  LutzuRaimondo, 1, 1, 0, yes
787748865197875201,  serenit16, 18, 8, 10, no
1430511258,  aldofonzari, 3, 2, 1, yes
1161234596,  marco_murru, 6, 6, 0, yes
703169158318395393,  ioiochistocazzo, 4, 3, 1, yes
789452227228397568,  SiciliaFuturaCL, 1, 1, 0, yes
341454449,  GiovanniGrasso4, 3, 3, 0, yes
1260351403,  Den3279, 16, 8, 8, neutral
512483991,  EBenfatto, 2, 2, 0, yes
91630926,  ross979, 1, 1, 0, yes
803252196695543808,  Wolter7300, 5, 1, 4, no
2298886449,  Luca_Bs63, 2, 2, 0, yes
799543436768641026,  Ing_Orlando71, 8, 8, 0, yes
746302511095685120,  Cepu08971947, 20, 11, 9, yes
780815403320696832,  Gallaccio_diBua, 8, 7, 1, yes
772520766885728260,  Torex1979, 36, 17, 19, no
533567185,  SLCaforio, 5, 4, 1, yes
263821079,  mollytf, 1, 1, 0, yes
509494637,  GLocarni, 5, 3, 2, yes
438790885,  MarcoPedde, 2, 2, 0, yes
3228670575,  leobrigata, 2, 2, 0, yes
3088122919,  BirdmanLyndon, 3, 2, 1, yes
791266763891699712,  CacciolaCarmela, 1, 1, 0, yes
376709843,  GaetanoLipani, 1, 1, 0, yes
48996987,  AngeloBongio, 17, 17, 0, yes
418785833,  Mic_Chinni, 3, 3, 0, yes
803658046694158336,  CukiGelo, 1, 1, 0, yes
170019149,  breveinutile, 3, 2, 1, yes
337896504,  AntonioCoscia, 1, 1, 0, yes
455612937,  CarigliaMichele, 9, 5, 4, yes
20423071,  poliziadistato, 1, 1, 0, yes
464788251,  alebaiocchi, 2, 2, 0, yes
779271293359325184,  enricosagulo, 12, 3, 9, no
25744893,  SandroMattioli, 1, 1, 0, yes
950503766,  ArtLuca, 2, 2, 0, yes
4821301455,  antoniospa67, 1, 1, 0, yes
487403439,  discoradioIT, 21, 11, 10, yes
320725662,  base1075, 18, 10, 8, yes
225599409,  xxpetruccioxx, 4, 3, 1, yes
417218503,  MarcoVolpe89, 3, 3, 0, yes
1103663557,  Flavio_cdl, 2, 2, 0, yes
796181961513504772,  lumberjackre, 9, 8, 1, yes
4867693204,  k3kkaaa, 3, 3, 0, yes
255453880,  Ivanca72, 5, 3, 2, yes
1692026178,  LuiNotaro, 3, 3, 0, yes
2352343378,  CestaAle, 8, 4, 4, neutral
256660513,  ritape84, 7, 6, 1, yes
2279801235,  marinafor2, 4, 4, 0, yes
731733318157373442,  laziamary23, 7, 3, 4, no
866611646,  rosalba2arte, 1, 1, 0, yes
484729953,  PernaMassimo1, 1, 1, 0, yes
803024020094459904,  marco__87_1, 9, 9, 0, yes
767993102661521412,  serangeli_paolo, 1, 1, 0, yes
1280773926,  Bilo_Andrea, 2, 2, 0, yes
795673399083335680,  angelaannuzzi, 1, 1, 0, yes
2918046219,  millym75, 2, 2, 0, yes
469179599,  fabriziorich, 1, 1, 0, yes
366031591,  FabioNaples89, 1, 1, 0, yes
212661183,  BertinelliLuigi, 7, 2, 5, no
781405127366303744,  ApSenato, 19, 19, 0, yes
804309721201213440,  gaze_boss, 1, 1, 0, yes
4900863694,  cri_spa1977, 2, 2, 0, yes
527477202,  consulfa, 4, 4, 0, yes
2459817018,  Misebepi, 3, 3, 0, yes
1479114414,  Peppe_And, 37, 28, 9, yes
1132467116,  AgostiniLuca, 4, 4, 0, yes
755574364133662720,  carloromeo70, 1, 1, 0, yes
3909032295,  toni_pescasub, 16, 11, 5, yes
2331656722,  HalyKuyan, 1, 1, 0, yes
574620995,  laura_lauril, 16, 10, 6, yes
514506617,  alecobra1981, 8, 3, 5, no
559869101,  Ccarlotta8, 1, 1, 0, yes
618837236,  Graziascrive, 3, 3, 0, yes
186836715,  yesiamluigi, 3, 3, 0, yes
1384855346,  cune_gonda, 40, 9, 31, no
2755844146,  lumacarapida, 7, 7, 0, yes
552009008,  ilBiond0, 1, 1, 0, yes
71101905,  ivanleonte, 3, 2, 1, yes
392659299,  maxportera, 1, 1, 0, yes
1365417764,  AlessandroSarn1, 2, 2, 0, yes
441971587,  NKalso, 1, 1, 0, yes
4428184061,  FabioCovato, 1, 1, 0, yes
3053136223,  1b9b2f657e6b4fc, 1, 1, 0, yes
780772171241054210,  Smazzettore, 1, 1, 0, yes
2754454209,  FerrariLupo, 5, 5, 0, yes
3039121852,  francomoccia70, 3, 2, 1, yes
2368542160,  GpGuerino, 1, 1, 0, yes
436770342,  gianni_la_marca, 7, 4, 3, yes
457129775,  Biagio_Giusta, 1, 1, 0, yes
448852730,  DavidePanunzi, 6, 4, 2, yes
403003327,  FabioDeChirico, 1, 1, 0, yes
3209072371,  xmplll_eleazar, 1, 1, 0, yes
3424246541,  fabribotte, 1, 1, 0, yes
586654722,  gianpaolobiban, 38, 33, 5, yes
1917798224,  zucconiluca, 1, 1, 0, yes
398106338,  GiancaGori, 1, 1, 0, yes
874040911,  apraxx, 1, 1, 0, yes
3008542859,  corinnandreatta, 17, 7, 10, no
803239014685937664,  avvorlandof, 1, 1, 0, yes
2723056569,  IreneMusella, 3, 3, 0, yes
748041847264710656,  Nlorisis, 7, 5, 2, yes
3676376781,  danilo_dolce, 1, 1, 0, yes
112741355,  Biby_07, 6, 6, 0, yes
2890945384,  claudiarubini6, 1, 1, 0, yes
792789354838126595,  alexarienzo, 1, 1, 0, yes
63123584,  paolinab, 21, 15, 6, yes
796079716772016128,  Tamastroianni, 1, 1, 0, yes
464806438,  BDavico, 3, 3, 0, yes
726795528,  normannalive, 3, 3, 0, yes
51211942,  francese57, 1, 1, 0, yes
3297108689,  Sergio_M219, 16, 7, 9, no
2860233029,  MaellareAndrea, 3, 2, 1, yes
19072992,  Shaarinya, 1, 1, 0, yes
803142385077207040,  ilginecologo2, 1, 1, 0, yes
452855803,  elena_zuccarini, 8, 3, 5, no
373423842,  Maurizio_Lupi, 4, 4, 0, yes
400383332,  lucatoscoromano, 60, 44, 16, yes
455434012,  Maranto2012, 4, 4, 0, yes
4830782164,  carusoantonio78, 31, 16, 15, yes
1608819710,  moschelladario, 1, 1, 0, yes
749624647365365762,  monci1973, 4, 4, 0, yes
556771177,  RoccoOriginal, 10, 6, 4, yes
192324790,  filippocarlini, 1, 1, 0, yes
905834371,  RalexRds, 34, 18, 16, yes
411008647,  DonatoAntoniell, 2, 1, 1, neutral
4885464226,  UmbertoClement2, 1, 1, 0, yes
3233625838,  PanuccioRocky, 5, 5, 0, yes
224991770,  Flavi83, 5, 5, 0, yes
856918904,  LiberoBattitore, 2, 1, 1, neutral
1400111406,  ilariar12, 1, 1, 0, yes
3295345554,  LozziLuigi, 1, 1, 0, yes
2725711188,  mov19Luglio, 1, 1, 0, yes
470325112,  FrancoBuonamici, 2, 2, 0, yes
231967652,  Sionfulvio, 21, 12, 9, yes
506253690,  ector60, 5, 3, 2, yes
803938208836947969,  Fus_Matt, 3, 2, 1, yes
2585782921,  Viminale, 5, 5, 0, yes
423435597,  gortombina, 13, 11, 2, yes
135459652,  lucianolop21, 2, 2, 0, yes
4812464489,  crotone_siulp, 25, 11, 14, no
3299627499,  RoccaFil, 4, 3, 1, yes
359644807,  Beppe_Romano, 2, 2, 0, yes
4909508512,  hockey_yel_red, 4, 3, 1, yes
2179100758,  KrackedOld, 5, 3, 2, yes
4066666906,  LucaScopigno, 2, 2, 0, yes
297300122,  paganogiusep, 4, 4, 0, yes
2319675320,  NicoIamundo, 2, 2, 0, yes
1410780559,  ceramassimopio, 4, 4, 0, yes
312037859,  daminoL, 2, 1, 1, neutral
540701757,  G_Castiglione, 6, 6, 0, yes
783180575452594176,  Alessan32381963, 7, 6, 1, yes
799404407813185536,  stanislao91, 1, 1, 0, yes
746041091728752640,  Rappresentemax, 2, 2, 0, yes
726333230526373889,  ferragliomi3, 12, 12, 0, yes
728510029,  grasso_sonia, 1, 1, 0, yes
2896156791,  antcorrado5, 4, 2, 2, neutral
401602921,  GMassa93, 1, 1, 0, yes
1344242174,  benkafati, 1, 1, 0, yes
728568113847996417,  Beatrice_Ruta, 2, 2, 0, yes
602645893,  Alemontana79, 1, 1, 0, yes
786105738183712771,  lorenzomax67, 1, 1, 0, yes
2736319824,  HabiBamba, 2, 2, 0, yes
1441728823,  AioBio13, 6, 6, 0, yes
1917418159,  BarbaraRaisi, 6, 4, 2, yes
435880626,  SatirSfaction, 10, 8, 2, yes
2577315657,  Isamirti27, 15, 15, 0, yes
506057249,  andreasindaco, 2, 2, 0, yes
11995712,  maurizjo, 2, 2, 0, yes
586568738,  CastigaVIP, 12, 10, 2, yes
4426069323,  luisland_, 1, 1, 0, yes
377389027,  Ange_Marino, 9, 8, 1, yes
3023386197,  massigracciano, 1, 1, 0, yes
2445989868,  AverageMatt112, 1, 1, 0, yes
1372596200,  De_Sand21, 25, 21, 4, yes
329817290,  MarcoDelliPaoli, 11, 9, 2, yes
4010262106,  Lorena08079, 2, 2, 0, yes
2361835685,  RenatoRametta, 1, 1, 0, yes
1116398599,  filobusbus, 3, 3, 0, yes
765468572390944768,  gioachinoasti77, 6, 5, 1, yes
496135532,  dankal1970, 1, 1, 0, yes
450014325,  JunioBulfone, 3, 2, 1, yes
2929169337,  Milano_Popolare, 3, 3, 0, yes
1109683333,  AleColucci1, 2, 2, 0, yes
975008966,  BertoliBeppe, 6, 6, 0, yes
96994998,  franc_len, 1, 1, 0, yes
2224559949,  s_micozzi, 2, 1, 1, neutral
2512309993,  iThonio, 1, 1, 0, yes
610225746,  SpinaSandra1, 3, 3, 0, yes
109982964,  GiorgioTomasino, 1, 1, 0, yes
801461907794391040,  MargaretQeen, 3, 3, 0, yes
507474473,  dorina_bianchi, 3, 3, 0, yes
714929777090633728,  sunnystar334, 3, 3, 0, yes
312549849,  tanazap, 2, 1, 1, neutral
802899888916885504,  RickyPontic, 1, 1, 0, yes
81889184,  mimlep, 1, 1, 0, yes
949261333,  Andreacausin72, 2, 2, 0, yes
250285557,  laurapicci, 8, 8, 0, yes
2444699616,  51_luci, 1, 1, 0, yes
768076470,  CarloDachille, 1, 1, 0, yes
1134647432,  mrsiovinella, 6, 5, 1, yes
718207601780133888,  MesserBabau, 1, 1, 0, yes
4794539427,  agora746, 1, 1, 0, yes
2396403846,  HouseReporterIT, 1, 1, 0, yes
1281118717,  AlbertoSalme, 15, 4, 11, no
2197478480,  GuidoGuidesi, 1, 1, 0, yes
800370508793417728,  designinterno, 17, 6, 11, no
781917269664395264,  maplevotetrump, 1, 1, 0, yes
720617956540026881,  FurfaroFrancesc, 3, 3, 0, yes
4885253933,  ducezio3, 2, 1, 1, neutral
2300805158,  MarcoPiper, 1, 1, 0, yes
2759396308,  alessio_tag1, 19, 4, 15, no
744880546728247297,  mestessada, 2, 2, 0, yes
3049334202,  antoniopirrott1, 4, 3, 1, yes
1190157246,  CittadinoResp, 6, 2, 4, no
47873906,  giscoppi, 4, 3, 1, yes
735922157151256576,  claraliparulo, 5, 5, 0, yes
3830826267,  MolinaroGaetana, 1, 1, 0, yes
3731438296,  Carmen19755, 4, 4, 0, yes
578906912,  lillicarmen, 6, 3, 3, neutral
305164630,  AM22181, 1, 1, 0, yes
730809378,  MarioLepri, 1, 1, 0, yes
717391205642977280,  giammspada, 18, 10, 8, yes
3306587122,  silviaqueen5, 4, 3, 1, yes
398913989,  FilippoGrazzini, 4, 3, 1, yes
419142302,  ASSOPIUMA, 4, 2, 2, neutral
1329957211,  LaboMarco, 4, 3, 1, yes
443091757,  GabrieleLibianc, 1, 1, 0, yes
387555115,  mondeggiando, 3, 3, 0, yes
419743304,  AlessioLale, 62, 28, 34, no
51411846,  Ielpoman, 3, 3, 0, yes
3196375012,  gpstirparo, 1, 1, 0, yes
805728238588821504,  ciaogentebella, 19, 11, 8, yes
3224046916,  valdom70, 6, 4, 2, yes
2333704591,  mcuart, 3, 2, 1, yes
3340616146,  celani_simona, 10, 8, 2, yes
533592035,  danilocile, 14, 14, 0, yes
1021306837,  modamanager, 22, 7, 15, no
26802976,  KungPaolon, 2, 1, 1, neutral
801158222560301057,  mauro_bramato, 5, 4, 1, yes
435419527,  fungo1983, 6, 1, 5, no
1275214788,  ClauDif_, 1, 1, 0, yes
3580033637,  Sebastiano_73, 5, 5, 0, yes
220806987,  TullioFlorio, 25, 12, 13, no
3296548127,  gigi_imperato, 1, 1, 0, yes
1449837320,  TotiTule, 1, 1, 0, yes
176541363,  Nicbono, 10, 3, 7, no
778911204446236672,  SilvanaRuzzeddu, 1, 1, 0, yes
724729770236321797,  giangivad, 11, 11, 0, yes
515229378,  BeaLorenzin, 1, 1, 0, yes
1234133557,  gandfra, 2, 1, 1, neutral
244705592,  sfloriana, 27, 10, 17, no
486904199,  56_ross, 2, 2, 0, yes
802942235398565889,  silviofidelibus, 13, 11, 2, yes
1613535614,  caesar301073, 1, 1, 0, yes
805639749562171397,  webdifferente, 2, 2, 0, yes
248887130,  Enrico_4lin, 5, 5, 0, yes
2924599869,  AreaPopolareNa, 1, 1, 0, yes
780691596,  MosAlise, 2, 2, 0, yes
183594012,  Dumas_Suocero, 16, 8, 8, neutral
752647404,  giovannibizzott, 2, 2, 0, yes
526896427,  masman007, 16, 16, 0, yes
2367811931,  Luca_m1977, 5, 5, 0, yes
44304756,  aponic, 1, 1, 0, yes
4883011035,  gablat3, 7, 4, 3, yes
478954173,  RuggeroPutoto, 1, 1, 0, yes
3239005467,  DeGasperiFond, 2, 2, 0, yes
4494073469,  PeppePelle8, 6, 5, 1, yes
466404228,  marco_mansueto, 1, 1, 0, yes
800826550304313348,  lanzimassimo191, 29, 16, 13, yes
499936088,  sen_bianconi, 1, 1, 0, yes
1408224732,  redheart_80s, 3, 2, 1, yes
589342110,  AlbertoBrldghst, 3, 2, 1, yes
1008791754,  FraLevato, 10, 10, 0, yes
3311188835,  alesi_stefano, 8, 8, 0, yes
135211574,  picamia, 23, 14, 9, yes
2868997031,  Butterflylolo3, 4, 3, 1, yes
507569769,  FrancoisVayne, 1, 1, 0, yes
419489518,  NuccioCaffo1, 7, 7, 0, yes
793017516801007620,  andreamacchi70, 6, 5, 1, yes
269855245,  DavCuoreImpavid, 32, 30, 2, yes
359453947,  gdeglies, 1, 1, 0, yes
2400067920,  ALEggenda10, 2, 2, 0, yes
6568152,  scandura, 1, 1, 0, yes
1657344816,  cla124, 16, 12, 4, yes
410709996,  AbiusiAngelo, 1, 1, 0, yes
796004115688161280,  fdr985_, 21, 17, 4, yes
626291092,  CreaPaolo111, 1, 1, 0, yes
736482105245507584,  addezzio_d, 1, 1, 0, yes
2780202521,  petrongoloanto, 2, 1, 1, neutral
747243626,  aureapuligheddu, 3, 3, 0, yes
616293914,  Onofrio78, 1, 1, 0, yes
762023020047298560,  Miringo17, 3, 3, 0, yes
2307925110,  CristoforoRocky, 9, 7, 2, yes
551769009,  iredao81, 2, 2, 0, yes
3111670894,  antonellasalim1, 1, 1, 0, yes
412129293,  Paolameno, 11, 11, 0, yes
46638071,  r0xr00lz, 1, 1, 0, yes
165317427,  rudyroma, 1, 1, 0, yes
337838077,  aquilanerarosa, 4, 3, 1, yes
700411478977994752,  Edgardo17021966, 1, 1, 0, yes
57449355,  lucapaone, 1, 1, 0, yes
526191743,  brunoforesi, 4, 4, 0, yes
170341848,  matteov90, 6, 3, 3, neutral
462300120,  giannessidani, 1, 1, 0, yes
418758587,  lmaria_l, 10, 8, 2, yes
388185846,  FranzLandi, 1, 1, 0, yes
3888428213,  bracaleedda1, 4, 3, 1, yes
471117838,  EugenioBusin, 3, 1, 2, no
434824030,  emomarzi, 3, 3, 0, yes
2206789645,  FabrizioCossu, 2, 2, 0, yes
743070984987660289,  ciberago1965, 1, 1, 0, yes
3782747716,  Nonloso37092529, 3, 3, 0, yes
2715903351,  micthestar, 1, 1, 0, yes
1063794572,  g_lippolis, 2, 2, 0, yes
426130127,  senatorecimino, 1, 1, 0, yes
4031821385,  Pierf20, 1, 1, 0, yes
948318834,  ErreraGiovanni, 29, 15, 14, yes
132843246,  MrDarcyam, 2, 1, 1, neutral
1283054618,  rey7827, 1, 1, 0, yes
29695669,  tenaglia74, 5, 5, 0, yes
481603544,  FabioTuzz, 10, 8, 2, yes
2400349388,  Frances32131415, 13, 12, 1, yes
2476080717,  dottLuigiDis, 3, 3, 0, yes
1036878504,  rogerthiene, 4, 3, 1, yes
800327294,  leonardo_mcm, 2, 2, 0, yes
4114886943,  assuntamar15, 1, 1, 0, yes
1548002420,  FrancescoUlmini, 4, 4, 0, yes
423738002,  PierpaoloManca, 3, 1, 2, no
554550990,  kanalibeach, 12, 4, 8, no
416600770,  Giancarn, 1, 1, 0, yes
718775469345218560,  Paolap2791, 2, 2, 0, yes
1228034526,  PaoloPerugia1, 24, 12, 12, neutral
2752795762,  eusebio_enrico, 6, 6, 0, yes
569054211,  GCTesoro, 10, 3, 7, no
750413126986858502,  Stefani46802045, 1, 1, 0, yes
3341940117,  InBassoaDestra, 2, 2, 0, yes
400654283,  libertonic, 8, 8, 0, yes
505019583,  massimo7011, 7, 7, 0, yes
1860871,  agcolella, 6, 6, 0, yes
42024291,  LucaMartini, 2, 2, 0, yes
786553690039681024,  eduardomingion1, 1, 1, 0, yes
419047301,  Luca_Cauli, 1, 1, 0, yes
805497960360505344,  serena7213, 2, 2, 0, yes
801411882,  valentinomanfre, 6, 6, 0, yes
2864012763,  ClausScheide, 2, 2, 0, yes
40877771,  helios2207, 2, 2, 0, yes
796099800961843200,  koreano68libero, 1, 1, 0, yes
741338484,  lamarypopp, 5, 4, 1, yes
2575891271,  JAspide, 10, 9, 1, yes
610303661,  MManu57, 4, 3, 1, yes
475708986,  InndiMaria, 1, 1, 0, yes
910084836,  BrunoGiuseppe3, 1, 1, 0, yes
2739787766,  d209301743954b6, 31, 31, 0, yes
3377768080,  Tommaso19075195, 1, 1, 0, yes
4187308379,  SalvatoreRippa, 2, 1, 1, neutral
4916390609,  solopisa68, 2, 2, 0, yes
312933523,  do_NASO, 1, 1, 0, yes
3522132023,  Maxim3791, 8, 5, 3, yes
1097046230,  AntonioBuratto, 3, 3, 0, yes
531216203,  casapensione, 3, 2, 1, yes
3341072025,  Fabio73Fusco, 3, 2, 1, yes
750327113891377152,  liberpensatore, 3, 3, 0, yes
616842820,  niospa, 4, 3, 1, yes
3515613263,  gallinaro618, 1, 1, 0, yes
3434796675,  TeniAnna, 1, 1, 0, yes
417464655,  EPrevitali, 3, 3, 0, yes
782591780361539584,  SimoAnsa, 1, 1, 0, yes
490508673,  rosis_s, 2, 1, 1, neutral
804304569643782144,  pasquali_rob, 1, 1, 0, yes
83622909,  DelsantoRaf, 7, 6, 1, yes
510845484,  gianlucar81, 4, 2, 2, neutral
4842381857,  TommasoLumare, 6, 2, 4, no
413299340,  pierogiglio, 1, 1, 0, yes
1073727000,  Basta_tasse, 1, 1, 0, yes
829460082,  colomboita, 1, 1, 0, yes
149510682,  Nichino68, 1, 1, 0, yes
390276369,  divitopasquale, 1, 1, 0, yes
360821290,  AllegraLuce, 1, 1, 0, yes
768575901516828672,  paolovalle62, 12, 8, 4, yes
2297330555,  seguyx, 5, 5, 0, yes
471846501,  UnLuigi, 7, 5, 2, yes
142088836,  Emacu73, 5, 2, 3, no
170525017,  ste_marinelli, 2, 2, 0, yes
499870674,  jonnybrillante1, 1, 1, 0, yes
68111970,  lullabyg, 4, 1, 3, no
761516705445183488,  TheNaggingDick, 22, 13, 9, yes
286056337,  vervingiu, 1, 1, 0, yes
1212147877,  paceinterra_it, 2, 1, 1, neutral
805549735197163520,  Roccobaghy, 2, 2, 0, yes
1725220519,  MoniSacceddu, 5, 5, 0, yes
48808957,  gianluca_biondo, 2, 2, 0, yes
18505118,  bertatrullas, 4, 4, 0, yes
734391232470908928,  edonespa, 1, 1, 0, yes
379303654,  Vsaffezionato, 1, 1, 0, yes
782359808,  FrancescoCarfa1, 1, 1, 0, yes
36020729,  stfnglltt, 1, 1, 0, yes
81720890,  dwery, 3, 3, 0, yes
743718268846780416,  AntonellaBarte3, 1, 1, 0, yes
286779022,  mattiacabrelli, 1, 1, 0, yes
1384769748,  argeduard, 3, 3, 0, yes
729713207103922176,  Palmieri2016, 1, 1, 0, yes
801684184037212162,  slabchenkopl, 1, 1, 0, yes
1422345756,  loriano15, 1, 1, 0, yes
452279185,  GiancarloGava, 1, 1, 0, yes
33188455,  dantedb, 1, 1, 0, yes
1422780709,  annazappala, 1, 1, 0, yes
574727541,  benvenuto_m, 3, 3, 0, yes
980614603,  mimmocasalucci, 8, 6, 2, yes
3729773657,  paolamazzonipi1, 3, 3, 0, yes
4143834982,  fortunatosuria1, 1, 1, 0, yes
3307165198,  Salvopa74, 16, 12, 4, yes
3246766774,  pipporsi11, 1, 1, 0, yes
202268232,  MirkoGranata, 5, 5, 0, yes
2999464888,  SatiroPensante, 1, 1, 0, yes
737026430467444736,  VoceDeRoma, 2, 2, 0, yes
805755804922105856,  rhpolopositivo, 2, 1, 1, neutral
1978344314,  83enricoricci, 3, 3, 0, yes
407299205,  Salvo_Palermo, 1, 1, 0, yes
236956276,  Kazudo_8, 3, 3, 0, yes
1103834130,  giovanniancilli, 3, 3, 0, yes
1480667646,  YaAdami, 3, 1, 2, no
317006555,  nic_bru, 1, 1, 0, yes
802606815410319360,  Attilio38629334, 1, 1, 0, yes
1661880678,  jacopoilmito, 1, 1, 0, yes
2993765523,  FrancescoGileno, 6, 4, 2, yes
1062772934,  demonio721, 1, 1, 0, yes
805717986103410689,  nite08503796, 2, 2, 0, yes
403920729,  ghostintheruin, 4, 4, 0, yes
751920799964098560,  puravida6791, 14, 7, 7, neutral
1120202658,  MSpiaggiato, 2, 2, 0, yes
1482927091,  carlo_taormina, 1, 1, 0, yes
724250873216507906,  prof_emilio, 2, 2, 0, yes
805551699503042560,  federica_Felic, 1, 1, 0, yes
576115255,  CavalliMonica, 2, 2, 0, yes
768863741354053632,  dottorpeppe, 6, 6, 0, yes
2840014361,  sergioG602, 1, 1, 0, yes
2365824092,  KrisGxx, 1, 1, 0, yes
805589025155411968,  rosa_selv, 2, 2, 0, yes
1060252603,  fomba73, 1, 1, 0, yes
3065668461,  soddu71, 3, 2, 1, yes
400983889,  samuele_panzeri, 8, 7, 1, yes
3977244353,  deluchizzato, 2, 2, 0, yes
23197118,  romainbgb, 8, 7, 1, yes
451365630,  simosailor, 11, 7, 4, yes
390037641,  omar79bx, 2, 2, 0, yes
9817502,  12vda, 5, 4, 1, yes
3746304743,  AmeGaspa, 16, 12, 4, yes
411364138,  ErCrescina, 4, 3, 1, yes
292972975,  MassimilianoN, 8, 4, 4, neutral
720198001822732289,  Mingyonissimo, 12, 6, 6, neutral
485844453,  LeleReali, 1, 1, 0, yes
1206942487,  carmelosantoro6, 2, 2, 0, yes
739945587840286720,  frascarialuca, 1, 1, 0, yes
51049489,  GiuseppeCarosi, 3, 1, 2, no
1189899439,  Max_Danese, 5, 5, 0, yes
3981645562,  GerrMauri, 1, 1, 0, yes
1936456670,  Qangaceiro, 13, 9, 4, yes
955921100,  LemboSergio, 1, 1, 0, yes
709049290983866368,  imynontelodico, 4, 3, 1, yes
1028135312,  maurocesc, 2, 2, 0, yes
805042719252942848,  ilPDmerda, 29, 26, 3, yes
854678546,  IvanoMiraglia, 4, 4, 0, yes
337344038,  CelticTruce, 4, 4, 0, yes
3130043764,  GGironelli, 1, 1, 0, yes
578819937,  AltomareCorrado, 2, 1, 1, neutral
802145913456259072,  canatosusi, 1, 1, 0, yes
3428888823,  Mazzaufo, 10, 4, 6, no
2795660401,  GlobalTimeseu, 10, 10, 0, yes
541083079,  flexinexit, 12, 11, 1, yes
3226537523,  Silvio_Did, 6, 2, 4, no
788286737172799488,  Stef_Antoniozzi, 4, 4, 0, yes
1252942627,  mickyfab76, 1, 1, 0, yes
186292509,  Eragal, 1, 1, 0, yes
3005491031,  andreacaputo80, 1, 1, 0, yes
379245447,  caesar30011975, 5, 4, 1, yes
2652712809,  tommasogiannin3, 4, 3, 1, yes
1023008700,  calogero9517, 1, 1, 0, yes
314613895,  chriii_91, 1, 1, 0, yes
756061004556042244,  _mianing_, 7, 2, 5, no
109228733,  aceofdia, 2, 2, 0, yes
454914850,  Dukkere, 3, 2, 1, yes
2609290294,  triandafil, 30, 17, 13, yes
621138897,  LorySanto1, 1, 1, 0, yes
1331721332,  PiquboOfficial, 1, 1, 0, yes
777383174125019136,  e2016t, 8, 8, 0, yes
463925370,  piersaia, 1, 1, 0, yes
2508778031,  maxxxibb, 11, 6, 5, yes
514399725,  joanmariapique, 6, 6, 0, yes
1066882064,  ValterDOcchio, 7, 4, 3, yes
253254968,  kallagans, 1, 1, 0, yes
1395882728,  gabri48_123, 37, 24, 13, yes
2534379143,  micimpo, 3, 1, 2, no
358144312,  MimmoePalma, 2, 1, 1, neutral
228161787,  beppecastiglia, 4, 3, 1, yes
716624665507180544,  StefanoFerrett9, 5, 5, 0, yes
803714518182481924,  Marino67487495, 1, 1, 0, yes
295757870,  Gianfxy, 1, 1, 0, yes
540703786,  SCamillis, 1, 1, 0, yes
3313119640,  mariarosinetta, 6, 6, 0, yes
2951907850,  Joseph1973, 2, 2, 0, yes
2845626183,  scassatore1, 10, 4, 6, no
1037325842,  CharliRB, 1, 1, 0, yes
2363888992,  Mauro_DelGrande, 3, 2, 1, yes
747512387746598912,  danyrossoverde, 1, 1, 0, yes
2690461578,  riccardotacca1, 13, 11, 2, yes
615987223,  RinaEduardo, 1, 1, 0, yes
2781784450,  web_lucia, 107, 57, 50, yes
445596864,  MTartagni, 2, 2, 0, yes
804788082398609408,  Annina56964218, 5, 5, 0, yes
2397696805,  salvia_nicola, 5, 3, 2, yes
1006597970,  Ana9Pa, 6, 6, 0, yes
200034244,  PoldoB, 1, 1, 0, yes
2435083828,  GiulioVerro, 12, 11, 1, yes
283195353,  degi073, 8, 6, 2, yes
559609344,  geomtt, 19, 19, 0, yes
1880083801,  giodambro65, 1, 1, 0, yes
93709537,  lspeziali, 2, 1, 1, neutral
22771930,  clementinaz, 1, 1, 0, yes
2345353315,  rosetta71r, 4, 3, 1, yes
54655555,  EnriCampo, 2, 2, 0, yes
89161108,  mimidef, 5, 5, 0, yes
775752972093497344,  PopoloSItoscana, 3, 3, 0, yes
498255199,  francescocrott2, 5, 3, 2, yes
1070714532,  ibendin, 1, 1, 0, yes
803426934940123136,  LucaFalla, 3, 3, 0, yes
778911278693748736,  CarmMifsud, 1, 1, 0, yes
479865593,  Ciani_Lorenzo, 10, 8, 2, yes
476998460,  Francostars1, 2, 2, 0, yes
2778746520,  TowerBridgeUK, 2, 2, 0, yes
2905078605,  AdrianoVapsas, 4, 3, 1, yes
2449756487,  MazzeiLuigi59, 1, 1, 0, yes
227605442,  giodel65, 3, 1, 2, no
411699016,  massimilianomio, 11, 10, 1, yes
3299663764,  TotalBukharin, 1, 1, 0, yes
90007041,  martusciello, 2, 1, 1, neutral
3534749957,  sostienilacurva, 1, 1, 0, yes
2210428876,  stesantana7, 7, 7, 0, yes
88204916,  UrieleMaffei, 1, 1, 0, yes
764845377984065536,  57d0b96c6651487, 1, 1, 0, yes
49332881,  Airchucky, 3, 2, 1, yes
1218028574,  bocolavincenzo, 2, 1, 1, neutral
433694235,  Lory_Bianco, 18, 12, 6, yes
485050455,  ChristianFilip4, 6, 3, 3, neutral
51645818,  gauloise821, 1, 1, 0, yes
361960565,  ElioTuris, 37, 37, 0, yes
3586257136,  Angela3v999, 4, 4, 0, yes
1498219698,  FedericoZilia, 5, 2, 3, no
804961884,  AdrianoSalis, 63, 38, 25, yes
76299871,  MarescaCarlo, 7, 7, 0, yes
315428267,  Biofafafa, 34, 22, 12, yes
122644390,  fuser1975, 28, 4, 24, no
19392607,  micheleemiliano, 107, 13, 94, no
2773048230,  giannireale88, 5, 4, 1, yes
1921174561,  Riccardo_TG, 10, 5, 5, neutral
728265622363181056,  angelobonomini, 9, 7, 2, yes
2408803254,  Castruccio64, 19, 8, 11, no
590230314,  NinoCannistraci, 9, 6, 3, yes
786541347750588419,  wholedani, 53, 14, 39, no
488206666,  antoninopitrone, 5, 5, 0, yes
773684083117490180,  Flavio79865852, 21, 16, 5, yes
2354704705,  tamangha, 6, 5, 1, yes
4197183543,  AminelliVr, 26, 12, 14, no
751589078529871874,  Frustino4, 2, 2, 0, yes
3218386990,  StefanoRuxus, 10, 6, 4, yes
779211695239655424,  moniacristarel1, 203, 185, 18, yes
2242602102,  testasogna, 7, 6, 1, yes
2621807269,  adriano_brescia, 3, 3, 0, yes
742048419208925184,  Pino42405290, 14, 14, 0, yes
2375774460,  fpontiggia1, 4, 4, 0, yes
2546560394,  BimboMinkiaEROE, 17, 17, 0, yes
697576931575885830,  barbaragolino3, 5, 4, 1, yes
2997661401,  paolopanchini, 24, 23, 1, yes
3007848857,  massivale77, 8, 7, 1, yes
1457867539,  sisma05, 3, 3, 0, yes
2343678391,  Miriam91328235, 7, 7, 0, yes
70758797,  samueliuri, 2, 2, 0, yes
1965336218,  adrianapelligra, 4, 4, 0, yes
428304986,  EliAl73, 5, 5, 0, yes
2654152260,  peppenordafrica, 29, 3, 26, no
501526399,  AriuSerg, 24, 19, 5, yes
762338673547501568,  carminel69, 5, 4, 1, yes
63152361,  furbanzio, 10, 10, 0, yes
795707563190976512,  barbara_zanutto, 343, 307, 36, yes
366252148,  serenagalli, 73, 42, 31, yes
1296004291,  LuisaMainardis, 5, 5, 0, yes
1927387476,  MarioNapoletan3, 14, 5, 9, no
2827362754,  IoVotoNONNO, 3, 3, 0, yes
182777606,  Crepax73, 10, 6, 4, yes
2234343936,  lourcoa, 8, 8, 0, yes
250316913,  brales41216, 50, 16, 34, no
999645834,  MarisaLevi1, 4, 4, 0, yes
713058194059304960,  ObiOne61, 33, 22, 11, yes
2785117733,  ConflittiMarco, 20, 18, 2, yes
3600676817,  matalone_dam, 215, 188, 27, yes
4896181677,  pronto28862890, 5, 5, 0, yes
3224742693,  abbastanza94, 10, 5, 5, neutral
978937369,  johnnyna51, 4, 3, 1, yes
81915953,  immadibi, 9, 7, 2, yes
2496600643,  PatriziaAlessa2, 9, 5, 4, yes
65414833,  tizios, 4, 3, 1, yes
896112570,  didomax71, 12, 1, 11, no
437754476,  MartaLio71, 2, 1, 1, neutral
566489601,  MartaCacace, 6, 3, 3, neutral
912221263,  Pestone2, 3, 2, 1, yes
3055410513,  BgBrunogiovanni, 7, 5, 2, yes
1671070807,  amshare_armando, 18, 3, 15, no
940223707,  robertogo6, 24, 14, 10, yes
2912838387,  a_dicone, 3, 3, 0, yes
510952881,  ilariabbruzzesi, 11, 3, 8, no
3132601540,  espo17051978, 7, 5, 2, yes
946614068,  JacopoSvetoni, 11, 9, 2, yes
2201962850,  carlo_masera, 11, 1, 10, no
495925655,  BALUBA74, 4, 1, 3, no
2369270534,  Monica_Cecchi, 3, 1, 2, no
196518637,  ArtemioAntinori, 3, 1, 2, no
319141378,  carnif, 2, 0, 2, no
117065803,  sdb251, 7, 2, 5, no
766056010406649856,  Pareti_Max, 5, 0, 5, no
794234183128322049,  MaialiSenza, 82, 10, 72, no
1387461,  betman, 4, 1, 3, no
791287209508933632,  POSDstellarossa, 46, 27, 19, yes
1106715577,  ECARRATTA, 3, 1, 2, no
233446304,  dserpella, 2, 1, 1, neutral
495373098,  AndreaSellarol1, 5, 5, 0, yes
4842610353,  padovani56, 5, 5, 0, yes
263092501,  FraBartleby, 3, 2, 1, yes
256835865,  FranceRomeo, 9, 8, 1, yes
4822090449,  SiamoLuigino, 3, 1, 2, no
2516807525,  LegaNordRoma, 38, 14, 24, no
702514825214238720,  nadiagiacomazzi, 6, 2, 4, no
2665607653,  TheFansApps, 4, 1, 3, no
3011358083,  ItalExitTW, 6, 2, 4, no
3054346990,  MailaRatti, 3, 1, 2, no
3054312209,  GratiSandro, 6, 2, 4, no
3054364876,  DanieeFioretto, 6, 2, 4, no
980929243,  gusmelaura, 14, 7, 7, neutral
1065109687,  pparissenti, 17, 9, 8, yes
730034081698877443,  TristanoQuaglia, 119, 30, 89, no
353766961,  cashpalla, 12, 5, 7, no
476144741,  JacopoMorrone, 3, 1, 2, no
428417530,  lisabrambilla, 22, 9, 13, no
271468279,  pasquimaenza, 59, 27, 32, no
726543135136964608,  Fabry_5, 46, 23, 23, neutral
1320360776,  LBoratto, 9, 2, 7, no
1124867449,  SaccaniSaccani, 40, 4, 36, no
1371655940,  VitoeCarmelaPis, 18, 13, 5, yes
1567906891,  LuciFrancesco, 9, 1, 8, no
493854798,  CorradinoMineo, 31, 4, 27, no
1037740650,  foxes7777, 3, 3, 0, yes
3039360208,  4d06088983a44c8, 14, 11, 3, yes
1321896918,  cifi29, 5, 4, 1, yes
146364035,  bidizeta, 5, 5, 0, yes
409352382,  michelestimola, 25, 7, 18, no
1062997310,  Francy1950, 29, 10, 19, no
42075554,  cainooo, 3, 3, 0, yes
466383201,  mario_palmisano, 7, 5, 2, yes
1324221282,  alessandrogessa, 9, 4, 5, no
462343980,  antonyromanelli, 5, 1, 4, no
544153027,  vals_80, 3, 2, 1, yes
1105753646,  Giovanni2601, 23, 9, 14, no
2806242466,  MPellegrini1988, 10, 4, 6, no
415571726,  maumartina, 3, 2, 1, yes
234743222,  MarcoCav, 8, 1, 7, no
507652780,  simonefurlan1, 7, 2, 5, no
4092809355,  morrissey700, 108, 54, 54, neutral
1359838458,  giemme66, 1, 1, 0, yes
96313903,  Cescoreds, 1, 1, 0, yes
1269812862,  AndreaNessi1, 3, 2, 1, yes
827499890,  Maxromolo, 5, 5, 0, yes
964368552,  lugra50, 2, 2, 0, yes
397147405,  Giacomino725, 2, 2, 0, yes
2459245260,  ielo2, 1, 1, 0, yes
195279027,  agilulfo71, 9, 7, 2, yes
370892488,  SoniaGasperini, 1, 1, 0, yes
106705293,  flowy58, 1, 1, 0, yes
3349036179,  diarioditrieste, 3, 1, 2, no
3022123029,  Leolakyd, 8, 8, 0, yes
1179385580,  Myrtus_up, 16, 10, 6, yes
39546698,  Lerussi, 24, 24, 0, yes
787941432267051008,  antoniopacino12, 51, 51, 0, yes
217358711,  lucabaradello, 1, 1, 0, yes
2383537682,  ClaudiaNorbedo, 1, 1, 0, yes
1214982206,  svibblo, 8, 7, 1, yes
725776532258590721,  marcomontese, 1, 1, 0, yes
311484021,  DeliriousMind, 12, 12, 0, yes
163501750,  Mukkieteiner, 2, 2, 0, yes
2366790998,  AntonioOpallo61, 6, 5, 1, yes
540239814,  ConciaR, 1, 1, 0, yes
1364518398,  lorenzopresot, 1, 1, 0, yes
251345771,  SALVO1010, 4, 4, 0, yes
964488151,  adriano_savio, 16, 11, 5, yes
1275927386,  GloriaMura, 1, 1, 0, yes
1129328755,  espyFiciur, 9, 9, 0, yes
2622391643,  44pino44, 3, 3, 0, yes
1408515078,  paolocarucci4, 3, 3, 0, yes
422035414,  PirkkoPeltonen, 3, 3, 0, yes
36662574,  imago_mundi, 3, 3, 0, yes
98464365,  maxithesnow, 3, 3, 0, yes
1389335053,  gigig66, 18, 7, 11, no
3318421203,  PetteneAnna, 72, 20, 52, no
745330568590659584,  Lee_Jacobin, 5, 4, 1, yes
58528822,  AndreSime, 1, 1, 0, yes
355046996,  GiannoneGerardo, 4, 4, 0, yes
2741023859,  2014Calzolari, 3, 3, 0, yes
434430889,  Mnichetti1, 1, 1, 0, yes
382896347,  cleto_a, 1, 1, 0, yes
815731375,  leopoldast, 4, 4, 0, yes
15979440,  alexarnz, 1, 1, 0, yes
1620754188,  chilisummer, 14, 6, 8, no
2589322103,  ElisaGraffi, 6, 6, 0, yes
329564611,  FrancescoPilo1, 5, 5, 0, yes
387166314,  CipGabriele, 22, 20, 2, yes
72549997,  enzomartines, 6, 6, 0, yes
96355899,  lucaornago, 1, 1, 0, yes
2249221297,  1piede, 16, 7, 9, no
417147552,  RobertoTamburro, 2, 1, 1, neutral
397433071,  yuk_yuk_yuk, 7, 7, 0, yes
412922969,  direzionesud, 1, 1, 0, yes
1336542102,  biancamaria308, 2, 2, 0, yes
1006453046,  carloras1, 9, 8, 1, yes
470633026,  MarcoLombardo59, 2, 2, 0, yes
1041965744,  maphred, 1, 1, 0, yes
22003434,  thiswas_, 5, 4, 1, yes
3697596857,  Sweenytapi, 1, 1, 0, yes
309701654,  AnnaTaiani, 11, 7, 4, yes
2792238116,  private_post, 3, 2, 1, yes
408738224,  Il_sovranista, 36, 19, 17, yes
529787529,  redacla, 6, 6, 0, yes
339672122,  pinapic, 16, 16, 0, yes
274682737,  profugoincasa, 12, 12, 0, yes
1382914388,  PietroPleonetti, 1, 1, 0, yes
2600737247,  MfFeruglio, 1, 1, 0, yes
597554232,  fazius1960, 2, 1, 1, neutral
1328776837,  Quantomeno_, 1, 1, 0, yes
1178526410,  Cudrilibere, 4, 2, 2, neutral
2766500357,  AvvDox, 4, 3, 1, yes
1729205360,  PastoreFrance, 31, 19, 12, yes
1067756382,  durendala, 11, 10, 1, yes
362706589,  ercules7676, 10, 9, 1, yes
789536032819650560,  panzaantonio61, 3, 3, 0, yes
13056322,  coppolapaolo, 3, 3, 0, yes
798774739502141444,  LaBellezza8, 3, 2, 1, yes
303713268,  Algouthi, 3, 2, 1, yes
2408705279,  AudreyGeci, 1, 1, 0, yes
910577886,  MiglioraGianca, 2, 2, 0, yes
114141144,  BUGMIR, 2, 2, 0, yes
712695926,  Martinandenna, 6, 6, 0, yes
124828785,  ricmes63, 2, 2, 0, yes
775843885,  vittorinofilipp, 7, 7, 0, yes
2298937636,  mairon70, 11, 11, 0, yes
2950936654,  DrToninicesare, 50, 21, 29, no
243563921,  busotto, 12, 12, 0, yes
142003790,  CarnelosMatteo, 4, 4, 0, yes
268805462,  Astromauro, 1, 1, 0, yes
787567284,  ilaria_pinna, 2, 2, 0, yes
2227479807,  BocconiJordi, 1, 1, 0, yes
354832020,  Acclavio, 2, 2, 0, yes
3226558563,  pistoresir1, 50, 15, 35, no
1208976072,  MorrocoyC, 3, 3, 0, yes
2341770566,  DMichele74, 4, 4, 0, yes
1275456488,  claudioven90, 37, 18, 19, no
2878090661,  demichelibobby1, 3, 1, 2, no
1031198407,  priorra, 1, 1, 0, yes
22128223,  Fabiobros, 1, 1, 0, yes
2348140042,  nino_indelicato, 15, 2, 13, no
1050116880,  clborian, 2, 2, 0, yes
2304513812,  mariagraziata20, 8, 8, 0, yes
497008760,  AlessandroStan2, 1, 1, 0, yes
2326609739,  armandoespi1988, 1, 1, 0, yes
3246127000,  Ilgava1, 8, 5, 3, yes
1070697217,  IMorassi, 9, 9, 0, yes
532599235,  Domenic67108104, 2, 2, 0, yes
503510943,  gabrimarraffa, 1, 1, 0, yes
1275312618,  MonicaPaviotti, 6, 6, 0, yes
2348977906,  c_morico, 9, 7, 2, yes
397495359,  Saro_Privitera, 2, 2, 0, yes
1870986247,  fblaseo, 1, 1, 0, yes
454903753,  FedericoMargiac, 1, 1, 0, yes
434311922,  marinamaurizio, 1, 1, 0, yes
3012939605,  michiferrini, 1, 1, 0, yes
410375702,  duchessa49, 1, 1, 0, yes
4067206084,  miki28261052, 3, 3, 0, yes
1083334088,  Crisaster, 2, 2, 0, yes
2526179811,  SalvatorePaga19, 6, 3, 3, neutral
377578133,  GiuseppeFanzone, 1, 1, 0, yes
1334463464,  NicolaMarcheseM, 13, 9, 4, yes
208515764,  gtkd85, 2, 2, 0, yes
2361772625,  ParcoDel, 1, 1, 0, yes
31922220,  giornaleprociv, 2, 2, 0, yes
4897530316,  PapaOttusoMagno, 1, 1, 0, yes
110196134,  LEOFIB, 1, 1, 0, yes
1694396138,  FDemFVG, 1, 1, 0, yes
1282855974,  Fabrizio_Contu, 7, 4, 3, yes
989192558,  AntonelloAng, 13, 6, 7, no
202700312,  gerardos1982, 3, 3, 0, yes
863504472,  DaveLitfiba86, 4, 4, 0, yes
1015907563,  lextumusa, 2, 1, 1, neutral
2434012031,  maria_maribog, 7, 7, 0, yes
104491887,  anabasabana, 1, 1, 0, yes
1025103174,  BuaAldo, 3, 3, 0, yes
2987118586,  Gilberto6204, 1, 1, 0, yes
3310442920,  al67ca, 6, 3, 3, neutral
802226446206980096,  Jan47992606, 1, 1, 0, yes
754957121201004544,  siperilsud1, 20, 20, 0, yes
2676443188,  CPalamides, 1, 1, 0, yes
889202072,  66Giampy, 1, 1, 0, yes
497942532,  cami5200, 2, 2, 0, yes
915566532,  danil_etto, 23, 15, 8, yes
797088398183899136,  Alessan15343223, 1, 1, 0, yes
179976345,  fededarin, 1, 1, 0, yes
765651325610758144,  ILFortebraccio, 2, 2, 0, yes
1036611673,  GiancarloChimie, 1, 1, 0, yes
1951613647,  Misss_Morrison, 5, 5, 0, yes
929422430,  V_Franceschelli, 2, 2, 0, yes
44882802,  Marcotekas, 6, 6, 0, yes
925871749,  otrebu2010, 1, 1, 0, yes
194138920,  Acaiulo, 5, 4, 1, yes
524453451,  RoyBerardi, 8, 7, 1, yes
328354853,  giuliangiuliano, 1, 1, 0, yes
4492661435,  mariuccia150144, 2, 2, 0, yes
263158083,  capeppe, 7, 2, 5, no
3437142466,  LauraP89Bari, 2, 2, 0, yes
236055365,  flinxkk8, 1, 1, 0, yes
2509485582,  paolacignap4021, 20, 8, 12, no
1339910850,  claudioaiello2, 3, 3, 0, yes
2440662719,  glemonat63, 1, 1, 0, yes
1062790764,  MulasEnrico, 1, 1, 0, yes
48291322,  fabvix1971, 8, 4, 4, neutral
3841727477,  cardinali1974, 3, 3, 0, yes
1020102560,  AriannaMartire, 8, 7, 1, yes
244869589,  parulara, 17, 11, 6, yes
801060646699855872,  LaPecoraRossa_, 10, 10, 0, yes
803686734190018561,  ciguasta, 1, 1, 0, yes
4256715496,  Ale_Manzo83, 43, 21, 22, no
55950896,  unsorsodicaffe, 4, 4, 0, yes
415387207,  lisagori1, 16, 15, 1, yes
2316947536,  Ant_Romanelli, 6, 4, 2, yes
1635582812,  gruppopdfvg, 7, 7, 0, yes
1364214068,  cced96, 4, 3, 1, yes
466680328,  MarcoImera, 1, 1, 0, yes
462495614,  StefanoStegino, 6, 6, 0, yes
505745312,  GaleVince, 3, 3, 0, yes
1002084986,  maria6006, 12, 10, 2, yes
460408548,  AngeloRoncella, 5, 5, 0, yes
421406745,  marcomiscio, 10, 3, 7, no
713277977589624832,  aiellolaura5, 1, 1, 0, yes
962210358,  freemin_d, 3, 1, 2, no
484106374,  godan9, 25, 2, 23, no
411706932,  EmanueleTesti, 8, 1, 7, no
1180070557,  lindagangarossa, 1, 1, 0, yes
425965881,  LinaMonteleone, 8, 7, 1, yes
503150353,  luigi79350302, 2, 2, 0, yes
271518898,  Ntina_bi, 3, 1, 2, no
133175963,  claudiusen, 1, 1, 0, yes
805703133569708032,  wolfnikol2114, 4, 4, 0, yes
405515447,  WinMan5, 3, 2, 1, yes
819475597,  LDP_33, 11, 7, 4, yes
2185004339,  FrancescoBonni, 1, 1, 0, yes
761023579,  fabiotedeschi75, 7, 7, 0, yes
893208218,  GialsaTorri, 4, 2, 2, neutral
1275282337,  paullatam, 4, 2, 2, neutral
241597004,  robyempoli, 6, 6, 0, yes
1848435132,  RoccoRennola, 5, 4, 1, yes
427209531,  m_enomis, 20, 8, 12, no
341627555,  attangelo, 10, 7, 3, yes
236879257,  Claudio_Meneg, 1, 1, 0, yes
589095780,  robertodamico7, 1, 1, 0, yes
4578456569,  DaniloMariano90, 47, 47, 0, yes
523696848,  RobertoPetruzzo, 3, 3, 0, yes
4229765175,  1ancami, 8, 8, 0, yes
513282961,  maricaganci, 1, 1, 0, yes
982607838,  danilogoiettina, 2, 2, 0, yes
965693940,  massimofrisetti, 4, 4, 0, yes
23384495,  DanieleLeoni, 7, 7, 0, yes
1617496921,  barbiere_enzo, 14, 10, 4, yes
2611506554,  AndreBoc87, 1, 1, 0, yes
757278078,  fasiolo_laura, 5, 5, 0, yes
374994058,  FrancescoMattan, 3, 3, 0, yes
397433071,  cattivoumore, 5, 5, 0, yes
3010605299,  santenardocci, 4, 4, 0, yes
3288467218,  CataVinc, 2, 2, 0, yes
509356418,  ferdiava, 9, 6, 3, yes
316624631,  FabriSenigallia, 4, 2, 2, neutral
938907379,  bassi_danilo, 2, 2, 0, yes
222019028,  MissMaratona, 1, 1, 0, yes
2787109876,  DellOrtoCinzia, 2, 2, 0, yes
2766253847,  AlessandroAi, 3, 3, 0, yes
1154856690,  milo4646, 10, 7, 3, yes
498000791,  FincoNicola, 4, 3, 1, yes
1732239386,  CosettaMignani, 5, 5, 0, yes
22289832,  Flamenz, 1, 1, 0, yes
1334227477,  francescorio91, 1, 1, 0, yes
358919228,  ciromacri, 4, 4, 0, yes
3165917453,  TempiReali, 106, 102, 4, yes
3480866369,  PivessoLuca, 11, 9, 2, yes
324859854,  UmbertoSorrenti, 2, 2, 0, yes
2154033305,  AimiBeatrice, 2, 2, 0, yes
2154072705,  gioguer28, 3, 3, 0, yes
456066284,  mindofzayyn, 6, 6, 0, yes
1208311602,  TesoMaurizio, 3, 3, 0, yes
493164077,  a_santoro57, 4, 4, 0, yes
608237283,  LucaZeni1, 2, 2, 0, yes
128609755,  FrenchContin, 6, 6, 0, yes
780051591273611264,  lucio140271, 9, 7, 2, yes
425207661,  maurocecchi, 3, 2, 1, yes
205840088,  ienzottodue, 11, 5, 6, no
729924880288862208,  giovannicalled2, 3, 3, 0, yes
2909606831,  CristinaGrion, 5, 5, 0, yes
80916521,  UglyBibi, 3, 2, 1, yes
768146596919926784,  Madibened, 4, 3, 1, yes
2230323499,  enzoferreri94, 1, 1, 0, yes
312944110,  tar_francesco, 1, 1, 0, yes
2359338077,  fullembo, 5, 4, 1, yes
432637325,  feliceromano3, 12, 9, 3, yes
455542509,  francolarocka, 1, 1, 0, yes
1053223004,  emiramazzotta, 7, 7, 0, yes
29518367,  Marilmi, 8, 7, 1, yes
1444460232,  LSquame, 1, 1, 0, yes
536142648,  claudiogardini2, 11, 8, 3, yes
554095642,  LaurettaBellini, 3, 2, 1, yes
1379009540,  gabriele_valeri, 2, 2, 0, yes
3909677536,  Nunzio80097677, 15, 15, 0, yes
796655732628324352,  fraferraro1, 6, 5, 1, yes
2333173052,  59_bert, 3, 2, 1, yes
146890102,  enricoleader, 1, 1, 0, yes
1311291734,  stefanocasasco1, 10, 5, 5, neutral
771596356548820992,  Riccard73702519, 12, 12, 0, yes
1036905870,  mauroarnuzzo, 2, 2, 0, yes
380392437,  thisisfederica, 4, 4, 0, yes
1673632021,  marcopiva77, 4, 4, 0, yes
1064168858,  valtersardegna, 8, 8, 0, yes
401968500,  LuigiPetrelli, 2, 2, 0, yes
502998687,  roby_italy_51, 16, 16, 0, yes
383730592,  MINOPOLIG, 3, 1, 2, no
770333270,  friscketto, 2, 2, 0, yes
2437403087,  silvanodesogus, 8, 4, 4, neutral
1397662729,  DAlessioCiro, 3, 3, 0, yes
402117391,  simea71, 1, 1, 0, yes
781944137952231431,  fabriband74, 8, 5, 3, yes
1318295995,  porcellinodindi, 5, 5, 0, yes
191516737,  Magicanord, 3, 3, 0, yes
2744135452,  LbIbrido, 28, 27, 1, yes
754296809883832320,  SgtHartmanTALK, 23, 12, 11, yes
1156953199,  CianoServola, 3, 3, 0, yes
806122470390530048,  andrea221285, 1, 1, 0, yes
3806075187,  MoscaRufi, 1, 1, 0, yes
180377840,  Sannacarlo, 1, 1, 0, yes
2778206704,  fedfor2311, 3, 2, 1, yes
391394768,  peppedonati, 1, 1, 0, yes
8459172,  amosm, 1, 1, 0, yes
488505521,  LuigiDatorino, 4, 3, 1, yes
789737150753435648,  DinoFacundo_Mat, 3, 3, 0, yes
190964538,  Guly72, 1, 1, 0, yes
3154630425,  rizzi_rita, 7, 7, 0, yes
256938957,  PDERNetwork, 4, 4, 0, yes
1360384598,  cehondina, 5, 4, 1, yes
2520582142,  RaRoby56, 9, 6, 3, yes
894922832,  Davide_Amerio, 2, 2, 0, yes
2245874503,  Tracinailpesce, 3, 3, 0, yes
1168148899,  Luigide_vecchis, 4, 3, 1, yes
1039964510,  flang58, 2, 2, 0, yes
797327775963222016,  Incitatus8, 13, 13, 0, yes
164225638,  levpetrovitch, 19, 16, 3, yes
767449120718061568,  Rita5Ste2, 18, 18, 0, yes
3638802375,  PincoPa46974203, 3, 3, 0, yes
311092774,  LucaColucci1, 2, 1, 1, neutral
39028896,  7m70, 32, 13, 19, no
195515224,  tarutac, 1, 1, 0, yes
266711908,  gabryandi, 9, 9, 0, yes
761460870425829376,  55pinucio, 5, 4, 1, yes
81657705,  navajoblu, 1, 1, 0, yes
3065548348,  JayllndB, 2, 2, 0, yes
768698124793745409,  Anna62756217, 11, 9, 2, yes
1430789676,  gf_brivio, 4, 2, 2, neutral
2404476623,  auxibene, 3, 3, 0, yes
1068675048,  giuflora, 3, 3, 0, yes
359925448,  albertosantarel, 2, 2, 0, yes
411048509,  AscanioV, 18, 7, 11, no
954189332,  CBardelle, 4, 3, 1, yes
405111915,  andrea_guelfi, 1, 1, 0, yes
2735171102,  masafa75, 6, 6, 0, yes
293369383,  MBerberi, 1, 1, 0, yes
2212081663,  andreauaua1, 1, 1, 0, yes
1103812855,  lordbiron13, 20, 8, 12, no
790800665501175808,  MarcoMerlin0, 1, 1, 0, yes
164272724,  lucaverga, 17, 6, 11, no
4733290462,  Fedebiffiliber2, 1, 1, 0, yes
484982764,  carmenluongo1, 6, 4, 2, yes
4829678764,  Vespone_N1, 3, 3, 0, yes
3331220440,  SiamoQuaBcn, 1, 1, 0, yes
1144678758,  rosario_corte, 1, 1, 0, yes
50068659,  SilvioMarinoSan, 11, 9, 2, yes
406877049,  tizianotagliavi, 14, 13, 1, yes
782138334,  SalvaCostanzo, 19, 12, 7, yes
34187758,  MauroKiari, 6, 3, 3, neutral
370727961,  PietroPichierri, 1, 1, 0, yes
356156509,  Tapae_81, 4, 2, 2, neutral
492336250,  GiovanniRizzo11, 4, 4, 0, yes
352304658,  gigidimeodirect, 8, 6, 2, yes
4699832330,  dadolukarich, 1, 1, 0, yes
3183512487,  kludons73, 3, 3, 0, yes
1277182454,  unduetre76, 1, 1, 0, yes
293614669,  alberto_buson, 3, 1, 2, no
120557124,  mbslk67, 2, 2, 0, yes
465339096,  sergiomanenti1, 1, 1, 0, yes
450753841,  BrunoBusco, 5, 5, 0, yes
2185023238,  CsSoldi, 2, 2, 0, yes
613460008,  vittoriocam, 1, 1, 0, yes
948616670,  Salv_Morana, 4, 4, 0, yes
4871321181,  error404err, 5, 3, 2, yes
763032032993742852,  angelino411, 11, 11, 0, yes
22650622,  AMoriconi, 6, 3, 3, neutral
1383872294,  MaestrelliPaolo, 1, 1, 0, yes
1485497036,  LucioCatania13, 6, 6, 0, yes
14701360,  svalex, 4, 2, 2, neutral
2751588826,  rodriquezricca1, 1, 1, 0, yes
2361059236,  Roberto91337084, 1, 1, 0, yes
372433086,  Giobbi64, 4, 4, 0, yes
428216870,  emmeg5, 1, 1, 0, yes
2621438936,  02081952, 1, 1, 0, yes
2373907857,  pastissia21, 6, 3, 3, neutral
105355320,  T_Roox, 12, 9, 3, yes
2212948867,  febodecrepito, 4, 4, 0, yes
2737679113,  consprovenzale, 1, 1, 0, yes
353305472,  RussoRodolfo, 1, 1, 0, yes
310698229,  leonardo_marras, 4, 4, 0, yes
93505568,  andpiera52, 1, 1, 0, yes
2956862217,  alloversrl, 3, 3, 0, yes
131704372,  Davidestefa73, 2, 2, 0, yes
260251757,  salazartieri, 1, 1, 0, yes
2577264482,  VersaciMarina, 12, 11, 1, yes
721656926602399744,  zuppadifagioli, 2, 2, 0, yes
349554491,  BAT29BAT, 3, 3, 0, yes
615491286,  Bimontius, 3, 3, 0, yes
2360518479,  PandiniAle, 1, 1, 0, yes
2628648221,  RMarabelli, 6, 1, 5, no
1680443870,  AlternxItaliaFe, 4, 4, 0, yes
1365472506,  BladeRunner03, 10, 4, 6, no
431080962,  goodsoon6, 1, 1, 0, yes
1173130836,  IngRivoliA, 22, 16, 6, yes
829814995,  marioghini, 2, 2, 0, yes
731093813364723713,  francescoC1979, 5, 5, 0, yes
778495358,  eliseopaola, 1, 1, 0, yes
1192260607,  ladycast_catia, 30, 10, 20, no
774085705,  TotaroMercurio, 6, 4, 2, yes
3033519897,  francescobarat9, 1, 1, 0, yes
280580787,  silviarosai, 1, 1, 0, yes
184375711,  Kociss2010, 1, 1, 0, yes
5460312,  dibigi, 1, 1, 0, yes
4927824592,  Nanyebasta, 4, 4, 0, yes
745522720025128960,  Babushkamaru, 17, 13, 4, yes
724894143688876034,  RapiDa130479, 13, 11, 2, yes
3447326777,  NewsRSN, 1, 1, 0, yes
1056221840,  AAbriola, 3, 3, 0, yes
497215533,  AttilioCotroneo, 1, 1, 0, yes
411735017,  LiberaleMasi, 1, 1, 0, yes
1222608678,  diridolfi, 3, 2, 1, yes
127435541,  sc_1969, 14, 3, 11, no
1215352052,  VetrOskurato, 1, 1, 0, yes
436633476,  Costa_mazza, 2, 2, 0, yes
33205675,  CdGherardesca, 3, 2, 1, yes
863020105,  mdanz72, 33, 14, 19, no
513030568,  2giuss4u, 1, 1, 0, yes
2886106408,  alessandrovr79, 1, 1, 0, yes
728969931853828097,  ArrigoniEdoardo, 12, 12, 0, yes
426044440,  flaviomoro60, 2, 2, 0, yes
608359188,  FPanecaldo, 9, 9, 0, yes
182946752,  collez73, 8, 7, 1, yes
1062780343,  MarianoCasula, 2, 1, 1, neutral
516432515,  marcogaius, 21, 7, 14, no
1267442324,  VaniaFornaciari, 1, 1, 0, yes
558020613,  VZoccheddu, 2, 2, 0, yes
2953487277,  rafrancavilla48, 1, 1, 0, yes
594659714,  alex_pratissoli, 1, 1, 0, yes
627251488,  hynkel_A, 1, 1, 0, yes
3382760081,  hfurms, 13, 3, 10, no
2878690973,  paolocad01, 43, 30, 13, yes
2749367375,  DebbyBiagi, 2, 2, 0, yes
2262483365,  matteofila, 1, 1, 0, yes
716194484200022016,  sannita8, 4, 4, 0, yes
393722104,  fcr71, 2, 2, 0, yes
4192716989,  nigrotoni1, 1, 1, 0, yes
304598010,  marielSiviglia, 89, 28, 61, no
2257120515,  joe_arcturus, 1, 1, 0, yes
3471387317,  ilaria0803, 7, 4, 3, yes
170414906,  lupin32, 2, 1, 1, neutral
1931703270,  difrancescaanto, 1, 1, 0, yes
798602218857435136,  AngeloMusso4, 1, 1, 0, yes
4832530456,  ninidevito1, 4, 3, 1, yes
1412628403,  rafliberali, 4, 4, 0, yes
307566306,  olimp2, 2, 2, 0, yes
770348083343396865,  maurizio_guido, 3, 1, 2, no
202121386,  pitinbonatto, 2, 2, 0, yes
383901382,  Al_Nao, 3, 3, 0, yes
344008672,  stefano_rocchi, 1, 1, 0, yes
760392779533053952,  Gaugamela2, 12, 6, 6, neutral
2450265194,  MRHARLEY69, 16, 5, 11, no
1227045804,  teky59, 5, 3, 2, yes
313300815,  PaolaPivetta, 1, 1, 0, yes
1322645198,  MiriamPrati, 4, 4, 0, yes
47925263,  Giako87, 1, 1, 0, yes
2709647816,  chierici1950, 14, 8, 6, yes
618151340,  peegreco, 3, 3, 0, yes
1069263193,  massimparisi, 8, 8, 0, yes
237675515,  demaanna, 2, 2, 0, yes
224940210,  fannicanelles, 110, 110, 0, yes
760175760,  montanamodi, 1, 1, 0, yes
593976757,  gian_baldoni, 2, 2, 0, yes
392638414,  brollof, 1, 1, 0, yes
772016332615409664,  FMan724, 2, 2, 0, yes
54918493,  glucasala, 2, 2, 0, yes
803939813267304448,  AiuTiAmoGorizia, 2, 2, 0, yes
242461878,  ARTUR0SERRA, 4, 2, 2, neutral
127520006,  fabiozivelonghi, 2, 2, 0, yes
2607883488,  Pballaben1, 1, 1, 0, yes
3015653819,  alpforldan, 1, 1, 0, yes
53478215,  gian73, 5, 4, 1, yes
766525740829413376,  Sabrina09081973, 2, 1, 1, neutral
138029709,  christian_ITA_, 3, 2, 1, yes
501779209,  CiroCisab, 3, 3, 0, yes
799166341794201600,  caffeneroamaro, 1, 1, 0, yes
742292496999419904,  amir_veaposki, 4, 4, 0, yes
760849751608668160,  grazia7773, 7, 4, 3, yes
462417241,  GiancarloPesce, 1, 1, 0, yes
2301664084,  giovanniemilia, 13, 6, 7, no
1123148515,  LorenzoNincheri, 14, 10, 4, yes
3207730047,  4e244a174bce463, 2, 2, 0, yes
230844664,  auras55, 1, 1, 0, yes
800068301300776961,  carli_emilio, 6, 6, 0, yes
783585845106372608,  Paolo72x, 4, 4, 0, yes
558124980,  betta722, 2, 2, 0, yes
2201949219,  marchettagian, 5, 5, 0, yes
714432268761169921,  EuroTonnara, 20, 20, 0, yes
1239637880,  jankovicfvg, 4, 4, 0, yes
1492828722,  pitt971, 5, 5, 0, yes
430992730,  RossanoScaccini, 1, 1, 0, yes
569082778,  AntonioLiberti3, 1, 1, 0, yes
475249879,  massimodorigo, 1, 1, 0, yes
504263726,  antoniataglient, 1, 1, 0, yes
1131205976,  rossodisera14, 2, 2, 0, yes
407870404,  Lucadvmarcos, 4, 4, 0, yes
1040976385,  tatone28, 5, 5, 0, yes
761223170057723905,  brunori_valerio, 4, 3, 1, yes
41611563,  mirkonicolino, 3, 3, 0, yes
464781062,  frensy_f, 6, 6, 0, yes
493568309,  VeronicaT_errei, 10, 10, 0, yes
327361068,  EnricoChirico, 2, 2, 0, yes
443775053,  giuseppepetroce, 13, 5, 8, no
396387534,  Araneo3, 5, 5, 0, yes
246377592,  lupin1955, 7, 3, 4, no
337099500,  patrimell, 3, 3, 0, yes
47917860,  Giovanni_Bozzo, 1, 1, 0, yes
4134072261,  Berto2646, 9, 9, 0, yes
851621720,  BaticElisabetta, 3, 3, 0, yes
2453540430,  elsayedelgendy3, 3, 3, 0, yes
790876052440674304,  ischia1981, 1, 1, 0, yes
592301376,  eledumi, 1, 1, 0, yes
3374587240,  MarafonEmanuele, 3, 3, 0, yes
1601063588,  VitaC53, 3, 3, 0, yes
22895601,  remikijusz, 1, 1, 0, yes
282111513,  loryfelix, 4, 4, 0, yes
1409736301,  ilcjanpete, 43, 12, 31, no
419532396,  cristinabeffa, 1, 1, 0, yes
4342730236,  luigi0650, 1, 1, 0, yes
2842295578,  liviocellucci, 2, 1, 1, neutral
710789773963698176,  Marcopapaleo10, 2, 2, 0, yes
770157263118036992,  GcnBn, 4, 4, 0, yes
575279176,  pellegrino_fra, 3, 3, 0, yes
1398203953,  crispiz1973, 2, 2, 0, yes
453911215,  antoniobruno743, 1, 1, 0, yes
1085405436,  BaioFederico, 7, 7, 0, yes
3437649117,  MariellaMariel9, 1, 1, 0, yes
188865441,  OliverMcPic, 6, 3, 3, neutral
933010074,  turini_andrea, 3, 1, 2, no
711873569895149568,  Mario58673831, 1, 1, 0, yes
1231603440,  lupecchioli, 3, 2, 1, yes
2962238746,  alesgag, 1, 1, 0, yes
517766026,  hullotwetty, 1, 1, 0, yes
1454123221,  maurosartori3, 1, 1, 0, yes
344941448,  massimoankor, 5, 4, 1, yes
500846038,  Filonide76, 3, 1, 2, no
475904046,  alissandrin, 1, 1, 0, yes
387315829,  BPompili, 4, 3, 1, yes
548384553,  SAiello87, 1, 1, 0, yes
412482700,  FrancoRanocchi, 7, 5, 2, yes
2635078149,  fulvio_serbo, 1, 1, 0, yes
2696436896,  criscorvitto1, 5, 5, 0, yes
437789765,  giogrimaldi1952, 2, 2, 0, yes
126728166,  saveforex, 1, 1, 0, yes
483040611,  cpagliani, 1, 1, 0, yes
53438498,  rickyolgiati, 7, 6, 1, yes
4795609529,  annalisabo89, 1, 1, 0, yes
2786881413,  newsalutamu, 3, 1, 2, no
23781410,  magociclo, 1, 1, 0, yes
497384675,  PetraccaMario, 40, 10, 30, no
1330124653,  OrnellaPapitto, 2, 1, 1, neutral
2878223753,  lisi_24m, 15, 2, 13, no
2299452214,  cri2102, 2, 2, 0, yes
498085187,  Meta_Tsouth, 10, 10, 0, yes
172028905,  FATIMACURZIO, 1, 1, 0, yes
504973589,  mariave92602485, 14, 8, 6, yes
4914906047,  AlbertoFabris, 2, 2, 0, yes
487658598,  paolafabbrip, 3, 3, 0, yes
766015385065910274,  DegliaCInzia, 3, 3, 0, yes
4850404991,  edmond644, 5, 5, 0, yes
399337897,  annabuttazzoni, 4, 4, 0, yes
3404575379,  fontanarosano, 1, 1, 0, yes
4582785148,  vona_st, 6, 5, 1, yes
3384452417,  blazo66, 2, 2, 0, yes
802385620786155520,  gmilet3, 3, 3, 0, yes
153081388,  Pier5ba, 1, 1, 0, yes
236397131,  sgravina1, 2, 2, 0, yes
2357809380,  campross67, 1, 1, 0, yes
379791662,  busavin, 6, 6, 0, yes
3040064722,  _diegodamelio_, 6, 4, 2, yes
214634150,  Stefano_Sedrani, 4, 3, 1, yes
906326683,  paologadenz, 4, 4, 0, yes
500592044,  inkkiestadoc, 23, 12, 11, yes
2536995346,  giular28, 1, 1, 0, yes
378594294,  mauro1947, 2, 1, 1, neutral
786280190129283073,  saperloprima, 11, 7, 4, yes
53634013,  maxjuve, 16, 2, 14, no
2623465378,  gabriagrusti, 3, 3, 0, yes
3026585639,  diariodiudine, 6, 5, 1, yes
96089113,  PaoloBilly, 5, 4, 1, yes
755774969162899456,  rossivincen2, 2, 2, 0, yes
716980337159569408,  Emilia65241404, 1, 1, 0, yes
3167163237,  vigliottienzo1, 4, 2, 2, neutral
401238652,  GabrieleLonghi, 1, 1, 0, yes
484135793,  gaetanovinci71, 2, 2, 0, yes
2870991377,  Curioso501, 6, 5, 1, yes
94956249,  rocurri, 2, 2, 0, yes
746425402957135872,  ilcurator, 6, 4, 2, yes
627756711,  mariateresaro16, 4, 3, 1, yes
455562456,  GiovanniLaterz1, 2, 2, 0, yes
2312130859,  GMancarelli, 2, 2, 0, yes
303774933,  cinzialisi, 3, 2, 1, yes
2189827138,  2mbarbara66, 4, 3, 1, yes
783406451092033536,  Alessio44247344, 1, 1, 0, yes
423264962,  udinetoday, 1, 1, 0, yes
4180291971,  Patrizia78l, 5, 3, 2, yes
1139157704,  DinoTrentavizi, 2, 2, 0, yes
3310494263,  jacintocab1, 3, 3, 0, yes
751715726143217664,  older_balder, 8, 8, 0, yes
635401710,  slugaresi, 2, 2, 0, yes
284941914,  luicartin, 3, 3, 0, yes
2174659460,  carolipalladini, 1, 1, 0, yes
1869314520,  DrZio77, 10, 9, 1, yes
2445102772,  GalanoLuigi, 4, 4, 0, yes
3043396313,  GiovannaGpetri, 10, 10, 0, yes
3207714897,  andreaTornix, 5, 4, 1, yes
3205788934,  pdpolitica, 1, 1, 0, yes
2923272508,  teknovoodoo, 2, 1, 1, neutral
2271436581,  FoielliPaolo, 6, 6, 0, yes
1239907388,  F12525570, 2, 1, 1, neutral
34235172,  carolinabit, 2, 2, 0, yes
1088675498,  miciowilly, 7, 5, 2, yes
227339265,  her71mann, 2, 2, 0, yes
482765171,  MauroNardelli, 1, 1, 0, yes
480446420,  giofih, 1, 1, 0, yes
4033980106,  molly4marzo, 4, 3, 1, yes
306969284,  Rama_Marco, 1, 1, 0, yes
81712035,  skaglia05, 1, 1, 0, yes
866515321,  MatteoTacchi, 1, 1, 0, yes
440246396,  28giugno48, 1, 1, 0, yes
866580067,  GiusDella, 6, 3, 3, neutral
710474142,  bebostorti, 1, 1, 0, yes
498125833,  sergiosulmi, 3, 3, 0, yes
1225064317,  maricgrandoni, 2, 1, 1, neutral
990661279,  CaprioliSimone, 6, 2, 4, no
1221991964,  Maleficent84, 1, 1, 0, yes
594361390,  vsona46, 3, 3, 0, yes
364903511,  EmyBertoni, 1, 1, 0, yes
404063825,  galvertalain, 8, 8, 0, yes
449819882,  iPresidente, 30, 27, 3, yes
1309256480,  JulioOak, 1, 1, 0, yes
2909682868,  Valerione76, 7, 6, 1, yes
478135592,  Bea_merda, 5, 3, 2, yes
1044579342,  Mikeleo46, 14, 14, 0, yes
2362318798,  LmMartino82, 1, 1, 0, yes
367308374,  Diabolik1899, 1, 1, 0, yes
323909038,  lotar69, 1, 1, 0, yes
130181213,  maestrale71, 11, 7, 4, yes
3039699201,  BarraFed, 3, 3, 0, yes
772928363585503232,  paolovalrignano, 3, 3, 0, yes
1683090120,  alessandrapln51, 10, 1, 9, no
2156350619,  AlessioSacchet, 1, 1, 0, yes
829546003,  AngeloAmodeo, 6, 6, 0, yes
423564363,  TRIESTEALLNEWS, 1, 1, 0, yes
3055103145,  sonoiltuochef, 10, 8, 2, yes
499102941,  cacciaramarri, 8, 8, 0, yes
3246166239,  valituttanto, 11, 2, 9, no
707252292408512512,  CarmelaGaglian1, 18, 17, 1, yes
701839073145659398,  onydicandia, 1, 1, 0, yes
957962750,  enzosartorello, 40, 26, 14, yes
788772400653631489,  MarcoPoggi13, 1, 1, 0, yes
1690511394,  christ_ciprian, 2, 2, 0, yes
429144484,  gricc1947, 19, 9, 10, no
417993717,  MarcoMagnanoSan, 1, 1, 0, yes
1216645705,  MoriMrc, 1, 1, 0, yes
3067944443,  voicekat77, 8, 5, 3, yes
436184365,  santoplat, 3, 3, 0, yes
1384264394,  FabriBert, 1, 1, 0, yes
384535661,  Sungsam100, 1, 1, 0, yes
481103919,  AntonioProvenz3, 1, 1, 0, yes
1085112558,  olo4all, 1, 1, 0, yes
2375255690,  domenicoxLaura, 5, 2, 3, no
52201553,  R_DegliEsposti, 1, 1, 0, yes
229924590,  speriamotorni, 1, 1, 0, yes
2730005207,  raffaellobuons1, 1, 1, 0, yes
2774316855,  fabio_giugliano, 2, 2, 0, yes
207211184,  ARIZONA49, 4, 3, 1, yes
3315892769,  Marilen31343471, 1, 1, 0, yes
607112247,  claudiocostanzi, 55, 11, 44, no
1484550222,  MagdaZanonii, 7, 6, 1, yes
788338925832110080,  Umberto29597041, 1, 1, 0, yes
373533143,  diaberni, 1, 1, 0, yes
1083729685,  sergiobellato, 7, 7, 0, yes
47398478,  tablerider, 13, 8, 5, yes
3405242003,  Sashathebigcock, 3, 3, 0, yes
3745800203,  tommasoamato27, 3, 3, 0, yes
484956746,  lauramartinagr, 1, 1, 0, yes
83793343,  ArnaldoPetrucci, 13, 13, 0, yes
1231473788,  mauro_arena, 11, 7, 4, yes
995769296,  viamarzabotto, 12, 8, 4, yes
470384469,  ZaninMauro, 7, 7, 0, yes
2847895318,  bellomio95, 8, 2, 6, no
517635978,  giotechno, 19, 17, 2, yes
412615907,  MrLuGav, 1, 1, 0, yes
3172928945,  upskirt_lover2, 1, 1, 0, yes
2919591365,  cimedira, 7, 7, 0, yes
323835105,  salpizzolo, 1, 1, 0, yes
308536892,  MarcoSadun, 4, 2, 2, neutral
63878035,  frankcoc20, 12, 10, 2, yes
4505319742,  giulbaracco, 4, 4, 0, yes
2921151177,  tuttouncasino, 3, 3, 0, yes
783983079597694976,  gianpy50, 6, 3, 3, neutral
406469071,  giuliocampese, 52, 8, 44, no
434988195,  Grober_news, 5, 3, 2, yes
744458832311631872,  Kristiano22882, 5, 3, 2, yes
452457419,  robinzuli, 1, 1, 0, yes
2318573988,  SpiruPancio, 20, 10, 10, neutral
301529365,  vigj72, 1, 1, 0, yes
1224046206,  marialisa_de, 4, 3, 1, yes
2875189398,  luckyluke181067, 2, 2, 0, yes
1251324499,  billy5_s, 3, 3, 0, yes
616170389,  settantaset, 1, 1, 0, yes
432374589,  gianlucaposer, 1, 1, 0, yes
2908032201,  S0ldiPubblici, 11, 3, 8, no
1006980080,  AmorettiMarina, 8, 7, 1, yes
512433054,  RoluasC, 2, 1, 1, neutral
506455745,  perdetutto68, 5, 3, 2, yes
2607487320,  F_il_Magnifico, 15, 15, 0, yes
164837443,  giangerv, 1, 1, 0, yes
57069599,  marcsimon61, 3, 2, 1, yes
45095424,  dubwise74, 2, 2, 0, yes
547890554,  dilul68, 8, 5, 3, yes
372562995,  thomasbrookman, 2, 2, 0, yes
787911490586177536,  OggettoUomo, 4, 4, 0, yes
258024205,  Rositabetha, 1, 1, 0, yes
589053788,  ema_rigitano, 3, 1, 2, no
3938701215,  ericagiacomett7, 2, 2, 0, yes
1484793366,  massyscapicchi, 1, 1, 0, yes
800031968348041216,  Moirafabioluca, 1, 1, 0, yes
941478456,  HKhaang, 1, 1, 0, yes
2323994552,  lararo772, 2, 2, 0, yes
251762468,  bereem123, 2, 2, 0, yes
252585311,  pantycat, 16, 12, 4, yes
1007107039,  DiMarcounico, 4, 4, 0, yes
22960578,  MaurizioM, 1, 1, 0, yes
2869471262,  mrug3364, 6, 6, 0, yes
998818928,  gian_d_gian, 1, 1, 0, yes
410278490,  nicolfiorentino, 4, 4, 0, yes
2224975247,  photAnto, 3, 3, 0, yes
1048232539,  AlessandroZan16, 1, 1, 0, yes
1609040186,  donatofioretti, 2, 1, 1, neutral
82105312,  WINAVIL, 2, 2, 0, yes
480293671,  DIppolitiEnrico, 1, 1, 0, yes
170826091,  MB_1976, 2, 2, 0, yes
4120276461,  CARLO7211341, 1, 1, 0, yes
1137588186,  CiaboMassimo, 3, 3, 0, yes
1315127047,  IacopoCainero, 1, 1, 0, yes
594873448,  michelemuggianu, 1, 1, 0, yes
1040263164,  t_tt_ttt_tttt_, 2, 2, 0, yes
1671189985,  fiore7116, 3, 2, 1, yes
95916616,  usemlab, 3, 2, 1, yes
1638121028,  Niques19, 1, 1, 0, yes
2859495347,  Tuchenesai123, 1, 1, 0, yes
58241595,  salvobracchitta, 33, 24, 9, yes
2214610401,  AmedeoDAlessan1, 4, 1, 3, no
1298431310,  Giu_madhatter, 1, 1, 0, yes
789859112179949568,  somaini_marisa, 2, 2, 0, yes
2754851246,  francobortoli1, 3, 3, 0, yes
1776723175,  milanopulita, 2, 2, 0, yes
3226385187,  mbacci1, 3, 3, 0, yes
499085030,  frasco77, 36, 29, 7, yes
591076649,  PierMarioPozzi, 7, 4, 3, yes
495036664,  AdrianoMiconi, 3, 3, 0, yes
2310559129,  PippoAlessandr1, 14, 14, 0, yes
421953606,  75Galata, 4, 3, 1, yes
2223036664,  rekko15, 11, 8, 3, yes
373784603,  ajumpy, 3, 3, 0, yes
798969768875360256,  LuigiScoponi, 1, 1, 0, yes
2758700275,  DottFerrante, 2, 2, 0, yes
1941539966,  MassimoCampoli, 1, 1, 0, yes
730777400745791489,  antonie19712313, 11, 7, 4, yes
3653319917,  rizzotto_marco, 1, 1, 0, yes
2221874484,  abissi3, 20, 5, 15, no
3058936745,  tracyssima8812, 1, 1, 0, yes
449750843,  valentini81, 1, 1, 0, yes
986686861,  Susycampe, 8, 8, 0, yes
163818204,  DavideMoretti, 4, 4, 0, yes
944665938,  Romoletto72, 103, 41, 62, no
2248757802,  erikpaga13, 2, 2, 0, yes
1044114469,  giampluzi, 18, 7, 11, no
92996440,  sauron72, 19, 3, 16, no
385604119,  MarioPolese, 6, 6, 0, yes
934476271,  LPieceofart, 7, 5, 2, yes
3648147982,  bischerocazzul1, 2, 2, 0, yes
1226101082,  VDiGirgenti, 4, 3, 1, yes
3224669813,  MichelMauriello, 60, 44, 16, yes
949357016,  Mattews94, 3, 3, 0, yes
396750923,  angelabellia, 1, 1, 0, yes
829417766,  ziobucl, 14, 14, 0, yes
373270562,  felix78ud, 1, 1, 0, yes
1240845438,  FlavioPizzolato, 1, 1, 0, yes
3194476737,  MarcoELaico, 11, 11, 0, yes
1155119443,  fiabeschienrico, 11, 6, 5, yes
405631474,  PinoSancris, 4, 3, 1, yes
113491795,  killraf, 2, 2, 0, yes
2558496329,  romanoduccio, 14, 13, 1, yes
2729327680,  mari5217, 3, 3, 0, yes
473950075,  peppecan, 1, 1, 0, yes
445332184,  ABobbiese, 10, 5, 5, neutral
863050874,  CatPiatti, 3, 3, 0, yes
3063216130,  slopis55, 21, 14, 7, yes
429847277,  lageloni, 23, 13, 10, yes
394613,  mante, 5, 3, 2, yes
788770928,  FGuerri, 4, 3, 1, yes
940275222,  Profiterol75, 8, 4, 4, neutral
2281936099,  GAIDORic, 122, 5, 117, no
560046823,  pierocefaloni, 28, 1, 27, no
407661201,  DomenicoTripi, 3, 1, 2, no
1619769668,  GuidoAlberto6, 19, 9, 10, no
774281375402909697,  DonneVdaperilSi, 8, 8, 0, yes
55404019,  Legambiente, 5, 4, 1, yes
2765783097,  chicksandtrips, 2, 1, 1, neutral
219258170,  visitcaorlecom, 2, 1, 1, neutral
2238203192,  mariobeccarelli, 6, 4, 2, yes
1914586842,  ifi1962, 2, 1, 1, neutral
183168354,  superpaia, 3, 2, 1, yes
1875973597,  Eco_Magazin, 2, 1, 1, neutral
331223753,  arcocielo, 10, 2, 8, no
516755582,  nicolettianto, 4, 3, 1, yes
4294368214,  rosyros1962, 7, 5, 2, yes
560401416,  Hazydavey34, 9, 4, 5, no
560447930,  AndreaSaviane1, 18, 9, 9, neutral
2397882503,  gfnevegal, 3, 2, 1, yes
275037373,  Marco_Bonet, 4, 2, 2, neutral
428401163,  giodafaz, 2, 1, 1, neutral
180112128,  sdallagata, 3, 1, 2, no
464979129,  RaiaPasquale, 2, 1, 1, neutral
724477963,  SiamolaGente, 6, 3, 3, neutral
499186279,  Studentiper_Uni, 6, 3, 3, neutral
1150658946,  LegacoopVeneto, 4, 2, 2, neutral
4783916222,  viliamdbr, 4, 1, 3, no
1145390935,  borghial, 6, 4, 2, yes
2935626166,  Beverari_M, 7, 2, 5, no
2886860662,  fabyo40, 5, 1, 4, no
265903575,  APEOnlus, 9, 4, 5, no
1324893229,  zaiapresidente, 4, 2, 2, neutral
1499706972,  PasqRomano, 12, 6, 6, neutral
523255151,  virginiaftt, 2, 1, 1, neutral
854301498,  ConfcoopVeneto, 2, 1, 1, neutral
552518291,  ImocoVolley, 2, 1, 1, neutral
698226027756126210,  mmayr5, 71, 32, 39, no
804217770,  GiovArtiVE, 2, 1, 1, neutral
574568329,  ValerioBasalico, 4, 2, 2, neutral
1657995446,  MattiaLore29, 2, 1, 1, neutral
2660165421,  chiaralea14, 2, 1, 1, neutral
4860266019,  DreewMi, 14, 10, 4, yes
732223871529668609,  UsrVeneto, 10, 5, 5, neutral
717268101,  OnofrioRota, 6, 3, 3, neutral
2801467724,  ConfVeneto, 12, 6, 6, neutral
533690230,  vale_cittadin, 7, 4, 3, yes
351865559,  tizianobarone, 2, 1, 1, neutral
618119776,  UduVenezia, 4, 2, 2, neutral
995849594,  BuffoloJacopo, 4, 2, 2, neutral
756071598730477570,  peopleinjoy, 4, 2, 2, neutral
2265849538,  ale_asmundo, 2, 1, 1, neutral
542421730,  RedSMVeneto, 8, 4, 4, neutral
537275178,  alimentandonews, 4, 3, 1, yes
64696087,  Matteo2222, 7, 6, 1, yes
22495498,  Filippo_Nani, 12, 9, 3, yes
590296051,  AnnaAzzalin, 12, 8, 4, yes
717789567,  unsintagma, 7, 1, 6, no
2205598141,  marinacerioni, 23, 4, 19, no
1382206622,  FulvioGhio, 121, 2, 119, no
489353341,  PaolaLaSala1, 2, 2, 0, yes
326922978,  DavideGBianchi, 1, 1, 0, yes
745228268,  carlo647, 17, 15, 2, yes
766714182804836352,  G6298801945, 2, 2, 0, yes
3356427399,  Gianrocco5, 8, 8, 0, yes
1099302026,  LucaBassignana, 2, 2, 0, yes
491318883,  francescopolica, 38, 14, 24, no
2942381427,  zianonnaterri, 72, 37, 35, yes
233245609,  r_grossi, 14, 10, 4, yes
1870754606,  guerini_lorenzo, 5, 5, 0, yes
2911204708,  stefanobruscoli, 1, 1, 0, yes
480635666,  CarminePel, 3, 3, 0, yes
450637944,  ClaCucciatti, 1, 1, 0, yes
1549023900,  PositivoCoach, 3, 3, 0, yes
149097320,  DMBSchuster19, 30, 16, 14, yes
225423130,  Loupo85, 5, 4, 1, yes
514633070,  doddisalvatore, 1, 1, 0, yes
262592818,  ildavideferrari, 3, 3, 0, yes
703708224168599552,  AlessiaPurrone, 55, 25, 30, no
389076701,  medicojunghiano, 38, 20, 18, yes
799154116236865536,  tutoromul, 3, 3, 0, yes
131376735,  maruescala, 1, 1, 0, yes
2731197053,  chrcapuano, 76, 5, 71, no
922785494,  ferdisarno, 3, 1, 2, no
1058212146,  flaviabertoliss, 4, 2, 2, neutral
730858206830985216,  ficchinicchi, 7, 3, 4, no
4449871396,  andreaf31593441, 8, 3, 5, no
18484129,  galluccio, 9, 7, 2, yes
4120176819,  carmetrop, 7, 3, 4, no
2208802430,  denny_scarano92, 8, 4, 4, neutral
50625691,  nicolafavrin, 15, 3, 12, no
365105383,  TiroAcampari, 15, 11, 4, yes
188257090,  LucaGava, 3, 1, 2, no
854615178,  MissMartaOh, 3, 1, 2, no
397278990,  LorenzoAgresti, 9, 3, 6, no
28787275,  letissja_, 3, 1, 2, no
551084841,  ChiaraNews, 4, 1, 3, no
761047603,  SaraCintelli, 7, 2, 5, no
527830076,  AnfameFracico, 3, 1, 2, no
22621322,  placeinthesun, 3, 1, 2, no
2817088916,  signammancell, 21, 10, 11, no
3353589214,  tulipano_anna, 1, 1, 0, yes
4221091641,  porcokant, 8, 4, 4, neutral
955289912,  efisioassorgia1, 2, 1, 1, neutral
1405748826,  _Forza_Italia_, 43, 5, 38, no
2327373751,  Fi_Pdl_Senato, 31, 3, 28, no
487751312,  _paolo_romani_, 4, 1, 3, no
24699941,  idonea2volte, 3, 0, 3, no
22842432,  stefanoaurighi, 12, 11, 1, yes
384760605,  QuiMediaset_it, 6, 5, 1, yes
270877772,  DavideDiNoi, 28, 20, 8, yes
764362441757188100,  izzifede, 3, 2, 1, yes
1499227555,  medlivefp, 8, 7, 1, yes
1041739064,  GiulianoPoggi, 2, 1, 1, neutral
1543396879,  Jd2Tolosa, 2, 1, 1, neutral
2967886673,  FoxyBiondi, 91, 6, 85, no
258322414,  davide_silipo, 6, 5, 1, yes
389131517,  Kuzzo74, 6, 2, 4, no
796980229768093696,  Caiobonus23, 23, 8, 15, no
3743344103,  mariocolombo65, 18, 8, 10, no
2948661737,  giannonefp, 15, 4, 11, no
2294481057,  Frances70338962, 3, 0, 3, no
2191938685,  mariaan99531581, 24, 5, 19, no
2177262113,  TTore58, 23, 15, 8, yes
425264862,  IvanCuocolo, 5, 5, 0, yes
3318592725,  stanchissimo79, 3, 3, 0, yes
1562464483,  RafPatierno, 4, 4, 0, yes
3121373825,  KyrraKyrra14, 3, 3, 0, yes
420258738,  AlbertoFirmani, 3, 2, 1, yes
163409464,  uddue, 7, 7, 0, yes
368625261,  MassimoGranucci, 3, 3, 0, yes
2518864693,  Mocione, 3, 3, 0, yes
3145614550,  CammaVit, 8, 6, 2, yes
293110572,  F_LaParola, 6, 4, 2, yes
2150833213,  stefanopdci, 9, 4, 5, no
740652667425415169,  jokingjester93, 3, 3, 0, yes
2500415726,  Dennis_DeSantis, 2, 2, 0, yes
2917195101,  nives_neve, 4, 3, 1, yes
520432536,  alebosgallagher, 2, 2, 0, yes
2426793043,  SkillnoKill, 2, 2, 0, yes
2865752314,  Irridente, 20, 19, 1, yes
385370606,  roby7291, 5, 5, 0, yes
596325565,  blackbart6996, 2, 2, 0, yes
313535468,  frez_ettore, 3, 2, 1, yes
2958925781,  gcatenazzo1, 14, 10, 4, yes
2810546613,  hondanomala, 7, 7, 0, yes
2893494551,  RafLindia, 2, 2, 0, yes
3311899985,  yuiojgrc, 2, 2, 0, yes
4079216536,  Cittadino_Kane, 4, 3, 1, yes
65316505,  BabuShenoy, 5, 5, 0, yes
898218318,  RoccoPierri, 2, 2, 0, yes
405568547,  alessandromusc1, 3, 3, 0, yes
247343944,  serenatamburi, 2, 2, 0, yes
99273214,  angelodiana2, 4, 2, 2, neutral
257999001,  BerserkGatsu82, 4, 4, 0, yes
3437143409,  raffygiannella, 3, 3, 0, yes
987292123,  elenaditizio, 2, 2, 0, yes
634407554,  enzo6272, 2, 2, 0, yes
291661550,  dan1nolo, 2, 2, 0, yes
2820331583,  fabiopeluso3, 5, 5, 0, yes
2917914052,  Mr__Underhill, 3, 3, 0, yes
418236949,  frankshoes, 4, 4, 0, yes
534519434,  Pocayloca, 4, 4, 0, yes
428494406,  PierpaoloBruno, 2, 2, 0, yes
206592017,  Achille2389, 2, 2, 0, yes
1513658822,  Giov1983Aruta, 8, 8, 0, yes
497739457,  carpitwit, 5, 4, 1, yes
532601618,  MIRKA_PETRELLI, 9, 7, 2, yes
411487794,  SimoneGimona, 2, 2, 0, yes
2864302236,  luigi_orco83, 8, 8, 0, yes
752726608272846849,  antonioproiet14, 11, 3, 8, no
775416857796997120,  ciccioturano77, 7, 5, 2, yes
736299738241306624,  2_Broke_Boys, 60, 49, 11, yes
351816581,  kokopak, 5, 3, 2, yes
210906949,  Ginola_, 2, 2, 0, yes
418743064,  MattiaChetta, 10, 5, 5, neutral
4163509408,  hot_rats92, 2, 2, 0, yes
786870784841089024,  dubb_io, 6, 6, 0, yes
586921074,  lauratrevisi, 12, 11, 1, yes
428364426,  archguccione, 8, 3, 5, no
943709785,  ferrarellia, 5, 5, 0, yes
2191053715,  saldiacono70, 2, 2, 0, yes
542957424,  GornatiPaola, 4, 3, 1, yes
2420690215,  MauriceUtr92, 16, 7, 9, no
782228826847899648,  ClaudiaPagliar5, 152, 133, 19, yes
132525437,  Paolo_Puzzella, 4, 1, 3, no
319620609,  EdoardoSemmola, 6, 2, 4, no
305204306,  taddeovaio, 4, 1, 3, no
53747091,  pier_m, 3, 1, 2, no
219406236,  utique_eu, 46, 5, 41, no
771042114188742656,  giuliorossigno1, 26, 6, 20, no
500929319,  ruttodibosco, 5, 4, 1, yes
1556086555,  theBsaint, 10, 4, 6, no
2181304610,  ITALOPTIMUM, 12, 4, 8, no
444398234,  digiancamillo, 4, 1, 3, no
799905556832063489,  Angela2Patane, 11, 11, 0, yes
788462570827022340,  Elvira68389439, 28, 28, 0, yes
619798896,  giuseppegprete, 27, 27, 0, yes
784500022410969088,  MaurizioBilli17, 141, 52, 89, no
453165039,  ferdi_uliano, 1, 1, 0, yes
2953240439,  ZanoccoM, 1, 1, 0, yes
265134918,  GiulianoHughes, 1, 1, 0, yes
418570052,  simoneliti, 1, 1, 0, yes
422760961,  massimilianono2, 1, 1, 0, yes
3147439475,  AugustoBisegna, 4, 2, 2, neutral
1008174356,  RosariaBonacina, 1, 1, 0, yes
776306961604284416,  GianfrancoMicc1, 2, 1, 1, neutral
584826275,  EvangeliGerardo, 1, 1, 0, yes
2869496771,  GennaroAloisio, 1, 1, 0, yes
1460088601,  RewindFim, 1, 1, 0, yes
516778754,  _povero, 30, 25, 5, yes
2764922373,  andis14568, 1, 1, 0, yes
591978502,  RobertaRoncone, 2, 2, 0, yes
2881874930,  FimToscanaNord, 2, 2, 0, yes
3873877475,  paola91825279, 10, 6, 4, yes
276698656,  catlatorre, 1, 1, 0, yes
568417331,  antofix, 1, 1, 0, yes
1206184754,  Tuberosabianca, 1, 1, 0, yes
3346569904,  orsodicaneva, 20, 11, 9, yes
717984836401643520,  MLLSabbadini, 9, 9, 0, yes
3026496574,  DonneCgil, 4, 4, 0, yes
341097129,  maschera, 3, 1, 2, no
3654048027,  mo_sorte, 6, 1, 5, no
271025245,  MSilviaSacchi, 1, 1, 0, yes
1015929313,  PalumboPatrizia, 8, 2, 6, no
1086493584,  VittorioAgnese, 1, 1, 0, yes
2288794280,  Apocalisse23, 10, 1, 9, no
275628974,  pensierosecondo, 4, 4, 0, yes
47907492,  MBernacconi, 9, 9, 0, yes
970054074,  fra2009100, 11, 8, 3, yes
491327107,  BentivogliMarco, 2, 2, 0, yes
36030252,  VITAnonprofit, 2, 2, 0, yes
1704116298,  aureliapace11, 5, 4, 1, yes
356378416,  FrancescoTedes2, 1, 1, 0, yes
2831366043,  MarcAugliera, 54, 3, 51, no
377249170,  Rosenkavalier70, 2, 2, 0, yes
3295401159,  laroccafimcisl, 1, 1, 0, yes
1480630934,  GioOttomano, 1, 1, 0, yes
702284183,  VVerrascina, 1, 1, 0, yes
439386203,  dentistalegnano, 13, 13, 0, yes
1037730840,  a_maruska_m, 6, 3, 3, neutral
392041682,  DaniloLanzi, 1, 1, 0, yes
1877213636,  opssila, 2, 2, 0, yes
162432623,  CarloCattaneo, 4, 4, 0, yes
630524940,  DedeVincenzo, 17, 4, 13, no
2797440824,  Run_Man_, 5, 3, 2, yes
570045852,  MarchesiFranco, 22, 7, 15, no
999320468,  BerteroG, 9, 5, 4, yes
797805269539520512,  Tina6893, 234, 25, 209, no
1125077892,  teresadelgiudi, 12, 3, 9, no
795593003742220288,  voltair15, 6, 4, 2, yes
1100633432,  BilottaFranco, 8, 1, 7, no
1435196936,  RafTris, 7, 4, 3, yes
989645683,  BibiBec, 23, 8, 15, no
410210301,  fabio200908, 9, 5, 4, yes
10907112,  gky, 2, 1, 1, neutral
1392080886,  AnnaTavano, 8, 5, 3, yes
781834809408651264,  frances0755631, 2, 1, 1, neutral
3466496175,  bottazzo_davide, 2, 1, 1, neutral
795352402262114305,  paoloscuro, 2, 2, 0, yes
226491336,  SSLAZIO1900SS, 3, 2, 1, yes
83326299,  dk768, 17, 5, 12, no
714081957,  GmaiSilvio, 1, 1, 0, yes
2339316667,  gr_grim, 6, 5, 1, yes
467659856,  nickyangeli, 30, 13, 17, no
723993776008605696,  BarbaGiampi, 1, 1, 0, yes
969081366,  tatianabasilio1, 5, 3, 2, yes
1089745982,  Mnemo2, 3, 2, 1, yes
133366702,  nicola_bianchi, 8, 3, 5, no
2784514879,  saxone609, 1, 1, 0, yes
1394952978,  alessio_54, 10, 4, 6, no
738414815660670976,  blu_mirtillo, 4, 3, 1, yes
13423502,  Maria_Piera, 2, 2, 0, yes
2746586057,  AMedaglini, 12, 9, 3, yes
398611235,  chiara_201181, 21, 3, 18, no
14398193,  ikol22, 8, 4, 4, neutral
468356881,  spotclod44, 14, 4, 10, no
758372531392901120,  cricolombo74, 2, 1, 1, neutral
3334952776,  TGPorco, 15, 11, 4, yes
462353930,  MMariagiovanna, 2, 1, 1, neutral
31880558,  grmnsnxxxco, 6, 3, 3, neutral
307030677,  FabriziaGallo, 2, 1, 1, neutral
244582346,  aereorapace, 6, 3, 3, neutral
118178579,  nazca27, 6, 1, 5, no
702455771670380544,  ILCHE5, 18, 17, 1, yes
538946856,  AntonellaBerar4, 3, 1, 2, no
525733847,  leovitoantonio1, 38, 27, 11, yes
293964664,  fabio_sandri, 10, 7, 3, yes
132211267,  bernardinitw, 2, 1, 1, neutral
1729146290,  DomenicoVerago, 3, 1, 2, no
236333273,  lillyhami, 17, 3, 14, no
244477620,  Massa5Stelle, 10, 2, 8, no
910294460,  Ignaz_Goronsky, 1, 1, 0, yes
4340881457,  Tombstone46, 3, 2, 1, yes
1421381328,  HerrProof, 23, 5, 18, no
2514624711,  G_Chinellato, 4, 3, 1, yes
3069933261,  domenicomanzo87, 14, 8, 6, yes
1443750158,  WalterKowalsky1, 3, 2, 1, yes
3395550653,  onazaren, 3, 3, 0, yes
22602333,  edn__, 2, 2, 0, yes
90849691,  amadeuscorsaus, 15, 14, 1, yes
1118805018,  giord_mar, 5, 4, 1, yes
725557127872417792,  luciolucio1953, 42, 9, 33, no
102223854,  omnologos, 1, 1, 0, yes
851233315,  LuzPagoda, 24, 3, 21, no
228863976,  pieronic, 1, 1, 0, yes
3307303701,  illeggibile, 2, 1, 1, neutral
529745696,  MicheleFaioli, 1, 1, 0, yes
423327600,  calalaruta, 8, 8, 0, yes
802990670159970304,  jeangoccetto_2, 14, 14, 0, yes
428215064,  LaviniaDixit, 1, 1, 0, yes
144114581,  BeppeGar, 1, 1, 0, yes
838332596,  ser_enella, 1, 1, 0, yes
2158195314,  F_Castellucci, 19, 5, 14, no
753901145366626304,  stefanoioele, 32, 10, 22, no
407726930,  Sergiopater, 1, 1, 0, yes
2215701370,  FiorellaBangraz, 33, 3, 30, no
438634199,  machedavero, 7, 4, 3, yes
1114848306,  MaoMaselli, 2, 1, 1, neutral
845781758,  raffo1900, 66, 6, 60, no
521798851,  sebanderas, 10, 7, 3, yes
756873097622552576,  emanuelasaccen2, 1, 1, 0, yes
418932368,  Riccardoet, 3, 2, 1, yes
1704854190,  GaProfgio, 57, 8, 49, no
574560605,  AdrianoGenka, 4, 3, 1, yes
870647947,  ANTIPOLLITICA, 64, 22, 42, no
427583657,  NikosMamoutis, 7, 3, 4, no
109216039,  Eliobor, 16, 8, 8, neutral
805176330367172608,  ilcamo23, 2, 2, 0, yes
522135908,  agidulfo, 1, 1, 0, yes
2342630384,  ellygatta81, 28, 20, 8, yes
744902750073421824,  ZANNIN17, 2, 1, 1, neutral
451416799,  amargosa7, 2, 2, 0, yes
925137320,  Enzo_Altieri, 12, 9, 3, yes
75155781,  alepaganotwit, 22, 11, 11, neutral
488339106,  ANNAMARIAPOMARE, 98, 21, 77, no
54209383,  ciccian, 8, 5, 3, yes
993135720,  AquilaRossa3, 6, 1, 5, no
1119430706,  LuigiTranquill, 30, 9, 21, no
770611373713854464,  Gabriel13111961, 8, 3, 5, no
2331718804,  GiovanniToti, 10, 5, 5, neutral
3019669299,  e79f53507876409, 15, 6, 9, no
799340178854866944,  giusepp55986457, 20, 9, 11, no
402140522,  stefanogianell1, 6, 4, 2, yes
1238504988,  susialdo, 5, 3, 2, yes
14270140,  carlopiana, 3, 3, 0, yes
753173071515836416,  PaoloPiercecchi, 2, 1, 1, neutral
432031665,  MarlyKohime, 5, 4, 1, yes
417094530,  eliadallaglio, 8, 7, 1, yes
797599806319448064,  francoape, 6, 5, 1, yes
1699649724,  LorenzoWVilla, 3, 3, 0, yes
1426319126,  Paolo_Calloxi, 6, 2, 4, no
4055569005,  davidivad66, 1, 1, 0, yes
706768881625513984,  MarcTirinnanzi, 11, 8, 3, yes
3015642023,  marizar_ud, 29, 19, 10, yes
1488327588,  Sam5stelle, 9, 3, 6, no
3127610290,  emaparr, 9, 5, 4, yes
381964547,  fairybloom1, 2, 1, 1, neutral
16615233,  armgra, 3, 1, 2, no
437537959,  CiccioMazzotta, 3, 3, 0, yes
1227624775,  AntoniaFischio, 20, 10, 10, neutral
743782951285043200,  mattdra76, 22, 12, 10, yes
1264214780,  lrcasanova1, 15, 5, 10, no
712430076311314433,  RollyRenzi, 62, 10, 52, no
1077110826,  YanezTweetMan, 2, 1, 1, neutral
14162223,  amalianita, 19, 17, 2, yes
4195937194,  paolo_sommariva, 4, 3, 1, yes
2350203541,  FioriMarcello, 25, 2, 23, no
2984362528,  CioceSilvia, 4, 3, 1, yes
3387135933,  AltraItaliaSB, 35, 14, 21, no
775301877512675328,  dario_dibordo, 154, 16, 138, no
1960868090,  ForzaItaliaRM, 308, 29, 279, no
775299421705732097,  PaolettaSabe, 158, 17, 141, no
2221318495,  SilvioSaleri, 119, 17, 102, no
2221331701,  Spagnolo_S, 200, 20, 180, no
2432208854,  CarolinaPetitti, 200, 16, 184, no
2221319742,  FraSoriano27, 173, 17, 156, no
756085177709916161,  ComitatoNoRoma, 234, 32, 202, no
2221331347,  FrancescoPotril, 125, 17, 108, no
1725558426,  _TV_Watch, 167, 24, 143, no
775632857993797633,  DiBattistaVale, 155, 16, 139, no
789012950585643008,  FreeNews_Online, 45, 13, 32, no
775294620259483648,  LuStuffo, 126, 18, 108, no
776003975921401862,  FanCluBrunetta, 141, 19, 122, no
368588066,  LorenzoZL74, 14, 10, 4, yes
2949739355,  a_stima, 9, 5, 4, yes
4914230231,  AnnaCarrano5, 21, 6, 15, no
409448246,  SerpicoFra, 127, 5, 122, no
997586305,  vitube8991, 5, 5, 0, yes
1521671185,  RidolfiSabrina, 58, 4, 54, no
2466256099,  CristianaQ69, 11, 1, 10, no
2922539446,  depaoli_tiziano, 9, 3, 6, no
947694301,  chiarafasano3, 2, 1, 1, neutral
46887047,  michelemaffei_, 10, 6, 4, yes
2589653764,  ar_cavaliere, 28, 18, 10, yes
1228485109,  AlbrigoAndrea, 12, 4, 8, no
1581362773,  PamelaPaparoni, 8, 8, 0, yes
2523336293,  marcelgiorda, 13, 6, 7, no
725325711846825984,  gabriellaTS2, 2, 1, 1, neutral
407003733,  LoredanaTaddei, 5, 4, 1, yes
2840929653,  metacognizione, 2, 2, 0, yes
1159982192,  FabioMartina72, 9, 7, 2, yes
347764181,  GambiniStefano, 4, 2, 2, neutral
22130099,  mowkina, 2, 2, 0, yes
136225328,  Ponzietto, 20, 6, 14, no
1057840633,  FerrfabAvv, 10, 10, 0, yes
102804357,  lpasquarelli010, 3, 3, 0, yes
1145835457,  marinaM5S, 10, 4, 6, no
3004141911,  mariopedretti5, 2, 2, 0, yes
376998975,  patriziaguidett, 2, 2, 0, yes
4063380377,  Brasviz1, 52, 25, 27, no
471893357,  AntonellaVeltri, 1, 1, 0, yes
453813069,  AlRobecchi, 7, 5, 2, yes
777112460415406081,  OrinailMerlo, 2, 1, 1, neutral
2429027969,  AnnaAnnaritabo, 27, 7, 20, no
54848505,  trading975, 1, 1, 0, yes
3620391615,  LucchiRina, 2, 2, 0, yes
6322582,  a_monteleone, 3, 1, 2, no
3024022989,  UrbanGaps, 20, 14, 6, yes
532572724,  Luca_Fantuzzi, 17, 16, 1, yes
1264718174,  millaadelaide, 78, 65, 13, yes
1341901291,  gianmarconic, 2, 2, 0, yes
510211619,  ARicciardi87, 7, 6, 1, yes
3302171225,  PinoTor64, 1, 1, 0, yes
584857010,  gabriconni, 1, 1, 0, yes
2203429105,  SardusAutocton, 6, 5, 1, yes
3242281907,  silvana_59, 10, 7, 3, yes
1263909744,  1958Aldo, 4, 3, 1, yes
785825867012444160,  Giovanna29908, 16, 4, 12, no
268463193,  AnddhreaDeLuca, 2, 1, 1, neutral
406324316,  fgangelini, 2, 2, 0, yes
484622821,  kingiRie77, 2, 2, 0, yes
2957106160,  anli65_angela, 3, 3, 0, yes
14700959,  pjbury, 2, 2, 0, yes
304560022,  SalVolpicelli, 1, 1, 0, yes
2872007299,  guidosfe, 48, 25, 23, yes
3050657679,  CChiara80, 5, 4, 1, yes
3802266503,  FondazioneBV, 1, 1, 0, yes
800409968021098496,  DalilaFoglia, 6, 6, 0, yes
68356587,  flaviofelice, 1, 1, 0, yes
753855753119817732,  Mellino_U, 4, 2, 2, neutral
2815038046,  antonellasempre, 1, 1, 0, yes
1943435372,  ostoreros, 2, 2, 0, yes
565727870,  92Richmond, 3, 2, 1, yes
955561676,  Marcostoppa92, 3, 1, 2, no
16867526,  SabinaGuzzanti, 6, 4, 2, yes
2286354934,  AntonioBurrasca, 9, 8, 1, yes
33160759,  NMasiani, 3, 2, 1, yes
112010082,  Hyodyo, 3, 1, 2, no
4160599461,  mariuskrossi1, 142, 53, 89, no
772136635928633344,  AntiVacuo92, 17, 16, 1, yes
1418976222,  BocchiniLuca, 32, 4, 28, no
495441382,  paolaparm, 2, 2, 0, yes
2300311050,  balduroberto, 87, 19, 68, no
782889902589485056,  Carmelo57255972, 3, 3, 0, yes
1390614042,  AaaaaUrsula, 15, 4, 11, no
633601330,  vitaindiretta, 9, 6, 3, yes
1969148101,  SegSocialeRai, 1, 1, 0, yes
4248456317,  ManilaciMN, 2, 1, 1, neutral
1228029926,  larca59, 12, 10, 2, yes
405620123,  Ida_____, 3, 1, 2, no
183812823,  _MarcoGualtieri, 10, 9, 1, yes
754440616487055364,  rodolfo_remondi, 9, 7, 2, yes
14900051,  drlectar, 29, 4, 25, no
475021007,  loucattani, 7, 6, 1, yes
2306454341,  Cocapolitik, 1, 1, 0, yes
2341987590,  stat_wald, 6, 5, 1, yes
1041842736,  GianniCARLOTTA, 1, 1, 0, yes
2191542633,  CalogiuriL, 2, 2, 0, yes
1655058528,  vincensco, 3, 2, 1, yes
3387294747,  luigia79p, 8, 2, 6, no
358200513,  selliamar, 3, 2, 1, yes
623993932,  Pietro0676, 5, 5, 0, yes
417461282,  massimoschiliro, 6, 6, 0, yes
376310225,  gigitudine, 20, 5, 15, no
2414596461,  avellino53, 22, 8, 14, no
540078984,  rominarossi14, 1, 1, 0, yes
307819050,  pensareliberi, 5, 4, 1, yes
2221118662,  francogriffo62, 2, 2, 0, yes
2811397962,  valentinopas, 2, 1, 1, neutral
30873105,  petronip, 4, 4, 0, yes
1386737474,  Angiolara, 5, 2, 3, no
2887792900,  lukegiaco, 2, 2, 0, yes
3407360374,  Titty_Gaudio, 19, 19, 0, yes
795764425697488896,  fritatalover, 8, 6, 2, yes
385130841,  PolaDir, 35, 34, 1, yes
987421129,  Penelope1915, 2, 2, 0, yes
722794470,  PetroneIvan, 8, 7, 1, yes
390040304,  eclipsedlunatic, 4, 3, 1, yes
573648634,  ElenaPellegrin7, 8, 4, 4, neutral
1858411734,  triolo_antonio, 11, 9, 2, yes
1430162268,  sferriam, 32, 4, 28, no
104764195,  rostili, 3, 3, 0, yes
801526539817013248,  peglorioso, 6, 4, 2, yes
291018700,  EliotWind, 4, 1, 3, no
55403428,  S_T_04_09, 4, 2, 2, neutral
4684962704,  Antonel29395200, 86, 86, 0, yes
771197191,  claryvic, 13, 4, 9, no
360748546,  rbonacina, 7, 7, 0, yes
231200390,  oilforbook, 1, 1, 0, yes
752185006517346304,  europeiperilsi, 4, 4, 0, yes
544183052,  ctoniarch, 3, 2, 1, yes
421792769,  ronchigiovanni, 2, 2, 0, yes
133297534,  ChiaraPottini, 2, 2, 0, yes
1409815622,  GagliardiGius, 4, 4, 0, yes
2182403667,  saraosalvatore, 35, 16, 19, no
3347021776,  LombardiPel, 1, 1, 0, yes
973647258,  AntPietrangeli, 2, 2, 0, yes
1854556328,  PireddaMa, 36, 14, 22, no
2877035033,  maxxam66, 3, 1, 2, no
112262850,  Antomiozzo, 1, 1, 0, yes
319074916,  UbaldoLorenzo, 11, 8, 3, yes
520826737,  CCivetta, 15, 9, 6, yes
48182327,  ofrakia, 6, 4, 2, yes
782907556159221760,  neuroperplesso3, 22, 14, 8, yes
508008536,  Filolella, 4, 2, 2, neutral
42603583,  wwwDARIOVEROcom, 5, 1, 4, no
1308988975,  ilFrancoTirator, 7, 7, 0, yes
2318486375,  EmanuelaOmal12, 13, 6, 7, no
953503003,  star_ard, 1, 1, 0, yes
2367128011,  amici_p, 8, 4, 4, neutral
63523101,  Wally_80, 1, 1, 0, yes
1627031726,  carmentpf, 77, 41, 36, yes
427804855,  Giuseppe4g1, 32, 4, 28, no
1173008125,  zioerny, 1, 1, 0, yes
706217983862054913,  marcoconti1973, 26, 9, 17, no
1169471665,  SilvioFrasca, 3, 1, 2, no
399938605,  JuryCitera, 4, 4, 0, yes
153700119,  Padulo69, 32, 22, 10, yes
168586183,  GBenamati, 5, 5, 0, yes
439454885,  GianniVukaj, 1, 1, 0, yes
564360716,  Fabme0801, 51, 16, 35, no
496948669,  SilviaGiomi, 7, 3, 4, no
2429443561,  matteibarbara1, 19, 15, 4, yes
174345617,  donvaccarelli, 2, 1, 1, neutral
490218504,  profmaresca, 1, 1, 0, yes
120812398,  silvidll, 3, 2, 1, yes
784909327387783170,  gciccar78, 9, 4, 5, no
453712873,  fab2563, 9, 2, 7, no
2224787402,  PaolaAterini, 6, 0, 6, no
797053138326945792,  PinoFummo, 46, 1, 45, no
738345206056128512,  Franksognatore, 4, 0, 4, no
1339529246,  ufogufo, 53, 6, 47, no
2175102489,  ferdan1970, 3, 0, 3, no
39239835,  ales_fama, 30, 1, 29, no
737351757819486208,  ceraroma2016, 7, 0, 7, no
1018416800,  gianninipiero, 4, 0, 4, no
2834036535,  labyrynthique, 4, 0, 4, no
585554400,  Plyrique, 5, 0, 5, no
1699586232,  PTinello, 23, 12, 11, yes
1923814338,  luiginic73, 4, 1, 3, no
792019525,  michelevenezia2, 3, 0, 3, no
508213354,  DomenicoAuci, 6, 3, 3, neutral
3434003098,  invisibile1959, 15, 6, 9, no
956969354,  corsaro47, 24, 6, 18, no
721143737770971136,  ApriGli_Occhi, 11, 4, 7, no
759601758,  HotmaMomi, 4, 0, 4, no
781846768661192704,  ManiniGiancarlo, 3, 0, 3, no
4890070021,  pane_nero, 7, 0, 7, no
1510536295,  merten_65, 5, 1, 4, no
1043011003,  ceciliavalent12, 29, 4, 25, no
553449880,  Hobgoblin3964, 3, 0, 3, no
1026539899,  irwinsmileaw, 3, 0, 3, no
1962856872,  le3scimmiette, 14, 2, 12, no
795177099392909312,  Enzopiz1, 5, 0, 5, no
3386077780,  foi_guido, 10, 3, 7, no
3345500597,  DiBaYsusHnos, 6, 0, 6, no
2721656760,  vorto752, 3, 0, 3, no
23724160,  yuuraku, 3, 0, 3, no
770010584033140736,  shokan1966, 4, 0, 4, no
1698522818,  M5STreviso, 9, 0, 9, no
3106260993,  STEFANIALOVE69, 5, 2, 3, no
738344440851468288,  ilbomba_, 27, 1, 26, no
2706185665,  Oscar4Marilyn, 11, 4, 7, no
761303645518499840,  DaniloBigonzi, 67, 3, 64, no
526894466,  willi752003, 8, 0, 8, no
765965375792148480,  BaffoJak, 72, 2, 70, no
2569703055,  deepakbaiocchi, 21, 5, 16, no
2400269172,  capotecnico, 8, 0, 8, no
708755071861964800,  PariniAlberto, 11, 0, 11, no
2302888393,  e_cozzolino, 13, 0, 13, no
169566296,  GianniVaretto, 4, 1, 3, no
584022845,  pdrmsmm, 57, 3, 54, no
2942183974,  CiniselloBM5S, 11, 1, 10, no
160011017,  Dix73, 62, 2, 60, no
517672213,  LorellaTotaro, 15, 1, 14, no
117402258,  cocorieo, 3, 0, 3, no
85167868,  danieleprato, 14, 3, 11, no
1045573032,  rosadep, 45, 2, 43, no
3914047581,  Italians4Trump, 17, 3, 14, no
711634646933618688,  gtagliente511, 7, 0, 7, no
177338309,  JorgeBlst, 4, 0, 4, no
142690511,  borrellidavid, 6, 0, 6, no
3300846436,  giulivi_luca, 3, 0, 3, no
3295966795,  nicodallara2, 12, 1, 11, no
1042807543,  supermario_75, 14, 4, 10, no
390721955,  franky_Cia, 6, 0, 6, no
799866654717054976,  MaurilioValeri, 5, 0, 5, no
786215749035720704,  Loredan60705692, 68, 1, 67, no
800464320484098048,  RSTopnews, 55, 4, 51, no
701169921053605888,  MARTEDEGANIP, 19, 3, 16, no
1444784371,  skleratha, 32, 1, 31, no
1521455803,  tuttigiuperterr, 30, 9, 21, no
299020216,  AnniPitea, 22, 1, 21, no
1702719008,  smarthicks76, 17, 5, 12, no
4814832225,  papagnap, 4, 0, 4, no
2506822612,  AntonellaIacob1, 39, 0, 39, no
2415685429,  stevvid, 19, 1, 18, no
538874342,  Paolo_HY, 3, 0, 3, no
1382241883,  roma_e_roma, 7, 0, 7, no
2207172466,  Claudiozanott, 132, 3, 129, no
728228470816395266,  orsoloco67, 3, 0, 3, no
2237096859,  SteccaAlessio, 55, 0, 55, no
585883841,  EdiMommi, 12, 2, 10, no
3261842987,  giagiangi, 9, 0, 9, no
2330689508,  luigi08020856, 16, 7, 9, no
706057101,  stefanocazzola1, 17, 4, 13, no
3345485428,  toninococ, 7, 0, 7, no
801092954454683650,  stefano19446629, 14, 1, 13, no
1301159155,  ESprovieri, 4, 0, 4, no
3085895092,  DoctorPanza, 11, 0, 11, no
4688664552,  ivanau87, 26, 0, 26, no
789137491190226944,  p81841108, 9, 0, 9, no
2904311573,  DarkMatterMario, 15, 5, 10, no
1151876744,  R__Rob, 27, 0, 27, no
576999728,  fabioazzaro, 3, 0, 3, no
3330461728,  Er_Cattivo, 44, 3, 41, no
96337794,  MarinoBruschini, 48, 8, 40, no
204249074,  francotuologo, 7, 0, 7, no
465763892,  cecegranata, 6, 0, 6, no
265399668,  DinoGambacorta, 6, 0, 6, no
3879470056,  KarimRahimi13, 10, 0, 10, no
427201823,  PietroVagli, 11, 1, 10, no
749617259849584640,  consoleantonio1, 22, 0, 22, no
302561494,  FBellusci, 18, 3, 15, no
1120118342,  Lamp__1, 42, 6, 36, no
498962103,  GionbatGiovanni, 3, 0, 3, no
736543941101817856,  enzoangeletti13, 4, 0, 4, no
745931678649061376,  gubitosagianni, 4, 0, 4, no
704431464524423168,  milena_vireca, 29, 2, 27, no
621771505,  FilippoFortuna, 18, 3, 15, no
570728506,  abertumella, 4, 0, 4, no
1089615589,  Gianfra58, 45, 8, 37, no
419768382,  antiglio, 16, 0, 16, no
516574301,  MassimoEsquilin, 6, 0, 6, no
1102216892,  NicoCusimano1, 33, 5, 28, no
395967162,  MIMMOLILLO, 3, 0, 3, no
937020181,  M5STerme, 4, 0, 4, no
227306075,  PatriziaErre, 10, 1, 9, no
1715119512,  micillom5s, 67, 0, 67, no
330574100,  emme_erre_ci, 8, 0, 8, no
1648199708,  filsco2004, 8, 0, 8, no
2913833871,  yujizainesilio, 43, 0, 43, no
340294381,  MELONEDAVIDE, 19, 4, 15, no
794473839526813696,  Armanfo7, 3, 0, 3, no
754009621724012544,  jacklamotta75, 16, 0, 16, no
261421785,  Benedict_Ux, 7, 2, 5, no
2999325983,  Silvano15018818, 12, 4, 8, no
2491958276,  zanderzermeno, 3, 0, 3, no
2508295280,  ilcieco07, 36, 3, 33, no
724560206152216583,  PacettiGiuliano, 7, 0, 7, no
3324608649,  INTEER999, 54, 1, 53, no
1908263497,  ma3dit, 42, 0, 42, no
464477564,  FlavioPatrizi, 13, 0, 13, no
589423738,  antoniavalenzis, 25, 0, 25, no
397481743,  enricome63, 5, 0, 5, no
751662668327583745,  MiminoOrlando1, 3, 0, 3, no
2427827258,  AleFiveStars, 30, 8, 22, no
369177021,  CarielFr, 14, 0, 14, no
1431247669,  stefanostaffa1, 39, 7, 32, no
2442517233,  Movimento_5s, 114, 5, 109, no
503276338,  GiuseppeConi1, 6, 0, 6, no
2173707058,  GinaNatuzzi, 9, 0, 9, no
4888582030,  lollomuay, 22, 0, 22, no
760548711701282816,  francescotozz11, 24, 0, 24, no
730380067637956610,  ciri2016, 28, 0, 28, no
1376730776,  mariaederaM5S, 19, 0, 19, no
533692413,  rdalzilio, 36, 0, 36, no
1472956555,  gianlucalibrale, 19, 1, 18, no
2751862871,  Zagaria22, 36, 0, 36, no
950313325,  umbagu, 20, 5, 15, no
1238622974,  Gunnyidol, 151, 6, 145, no
2371137846,  Nuccia58, 67, 1, 66, no
733743405751271424,  Blackwhite2840, 43, 3, 40, no
3291324425,  PaolettoDoro, 32, 0, 32, no
633645457,  maria_demurtas, 20, 2, 18, no
1142540912,  Canto_Quinto, 14, 1, 13, no
161428463,  aleottim, 35, 6, 29, no
704249890793193472,  Patriciaciribi3, 7, 0, 7, no
502039896,  utor34, 23, 0, 23, no
345535835,  libellula58, 56, 4, 52, no
2271552805,  saracinogino197, 4, 0, 4, no
2595566549,  midnightsilvia, 5, 0, 5, no
2499039877,  Vittori57825173, 3, 0, 3, no
725050316849336320,  marchio79, 10, 4, 6, no
771114116035543041,  AntoninoShop, 7, 0, 7, no
223549496,  bobo3340, 3, 0, 3, no
701059824520396800,  Marc0Manz0, 48, 2, 46, no
173430456,  xavierbellanca, 12, 0, 12, no
2951279819,  luce_lucialenzi, 303, 15, 288, no
473027302,  stefanoschwarz, 11, 2, 9, no
318923862,  Varese5Stelle, 9, 0, 9, no
2226747666,  pinodemi, 17, 0, 17, no
968433782,  emidioflamini, 18, 7, 11, no
481287765,  PaoloSartori4, 16, 7, 9, no
22678247,  ilmangia, 3, 0, 3, no
305051024,  eikouarucroatia, 3, 0, 3, no
111263349,  santy_07, 3, 0, 3, no
137275274,  prosperi_s, 4, 0, 4, no
500583344,  paolopietrodila, 7, 0, 7, no
1079126036,  claudioporcu73, 88, 1, 87, no
707643839343939584,  frances37000482, 7, 2, 5, no
1215628212,  Fandistelle, 36, 2, 34, no
721242552469479424,  Amedeo111960, 15, 1, 14, no
1036719990,  CiranGuccini, 48, 10, 38, no
1150394972,  EspeMarco, 11, 3, 8, no
914574283,  CIRAGGI, 56, 0, 56, no
773204075303276545,  Antonio_jz4, 4, 1, 3, no
2733334557,  vannigio3, 11, 2, 9, no
80871910,  Andrea_ONE, 3, 0, 3, no
2365532641,  PeppeGrillo_, 52, 16, 36, no
20968074,  Etrust12, 7, 0, 7, no
762573760037871616,  krefused, 3, 0, 3, no
350368337,  sinatratiziano, 6, 0, 6, no
3435243441,  antoninilidia, 3, 0, 3, no
326183542,  nicuzzo, 14, 0, 14, no
391620881,  pierodm, 76, 4, 72, no
581285865,  muttley_1974, 21, 2, 19, no
2521249817,  tile_small, 3, 0, 3, no
2762991057,  fabippol, 29, 17, 12, yes
3862086448,  ada_bizialuna, 53, 4, 49, no
621679998,  araelmose, 6, 0, 6, no
802805449099776000,  ShNushin, 3, 0, 3, no
616365409,  Giuliani94, 14, 8, 6, yes
749173351999037441,  Salvo160, 7, 0, 7, no
507006278,  Mattia_Bracco, 14, 0, 14, no
802059051064561664,  OfficialRube, 24, 9, 15, no
802581982035247104,  pankadrillo17, 41, 13, 28, no
354896841,  dunky2588, 4, 0, 4, no
306180757,  LalloCocco, 99, 12, 87, no
711229634,  OcchiniSilvio, 6, 0, 6, no
160136129,  s_alati, 5, 0, 5, no
405443137,  alfredomartel65, 87, 1, 86, no
2153812941,  QuintoValter, 193, 6, 187, no
995341382,  campagnoli85, 27, 3, 24, no
3320655053,  ott_alba, 93, 3, 90, no
801062327810461696,  EnzaSorti, 90, 39, 51, no
475325454,  fausto_cag, 26, 12, 14, no
558010244,  susi1961, 6, 1, 5, no
420931672,  EmeiMarkus, 11, 0, 11, no
166161984,  titominardi, 12, 0, 12, no
538974240,  ernestopan, 6, 1, 5, no
218931858,  fedeRRik800, 70, 0, 70, no
34445466,  Astaschera, 6, 0, 6, no
609872484,  1DiMaio, 8, 2, 6, no
707218166250864640,  WalterAktarus, 30, 0, 30, no
75789796,  morettipaolo, 7, 2, 5, no
797171468002033664,  orl_dan, 19, 4, 15, no
2320901282,  DamendaoLibero, 3, 0, 3, no
800260812875055104,  CastlesJames2, 3, 0, 3, no
805772104461352960,  marekiaro19, 3, 0, 3, no
90859217,  okadascape, 11, 3, 8, no
710044495748927488,  IovotonoG, 67, 1, 66, no
353463744,  banawedata, 3, 0, 3, no
174210451,  largociospe, 16, 2, 14, no
1065974568,  Maximum70Mm, 3, 0, 3, no
199002258,  remomix, 3, 0, 3, no
875324551,  marco63307847, 15, 6, 9, no
3001188891,  erFabrillo, 12, 0, 12, no
471428838,  gizzi31, 222, 2, 220, no
3155684650,  AattAlessio, 3, 0, 3, no
1888044751,  silviachimienti, 7, 1, 6, no
474132230,  MasiaOssi95, 4, 0, 4, no
2397799935,  CanioA, 8, 0, 8, no
420543944,  o0desy0o, 21, 10, 11, no
733366019666944000,  claudiozano1961, 5, 0, 5, no
2351601439,  vic24g, 45, 1, 44, no
798899498152034305,  Penstellatotw, 9, 0, 9, no
3939431595,  LiberatiLinda, 32, 3, 29, no
369459091,  ivorobertocarbo, 5, 1, 4, no
58636171,  FabioILLogico, 67, 8, 59, no
197056224,  ANNAQuercia, 88, 1, 87, no
971780588,  marziazichella, 3, 0, 3, no
802931004700852228,  RobertoRossato4, 3, 0, 3, no
302967121,  gesa_2006, 13, 0, 13, no
368533605,  Leotennents, 6, 1, 5, no
762186331011375104,  piergio71, 96, 32, 64, no
51060893,  paolorivieccio, 3, 0, 3, no
1361432923,  mfantoni1977, 22, 1, 21, no
72848245,  lorenzoyzf, 4, 0, 4, no
802653586563928064,  NicolaMansi4, 5, 1, 4, no
2370908109,  VincenzoVickis1, 35, 2, 33, no
4872258489,  M72seventytwo, 8, 1, 7, no
4054730097,  ClaudioScarpino, 3, 0, 3, no
488587270,  LorellaBasso, 26, 2, 24, no
2532166333,  CarloFagnani, 4, 0, 4, no
19067940,  beppe_grillo, 106, 3, 103, no
697883940728782852,  Silviaa___, 3, 0, 3, no
289400495,  Mov5Stelle, 46, 0, 46, no
1530798872,  virginiaraggi, 8, 0, 8, no
2444235358,  shootingrome, 30, 6, 24, no
4827481564,  Gio_Angotti, 3, 0, 3, no
807579925,  cicciobronx77, 19, 9, 10, no
3406855018,  annamali458, 6, 0, 6, no
4603645649,  rossimatteol, 27, 6, 21, no
500923718,  vcioccolini, 3, 0, 3, no
4067152936,  SilvestriViola, 3, 0, 3, no
1540142966,  stefaboy3, 59, 4, 55, no
426706142,  cucciolo70, 9, 0, 9, no
702921914,  Titty973, 35, 6, 29, no
761582724176027649,  MassmilianoS, 136, 38, 98, no
247609737,  nataliemrizzo, 3, 0, 3, no
776488765183459328,  battini59, 19, 0, 19, no
1580176014,  italiaconGrillo, 22, 1, 21, no
2870220975,  GiacconeRosy, 69, 0, 69, no
1116671611,  gioatriz, 61, 9, 52, no
1114715887,  HomoItalicus, 11, 5, 6, no
1023807246,  Avv_Natalina, 8, 0, 8, no
2669111564,  Elpidio_Erc, 4, 0, 4, no
2901676730,  IEUREPORTER, 5, 0, 5, no
79036955,  serenasaetti, 21, 0, 21, no
413352483,  andreagonella77, 6, 0, 6, no
410117686,  claudiogalasio, 4, 0, 4, no
787664361036939264,  Claudio89801980, 3, 0, 3, no
1183652605,  PelusoRaffaele, 36, 1, 35, no
591884349,  ClaudiaTripoli, 10, 0, 10, no
2708501001,  piccolofux, 4, 0, 4, no
1283446118,  dangelo_luciana, 95, 6, 89, no
889099008,  luigiza2, 9, 0, 9, no
4210429707,  h3nkel, 5, 0, 5, no
3763150757,  NapolGiovanni, 12, 0, 12, no
4923691078,  Frances29571990, 3, 0, 3, no
281884852,  romano5stellebs, 134, 14, 120, no
737359266122727426,  SestoPd, 2, 2, 0, yes
1286087234,  GusNazionale, 1, 1, 0, yes
3386107840,  ro_ripam, 1, 1, 0, yes
1402978436,  SegatDavide, 26, 19, 7, yes
758737897,  comis_william, 13, 8, 5, yes
2260173647,  clalui2009, 1, 1, 0, yes
1475105226,  AntonioDeSiato2, 1, 1, 0, yes
1171703372,  ClaudiaCarbona1, 1, 1, 0, yes
112807659,  franpj2, 10, 9, 1, yes
377619841,  anubidal, 51, 50, 1, yes
725353317535211520,  Manuela26140, 1, 1, 0, yes
728944152185081856,  AlbaLaValle, 4, 4, 0, yes
711159303709847558,  eppursiride, 4, 0, 4, no
356923000,  1603ina, 40, 7, 33, no
997910394,  perronefulvio, 20, 2, 18, no
1397326392,  TeresaMarzocchi, 2, 2, 0, yes
473917488,  AntonellaTauro1, 2, 2, 0, yes
2329384532,  mrosabelotti, 3, 3, 0, yes
43309580,  saracristaldi, 10, 10, 0, yes
41361889,  roberto_papa, 2, 2, 0, yes
797922363270631424,  anetavilla94, 3, 0, 3, no
978156859,  marcogabriele84, 4, 3, 1, yes
2596174452,  GPBaglioni, 3, 2, 1, yes
80639000,  andreaDeB, 4, 4, 0, yes
719601133019336706,  CristianaPazzi, 14, 1, 13, no
2849367177,  rinobattista2, 9, 3, 6, no
1110202813,  GmPoppi, 52, 4, 48, no
96340114,  PaoloX68, 22, 2, 20, no
582236593,  fabiopi1000, 23, 4, 19, no
299178306,  ninonovecento, 5, 1, 4, no
420852268,  indianmar1, 21, 3, 18, no
2178157155,  tonyasome, 10, 4, 6, no
516802751,  amvecchietti, 103, 25, 78, no
228249426,  selezione5stell, 18, 1, 17, no
2225431370,  AquilianoMolfa, 24, 2, 22, no
738086816226676736,  francyroll, 8, 1, 7, no
795564464829595648,  dam_malg92, 12, 4, 8, no
446937412,  LolloLollino, 20, 4, 16, no
2283780786,  PALMAMOLLO, 27, 4, 23, no
721337052168613888,  nelsanchezvill1, 5, 4, 1, yes
2970225064,  pmaremmi, 23, 2, 21, no
170747137,  pepcarp, 48, 3, 45, no
1908575102,  rosati22, 11, 4, 7, no
1737163674,  andy_message, 8, 3, 5, no
1524453986,  maxxxks, 21, 8, 13, no
37756411,  unaironeblu, 8, 1, 7, no
2593299788,  Akjnuk, 17, 1, 16, no
51361757,  idlavi, 24, 9, 15, no
805665659900329985,  eliana29419781, 6, 4, 2, yes
801328171362697216,  junijuno888, 2, 1, 1, neutral
389348747,  FrankieCS76, 15, 5, 10, no
4187885897,  crespil72, 16, 5, 11, no
22694862,  lellocardone, 2, 1, 1, neutral
756514855461453827,  maurizioceccar5, 31, 11, 20, no
734594705229545472,  marcocampus, 11, 1, 10, no
753651559003750400,  giuseppetat1, 4, 1, 3, no
247209095,  folfra, 21, 7, 14, no
158891854,  Pausini67, 15, 1, 14, no
622020182,  19marino74, 27, 9, 18, no
712643100590620676,  irbaf641, 3, 1, 2, no
561058451,  linares1965, 8, 4, 4, neutral
438431990,  cny45tpa, 8, 2, 6, no
593602954,  VittoriaEffe, 2, 1, 1, neutral
363542054,  claudiovr1, 63, 16, 47, no
324332181,  pierluigimolina, 9, 8, 1, yes
411403085,  ottobrerosso11, 11, 4, 7, no
541670926,  GiorgioAntonel1, 43, 5, 38, no
546851983,  NahuelCespi, 3, 1, 2, no
348393342,  SarahBJ3, 9, 5, 4, yes
564609095,  domenicocarrara, 14, 1, 13, no
1218936162,  augustabenedett, 21, 2, 19, no
978488840,  carlaruocco1, 11, 1, 10, no
435136836,  BrunelloEsu, 42, 2, 40, no
852549655,  Saveriogas, 4, 1, 3, no
560462597,  sipej, 9, 2, 7, no
2924683299,  LucheroniFabio, 3, 1, 2, no
574072662,  IvanGrippa, 9, 1, 8, no
782809034,  Kram11000, 8, 3, 5, no
313514631,  franknocode, 56, 5, 51, no
631465083,  rosanna_1990, 9, 2, 7, no
592174264,  Happy97164636, 12, 1, 11, no
216032839,  erTwitto, 5, 1, 4, no
2385799301,  annadelbello1, 15, 1, 14, no
2310308158,  plsgrd1965, 16, 5, 11, no
2597273655,  fabiocarusoCT, 21, 3, 18, no
2766126468,  giannettinoaldo, 2, 1, 1, neutral
724438831,  SilviaPaar, 7, 4, 3, yes
2418170407,  allenatorebis, 42, 5, 37, no
2997735143,  GbBrandone, 2, 1, 1, neutral
400273310,  GabriellaSantor, 27, 1, 26, no
3380511171,  patripatty5, 16, 3, 13, no
253175429,  orsettinoit, 41, 1, 40, no
2312319749,  diditomassi, 7, 5, 2, yes
711187023,  PScotto1972, 37, 8, 29, no
398809701,  CoppolaLiliana, 23, 2, 21, no
1231417717,  RGrupelli, 19, 7, 12, no
3696089777,  athinaonassis1, 6, 1, 5, no
195689744,  Maxdero, 2, 1, 1, neutral
1070320147,  jobbe50, 15, 4, 11, no
939204590,  BuzzSid, 10, 6, 4, yes
438236543,  valente_adriano, 7, 2, 5, no
266841916,  TheRenry, 29, 4, 25, no
288339892,  gioderr, 8, 3, 5, no
97699315,  MauroLupo, 23, 9, 14, no
4394434523,  concettalombar8, 15, 2, 13, no
283080198,  Patrizia_Monica, 122, 7, 115, no
270518699,  OderzoGrillaM5S, 14, 1, 13, no
3521388197,  Maria89822729, 75, 38, 37, yes
2179652340,  beppem54, 12, 4, 8, no
1318788918,  Fernet8, 14, 1, 13, no
313331114,  RiccardoBusi, 127, 44, 83, no
2786595941,  M5SCampaniaNews, 87, 7, 80, no
1277743430,  Ichnos1973, 19, 1, 18, no
2954613465,  salvatoresolop1, 13, 6, 7, no
1274289852,  Rokketto1, 10, 1, 9, no
447168507,  fasolimarisa, 2, 1, 1, neutral
4908787277,  Menocchio2, 5, 2, 3, no
2385290202,  FPuggini, 103, 6, 97, no
464145995,  GianniZarrillo, 6, 1, 5, no
1216273854,  jacoboome, 17, 6, 11, no
3416068515,  1974_sim74, 6, 2, 4, no
753620675970142208,  JohnMilnerCA, 3, 1, 2, no
721466546279817217,  robertocrieleni, 11, 1, 10, no
1200548598,  adamodevelli, 2, 1, 1, neutral
356975403,  Silviy5stars, 88, 2, 86, no
733682239473635328,  amcs1963, 2, 1, 1, neutral
2437846648,  RettaroliS, 28, 4, 24, no
89463988,  _HankChinaski_, 7, 5, 2, yes
1052596340,  riccardo_fra, 4, 1, 3, no
2231318146,  LRoscetti, 19, 8, 11, no
986828390,  Elenaunica64, 62, 2, 60, no
621326231,  DiGiu2273, 5, 2, 3, no
11945512,  mirellaliuzzi, 7, 1, 6, no
134516956,  marcodifinizio, 9, 4, 5, no
2389396971,  6f94b7b2b0c4489, 3, 1, 2, no
1289227574,  Marco__Bellucci, 26, 3, 23, no
3410104307,  VienDalMare84, 15, 2, 13, no
2241896284,  Undertall65, 14, 9, 5, yes
250624869,  MarcoTalluto, 13, 1, 12, no
231010672,  carlino92, 3, 1, 2, no
1327241030,  scevro69, 58, 8, 50, no
22834067,  Roberto_Fico, 5, 1, 4, no
1853780203,  viverliberi, 4, 3, 1, yes
1068963974,  andreagaudio73, 7, 2, 5, no
256909243,  _Alberto_MaRcOs, 2, 1, 1, neutral
792130389963857920,  cyben0709, 2, 1, 1, neutral
1276570771,  CorinnnaT, 11, 2, 9, no
1244162966,  pa1pa2, 12, 6, 6, neutral
554581695,  GriecoV, 33, 10, 23, no
581801913,  loureiro1966, 105, 10, 95, no
2674872705,  Archimede02, 10, 8, 2, yes
865973760,  UldericoFilippe, 6, 1, 5, no
103064354,  Dukeflleed, 19, 11, 8, yes
220750726,  paoloviri, 5, 2, 3, no
2942054782,  igor081976, 15, 1, 14, no
706363546,  stefano_muggio, 4, 1, 3, no
2831558388,  morlando46, 7, 3, 4, no
3049129313,  PaolaRomDiP1, 5, 1, 4, no
68374302,  gtnrrt, 2, 1, 1, neutral
18114610,  glctesta, 14, 2, 12, no
602173921,  AngileriDaniele, 3, 3, 0, yes
2272916900,  delmonacofondie, 58, 22, 36, no
342588019,  GaetanoTerranov, 14, 8, 6, yes
400020221,  150tricolore, 3, 2, 1, yes
3331798360,  15Massimo, 12, 8, 4, yes
277603295,  ManuelaDonghi, 3, 2, 1, yes
801258780,  tiziano_pasella, 15, 4, 11, no
84018589,  andreaoverall, 22, 13, 9, yes
761787475,  gustinicchi, 7, 5, 2, yes
585919562,  MauroCherubino, 17, 0, 17, no
476836933,  enrico_zanetti, 42, 40, 2, yes
9479042,  micheleficara, 6, 3, 3, neutral
557637492,  vellapaolo1, 9, 1, 8, no
2319599310,  leomartini_fi, 3, 1, 2, no
321375506,  FGaragnani, 21, 8, 13, no
101272144,  shady_el_mouine, 7, 2, 5, no
47781017,  cafifal, 10, 2, 8, no
172675414,  gabri_it, 3, 1, 2, no
238604711,  fulviagr, 17, 8, 9, no
3289832699,  LucaLucacchio, 4, 2, 2, neutral
253548405,  wilwal68, 5, 3, 2, yes
782643007,  ttenti, 30, 1, 29, no
958322611,  PaoloDiGiovine, 30, 3, 27, no
962612156,  giulianavespa, 379, 3, 376, no
264703894,  serpyco72, 4, 2, 2, neutral
483671947,  Aaronn31, 14, 5, 9, no
3145265249,  peppemessina65, 75, 3, 72, no
785089989692493824,  LavoratoriPerNO, 297, 3, 294, no
932478324,  MasucciCarlo, 206, 3, 203, no
3368385652,  VaIentina_Iori, 168, 4, 164, no
2403776046,  deboramau, 97, 7, 90, no
1040235834,  anto_ninco, 4, 4, 0, yes
3439750456,  _FawkesGuy_, 5, 5, 0, yes
3978247071,  poliziana, 4, 4, 0, yes
28119689,  ryoga76, 6, 4, 2, yes
912474818,  kalu_costa91, 3, 3, 0, yes
488990940,  RBottos, 3, 3, 0, yes
99736212,  feniceitaliana, 9, 5, 4, yes
53185852,  TaRulleGulle, 4, 4, 0, yes
362441023,  emirjankalaj, 4, 4, 0, yes
493981441,  FrancZazz, 4, 4, 0, yes
15980018,  faberpiredda, 7, 3, 4, no
323780096,  airpiano4, 4, 4, 0, yes
2515144546,  BMascalchi, 38, 17, 21, no
2436755911,  ndrededu, 4, 3, 1, yes
1385397686,  NCicuta, 8, 7, 1, yes
135550598,  7Mav, 4, 3, 1, yes
375613212,  federicoviri, 4, 3, 1, yes
2588366118,  Antigon68185047, 22, 12, 10, yes
733738142138785794,  wukunny, 3, 3, 0, yes
1526739516,  LucianaBonechi, 2, 2, 0, yes
476936806,  TozziDebora, 7, 6, 1, yes
840555816,  BolognaxRenzi, 25, 13, 12, yes
13728662,  marcomariaricci, 18, 2, 16, no
897054630,  patriziabottell, 16, 6, 10, no
4024983855,  MareBlu2015, 16, 0, 16, no
89510180,  maghiaz, 2, 2, 0, yes
323141630,  mampaheka, 5, 5, 0, yes
528277961,  cdhanto, 7, 6, 1, yes
2273700867,  marcigiannetti, 3, 3, 0, yes
3253240709,  elisa_eliea, 140, 115, 25, yes
2609521728,  SANTImbanque, 3, 3, 0, yes
939337284,  GiuseppeMorrea3, 13, 4, 9, no
780133788001112066,  PalettaAlina, 28, 27, 1, yes
2403102446,  ignazio72mineo, 2, 2, 0, yes
186771181,  WalterCabrini, 2, 2, 0, yes
1192866157,  fgiro3, 13, 1, 12, no
2172522723,  met1927, 5, 1, 4, no
468260476,  sieynard, 4, 3, 1, yes
3697237636,  Jacopo28_, 5, 4, 1, yes
52694024,  Raffidi, 15, 8, 7, yes
796684613452238848,  IoVotoNoInfo, 58, 25, 33, no
426246902,  elisamassimi, 4, 2, 2, neutral
726417519964213248,  gpatritti11, 11, 6, 5, yes
3377131258,  Frenci61Gimmi, 2, 1, 1, neutral
3075142522,  demeosindaco, 2, 1, 1, neutral
457889747,  melannas, 13, 6, 7, no
466565978,  Trottola62, 4, 1, 3, no
1578337921,  Silvia_amed, 28, 11, 17, no
32875709,  mgabriella, 2, 1, 1, neutral
557545233,  vsilvestrelli, 6, 2, 4, no
709061581867454464,  Lux_Clarissima, 4, 2, 2, neutral
81637419,  lameduck1960, 5, 1, 4, no
794099287894396928,  Salvado52694110, 3, 1, 2, no
714509054215905280,  Laura97209244, 2, 1, 1, neutral
176712900,  picture61, 49, 16, 33, no
482306466,  Stele666, 5, 2, 3, no
1581093506,  casalingalcoliz, 2, 1, 1, neutral
411323343,  divitoluigi, 19, 10, 9, yes
541147498,  mab29a, 229, 63, 166, no
577936933,  graziamorisi, 44, 20, 24, no
2223326053,  TweetyMelis, 17, 9, 8, yes
2608969241,  andersjump, 2, 1, 1, neutral
53027331,  mirkomastri, 7, 4, 3, yes
717714341915729921,  AntonioDomenic8, 6, 3, 3, neutral
2273086657,  ElleBiondi, 3, 2, 1, yes
104772578,  cosimocaridi, 9, 5, 4, yes
1142502205,  roberto_marsura, 13, 6, 7, no
2369214387,  valerio_negrini, 12, 7, 5, yes
3129266409,  GiuseppeStalta1, 66, 28, 38, no
1953930264,  maxPatriots, 76, 30, 46, no
601368027,  LeonardoFontan7, 11, 5, 6, no
1048144170,  Iomarcomarzari, 16, 4, 12, no
4691185219,  vagusvag, 2, 1, 1, neutral
366492481,  simostu9, 14, 11, 3, yes
1050781381,  cosimo1313, 24, 10, 14, no
2182969790,  SerafinoPietro, 16, 7, 9, no
301361724,  rougimar, 6, 4, 2, yes
265310236,  L4L5S1, 5, 2, 3, no
2442834988,  selena_sbadili, 32, 13, 19, no
402324365,  16dicembre1899, 7, 5, 2, yes
713040261249687553,  eltankerjuve, 3, 1, 2, no
2571630204,  Pascu1970, 6, 4, 2, yes
2224794707,  vmastrange, 5, 3, 2, yes
795317869131268096,  LiberoPensator5, 12, 5, 7, no
2349153735,  pofa63, 2, 1, 1, neutral
3195753809,  ivanchessa77, 6, 4, 2, yes
2465775372,  salvatop32, 6, 3, 3, neutral
90593797,  profondo, 5, 1, 4, no
797820581584453632,  PrimulaBianca1, 58, 11, 47, no
1221995204,  nando_saviano, 74, 15, 59, no
398317849,  giamart1975, 7, 3, 4, no
488714232,  Fresh_chi, 6, 2, 4, no
2560083548,  chichoarena, 5, 1, 4, no
481267605,  EnzoLorenziBg, 12, 2, 10, no
723496493903130624,  eLQ0Ixdmn2Y4Z12, 2, 1, 1, neutral
3369259859,  Seby_5_, 5, 2, 3, no
1340725916,  mikele2507, 2, 1, 1, neutral
2803289796,  3ZEiMhhVVpwECLe, 5, 1, 4, no
2464999802,  Zuzzurellone84, 5, 1, 4, no
2771102763,  lazzarin_andrea, 2, 1, 1, neutral
780698788482588672,  verdeocchio, 13, 11, 2, yes
343442484,  tuscolo, 54, 19, 35, no
383817075,  AlanBisio, 2, 1, 1, neutral
1132327098,  realNEILASPINAL, 2, 1, 1, neutral
1272647660,  TScatigna, 2, 1, 1, neutral
2287024507,  TizianaDAmico1, 17, 4, 13, no
3080518259,  david_raganelli, 2, 1, 1, neutral
776138045682806784,  CarloStef48, 19, 10, 9, yes
408118133,  ScottoLavina, 24, 5, 19, no
2761823415,  mau_roglia, 2, 1, 1, neutral
22009685,  ansim999, 10, 2, 8, no
1117558933,  hele_fr, 76, 36, 40, no
787562992728670209,  Royrb3, 6, 2, 4, no
719193903694524417,  Meryefa21, 3, 2, 1, yes
2420911521,  alevinc7472, 21, 11, 10, yes
2275661440,  Zac_TW, 6, 4, 2, yes
799621112040751104,  eva_3333, 3, 2, 1, yes
3822891293,  russel1951, 3, 1, 2, no
2392662752,  SandraSara7, 6, 3, 3, neutral
2390747907,  CattoAngelo, 7, 2, 5, no
3438614458,  5945USARTR, 2, 1, 1, neutral
800339370129559552,  Giusepp62142292, 14, 4, 10, no
2731547843,  casta752536, 2, 1, 1, neutral
4136518337,  annamariaduca53, 3, 1, 2, no
2929270474,  AdrianoBagna, 16, 7, 9, no
382923274,  Ohara_74, 5, 3, 2, yes
890460000,  LetiziaBalestri, 4, 1, 3, no
708285133971914752,  nicole287lulu, 8, 4, 4, neutral
616442617,  KikaKahshan, 9, 4, 5, no
3076845342,  adDOGted_, 2, 1, 1, neutral
467309286,  fab_patti, 2, 1, 1, neutral
594454720,  GabrieleStrozzi, 2, 1, 1, neutral
2962245928,  s_trassinelli, 11, 7, 4, yes
424237536,  torrese99, 5, 2, 3, no
45937235,  andreasarubbi, 2, 1, 1, neutral
4780779442,  robert7019, 4, 2, 2, neutral
754321990257938432,  mir6513, 4, 2, 2, neutral
2615476385,  PMurroccu, 13, 7, 6, yes
146858495,  antoiuli, 4, 2, 2, neutral
719612791087374337,  AlleanzaBz, 11, 2, 9, no
791301361128333313,  dioppo, 13, 6, 7, no
972598303,  spadasla, 6, 3, 3, neutral
251309387,  govi47, 18, 6, 12, no
326176754,  salvo9284, 3, 1, 2, no
776754983626760192,  DarKnight1023x, 7, 4, 3, yes
582265897,  AssuntaAccetto1, 31, 14, 17, no
2404494057,  michele_ugge, 54, 26, 28, no
430253778,  SimoArge, 4, 2, 2, neutral
2503994871,  rirosas3, 2, 1, 1, neutral
933078536,  SussyEgo, 7, 3, 4, no
787432374237822977,  angyco888, 43, 21, 22, no
557234714,  FFiloso, 2, 1, 1, neutral
3046004253,  sguia81, 2, 1, 1, neutral
798972715982000128,  Giovijonj, 2, 1, 1, neutral
327411320,  bncntn71, 4, 1, 3, no
102119771,  andre_lanz, 8, 3, 5, no
1052221009,  RinaldoLalo, 2, 1, 1, neutral
739543389721485312,  Eraclito992, 12, 3, 9, no
1715498894,  marcofalconect, 11, 2, 9, no
778914262689480704,  Spartako60, 16, 10, 6, yes
3852977062,  paoloumberto191, 2, 0, 2, no
473209868,  PieraPadovani, 13, 5, 8, no
1952610200,  conteNitore, 3, 1, 2, no
13680802,  r_formigoni, 5, 1, 4, no
2350743580,  pino_maio, 8, 3, 5, no
4457987716,  milandenzaN2, 8, 3, 5, no
394814291,  ilmauri5, 2, 0, 2, no
366228620,  ResiannaM, 2, 1, 1, neutral
556169238,  RitaVisinoni, 11, 8, 3, yes
3151943686,  Vorlander13, 2, 2, 0, yes
2338370276,  lavaporiera, 7, 6, 1, yes
2974517662,  JuveClubTweet, 5, 2, 3, no
435722284,  marisa7691, 2, 2, 0, yes
38695490,  stanka67, 5, 4, 1, yes
251235949,  MaraRaqu, 13, 6, 7, no
975251790,  nicoterranova, 3, 1, 2, no
840241477,  annalisabi76, 6, 6, 0, yes
2811521884,  sjlviep, 10, 7, 3, yes
2359496138,  CloudsInClod, 21, 6, 15, no
2328728342,  elbandzzzzzzzzz, 6, 3, 3, neutral
858003427,  enzoben43, 20, 9, 11, no
385301441,  baolo5, 1, 1, 0, yes
129272788,  xFister, 3, 3, 0, yes
55045274,  lucdilo, 7, 3, 4, no
383100901,  Draghidottone, 3, 2, 1, yes
372428924,  Annamorrone88, 1, 1, 0, yes
15036282,  saviciuz, 4, 4, 0, yes
768469887815647233,  palcolucifonica, 1, 1, 0, yes
455562995,  raffaellapaita, 6, 6, 0, yes
3309729695,  ScattoneF, 6, 4, 2, yes
394952261,  alessandrozzz, 1, 1, 0, yes
396237618,  Davide_Magno, 11, 3, 8, no
2459704421,  AgneluttoP, 6, 4, 2, yes
418192481,  Mikele_L81, 1, 1, 0, yes
596228713,  mimmdem, 2, 1, 1, neutral
550807420,  ellesi1962, 2, 2, 0, yes
2487419119,  Matteofuso73, 10, 10, 0, yes
517477760,  tirolermaxx, 1, 1, 0, yes
737329919563292672,  FContixunSi, 1, 1, 0, yes
3086030505,  mariarosaranza1, 3, 2, 1, yes
448981774,  GiorgioGrisi, 5, 3, 2, yes
466744379,  paolaiani, 1, 1, 0, yes
2148555672,  BeppeBasile2, 2, 1, 1, neutral
870289915,  AleBerlo, 4, 2, 2, neutral
769269640946184192,  JulKlee, 5, 5, 0, yes
1131342930,  ulde_sco, 6, 4, 2, yes
852983923,  giangi20l, 6, 5, 1, yes
995982720,  megamike0360, 3, 3, 0, yes
441863803,  StefanoCeccanti, 7, 4, 3, yes
1318519585,  BrunoCalcagni, 1, 1, 0, yes
2609504528,  WomanWithPen, 3, 3, 0, yes
2679522658,  Pipp61479281, 13, 7, 6, yes
1178411384,  emmenasi, 30, 10, 20, no
1243866121,  cossio_f, 1, 1, 0, yes
55400533,  beskat, 1, 1, 0, yes
4576031421,  riri000197, 5, 2, 3, no
198585878,  piratalove73, 1, 1, 0, yes
532343737,  aleza_zanon, 1, 1, 0, yes
307278565,  Dome689, 197, 14, 183, no
92511984,  Monalisazelf, 2, 2, 0, yes
1536096506,  canerandagio46, 6, 5, 1, yes
1077269276,  CurrentiCalamo_, 3, 1, 2, no
233225190,  DarrenJWithers, 3, 2, 1, yes
767307970594140160,  domchiar1, 4, 2, 2, neutral
585810693,  SosInvestimenti, 1, 1, 0, yes
109605368,  zamy58, 2, 2, 0, yes
2416067982,  CarloCalenda, 2, 2, 0, yes
1543158968,  IlGiustoGustoPC, 21, 20, 1, yes
3297601040,  mistef63, 27, 26, 1, yes
3673796295,  LArcidiaco, 6, 2, 4, no
4896102700,  Lizzi48397615, 7, 4, 3, yes
761237376601563136,  ComeunT, 55, 2, 53, no
1172358768,  samueljoe911, 1, 1, 0, yes
1048802419,  tittina2013, 15, 5, 10, no
523138689,  NunzioPierri, 7, 5, 2, yes
1227953550,  nazareno_viale, 2, 2, 0, yes
3309033459,  miraglia55, 1, 1, 0, yes
1568260291,  MirkoBisesti, 1, 1, 0, yes
69405600,  baccolo75, 3, 3, 0, yes
717647109114224640,  simone_macchia, 8, 3, 5, no
104798720,  sarafrangini, 1, 1, 0, yes
703579471983546369,  serenmenteliet, 6, 4, 2, yes
3105987653,  c___luca, 1, 1, 0, yes
2397878181,  annaliaconti, 2, 2, 0, yes
400209582,  arianoisidori, 10, 2, 8, no
447361197,  antoniofenio, 4, 4, 0, yes
474399960,  enniamarinucci, 1, 1, 0, yes
419281902,  DenisGobbi, 3, 1, 2, no
315176785,  maurySatiro, 1, 1, 0, yes
307536761,  marcellodegni, 1, 1, 0, yes
1318108844,  babylonboss, 8, 4, 4, neutral
746970733,  GabriellaErcoli, 4, 4, 0, yes
4919443492,  Sfanculotutti2, 7, 5, 2, yes
710558844657790976,  asitcilento1, 3, 2, 1, yes
3252061715,  mamia6570, 3, 1, 2, no
156316785,  M_Fedriga, 71, 32, 39, no
768783082736455680,  BeraldoAnnalisa, 421, 208, 213, no
406907214,  GLPini, 7, 4, 3, yes
756156933879525376,  LDream08, 25, 8, 17, no
719987714448355330,  kazaoker, 5, 3, 2, yes
1735223353,  SumAlessandro, 9, 3, 6, no
791407162790649856,  TizianaSandrin3, 7, 3, 4, no
728245393503424513,  lisa_libra_bram, 20, 8, 12, no
3291727493,  tullio_crespi, 11, 3, 8, no
737235071137140740,  paxmix7172, 2, 1, 1, neutral
4069116213,  Il_Reissimo_, 6, 4, 2, yes
4201687816,  _xabaras_, 5, 1, 4, no
492574235,  AngeloVenturel, 2, 1, 1, neutral
275225571,  Simo_Storti, 13, 6, 7, no
2385918867,  ottobrina71, 16, 4, 12, no
543157991,  chellacantra, 2, 1, 1, neutral
2274450562,  anto_d_63, 27, 18, 9, yes
83654381,  iannonenico, 6, 4, 2, yes
165411387,  DrAdder, 4, 3, 1, yes
404949783,  spiller_ale, 2, 1, 1, neutral
199656773,  ClaudioPace, 13, 8, 5, yes
3413676334,  colui71, 4, 1, 3, no
2201948028,  SirWiller, 6, 4, 2, yes
305623772,  anna_mitica, 5, 2, 3, no
1128901224,  domcamodeca, 3, 2, 1, yes
495412522,  erreelleci, 14, 4, 10, no
1879932181,  elletama, 5, 3, 2, yes
239572336,  _Dom_Man_, 3, 2, 1, yes
3008953167,  panste85, 3, 2, 1, yes
371698564,  CrisGAMBARDELLA, 3, 1, 2, no
74966378,  fr4nk18, 6, 4, 2, yes
173925687,  Abocconetti, 130, 18, 112, no
749151808682164225,  Come___Marco, 3, 1, 2, no
29983104,  silviasemenzin, 9, 2, 7, no
1088385948,  enricop80, 6, 3, 3, neutral
370193812,  FraSottile, 28, 5, 23, no
416348802,  tweettatore, 18, 6, 12, no
18319776,  otyx, 3, 1, 2, no
17063476,  IlTagliando, 4, 1, 3, no
23116138,  ursulapala, 3, 1, 2, no
710385175,  LudovicoCordoni, 17, 5, 12, no
398635221,  Bossartiglio_, 5, 2, 3, no
1013634678,  SolomonClaudio, 3, 1, 2, no
1259291893,  lumirKu, 3, 1, 2, no
312250044,  mlauria93, 6, 2, 4, no
292376362,  AlexBrullo, 3, 1, 2, no
498925846,  fabio0petrucci, 5, 3, 2, yes
1270647104,  Fra_luch, 3, 1, 2, no
2627878649,  ica_feder, 3, 1, 2, no
4190295975,  RobertoPopeo, 5, 2, 3, no
4891704587,  ap_bcn, 3, 1, 2, no
397122109,  michelecarugi, 9, 4, 5, no
3237007931,  retweet_radio, 2, 2, 0, yes
619316778,  francesco60221, 8, 0, 8, no
1200815466,  gattorosarosa, 5, 1, 4, no
4864664511,  eliorenzi1959, 68, 3, 65, no
4860559857,  Zaddl3, 22, 9, 13, no
2900897831,  sevise2, 26, 6, 20, no
320405620,  fabiosommo, 3, 0, 3, no
69743321,  ale_s84, 6, 0, 6, no
734074574275514368,  RedditCittadini, 232, 9, 223, no
383955971,  fabrifour3, 3, 0, 3, no
257223860,  bournetw, 15, 6, 9, no
2588246800,  CanciAbo, 205, 24, 181, no
2193790769,  DaianaColantuo, 4, 1, 3, no
2817371306,  selfie_gleba, 3, 0, 3, no
36493382,  gdiges, 19, 6, 13, no
474657743,  mattpalazzi, 8, 4, 4, neutral
1562493492,  Franzcolaleo, 11, 5, 6, no
718536182846648321,  RosannaGrazian1, 11, 8, 3, yes
2159452392,  BeckerSwan, 8, 4, 4, neutral
433536879,  ale_quarta, 3, 0, 3, no
558051435,  camilla_O, 3, 0, 3, no
427564624,  LorenzoManfro, 6, 1, 5, no
437807413,  silviasprea, 5, 2, 3, no
121368445,  Geillis68, 54, 47, 7, yes
815304163,  RiccardoDiofebi, 16, 6, 10, no
157994523,  rita_mameli, 3, 0, 3, no
354284014,  murba63, 29, 9, 20, no
515474269,  DarioViking, 14, 5, 9, no
458146177,  Alf_56reporter, 9, 1, 8, no
176085681,  Cost83, 3, 0, 3, no
805141954329800704,  Toto70451603, 174, 72, 102, no
3258090545,  cam_gioe, 6, 0, 6, no
625051527,  DJ491Official, 3, 0, 3, no
159459884,  ralex1976, 4, 0, 4, no
443708574,  V_Ani6, 21, 2, 19, no
328946204,  632101Viktormh, 11, 1, 10, no
2605945762,  CapuaFranco, 22, 9, 13, no
621761723,  grazianomatera1, 4, 0, 4, no
3352514566,  Simonebocs, 4, 0, 4, no
2809692579,  frt_valentina, 4, 1, 3, no
1974119078,  flowervigna, 9, 3, 6, no
3400668957,  lui_gi85, 3, 0, 3, no
2478580177,  salvatoremero12, 12, 0, 12, no
1317255619,  mirkokrea78, 17, 3, 14, no
2310230647,  henrydurante, 3, 0, 3, no
152671788,  Fexkiller, 4, 0, 4, no
3143883839,  EmanueleMugnas, 2, 2, 0, yes
2491091820,  Marzio_Pol, 2, 2, 0, yes
721586993138921472,  ArcaSandro, 6, 6, 0, yes
732545752392708097,  Mar1aM0n1ca, 2, 2, 0, yes
328020740,  LuisaBerti_, 15, 15, 0, yes
1962516367,  xtheflippers, 8, 8, 0, yes
2204412148,  Zulimondo, 2, 2, 0, yes
776315743520583680,  azimi_vida, 18, 11, 7, yes
438358126,  celineshortie, 4, 4, 0, yes
2807370949,  enrichetta5, 3, 3, 0, yes
2741955700,  davidedado1312, 2, 2, 0, yes
102082331,  djpiombo, 2, 2, 0, yes
548247476,  ottaviomele, 7, 5, 2, yes
1125594104,  vitaguccione, 6, 5, 1, yes
1431691753,  felii1977, 12, 12, 0, yes
169641907,  nicolanegro, 3, 3, 0, yes
247479499,  antoamadori, 3, 3, 0, yes
435601309,  lukalancia, 7, 7, 0, yes
400076822,  ilSIC56, 19, 17, 2, yes
2363590581,  ElizzBenissone, 11, 7, 4, yes
244887323,  antoniotelesca1, 2, 2, 0, yes
327420391,  pinodemartino, 3, 3, 0, yes
143813004,  adriespo, 10, 1, 9, no
253542906,  gaboferraris, 4, 1, 3, no
477725496,  feliseo79, 4, 4, 0, yes
1088813024,  wonderjake, 7, 7, 0, yes
795584520024158208,  DajeMarche, 2, 2, 0, yes
510430303,  AP_architects, 3, 2, 1, yes
3969988522,  simonesciamann_, 2, 1, 1, neutral
2178758289,  galimberti61, 29, 11, 18, no
331525693,  ANDREACECCHINI1, 5, 0, 5, no
5393722,  gattasorniona, 3, 2, 1, yes
111063679,  michelevece, 18, 15, 3, yes
233896013,  MatteoAVFugazza, 2, 2, 0, yes
1227796518,  VeneraBellia, 2, 2, 0, yes
329557869,  DavideDucks, 3, 3, 0, yes
2357012943,  GuibecGuido, 5, 5, 0, yes
2315848360,  La_CasainLegno, 8, 8, 0, yes
451527795,  FilippettiNews, 3, 3, 0, yes
318553195,  rosso_di_sera, 3, 2, 1, yes
786961372991090688,  GalAdelaide, 5, 3, 2, yes
50583397,  fdefranco1976, 16, 10, 6, yes
4589805027,  thecroalx, 14, 8, 6, yes
290597561,  ManuArrigons, 5, 0, 5, no
3048846859,  pasquino_spqr, 31, 2, 29, no
2654085878,  vince_cassano, 5, 0, 5, no
777565323344113664,  PdSudSanSevero, 30, 1, 29, no
2366076180,  faro82tv, 2, 2, 0, yes
3140978387,  esse_giovac, 3, 0, 3, no
3361200257,  Vitali_FV, 13, 0, 13, no
888296226,  RiccoLuciano, 20, 8, 12, no
731011029686190080,  ValeriaFabio73, 5, 5, 0, yes
1283852282,  maviccarone, 10, 10, 0, yes
2978426715,  plataniarobert1, 2, 2, 0, yes
737327544077287426,  caterin85020523, 11, 11, 0, yes
211547752,  News24Italy, 6, 6, 0, yes
718974916,  contemax72, 12, 12, 0, yes
781483818696007681,  robymacci, 2, 2, 0, yes
781113518019969028,  mpaola66, 10, 10, 0, yes
703817284,  paddeujose74, 4, 2, 2, neutral
735192087298117632,  Gersy09271153, 4, 4, 0, yes
781805054596636672,  barbarcolla, 6, 6, 0, yes
143934900,  AntonelloDAmico, 18, 16, 2, yes
785104448,  nazione_gianni, 1, 1, 0, yes
735162653123846145,  AnnaMariaCoron6, 7, 7, 0, yes
722931043578310656,  vita_felicetto, 16, 4, 12, no
2460919525,  visit_lazio, 2, 2, 0, yes
1378974757,  Italy_global, 1, 1, 0, yes
735061913349033984,  sandro_depaolis, 3, 3, 0, yes
753522606200983552,  Martawip, 1, 1, 0, yes
1331128747,  Sandra_AbbDR, 20, 8, 12, no
3386078415,  maurizio_lecci, 6, 1, 5, no
712303381574975488,  vincenz34424479, 2, 2, 0, yes
489291238,  claudiaxx83, 13, 10, 3, yes
800698016768233472,  laura_marghe, 60, 22, 38, no
3002191163,  PolveriniRemo, 2, 2, 0, yes
3947845402,  MrMartcus, 3, 2, 1, yes
2652929369,  ciocco09, 8, 1, 7, no
799963787059167232,  Divina59297343, 9, 3, 6, no
2925163426,  OfficinPasolini, 10, 10, 0, yes
29703078,  castellidsabbia, 6, 6, 0, yes
801532114139250688,  anto_terr_1947, 42, 15, 27, no
3062543201,  LazioCreativo, 2, 2, 0, yes
416341630,  marco_giobbi, 4, 4, 0, yes
19662510,  Fr_Merola, 1, 1, 0, yes
768173050890158080,  ranieroscarpon3, 2, 2, 0, yes
2638919492,  lunatica10001, 4, 3, 1, yes
1479178320,  duniaTwitting, 1, 1, 0, yes
366563735,  nataledicola, 2, 2, 0, yes
2556530227,  patriziagermin3, 2, 2, 0, yes
365552092,  IlarioGra, 3, 3, 0, yes
3132792268,  demissheart, 1, 1, 0, yes
787264983268749312,  radioincontrodo, 1, 1, 0, yes
1002688524,  fabio_andreola, 4, 4, 0, yes
188029214,  davjang, 24, 8, 16, no
2801319319,  giaco1492, 1, 1, 0, yes
711919695054692352,  ScuolaBaronio, 1, 1, 0, yes
881565745,  primapag_tweet, 6, 4, 2, yes
775000178558431233,  fabio_calcioli, 5, 5, 0, yes
323670080,  fianoromano, 4, 4, 0, yes
3630259279,  chiarettaT86, 1, 1, 0, yes
420593314,  Dr_urbe, 9, 8, 1, yes
385014976,  missNormaJane, 6, 1, 5, no
2742689487,  PiersantiPaola, 2, 2, 0, yes
735771855689109506,  romeotere, 1, 1, 0, yes
460080666,  frandan52, 1, 1, 0, yes
3127155902,  LamoglieCarmine, 2, 2, 0, yes
722400748408016897,  ScuolaVolonte, 1, 1, 0, yes
353160476,  RobertoRenga, 8, 3, 5, no
120398190,  faustinoguarald, 2, 2, 0, yes
70976677,  AndreaTardiola, 1, 1, 0, yes
2603992294,  miami_karim, 1, 1, 0, yes
24252705,  aural85, 31, 8, 23, no
784072358923558912,  1970stefania, 2, 2, 0, yes
246749281,  maurods2010, 3, 3, 0, yes
3025327283,  cacqua65, 1, 1, 0, yes
259673238,  EnteRomaNatura, 1, 1, 0, yes
1622368327,  Merin_Alba, 1, 1, 0, yes
519866924,  MirkoLoche, 1, 1, 0, yes
160556117,  franceskino75, 5, 4, 1, yes
1364657192,  LauraShardana, 1, 1, 0, yes
715994295,  nadbitti, 1, 1, 0, yes
802150000440569857,  kyply_bot, 20, 19, 1, yes
982731098,  iaiadipietro, 1, 1, 0, yes
51271311,  RiflessoDiLuna, 19, 7, 12, no
3957480201,  RLFilmComm, 2, 2, 0, yes
3048192892,  notaioditaranto, 2, 2, 0, yes
4889871352,  leet01styles, 1, 1, 0, yes
2740582169,  ceciliargt01, 1, 1, 0, yes
474340946,  Annalisadesisto, 1, 1, 0, yes
3716455887,  innammoratog, 2, 2, 0, yes
2188314006,  LatinaQTW, 2, 2, 0, yes
2676005622,  danielameo33, 1, 1, 0, yes
787931321561645056,  marcoiuff, 1, 1, 0, yes
2972919280,  A_digia86, 1, 1, 0, yes
2482396225,  nonnino37, 13, 2, 11, no
139508606,  Adamodandrea, 1, 1, 0, yes
805578426354638848,  SerraghhvHvv, 1, 1, 0, yes
360001375,  FictionFest, 1, 1, 0, yes
291976089,  Cristina66Rm, 1, 1, 0, yes
721269101566500864,  merycoty1975, 1, 1, 0, yes
726007952,  VincenzoArgent3, 2, 1, 1, neutral
542548905,  Rita27546, 3, 3, 0, yes
140643619,  FundacionTomy, 1, 1, 0, yes
125248235,  Mily_Ortiz, 1, 1, 0, yes
14911274,  marcocagnoli, 1, 1, 0, yes
381142019,  valeriosecco, 1, 1, 0, yes
375505860,  SteMicDM, 3, 2, 1, yes
2363871535,  Dani23493, 1, 1, 0, yes
303278808,  FabrizioSantori, 7, 4, 3, yes
3356663781,  antoaurigemma, 3, 3, 0, yes
485178877,  buschinimauro, 1, 1, 0, yes
802512718905409536,  emme_lp, 5, 3, 2, yes
1243846381,  GiacomoMarcella, 6, 4, 2, yes
24346799,  SaraSbaffi, 1, 1, 0, yes
129455752,  lucatocchio, 6, 3, 3, neutral
73875150,  omnibass, 1, 1, 0, yes
365064255,  HassanBassi, 1, 1, 0, yes
48785279,  annaitaly, 1, 1, 0, yes
91899366,  VisualPersist, 1, 1, 0, yes
717973854325444608,  rsacislfpsantal, 3, 3, 0, yes
3014215193,  IICColonia, 1, 1, 0, yes
3002983853,  izzo_lucio, 2, 2, 0, yes
1291867831,  CorintiLuciano, 1, 1, 0, yes
2959959556,  Marlinxy1, 1, 1, 0, yes
1128420954,  ManzoEsteban, 1, 1, 0, yes
104142050,  umbertoilari, 2, 1, 1, neutral
3257937245,  Etta_Giu, 1, 1, 0, yes
3389132949,  ARPALazio, 2, 2, 0, yes
2153829339,  anna_mattarelli, 31, 7, 24, no
589023152,  CROMA_UNIROMA3, 1, 1, 0, yes
2398081981,  ProLocoFondi, 1, 1, 0, yes
3578377822,  parcoausoni, 1, 1, 0, yes
791907732169326592,  cocilovo2106, 1, 1, 0, yes
3072520637,  ValentinoAbbate, 1, 1, 0, yes
2301639524,  nshongi, 1, 1, 0, yes
745315872521207808,  UGLIgAmbientale, 1, 1, 0, yes
470603138,  benedettoparis, 5, 5, 0, yes
710626130823348224,  bisluc65, 2, 2, 0, yes
2593364107,  rickyvagnarelli, 1, 1, 0, yes
1286898733,  angelobagnato, 1, 1, 0, yes
782173646089494528,  oltrepubblico, 2, 2, 0, yes
801913624893722624,  ortokinesis1, 3, 2, 1, yes
431042454,  MariaMarano_, 2, 1, 1, neutral
111933671,  cosimo73, 30, 13, 17, no
872443554,  giusedellosso, 6, 1, 5, no
417279241,  VasileAntonio, 17, 6, 11, no
41548247,  arcangelolamola, 8, 3, 5, no
411010417,  AGazaneo, 5, 1, 4, no
276697615,  supermariobrooo, 11, 4, 7, no
2270694999,  CarlaSicuro1, 3, 1, 2, no
133998087,  sdegnata, 11, 3, 8, no
527413030,  LorenzoComar, 11, 6, 5, yes
4805642373,  simonelaselva73, 2, 1, 1, neutral
2448108305,  martino311280, 4, 1, 3, no
2735997057,  73antonio27, 8, 5, 3, yes
1228391671,  pierpu6767, 69, 8, 61, no
413104909,  paoloamorico, 4, 2, 2, neutral
2413730278,  GiuMang81, 14, 7, 7, neutral
217827055,  Filonide, 8, 4, 4, neutral
543591886,  Matteo_LT, 3, 1, 2, no
134030762,  Si_fosse_foco, 2, 1, 1, neutral
797160016096690178,  Pyth8, 2, 1, 1, neutral
819829657,  gisellaruccia, 20, 9, 11, no
600415712,  stefanofumarulo, 7, 1, 6, no
1012943576,  MazzoneSabino, 5, 1, 4, no
119001227,  RinaldoMelucci, 9, 4, 5, no
245064844,  kapano76, 2, 1, 1, neutral
2253516584,  DrLoritatinelli, 5, 3, 2, yes
64692722,  WalterMusillo, 7, 4, 3, yes
799185635999412224,  N8lino, 4, 1, 3, no
4273349056,  RitaMaio1, 16, 4, 12, no
633842141,  tombecker86, 2, 1, 1, neutral
47963163,  inchiostroverde, 10, 3, 7, no
2350131678,  marce4733007, 5, 1, 4, no
2459726545,  CordelGiorno, 9, 5, 4, yes
452831702,  laurettasivo, 11, 2, 9, no
120389213,  Gigionda, 2, 1, 1, neutral
2353082360,  MicBorrillo, 6, 2, 4, no
433192298,  GrecoGio, 7, 1, 6, no
3064471084,  BlasiFrance, 2, 1, 1, neutral
386041299,  fantini_irene, 4, 2, 2, neutral
145702693,  mchicco, 3, 2, 1, yes
429201666,  antodaloiso, 2, 1, 1, neutral
3041485138,  fedi2511, 8, 4, 4, neutral
2245661774,  mongi1965, 5, 2, 3, no
224699717,  Puglia_in, 5, 4, 1, yes
473940458,  bobmastrangelo, 5, 3, 2, yes
2976177485,  coQua_ine, 4, 2, 2, neutral
37901057,  miketursi, 3, 2, 1, yes
4850084878,  TgrRaiPuglia, 10, 6, 4, yes
138799201,  onirepap, 5, 1, 4, no
1230010460,  ZPaolino, 3, 1, 2, no
1329985766,  adele_marinelli, 6, 2, 4, no
2760801606,  3626cac7561740f, 9, 5, 4, yes
1364646517,  FrancescoGualdi, 6, 3, 3, neutral
558591392,  QuagliarielloG, 14, 2, 12, no
2248969512,  QualeFuturo, 10, 5, 5, neutral
4192474587,  MaridaAlesi, 8, 5, 3, yes
3364660727,  gianturco4, 19, 6, 13, no
2995826032,  giocasmirri, 11, 2, 9, no
2935824485,  lucasoldini_93, 11, 10, 1, yes
81310857,  sylver65, 4, 3, 1, yes
27833981,  giantrom, 6, 1, 5, no
28700620,  AlexilSecco, 3, 1, 2, no
2157630750,  stefelici, 5, 2, 3, no
2949242037,  Ludimar54Luigi, 7, 2, 5, no
3239016405,  claudio301065, 61, 23, 38, no
2351753245,  danielebovisio, 8, 4, 4, neutral
461301109,  simonettamarcel, 12, 7, 5, yes
3375673725,  5ef9c280748a475, 37, 23, 14, yes
158470519,  Lellasilvi, 49, 32, 17, yes
3108373833,  ChisciotteF, 4, 4, 0, yes
2876741794,  LucaMurrone, 5, 5, 0, yes
10939652,  gluca54, 15, 15, 0, yes
212638814,  MassimilianoLB, 8, 8, 0, yes
1895022302,  blancinera, 6, 6, 0, yes
234134162,  GiadaFazzalari, 3, 3, 0, yes
1139871650,  sindacosasso, 16, 16, 0, yes
175557941,  trasanni, 4, 4, 0, yes
997500716,  Giomatr, 9, 9, 0, yes
3431535287,  camilla_bosi, 11, 11, 0, yes
748870907456786432,  ZoffoliPaolo, 27, 27, 0, yes
380209326,  AndreaMarretti, 5, 3, 2, yes
293511877,  NicoPavarin, 6, 4, 2, yes
412254670,  Ariaribi, 7, 7, 0, yes
39475962,  gps72, 10, 8, 2, yes
14070425,  PDBologna, 3, 3, 0, yes
402619254,  Gigisilver71, 5, 5, 0, yes
418568518,  GioCher75, 2, 2, 0, yes
374706184,  cesaremarcorell, 3, 3, 0, yes
713988077,  MPigni66, 3, 3, 0, yes
474873502,  leprif, 2, 2, 0, yes
488234925,  V_CogliatiDezza, 7, 7, 0, yes
499857709,  miche_marchi, 2, 2, 0, yes
1557514573,  elio_vito, 10, 1, 9, no
3316777688,  NiccoPPatrone, 5, 5, 0, yes
1077597126,  YazidVentuno, 5, 3, 2, yes
320184550,  crysbruni, 1, 1, 0, yes
2572838813,  ItalyinBH, 5, 5, 0, yes
618782497,  mlchaellaxphoto, 1, 1, 0, yes
3317745995,  SaxumTarpeium, 4, 2, 2, neutral
486384806,  Ammacca_Banana, 5, 5, 0, yes
770630183837655040,  pianetapensioni, 4, 2, 2, neutral
337168538,  ninaeffemele, 22, 20, 2, yes
2249221297,  3DicoNO, 6, 5, 1, yes
212145625,  CGiachi, 8, 8, 0, yes
85793150,  Paolo_Improta, 9, 4, 5, no
50584579,  beabri, 57, 3, 54, no
3434252595,  42_leo42, 3, 3, 0, yes
3294561682,  ferronibalbante, 3, 1, 2, no
341605090,  Antonella_Mansi, 1, 1, 0, yes
113564851,  AICEMilano, 3, 3, 0, yes
514604251,  romani_m, 4, 1, 3, no
97565162,  anniecliff, 1, 1, 0, yes
14443701,  epicariello, 2, 2, 0, yes
437533038,  francofontana43, 30, 6, 24, no
178971221,  ITASydney, 1, 1, 0, yes
441765625,  Diplomazia_Ec_I, 1, 1, 0, yes
484283827,  silvestrogio, 14, 10, 4, yes
953332236,  claudio4726, 2, 1, 1, neutral
732136568421556224,  Confindustria, 1, 1, 0, yes
1405186506,  AmokraneAzouza, 1, 1, 0, yes
306438236,  ZoldanClara, 1, 1, 0, yes
9522032,  ASSAFRICA, 1, 1, 0, yes
2480728985,  RowdyMike__, 1, 1, 0, yes
712267861,  antonio_musso, 3, 2, 1, yes
722086969094905864,  BenjaminW1892, 17, 1, 16, no
140358976,  francescobat, 8, 2, 6, no
56622417,  kebchiza, 2, 2, 0, yes
380551414,  patrizietto75, 5, 1, 4, no
100031881,  lucabazzana, 2, 2, 0, yes
1331730614,  appnau, 9, 1, 8, no
73445989,  icib, 1, 1, 0, yes
2333203880,  IoVotoNo78, 18, 12, 6, yes
409090466,  Unindustria_NA, 1, 1, 0, yes
2229049953,  eticasolitaria, 11, 1, 10, no
232972471,  JackieMilesiF, 9, 8, 1, yes
414174311,  vitosalfadda, 5, 3, 2, yes
625000187,  schnitzlerrr, 33, 12, 21, no
6164412,  olivar, 8, 4, 4, neutral
1180215542,  pagliani_t, 6, 4, 2, yes
411525579,  umbass, 6, 6, 0, yes
432661736,  Pazq63, 3, 3, 0, yes
425887937,  AlessiaArgent, 6, 4, 2, yes
2854343933,  lauraspring66, 1, 1, 0, yes
2280439274,  FernendoNevruZ, 5, 5, 0, yes
1277793402,  borderman74, 12, 12, 0, yes
740822746372972544,  ITASingapore, 2, 2, 0, yes
399075857,  DiMambro71, 1, 1, 0, yes
77554140,  crialicata, 36, 14, 22, no
2302922786,  aarturo_cravan, 1, 1, 0, yes
593644722,  AlfioMarciante, 6, 3, 3, neutral
3049910135,  corallo_gianni, 5, 2, 3, no
1094889476,  Markuslizza, 1, 1, 0, yes
68239562,  EdoardoMazzella, 9, 1, 8, no
491539735,  gbsxf4, 5, 3, 2, yes
2923831751,  DPludwinski, 2, 1, 1, neutral
2490046569,  AMcManl, 1, 1, 0, yes
14210532,  gabrieligm, 2, 2, 0, yes
1537342195,  valmatteucci, 5, 1, 4, no
539174332,  GDemola, 15, 11, 4, yes
85117452,  aniramiznat, 9, 3, 6, no
837804025,  emanuelevilla74, 29, 7, 22, no
41068452,  giacomofaustini, 22, 18, 4, yes
2987520981,  berchieale, 7, 2, 5, no
2493176940,  IIC_San_Paolo, 1, 1, 0, yes
2409152520,  LupoExpress, 22, 11, 11, neutral
62572408,  AnisioCiscotto, 3, 3, 0, yes
468724363,  EdoardoGarrone, 1, 1, 0, yes
3003254493,  carmen_distaso, 36, 16, 20, no
595426729,  LucianoOgnibene, 12, 11, 1, yes
1489971883,  ghite2, 6, 6, 0, yes
2970990513,  rs4design, 1, 1, 0, yes
1158606793,  stefania_lookb, 1, 1, 0, yes
2853317513,  Fed_ANIE, 1, 1, 0, yes
3354994965,  danicannix, 1, 1, 0, yes
64744912,  omar_quraishi, 1, 1, 0, yes
492652169,  MarcoPalillo, 3, 3, 0, yes
695753,  ezekiel, 22, 11, 11, neutral
424915583,  fpalermomm, 4, 2, 2, neutral
151029385,  PietroSalvatori, 5, 4, 1, yes
1601790577,  BaroneNigi, 4, 4, 0, yes
2355253204,  PietroCotroneo, 44, 42, 2, yes
494980825,  yborarram, 1, 1, 0, yes
379296972,  ANGELOCONCAS1, 1, 1, 0, yes
2438052497,  shasyafanzia, 2, 2, 0, yes
2858594918,  toddmcclaymp, 1, 1, 0, yes
2483029138,  lanjuers, 1, 1, 0, yes
326144852,  maddai_, 13, 12, 1, yes
500748464,  silviaballestra, 6, 3, 3, neutral
19447964,  Bla___, 14, 7, 7, neutral
787115406,  avvelenato1970, 13, 11, 2, yes
1320735566,  adriano_bernini, 1, 1, 0, yes
403270396,  Annamariabbate, 12, 10, 2, yes
798601134655078400,  Martina_CDP, 1, 1, 0, yes
2385051897,  MominHkhan, 1, 1, 0, yes
3134724957,  DonatoMontanino, 1, 1, 0, yes
748147422895943680,  chefinaccia, 2, 2, 0, yes
148032190,  MarcoMCrespi, 11, 8, 3, yes
40312584,  fuaadalawi, 1, 1, 0, yes
710193656708333568,  dakkar16, 5, 5, 0, yes
493524331,  clapaudice, 5, 1, 4, no
617544283,  beausbixnt, 1, 1, 0, yes
780579255256174592,  ItalyinNZ, 1, 1, 0, yes
789073047034757120,  elisaserena80, 13, 13, 0, yes
1660263480,  christianemmola, 5, 5, 0, yes
752199246997258241,  alfokid, 39, 35, 4, yes
47901347,  simonedistefano, 10, 10, 0, yes
593693314,  paolomassa58, 3, 3, 0, yes
14967240,  serenatudisco, 13, 7, 6, yes
734839351,  FCaliv, 12, 11, 1, yes
782137993649848320,  magique801, 90, 79, 11, yes
3238508633,  laluisellina, 22, 22, 0, yes
495103388,  Consentino_G, 5, 5, 0, yes
3102210747,  1971Piacentini, 12, 11, 1, yes
2157719841,  benalt66, 10, 9, 1, yes
3176594760,  giandomenic45, 190, 104, 86, yes
1361794033,  BiogalFa, 24, 9, 15, no
398309067,  PieroMonizio, 4, 2, 2, neutral
2404185052,  StruzzoSapiens, 6, 2, 4, no
2261701074,  Rizzolo1955, 23, 10, 13, no
2336448263,  avv_merighi, 3, 0, 3, no
471987010,  gpacenti, 17, 1, 16, no
1114596824,  LucioRomano02, 7, 7, 0, yes
2675322447,  demosolidale, 3, 3, 0, yes
2846869078,  maccantiingrid, 1, 1, 0, yes
2420250486,  FrancyVi855, 1, 1, 0, yes
608063632,  MassimoLeaderPD, 16, 10, 6, yes
706841262679310336,  BenitoMimmo, 5, 1, 4, no
494439200,  ab_itudinario, 5, 5, 0, yes
519379680,  sandromerg, 21, 7, 14, no
383790840,  danielamazza2, 16, 6, 10, no
712111069,  Kalverch, 7, 7, 0, yes
2918273481,  JepCagnola, 6, 3, 3, neutral
4900292662,  Gloriacrisci, 1, 1, 0, yes
2233203519,  marrocco52, 23, 7, 16, no
388284615,  giusmo1, 6, 5, 1, yes
29203505,  francescomosca, 2, 2, 0, yes
726721856749842436,  gabrillasarti2, 41, 16, 25, no
783250520412655616,  bastaunsiaversa, 4, 4, 0, yes
774208605339934720,  nortoncinque, 1, 1, 0, yes
604293321,  oliveri_giacomo, 3, 2, 1, yes
1364383692,  Fiorello, 1, 1, 0, yes
1557615492,  Jionni69Marco, 2, 2, 0, yes
629136662,  FranCarone, 6, 5, 1, yes
3622910547,  marco62108532, 3, 3, 0, yes
2393710947,  ScaGiusy, 19, 19, 0, yes
726444387123736577,  emanuela_zappia, 41, 41, 0, yes
2465793935,  Lista_Trippas, 1, 1, 0, yes
3070539136,  InsegnAspirante, 43, 43, 0, yes
726475563536359425,  violadrago, 22, 22, 0, yes
60890659,  RobertaLampis, 1, 1, 0, yes
727175188664729601,  margheritagior8, 32, 32, 0, yes
4689219091,  grazia_sciacca, 25, 25, 0, yes
4697190798,  TurdoLorenzo, 17, 17, 0, yes
2976723051,  ViniMagliulo, 37, 37, 0, yes
803524673032114180,  MARCELL04259284, 3, 0, 3, no
345462468,  pierviparisi, 3, 0, 3, no
796428219301953546,  bobbore1960, 3, 0, 3, no
789025525322899456,  TrollHunterXL, 28, 1, 27, no
1063063351,  CristinaTarqui1, 19, 18, 1, yes
722572543610195968,  valentinachioc, 3, 1, 2, no
67986502,  leti_palmisano, 2, 1, 1, neutral
3127521489,  FantinoLuciana, 3, 0, 3, no
1733164921,  AgostinoDAndrea, 2, 0, 2, no
83071101,  gipiredo, 8, 1, 7, no
991727834,  giularegina, 32, 4, 28, no
596157185,  BerriaLuca, 7, 4, 3, yes
209975198,  xPrenotare, 3, 1, 2, no
705303424951324672,  emiliobrizio, 4, 0, 4, no
760729745948565504,  TizianaDemma, 16, 0, 16, no
723538940502913024,  FdiAnUdine, 8, 3, 5, no
988229000,  MarcoGalbiati3, 4, 0, 4, no
392962936,  AngeloPrinci, 13, 0, 13, no
447893897,  BrigatiNicolas, 3, 1, 2, no
3317075583,  marcorigo82, 3, 1, 2, no
4452408435,  Valeriaflagiel1, 4, 1, 3, no
2319748337,  ForzaSilvioTW, 28, 2, 26, no
1288260026,  italialcentro, 12, 6, 6, neutral
243216805,  FAltitonante, 2, 0, 2, no
1577808642,  GruppoFI_Lomb, 5, 0, 5, no
1183179234,  vincirinaldi, 139, 50, 89, no
784666406508003328,  raimondo8858, 10, 1, 9, no
801841062763491328,  Cofi7, 47, 24, 23, yes
717328600,  it_pv, 3, 2, 1, yes
418717321,  Marcodv76, 4, 1, 3, no
136566683,  rinodid, 3, 1, 2, no
2243630040,  StePeschiaroli, 33, 1, 32, no
55678400,  ReferendumExit, 11, 4, 7, no
889582477,  masi_marcri, 8, 1, 7, no
4318424669,  SorrentinoAnt10, 28, 10, 18, no
2409656637,  76_tiffany_, 2, 1, 1, neutral
52011737,  fserneri, 11, 4, 7, no
1295447916,  Verkhojansk, 17, 3, 14, no
2677040619,  michelemancuso8, 2, 1, 1, neutral
2452296161,  franzin53, 17, 5, 12, no
430169858,  Arturo_Scotto, 36, 21, 15, yes
2891879969,  marcodilecce, 10, 4, 6, no
2394791163,  hawking1963, 3, 1, 2, no
3346079991,  LepriViola, 2, 1, 1, neutral
594882199,  mauraelzi, 14, 6, 8, no
457526922,  StefanoCarmelo, 2, 1, 1, neutral
126968751,  albturco, 4, 3, 1, yes
270951173,  vitaliadf, 36, 10, 26, no
561375612,  EnzoGioven, 19, 11, 8, yes
247722432,  Laura__Vittoria, 50, 33, 17, yes
2504756914,  listabiaso, 7, 2, 5, no
1037931534,  laur_bellezza, 3, 1, 2, no
792721026094395392,  RovazziGvt1234, 8, 4, 4, neutral
433395124,  AntonioRubino6, 6, 2, 4, no
791345703679324160,  Silvano77208402, 4, 1, 3, no
3436942246,  ivrea_n, 93, 56, 37, yes
2792329485,  PalaPala01, 3, 1, 2, no
2171153391,  praparelli, 11, 7, 4, yes
1085531312,  albealias, 4, 2, 2, neutral
1444752530,  lecorbuciccio, 11, 5, 6, no
1324304905,  GiovaPastor98, 9, 2, 7, no
3082802711,  francescasp89, 90, 5, 85, no
128311146,  piemarcy, 11, 4, 7, no
1360232480,  FmMosca, 11, 4, 7, no
754593317313216512,  radio_torino, 5, 1, 4, no
1239996265,  enricotorlo, 2, 1, 1, neutral
302720976,  LapoBeldonato, 21, 5, 16, no
781260487396843520,  EmanueleBontem5, 16, 8, 8, neutral
797109025162887168,  Aloia2Antonio, 6, 3, 3, neutral
1404322896,  rinaldi_rin, 11, 4, 7, no
48296648,  fedus80, 2, 1, 1, neutral
743910090000994304,  VitoBenzina, 2, 1, 1, neutral
442677409,  DiegoZardini, 3, 2, 1, yes
300362067,  leobollett, 17, 9, 8, yes
3048124403,  emma_cammarota, 4, 2, 2, neutral
985559940,  nceradini, 2, 1, 1, neutral
61751856,  frenkilsolito, 83, 29, 54, no
1193114784,  schivo97, 2, 1, 1, neutral
2941026292,  mr725905, 6, 2, 4, no
92501125,  marinogorsini, 14, 7, 7, neutral
2561421959,  stefatien, 13, 6, 7, no
446659785,  joe_giordano_, 2, 1, 1, neutral
2361146452,  Fiocchetto23, 12, 2, 10, no
803371786993893376,  LeoWolf1992, 47, 14, 33, no
594986631,  MirkoTani, 4, 2, 2, neutral
431454179,  PAOLANURNBERG, 3, 2, 1, yes
2372093340,  batt_tue, 2, 1, 1, neutral
1133542134,  stefania_dice, 2, 1, 1, neutral
986382066,  SelviStefano, 37, 14, 23, no
2460156105,  Leonardolux10, 9, 6, 3, yes
827908404,  cescverducci, 7, 4, 3, yes
563773403,  itbread, 23, 8, 15, no
2361146452,  pollettofarf, 28, 4, 24, no
896141977,  dedonno67, 4, 2, 2, neutral
414719178,  albertosofia, 3, 1, 2, no
594106386,  AnielloNapolita, 3, 1, 2, no
2957102265,  ainsy7, 2, 1, 1, neutral
2319858423,  mary_puccini, 2, 1, 1, neutral
615033595,  ConfortoC, 20, 1, 19, no
2614807096,  ZioToretto1991, 4, 2, 2, neutral
136325789,  marziascarano, 4, 3, 1, yes
410910327,  zikiluna, 54, 2, 52, no
407108278,  benedettocafaro, 2, 1, 1, neutral
154223938,  maxioffida, 2, 1, 1, neutral
803276193835470853,  Markyt_89, 8, 7, 1, yes
19643514,  paivetto, 35, 2, 33, no
911094367,  annamariabaldo1, 59, 0, 59, no
527516661,  GDezuani, 32, 8, 24, no
564388390,  DipendenteRai, 9, 9, 0, yes
502918121,  AntimiJenny, 9, 9, 0, yes
722039071049125888,  Ganjamanni, 18, 12, 6, yes
2429625547,  ADCAR13, 13, 8, 5, yes
478807479,  chiaracame78, 14, 11, 3, yes
946282471,  emanu_3l, 17, 12, 5, yes
4735924216,  Maffeisdani, 2, 2, 0, yes
13159862,  Matteo67, 10, 7, 3, yes
2548104146,  giuleo26, 45, 34, 11, yes
1159457418,  EmilioDilo, 3, 2, 1, yes
50571065,  sel2by3, 2, 2, 0, yes
491591759,  mennasesto, 6, 5, 1, yes
447894409,  StanzieVonDunk, 6, 6, 0, yes
244442502,  giosettanni, 2, 2, 0, yes
2920376271,  doncarlo74, 11, 6, 5, yes
619306530,  richidj1, 2, 2, 0, yes
64522965,  SaffronHorizon, 11, 1, 10, no
1642789244,  CarmeloMontana2, 44, 9, 35, no
2786191966,  tramontana971, 10, 8, 2, yes
3182081069,  Luigiantonio80, 5, 4, 1, yes
849590082,  enzo_boschi, 6, 6, 0, yes
32471056,  AreaLegno, 5, 5, 0, yes
38042921,  SimoneRaul, 3, 1, 2, no
2329940551,  TizianaMaurizi, 11, 1, 10, no
3445916417,  Casear_Iulius, 16, 1, 15, no
431089246,  santilligia, 7, 2, 5, no
284945036,  marinodestena, 4, 2, 2, neutral
467792801,  LagrangeThomas, 3, 2, 1, yes
52149689,  TRotesi, 3, 1, 2, no
62040984,  salmess, 2, 1, 1, neutral
498843395,  buc_alessandro, 3, 2, 1, yes
416952898,  MARCOFALCONE4, 2, 1, 1, neutral
430188772,  AdelaideFois, 2, 1, 1, neutral
3290952204,  Ale_Maccagni, 4, 2, 2, neutral
804781187524947968,  AnzideiMichela, 2, 1, 1, neutral
411636230,  VictorXMenendez, 6, 3, 3, neutral
332522093,  deltahf73, 13, 8, 5, yes
706841301,  ItAndreaScurti, 12, 2, 10, no
390641455,  Narutaru86, 16, 6, 10, no
1220930162,  elettroing, 11, 6, 5, yes
396494574,  wrsn75, 3, 2, 1, yes
3136144581,  Starwatcher00, 11, 3, 8, no
289839081,  lusami74, 5, 1, 4, no
288764479,  ChiaraScalzi85, 7, 5, 2, yes
214823847,  ienzus, 6, 1, 5, no
138418305,  poetam78, 8, 1, 7, no
1322287016,  scessa, 2, 1, 1, neutral
252604372,  AngCappellina, 10, 2, 8, no
240753714,  ConteAgostino, 7, 1, 6, no
614540697,  GiuseppeFilieri, 7, 1, 6, no
145978802,  la_kinetica, 4, 1, 3, no
1086972710,  robyschen, 11, 2, 9, no
2851732053,  scastellari61, 4, 4, 0, yes
592160447,  BiancofioreMiky, 9, 6, 3, yes
2386864207,  Sorrentino_Giov, 4, 2, 2, neutral
4229274312,  DRAGO__ENZO, 27, 20, 7, yes
2597062222,  davsmons, 10, 7, 3, yes
474924698,  sch_antonio, 4, 2, 2, neutral
2560295545,  IRIC10, 6, 2, 4, no
4869751612,  Alfredo47186635, 7, 4, 3, yes
2596224055,  rawandcook, 4, 2, 2, neutral
1163858592,  BarbaraFufu, 49, 28, 21, yes
1915050013,  Wlajuventus34, 10, 6, 4, yes
783330667258142721,  Bellinieugenio1, 28, 11, 17, no
29556279,  leograd, 14, 13, 1, yes
2616804263,  UnghieLaura, 10, 5, 5, neutral
771614243682562048,  UnMotociclista0, 2, 1, 1, neutral
2855546278,  nicocaciola, 3, 2, 1, yes
803287585527304193,  federicocarbo92, 2, 1, 1, neutral
723809827055607808,  NadiaCattai, 2, 1, 1, neutral
2694983040,  ConfcoopRO, 2, 1, 1, neutral
1890326197,  PicchixFirenze, 75, 15, 60, no
624548116,  silvons, 2, 1, 1, neutral
1647790712,  Nicus_Tarvisii, 8, 4, 4, neutral
768854242606116864,  UDU_Verona, 4, 2, 2, neutral
800298380714909697,  Luigi_Gandi, 11, 6, 5, yes
110439086,  MassimodeFavari, 7, 5, 2, yes
469502626,  ManzoniDavide, 7, 1, 6, no
2594466834,  damany81, 3, 1, 2, no
3166400685,  gattondemoniato, 19, 13, 6, yes
273051883,  Donburo, 9, 4, 5, no
1519870862,  AntPietrogrande, 3, 1, 2, no
408350460,  Rete_Studenti, 4, 2, 2, neutral
748157510,  RedSMTreviso, 2, 1, 1, neutral
3055936248,  GiammarcoManfr1, 4, 2, 2, neutral
3086498489,  IlMancinoVeneto, 2, 1, 1, neutral
1369431798,  EsterPeruffo, 2, 1, 1, neutral
71530179,  Achab94, 4, 1, 3, no
13631242,  balessa, 33, 6, 27, no
500191390,  SalGuttieri, 4, 1, 3, no
435760551,  GabrieleZahami, 6, 1, 5, no
426598982,  NicolaViti, 3, 1, 2, no
2691410693,  FdianF, 7, 1, 6, no
2301561164,  beppezini, 5, 1, 4, no
66997607,  mrjones1981, 6, 2, 4, no
1067868320,  68Cliffs, 3, 1, 2, no
82065633,  9cento, 14, 3, 11, no
2241594340,  mludodc, 9, 2, 7, no
16616869,  AbsurdityT, 6, 3, 3, neutral
3631947141,  luconeb81, 41, 17, 24, no
51539940,  guidobesana, 4, 1, 3, no
3147416317,  JukicEffe, 3, 1, 2, no
33228802,  BeatriceFeudale, 3, 1, 2, no
2425305955,  Skassankazzahia, 5, 2, 3, no
518949245,  Frank_Gira, 25, 15, 10, yes
559899927,  MarcoCantamessa, 4, 2, 2, neutral
1183794373,  Kia_InSpace, 3, 1, 2, no
2227588349,  BaldCezar, 5, 1, 4, no
473220410,  Cri_Giordano, 5, 2, 3, no
421040395,  Naso29, 4, 1, 3, no
438660521,  valeria_e_ben, 3, 1, 2, no
143377146,  EugenioMadda, 6, 2, 4, no
945729890,  MarcoCerreto, 4, 1, 3, no
849582750,  FedericaTordi, 5, 2, 3, no
463834585,  MANUELALUZI1, 5, 2, 3, no
723463953876180993,  faffa42, 4, 2, 2, neutral
803242837,  Lollo_Vio, 3, 1, 2, no
3058937357,  giancasalemi, 5, 5, 0, yes
488716638,  udiprimio, 6, 3, 3, neutral
2752833515,  BrusantePaola, 8, 5, 3, yes
564572462,  gealdambe, 5, 4, 1, yes
89412025,  JovaGraziano, 8, 2, 6, no
2358475547,  _John80, 13, 3, 10, no
237608753,  rosso72, 15, 6, 9, no
122088248,  sannita90, 3, 1, 2, no
42878311,  Omardegoli, 2, 2, 0, yes
507792558,  natasu5stelle, 70, 4, 66, no
2927289074,  TrunfioDomenico, 7, 2, 5, no
272028995,  Luca_O_o, 24, 22, 2, yes
778753237721706496,  giudiiiiiiiiii, 69, 10, 59, no
388299949,  bars_barbara, 15, 5, 10, no
2171267092,  mrpgln, 2, 2, 0, yes
923096305,  MarkoKardia, 4, 2, 2, neutral
449278512,  angelo_porcu, 8, 5, 3, yes
376042986,  stefanofilippuc, 3, 3, 0, yes
56635616,  Umbyboy, 3, 3, 0, yes
2891356306,  LBaccio, 2, 2, 0, yes
2328471661,  weevil_forbix, 48, 9, 39, no
1145224136,  romanrussian77, 2, 2, 0, yes
376871430,  Enzo_Pappalardo, 21, 7, 14, no
358143005,  enzus83, 31, 31, 0, yes
373413749,  DamnMonta, 4, 4, 0, yes
2874455566,  galante_marina, 23, 23, 0, yes
45140845,  enricovulpiani, 13, 6, 7, no
2954907201,  RCaricati, 9, 9, 0, yes
85852670,  CircoloFuturist, 8, 8, 0, yes
990311348,  Casaliderosa, 5, 5, 0, yes
411041852,  giorgiobenigni, 2, 1, 1, neutral
2347131464,  Iacobelli1987, 6, 1, 5, no
1474185410,  SupposteRette, 84, 5, 79, no
773827612800147457,  Kurdefeso, 6, 4, 2, yes
1470576733,  PesentiBianca, 7, 6, 1, yes
984807936,  stefanomanzoni8, 3, 3, 0, yes
144987828,  massimolanza, 7, 7, 0, yes
2975733075,  4ce3d7b36ecf4a2, 28, 28, 0, yes
3243183527,  alirovaris, 9, 7, 2, yes
973851150,  fmuia87, 2, 2, 0, yes
609145539,  ThePecana, 56, 51, 5, yes
877434170,  lucabruno18, 36, 30, 6, yes
800834104593936385,  DIVINASKY4, 3, 3, 0, yes
2509366304,  Angel_Ranieri, 2, 2, 0, yes
398717205,  BlackMamb_, 6, 4, 2, yes
3046231307,  ES_pressa, 6, 5, 1, yes
2836615967,  vocidallestero, 11, 7, 4, yes
984602317,  alessan61847326, 2, 2, 0, yes
1201274174,  pieronederland7, 15, 5, 10, no
2369467775,  CarmeloPozzo, 8, 3, 5, no
147322443,  Phuntsog_Tashi, 2, 2, 0, yes
871223384,  banglamunghe, 4, 3, 1, yes
141236993,  liukwell, 3, 3, 0, yes
213583658,  MaxGiomi, 2, 2, 0, yes
774210914409127937,  albertobrev, 21, 14, 7, yes
97322775,  tinomotta, 7, 5, 2, yes
1188920809,  BossiGmai, 2, 2, 0, yes
14573456,  gionninanni, 3, 2, 1, yes
784340188679974913,  MattiaCorna, 40, 22, 18, yes
22929449,  TitanMorgan, 3, 3, 0, yes
217003698,  LuigiAmbrosio, 9, 9, 0, yes
198526842,  yaripiazza, 2, 2, 0, yes
3341541105,  blu_pervinca, 2, 2, 0, yes
983222238,  angelo_cennamo, 12, 6, 6, neutral
732098776312250370,  Roberta21983814, 17, 16, 1, yes
315140856,  56carlo, 10, 3, 7, no
789957825917222913,  LamaCla11, 3, 2, 1, yes
164267043,  TheNewKing87, 2, 2, 0, yes
796309484381569024,  giuper74, 13, 8, 5, yes
1149014184,  sandradesnos, 5, 3, 2, yes
379161469,  domgokusei, 3, 3, 0, yes
544433402,  MatteoSarto1, 4, 4, 0, yes
116745529,  NicolePirozzi, 2, 2, 0, yes
764928828254871552,  vsnute, 5, 5, 0, yes
2328729294,  MIBrutus, 7, 5, 2, yes
420406571,  mickysal, 12, 11, 1, yes
216630942,  leomauro73, 5, 2, 3, no
433764828,  paganoturilli, 2, 2, 0, yes
47891008,  marcoforn, 3, 2, 1, yes
370615337,  Paskunky, 3, 3, 0, yes
1288192483,  emiliodanzi, 3, 3, 0, yes
1683545012,  2631925, 2, 2, 0, yes
598691163,  vpthevoice, 7, 4, 3, yes
2516094818,  OrgoglioSP, 2, 2, 0, yes
126903584,  mbriotti, 4, 4, 0, yes
82093201,  asetruria, 7, 6, 1, yes
528379927,  GDSenigallia, 2, 2, 0, yes
410972234,  gianzic, 17, 17, 0, yes
2894781395,  elconducator, 3, 3, 0, yes
721018058580606976,  MariaGraziaVas3, 10, 10, 0, yes
1058440837,  antomal62, 102, 101, 1, yes
783287015865511937,  Pina0988, 17, 17, 0, yes
756751959386906625,  enza_pedone, 12, 12, 0, yes
595663730,  DavideGuida3, 18, 18, 0, yes
148482956,  katia_donato, 4, 4, 0, yes
17409633,  fmanzo, 2, 2, 0, yes
1528603020,  pezslaugh, 8, 8, 0, yes
620071268,  elenaorrore, 6, 6, 0, yes
460136954,  meotange, 2, 2, 0, yes
384690779,  spedstefano, 18, 11, 7, yes
705034621,  SanteCasali, 2, 2, 0, yes
786474228258332672,  ValeriaMazzocco, 55, 54, 1, yes
788827713624735744,  MariellaC66, 18, 18, 0, yes
788816274168119296,  nunzia_spina, 65, 64, 1, yes
788744386553208832,  AntonellaViol16, 17, 17, 0, yes
1315096190,  giuliasock, 8, 5, 3, yes
151597193,  maxcoach71, 7, 7, 0, yes
3222791895,  Salvatoreborri8, 12, 12, 0, yes
541622566,  MRmaily, 6, 6, 0, yes
1083645529,  g_falcomata, 24, 24, 0, yes
3404851961,  Laura_Fagiolini, 7, 7, 0, yes
798886486712131584,  serena_antonaci, 13, 13, 0, yes
788468077079977988,  katia_lanciano, 9, 8, 1, yes
256455493,  tarzanarnone, 9, 9, 0, yes
170296809,  Caymano1987, 5, 2, 3, no
504355470,  nicolamarinab, 9, 8, 1, yes
715574358350163970,  olgacas78, 24, 24, 0, yes
800006070777298944,  RosariaMezzina, 15, 14, 1, yes
752081166384136192,  Sabina19461973, 7, 7, 0, yes
95503892,  archeomatt, 4, 3, 1, yes
788839435123195905,  danielagaglian5, 2, 2, 0, yes
786289703913914368,  8000esiliati, 3, 3, 0, yes
159760914,  M_R53, 3, 3, 0, yes
229298725,  LucaCico80, 9, 5, 4, yes
420369685,  UgoMilone, 3, 3, 0, yes
416561452,  csttino, 2, 2, 0, yes
336861442,  emiolo84, 11, 11, 0, yes
294567524,  VSannino, 6, 6, 0, yes
414170151,  lucci_marco, 2, 2, 0, yes
469753776,  Roberto_Rosso, 3, 3, 0, yes
441973402,  _MrWolf_, 4, 4, 0, yes
253130527,  LaMartina18, 2, 2, 0, yes
520333330,  GIOVANNISARIGU, 4, 4, 0, yes
575116715,  FCaberlotto, 4, 4, 0, yes
3563789836,  TWroscal, 4, 3, 1, yes
473960090,  Seamus_The_Dog, 19, 10, 9, yes
293043500,  miclapadula, 13, 13, 0, yes
768438281440813056,  _pullero, 11, 9, 2, yes
2241735773,  valewasherez, 2, 2, 0, yes
4264651871,  Candid_S_Voce, 9, 4, 5, no
3402750436,  MarioInTheRye, 11, 10, 1, yes
1333631328,  senza_impegno, 3, 3, 0, yes
22075599,  angelocasale, 22, 18, 4, yes
3026614547,  giorgiofontan, 34, 23, 11, yes
433287204,  massimoscolari, 5, 4, 1, yes
2996368373,  ndrfnc, 2, 2, 0, yes
2349060598,  Claudia_C911, 31, 29, 2, yes
1102037316,  anmart31, 2, 2, 0, yes
701091324,  padfrance, 7, 7, 0, yes
114695244,  Marcomixs, 5, 2, 3, no
878633929,  PaoloRighini, 7, 7, 0, yes
742262878867214336,  _pp7_, 2, 2, 0, yes
89747812,  TURINET, 5, 3, 2, yes
1694585623,  edo_peruz, 5, 5, 0, yes
2359005711,  FlorianoViggian, 6, 6, 0, yes
496114997,  porcelliluigi, 2, 2, 0, yes
400321579,  Patri528, 18, 18, 0, yes
10331712,  GerardoJGrasso, 8, 8, 0, yes
317144718,  Ezioledo, 5, 2, 3, no
413125526,  TschanzMF, 4, 4, 0, yes
1255385090,  antonellatenan, 2, 2, 0, yes
443678992,  Mapedone, 2, 2, 0, yes
1040220258,  MACCHIEle, 22, 22, 0, yes
636908542,  Mariocrisk85, 3, 3, 0, yes
1018537970,  bettypra, 3, 3, 0, yes
119128219,  bluesinbologna, 5, 4, 1, yes
332840450,  ElisabettaSoler, 8, 7, 1, yes
562316355,  JeSuisGiorgio, 7, 6, 1, yes
368875390,  francescgalleno, 2, 2, 0, yes
4047418282,  Olly69870522, 4, 4, 0, yes
92325737,  Amandiamante, 2, 2, 0, yes
1321230390,  GaDalu71, 2, 2, 0, yes
465016976,  giampiegirillo, 3, 3, 0, yes
784403303497170944,  chiccola7, 15, 13, 2, yes
3300735423,  gnaafamos, 18, 8, 10, no
466789101,  stuksman, 16, 13, 3, yes
352272919,  LoSpecchioRotto, 3, 2, 1, yes
1039461792,  patanemi, 15, 14, 1, yes
238604906,  matbonassi, 2, 2, 0, yes
1691785056,  Caticorselli, 2, 2, 0, yes
427395499,  barbaravellucci, 5, 5, 0, yes
48980680,  Rinocollocola, 4, 3, 1, yes
195742892,  GiammaSoftEng, 2, 2, 0, yes
33982163,  TommasoC, 26, 25, 1, yes
2605121005,  flevioh, 2, 2, 0, yes
90831777,  Sablab, 3, 3, 0, yes
430194752,  donvanniuno, 3, 3, 0, yes
331170505,  danielacirrone, 4, 4, 0, yes
1479702782,  sandrazing71, 23, 23, 0, yes
2177411409,  articiles, 2, 2, 0, yes
2234253145,  fra_din, 12, 8, 4, yes
423259720,  AnnaPinaju, 4, 4, 0, yes
357597253,  fmengacci, 7, 5, 2, yes
3806718323,  ely_aless, 2, 2, 0, yes
73598026,  apatarga, 4, 4, 0, yes
736281096686559232,  Verdesperanza75, 2, 2, 0, yes
335892778,  gcosentino_84, 2, 2, 0, yes
545213081,  SoniaSpinozzi, 3, 3, 0, yes
2445616026,  votosottoesame, 15, 15, 0, yes
2982262649,  nick_rm, 2, 2, 0, yes
591192759,  Lisa_Benvenuto, 4, 4, 0, yes
4506015149,  Marklan76, 2, 2, 0, yes
3046968035,  whoobee76, 3, 3, 0, yes
334337968,  MonicaCirinna, 15, 6, 9, no
774241370890469376,  mottura_antonio, 7, 4, 3, yes
776691079429099520,  pierlu_marche, 3, 3, 0, yes
251093963,  CarMa_77, 4, 4, 0, yes
1090516986,  Consell100, 4, 4, 0, yes
960666673,  Agricolae1, 9, 8, 1, yes
336770410,  MrEfis79, 38, 31, 7, yes
711310994,  RomanticoSky, 19, 12, 7, yes
2596256804,  blazar30, 3, 3, 0, yes
141217326,  AndBorto, 4, 4, 0, yes
31786481,  cardono, 2, 2, 0, yes
258037247,  Niviva64, 5, 5, 0, yes
4151187135,  illombardo, 4, 3, 1, yes
135861040,  Rafilucciu, 3, 3, 0, yes
199029542,  albmarg, 3, 2, 1, yes
535713785,  fabio_varone, 6, 6, 0, yes
703673755286020097,  LuanaBilardo, 2, 2, 0, yes
448775894,  hug_me_jd, 2, 2, 0, yes
384437761,  PdToscana, 10, 9, 1, yes
771295305128181760,  FidenzaSi, 56, 56, 0, yes
260372319,  fmiritello, 8, 8, 0, yes
2212470754,  AmatoGianmarco, 23, 23, 0, yes
2414070806,  GiuseppePalma78, 6, 6, 0, yes
396884500,  cri2991, 6, 3, 3, neutral
3664134095,  ritarimix, 2, 2, 0, yes
2374166250,  importechitalia, 6, 6, 0, yes
3121797969,  MoroniVisual, 2, 2, 0, yes
1251089251,  salidaparallela, 14, 0, 14, no
804670047117574144,  clurbanpeople, 7, 3, 4, no
16112979,  AndreaDiMaio, 14, 1, 13, no
293524143,  Luizinho100verg, 9, 5, 4, yes
557057167,  sloquik, 8, 0, 8, no
2342009888,  mose_sorbo, 4, 0, 4, no
518366373,  la_miranet, 4, 0, 4, no
3298864072,  SSegnala, 15, 1, 14, no
710609693,  100Clacco, 15, 3, 12, no
883001814,  fidelioit, 9, 1, 8, no
434870760,  pitta1958, 7, 2, 5, no
901555177,  signorinigc, 14, 1, 13, no
424540306,  PSchirripa, 11, 0, 11, no
2164822594,  steanti19, 5, 0, 5, no
1074801517,  MencacciAndrea, 130, 123, 7, yes
794164110061699072,  simocalabrese1, 40, 35, 5, yes
753856766639824896,  Vincetwittfos, 54, 16, 38, no
1690321208,  fabriziomontag, 241, 224, 17, yes
431500211,  angytnt, 12, 3, 9, no
871132850,  sanaricapaola, 5, 0, 5, no
1298737056,  SilviaDV73, 45, 0, 45, no
3002999651,  7andrea8, 9, 9, 0, yes
189613925,  mlabriola73, 7, 4, 3, yes
992119471,  Italicuss, 8, 5, 3, yes
1219888831,  FedericoGer, 9, 3, 6, no
424997954,  MaryPetrillo1, 13, 4, 9, no
245079861,  AlessioNeroni, 7, 5, 2, yes
1010807990,  PaperinikEdonna, 64, 35, 29, yes
401947052,  PinoMartino03, 10, 4, 6, no
742397759991480320,  manu_etoile, 106, 51, 55, no
114179008,  Savo27, 15, 7, 8, no
3400696882,  Vero82G, 51, 24, 27, no
585988043,  rfigliola, 9, 3, 6, no
766589504694214664,  Simo10689923, 11, 2, 9, no
1021541239,  tommybonaveri, 66, 0, 66, no
989841337,  NICOLAfromROMA, 10, 0, 10, no
2356757923,  SoriceAntonio, 2, 2, 0, yes
1051114320,  APeppinodit, 47, 2, 45, no
790567158489153536,  piras2017, 31, 0, 31, no
2822583095,  Hammurabhi, 38, 8, 30, no
590037686,  fanellis66, 21, 0, 21, no
2322734663,  gamin1978, 14, 5, 9, no
465960856,  CEustacchi, 9, 1, 8, no
2815530124,  lostupidiario, 11, 4, 7, no
4891656874,  PinoCostanzo1, 4, 0, 4, no
532495679,  MicheleAlquati, 6, 5, 1, yes
460322510,  bassi_riccardo, 2, 0, 2, no
1245505458,  SammyVarin, 27, 12, 15, no
2425643790,  ISPRAVIDEO, 4, 4, 0, yes
545136488,  FraMirabelli, 4, 4, 0, yes
439833080,  fernandorsini, 3, 3, 0, yes
722137405684346881,  Goodluck975, 3, 2, 1, yes
1370605363,  Eriador, 28, 17, 11, yes
114041232,  spippo_, 14, 13, 1, yes
748328221,  GuamoOnLine, 5, 3, 2, yes
2203769724,  92Alero, 10, 7, 3, yes
113386064,  SilverbackNews, 2, 2, 0, yes
540822800,  MGPersico, 2, 2, 0, yes
778917084399079425,  da_Gianburrasca, 4, 3, 1, yes
787611145083518976,  gepa2605, 2, 1, 1, neutral
170755030,  francescosegato, 2, 1, 1, neutral
1621071816,  ellamari53, 52, 22, 30, no
557943026,  cristina_gioia, 7, 2, 5, no
2354395787,  frau101_f, 45, 19, 26, no
1069080320,  MichelaRiviello, 7, 5, 2, yes
4775882567,  lamentedmente, 72, 2, 70, no
101762540,  winetaste01, 3, 1, 2, no
3468355577,  arghail2, 8, 5, 3, yes
416124700,  quintinocavallo, 12, 8, 4, yes
280401262,  mimmo_rinaldi, 29, 6, 23, no
1920377047,  TinaAnceschi, 13, 9, 4, yes
1344495229,  ildullo, 3, 1, 2, no
131800710,  MassFr, 4, 1, 3, no
425730108,  h2oroberto, 16, 7, 9, no
258758131,  nonmiricordo54, 12, 6, 6, neutral
545284832,  mazzocchitti, 16, 10, 6, yes
408445567,  Indios007, 2, 1, 1, neutral
3343049686,  adeerwith, 2, 1, 1, neutral
2382128702,  Daniela_Emme27, 33, 14, 19, no
4909156781,  pierguidob, 14, 3, 11, no
1275624685,  70Stefania70, 2, 1, 1, neutral
147371974,  PaoloBulcassimo, 59, 49, 10, yes
439258358,  Cipdimanu, 4, 0, 4, no
431096006,  paolotrande, 2, 1, 1, neutral
376610294,  IsabellaRauti, 6, 1, 5, no
1151076073,  ClaudioMonta64, 6, 2, 4, no
465471132,  danielabugatti, 49, 24, 25, no
2459996144,  M5S_Baroni, 12, 0, 12, no
760894592317358080,  1974giancarlo, 10, 7, 3, yes
2469248088,  GruppoPdLigur, 10, 10, 0, yes
3008168271,  Jonni231998, 5, 4, 1, yes
811707536,  tatixina, 4, 3, 1, yes
966148417,  RobertoMelideo, 2, 2, 0, yes
4451671336,  skaytg24, 5, 1, 4, no
538138673,  DoctorMaurinho, 14, 3, 11, no
968509314,  V_Mazzotta, 5, 0, 5, no
349555564,  davidegastaldo, 9, 2, 7, no
1076537990,  sanvi_pao, 5, 0, 5, no
3026297093,  venanzi60, 12, 0, 12, no
265278924,  VigilJosef, 34, 1, 33, no
3478668807,  claudiavalli85, 3, 0, 3, no
708276706,  DadoneFabiana, 6, 0, 6, no
1327481593,  marcellamaglion, 21, 0, 21, no
428261286,  ChiaraGiacosa, 21, 0, 21, no
163879703,  Piemonte5stelle, 25, 0, 25, no
3306971873,  GallonSr, 9, 0, 9, no
120178254,  vitaste, 2, 0, 2, no
1070732071,  camillafabbripd, 18, 16, 2, yes
621269962,  AlbertoMacciani, 3, 1, 2, no
3329627571,  UglPenitenziari, 5, 1, 4, no
397402165,  AntonioSilves11, 6, 2, 4, no
844228752,  EnasUGL, 4, 2, 2, neutral
932376896,  StefanoCetica, 125, 4, 121, no
1324201430,  uglaf, 55, 2, 53, no
1071492246,  Catone2013, 53, 3, 50, no
1327082838,  6ReTwitt, 22, 3, 19, no
2282354028,  WH_Beveridge, 35, 3, 32, no
2801772720,  Tanaquilla2, 15, 3, 12, no
113075421,  renatapolverini, 245, 4, 241, no
2160789500,  LIP_Rassegna, 43, 3, 40, no
1303711453,  1ConteOliver, 95, 4, 91, no
417342231,  fraba1, 3, 1, 2, no
1369768926,  celeste80686607, 9, 2, 7, no
454088602,  AmatrudaG, 28, 4, 24, no
185131593,  EzioFabiani, 8, 2, 6, no
3299633446,  tremendaful, 6, 5, 1, yes
2791785084,  SerenellaVerd, 5, 5, 0, yes
457323161,  RobyS1966, 6, 4, 2, yes
1011986162,  padrezampa, 5, 4, 1, yes
523511246,  vurchiosavino, 1, 1, 0, yes
2835121973,  Antincivili, 16, 1, 15, no
3304420265,  FVenarini, 1, 1, 0, yes
17214580,  RiccardoLuna, 11, 11, 0, yes
162472072,  nucciogerbino, 1, 1, 0, yes
216008083,  magdamante, 1, 1, 0, yes
281535434,  AlessandroDess, 2, 2, 0, yes
2433727925,  aidadafne, 20, 8, 12, no
2669177583,  davidebielli1, 4, 4, 0, yes
303139658,  unpendolare, 1, 1, 0, yes
333867424,  QTombolini, 5, 4, 1, yes
2415766076,  gianpaoloferra, 2, 2, 0, yes
411074123,  hadassah2362, 1, 1, 0, yes
759773365385048065,  BarbraScapegoat, 15, 8, 7, yes
793592565241110528,  karlos_87_87, 1, 1, 0, yes
493818614,  QuagliaAle, 2, 2, 0, yes
231525677,  giovanni121276, 6, 4, 2, yes
293355479,  Ilmercurio85, 1, 1, 0, yes
2895953165,  anninamonte, 1, 1, 0, yes
303217957,  jambolo1970, 4, 4, 0, yes
328133320,  vittobonfante, 2, 1, 1, neutral
125181108,  ValeReggio, 3, 3, 0, yes
324541622,  lilithwork, 1, 1, 0, yes
2629227623,  giuaformiglio, 5, 4, 1, yes
2567298888,  lucamanetta1, 3, 1, 2, no
498050516,  Grilli15, 2, 2, 0, yes
2201176105,  alpuglisi, 1, 1, 0, yes
431026181,  antonio15o, 1, 1, 0, yes
3405523131,  SabinaAristarco, 1, 1, 0, yes
2397594482,  lucilla908, 17, 2, 15, no
2435080910,  AlbertoNisti, 1, 1, 0, yes
998139500,  elenkall, 1, 1, 0, yes
1242301080,  francescoxconti, 3, 1, 2, no
179233827,  cherokeelouise, 2, 2, 0, yes
90501249,  Wu_Ming_Foundt, 2, 2, 0, yes
1269675482,  gulpg, 5, 5, 0, yes
2211479198,  elvcastellaneta, 8, 2, 6, no
1390511460,  leva_valentina, 2, 2, 0, yes
514264906,  bibbo125, 2, 1, 1, neutral
1040212734,  soniabertellot, 1, 1, 0, yes
496437886,  AndreaOrlandosp, 7, 7, 0, yes
2867200594,  minGiustizia, 7, 7, 0, yes
272112410,  giovicon, 5, 2, 3, no
602094087,  Menegaolo, 1, 1, 0, yes
2778061603,  spinassunta, 37, 17, 20, no
512524088,  piutardigodro, 1, 1, 0, yes
1110266634,  MatteoLgt, 3, 2, 1, yes
2359541056,  DGualerzi, 2, 2, 0, yes
455654704,  Marco_Raggi, 3, 3, 0, yes
185116067,  futuroetradiz, 2, 2, 0, yes
802343101775966208,  toicalmgeros191, 1, 1, 0, yes
330532430,  ascochita, 3, 3, 0, yes
2946340648,  Mnt14Steve, 1, 1, 0, yes
2462199506,  salvo_dagati, 3, 3, 0, yes
439546000,  StefanoScansani, 2, 2, 0, yes
3536077337,  Nikephoro, 5, 3, 2, yes
344937539,  mimmomazza, 5, 3, 2, yes
700862894800375809,  ITnewsAR, 1, 1, 0, yes
368543403,  Larina39, 1, 1, 0, yes
1349113298,  wgrasselli, 2, 2, 0, yes
462701585,  sydbarrett76, 11, 3, 8, no
266238202,  roxanne4591, 1, 1, 0, yes
248402270,  andrearoppoli, 1, 1, 0, yes
2433959065,  347mart, 1, 1, 0, yes
774596984997117952,  novatiS3, 2, 2, 0, yes
491255447,  annamariamoscar, 4, 4, 0, yes
55838333,  LetiziaCuscela, 1, 1, 0, yes
1365416479,  a_basaglia, 1, 1, 0, yes
2589059422,  cirillo_o, 4, 2, 2, neutral
1637660911,  thedreamer1707, 5, 2, 3, no
2987534445,  cioken1969, 3, 3, 0, yes
719093893795614720,  GigioSweet17, 2, 2, 0, yes
405487415,  gennyperron, 1, 1, 0, yes
435325982,  VeneziaGiacomo, 22, 22, 0, yes
73485492,  liviospl, 3, 2, 1, yes
1226262756,  RuggiSissi, 1, 1, 0, yes
139684967,  pasqualegranata, 4, 4, 0, yes
625814842,  roggiolani, 1, 1, 0, yes
1637600173,  patrinelli, 1, 1, 0, yes
64423644,  DonaFois, 2, 2, 0, yes
329051107,  millmr, 3, 3, 0, yes
778523278830862336,  DuccioOttanelli, 1, 1, 0, yes
2434019798,  XGiulioValerioX, 36, 28, 8, yes
762007460,  simonaburacci, 1, 1, 0, yes
2420183036,  frenato51, 1, 1, 0, yes
561338710,  BrunoAlfredoT, 1, 1, 0, yes
189676947,  marchiggia, 4, 3, 1, yes
2231736444,  geofilosofia1, 1, 1, 0, yes
481321999,  MaurizioDiGiuse, 12, 5, 7, no
1575366588,  ZAMBONPAOLO1, 1, 1, 0, yes
871430600,  MotisiAntonino, 1, 1, 0, yes
3246541323,  andrisaniale, 1, 1, 0, yes
803645797262888960,  Alessia46311014, 2, 2, 0, yes
756855937856602112,  irenebulga, 4, 2, 2, neutral
3342665663,  Terry_435, 1, 1, 0, yes
947584932,  MeniniMaurizio, 1, 1, 0, yes
1352450196,  kikka09f, 1, 1, 0, yes
31143368,  marcolillo, 2, 2, 0, yes
131262995,  dieguito82, 21, 10, 11, no
153531595,  lumukosta, 10, 6, 4, yes
405682451,  panettadomenico, 7, 7, 0, yes
729262286704128000,  AleRubicini, 1, 1, 0, yes
1292314838,  alessandrabosk, 1, 1, 0, yes
267678997,  getit_drone, 1, 1, 0, yes
2582893278,  LuciaDughetti, 1, 1, 0, yes
3671875756,  Philo1936, 4, 4, 0, yes
371147491,  vukbuk, 2, 2, 0, yes
393165018,  caputmax, 1, 1, 0, yes
24528653,  micgri, 1, 1, 0, yes
279527882,  feof81, 5, 5, 0, yes
927916422,  lilasart, 25, 5, 20, no
334238732,  AngeloNicotra, 6, 1, 5, no
1157781200,  pierocurrao, 1, 1, 0, yes
300814551,  ClaSantovito, 1, 1, 0, yes
463009167,  RobertoArduini1, 12, 6, 6, neutral
2356265088,  carlopelizzo, 2, 1, 1, neutral
788808578,  Infoblu_Roma, 2, 1, 1, neutral
396597980,  pinobranca, 2, 2, 0, yes
362476617,  tizianalepore, 9, 9, 0, yes
372344749,  andreavianel, 2, 1, 1, neutral
522438312,  MarcoCampagna8, 13, 13, 0, yes
633020845,  davide_turrini, 1, 1, 0, yes
770623385650995200,  LESBODROMICA, 2, 1, 1, neutral
769960650,  GiusMorrison, 5, 3, 2, yes
1050997706,  EspositoIvana, 10, 4, 6, no
486507645,  claudiopozza, 1, 1, 0, yes
2331669626,  20CenturyBoy_81, 1, 1, 0, yes
255526995,  ap_legambiente, 2, 2, 0, yes
600087907,  LegambienteLa, 1, 1, 0, yes
1308057632,  RobScacchi, 2, 2, 0, yes
382105521,  JohnnyParty2123, 2, 1, 1, neutral
35312869,  rafaelamedina, 1, 1, 0, yes
1039036466,  unasoltantum, 2, 1, 1, neutral
1538259277,  dimurogianpiero, 1, 1, 0, yes
448131888,  Melones79, 4, 4, 0, yes
488484539,  bicisnob, 6, 1, 5, no
227643160,  piuturismo, 1, 1, 0, yes
512848201,  MGrazietta, 1, 1, 0, yes
4900841613,  lorella_coppa, 1, 1, 0, yes
202192235,  mrassociati, 1, 1, 0, yes
220075111,  LucaPintavalle, 4, 4, 0, yes
477846429,  RMondschein, 1, 1, 0, yes
2339926361,  ddibagno, 3, 3, 0, yes
1174571874,  TwitBattito, 2, 1, 1, neutral
163969032,  morry74, 2, 2, 0, yes
526341596,  fededelprete, 2, 2, 0, yes
2425868442,  MicBuonomo, 5, 5, 0, yes
74693664,  MariaLatella, 7, 7, 0, yes
962482070,  djsolko, 1, 1, 0, yes
1113395882,  Belen31192, 5, 2, 3, no
464978906,  LuciaSoccorsi, 1, 1, 0, yes
1249082185,  CycloPrideIT, 1, 1, 0, yes
3153876826,  cycloprideita, 1, 1, 0, yes
1065507722,  lucelucente7, 5, 4, 1, yes
731480135505969152,  LaVoceRC, 11, 6, 5, yes
457472977,  galante55, 1, 1, 0, yes
1337654743,  FrancoFalbo1, 6, 1, 5, no
2555242896,  RenataRZargar, 2, 2, 0, yes
3824087723,  GiuNadia29, 1, 1, 0, yes
4130639901,  Sinistrait_, 34, 23, 11, yes
1162439142,  MailPatrizia, 1, 1, 0, yes
33521233,  michelataxistro, 82, 2, 80, no
144430939,  cieffe27, 6, 6, 0, yes
1382849929,  EZanchini, 2, 2, 0, yes
1127690690,  freefreefree23, 1, 1, 0, yes
2784350349,  asprinou, 1, 1, 0, yes
55244228,  lucaquagliato, 1, 1, 0, yes
840284599,  rizzo_lele, 7, 4, 3, yes
271879647,  MarcoCapoccetti, 9, 4, 5, no
539167684,  fabipaterniti, 3, 2, 1, yes
1172281572,  profgviesti, 2, 2, 0, yes
1219572878,  Ianus95, 1, 1, 0, yes
426767777,  mariokb0s, 1, 1, 0, yes
3334600017,  99Anntonio, 38, 21, 17, yes
3922344275,  mecca_salvatore, 25, 3, 22, no
9584192,  AlfonsoFuggetta, 19, 6, 13, no
744961229853167616,  gianpaolo72, 15, 7, 8, no
108550570,  ENEAOfficial, 3, 3, 0, yes
592806834,  fabertweet, 5, 5, 0, yes
2936813295,  PressMareItalia, 1, 1, 0, yes
516453272,  Iaya68, 5, 1, 4, no
46635793,  bluvi0lin, 7, 3, 4, no
304681933,  notav_info, 7, 1, 6, no
3179321705,  Lino230756Lino, 1, 1, 0, yes
3601766603,  IngPlazza, 1, 1, 0, yes
725700577007702016,  lucatriani1, 1, 1, 0, yes
1222221458,  DaniloLumini, 1, 1, 0, yes
57251373,  Ambro1Q84, 5, 5, 0, yes
3312179327,  AragoneMarianna, 2, 2, 0, yes
298532531,  RANRoberto, 12, 4, 8, no
393991844,  SpazioGuernica, 1, 1, 0, yes
1473356281,  Dany_morritz, 6, 2, 4, no
374678484,  GemmaRomano, 2, 2, 0, yes
464012055,  FBlutarsky, 3, 2, 1, yes
196248501,  SanGamaro, 1, 1, 0, yes
3333764236,  deb8479eaeef410, 19, 16, 3, yes
37903647,  sariccia, 2, 2, 0, yes
2728729392,  PisuAlberto, 2, 2, 0, yes
1429737960,  BALBOMariella, 1, 1, 0, yes
1156524972,  aprada7, 1, 1, 0, yes
490695573,  dariopanz, 1, 1, 0, yes
22248695,  anthos_04, 2, 2, 0, yes
1745966046,  luigidelucia218, 20, 2, 18, no
2976226983,  LaraPolidori, 2, 2, 0, yes
61162279,  zeropregi, 4, 2, 2, neutral
427379751,  Ferrovieit, 1, 1, 0, yes
614443056,  AnnaNigra, 2, 2, 0, yes
2365001385,  CinziaGrenci, 1, 1, 0, yes
144192877,  paolodavide, 1, 1, 0, yes
427386579,  LorenzoSicili, 2, 2, 0, yes
426749264,  marinorsi, 1, 1, 0, yes
1351818931,  annalisaricardi, 1, 1, 0, yes
439908934,  pippopapi, 2, 1, 1, neutral
741293293930188800,  Alba02426651, 4, 1, 3, no
4894437028,  AbbateEva, 1, 1, 0, yes
1904322224,  cardinali_vale, 1, 1, 0, yes
589334733,  redpuma1975, 1, 1, 0, yes
3054272141,  Aupo58, 3, 1, 2, no
800198053,  giuspaterniti, 8, 8, 0, yes
1190111017,  RoccoFernandoSe, 7, 3, 4, no
1135427762,  ARGDON62, 2, 1, 1, neutral
2665272079,  GuyHardingOC, 2, 1, 1, neutral
389477469,  capitano1971, 15, 7, 8, no
7824892,  thesignlab, 3, 2, 1, yes
344833457,  citizenpaki, 7, 5, 2, yes
25666697,  donatodesena, 6, 3, 3, neutral
432860042,  robertodiluigi, 2, 1, 1, neutral
253491171,  Fedelotti81, 2, 1, 1, neutral
2305058365,  laurapetrarca2, 4, 1, 3, no
2542889860,  marinocasoni, 5, 2, 3, no
1384230229,  lomejordeitalia, 12, 8, 4, yes
36079217,  ilmessaggeroit, 11, 8, 3, yes
6831142,  Gazzettino, 3, 2, 1, yes
519731238,  rizza_francesco, 10, 1, 9, no
2482258987,  sergiopreti76, 2, 1, 1, neutral
35721171,  aldotorchiaro, 7, 3, 4, no
418790167,  Ricky_Rock81, 8, 3, 5, no
545051848,  RobertoZetti, 4, 1, 3, no
409304097,  laresadeitonti, 5, 4, 1, yes
2332729915,  Parlamento5, 3, 2, 1, yes
83827013,  sebascuffari, 2, 1, 1, neutral
3078545590,  gavriel_amati, 2, 1, 1, neutral
730553777909075968,  Andr_Salome, 2, 1, 1, neutral
557829084,  CheccoMiggiano, 3, 2, 1, yes
745307744790515712,  ArniWinkelried, 2, 1, 1, neutral
6567492,  antokio, 8, 5, 3, yes
18944504,  dantesantacroce, 2, 1, 1, neutral
254584528,  Frag0laHonami, 3, 2, 1, yes
316684906,  ginomonzecchi, 9, 8, 1, yes
33872718,  fmorcavallo, 2, 1, 1, neutral
1288209314,  M5SpiuL, 20, 8, 12, no
947943943,  SamanthaBizzoni, 2, 0, 2, no
2851228124,  79b83962c72d42b, 13, 4, 9, no
604888657,  nicola_corrado, 2, 0, 2, no
790705219688693760,  Lab5Valenzano, 2, 0, 2, no
2216248313,  Statler_the_old, 4, 1, 3, no
696595370395172864,  PoliticaPerJedi, 6, 2, 4, no
593556512,  BertolliniR, 2, 0, 2, no
3189500505,  morelon9, 9, 2, 7, no
384225937,  carminebruno92, 4, 0, 4, no
125321939,  Bagos1984, 6, 1, 5, no
9334812,  notEricC, 2, 0, 2, no
374087921,  calpurniobestia, 5, 1, 4, no
967698096,  luiser133, 18, 1, 17, no
485039963,  demagistris_ant, 8, 0, 8, no
2919241120,  LDalfollo, 54, 1, 53, no
4893370455,  lupachiotto3, 49, 2, 47, no
440991666,  unodeibassi, 63, 2, 61, no
362093487,  ninotheworse, 24, 5, 19, no
4495833857,  luhamilano2013, 5, 4, 1, yes
292203548,  nopasaran846, 6, 1, 5, no
3177828940,  lapattytaro, 4, 2, 2, neutral
3457705635,  lucascano325, 8, 4, 4, neutral
3405845278,  WotanVolk, 2, 1, 1, neutral
359837842,  ivanficus, 10, 5, 5, neutral
3985072012,  WMenicacci, 28, 11, 17, no
801710252827807745,  paolatirab64, 16, 1, 15, no
952427629,  tf973, 7, 4, 3, yes
1066657957,  fortunatosommel, 11, 3, 8, no
779999286042001408,  Disinc_Anto, 30, 26, 4, yes
3327047817,  12cdba27ee8f4e6, 10, 5, 5, neutral
4876680137,  ChiaraLicciard, 50, 43, 7, yes
753558289,  tonymeola, 5, 2, 3, no
379768942,  1956lia, 3, 2, 1, yes
796490271630434304,  mcDonaldTrump6, 8, 3, 5, no
774283382108909568,  Sara27049966, 11, 9, 2, yes
1201970520,  grillonardo, 6, 2, 4, no
44775742,  aleusai, 3, 2, 1, yes
1091357406,  cutrupigiuseppe, 6, 4, 2, yes
4189019849,  giogio_al_cubo, 11, 5, 6, no
2347311747,  BernardiniAr, 7, 3, 4, no
794903125,  MicheleSepe96, 10, 3, 7, no
391335702,  elisasola_, 4, 2, 2, neutral
1278185288,  GonniePolman, 8, 3, 5, no
928202780,  fareleuropaxpd, 25, 24, 1, yes
482231012,  giudefilippi, 2, 1, 1, neutral
2188803397,  laredazzi, 25, 2, 23, no
492319960,  StefanoMontuori, 11, 5, 6, no
227632733,  apalma67, 8, 4, 4, neutral
1426157994,  MariaCostaBonec, 6, 5, 1, yes
911070912,  paiano_luca, 2, 1, 1, neutral
385910975,  Idongion, 3, 2, 1, yes
1252878440,  signorinacav, 1, 1, 0, yes
371160962,  MauroGrandi78, 6, 2, 4, no
2754433686,  simplyUmberto, 6, 2, 4, no
512982776,  VeroCatania, 6, 6, 0, yes
2645363448,  LaSpadaDeFoco, 2, 2, 0, yes
1308491004,  Ciopfrem, 8, 3, 5, no
3958632334,  righidegan, 12, 8, 4, yes
575833305,  LanfrancoPalazz, 10, 3, 7, no
769128592299134977,  NovaVetera, 30, 11, 19, no
4226454377,  pelle_adri, 3, 3, 0, yes
7500802,  matteobordone, 1, 1, 0, yes
231003363,  machediscorsi, 10, 7, 3, yes
3312303309,  frarorarf, 72, 2, 70, no
564148431,  camaleontimisti, 160, 4, 156, no
857823696,  luco1977, 3, 3, 0, yes
1151068016,  PossibilePadova, 2, 1, 1, neutral
211892670,  TommyLombardini, 1, 1, 0, yes
98212000,  jimimurani, 7, 3, 4, no
776304284,  RaffaelaSalmaso, 6, 5, 1, yes
418279884,  SilvanRossi, 2, 2, 0, yes
1008738409,  saivspa, 4, 4, 0, yes
742259446764711936,  marandando77, 7, 2, 5, no
59200159,  anton_petrovic, 1, 1, 0, yes
711206425,  vinc960, 22, 11, 11, neutral
377903863,  MauroPittorra, 1, 1, 0, yes
121598739,  lellapaolo, 1, 1, 0, yes
127936127,  glpaglia, 4, 4, 0, yes
4635757648,  cisco07121986, 1, 1, 0, yes
700690132769370112,  landrea92, 12, 2, 10, no
46928097,  marcofurfaro, 12, 7, 5, yes
330290202,  enbusetto, 2, 2, 0, yes
289979050,  PaoloTregnago, 1, 1, 0, yes
2306091538,  ClaudioColu, 7, 4, 3, yes
714775585088737280,  heredelilah, 10, 2, 8, no
2244030673,  frances_za, 6, 1, 5, no
797909640,  PovoloG, 2, 2, 0, yes
1098780246,  varesino66, 1, 1, 0, yes
353538686,  MaselliA, 4, 2, 2, neutral
21255779,  DocThomas, 3, 3, 0, yes
748058916093853696,  Antocava1, 2, 2, 0, yes
590918576,  pseudopodio, 12, 10, 2, yes
365962308,  NicolaBoldini, 1, 1, 0, yes
2542387598,  DanesiSimonetta, 13, 3, 10, no
14108472,  civati, 101, 5, 96, no
1510231602,  delucaGen88, 2, 0, 2, no
360868017,  PaoloBersani, 68, 20, 48, no
805858685717217281,  Massimi56414164, 10, 6, 4, yes
107737376,  accendino1111, 17, 11, 6, yes
3018738275,  sergiodadamo, 13, 7, 6, yes
1198415630,  MIZIOOOOOOO, 20, 12, 8, yes
409540134,  rossa008, 19, 8, 11, no
724633716396580864,  EmaMig67, 5, 1, 4, no
2456846400,  VEN_VIT52, 15, 9, 6, yes
348348465,  kela973, 8, 4, 4, neutral
418169027,  Zone1543, 9, 5, 4, yes
186184801,  Kiapp1, 2, 1, 1, neutral
4011901702,  GhinoDeZena, 6, 3, 3, neutral
401517487,  vincenzogra, 15, 14, 1, yes
1561485906,  Vince88Io, 3, 2, 1, yes
2369379741,  aalaimo73, 4, 3, 1, yes
702904109070946304,  normalatosca, 3, 1, 2, no
1062548953,  bettegasewin, 7, 1, 6, no
1331076596,  riomarri, 4, 3, 1, yes
168976687,  thequeenthree, 18, 8, 10, no
801816292013539328,  marcella_zarbo, 3, 2, 1, yes
137997259,  mvdvdl, 3, 1, 2, no
752117556077473792,  SimonettiLina, 16, 15, 1, yes
14897043,  antoniodimieri, 12, 6, 6, neutral
2401418695,  francodg60, 52, 22, 30, no
582549891,  GiovanniDeriu8, 3, 2, 1, yes
49099085,  L_Kincaid, 5, 4, 1, yes
619043733,  TenenteTanaka, 3, 2, 1, yes
797138085725278209,  realGiorgioBrux, 82, 33, 49, no
466001142,  NadiaGrmn, 6, 4, 2, yes
1652723858,  SteSantachiara, 10, 7, 3, yes
50026235,  piccololupo, 4, 3, 1, yes
733316908477493248,  dg261159, 5, 4, 1, yes
805366602619293696,  LaLaienaridens, 1, 1, 0, yes
2559192629,  plebani_clelia, 9, 7, 2, yes
1231825982,  mansi_francesco, 2, 2, 0, yes
951759308,  claudia_passa, 2, 2, 0, yes
409361259,  alexbarbera, 2, 1, 1, neutral
706570580,  OresteBortoluz, 33, 10, 23, no
802531601590657024,  andyneg71, 2, 2, 0, yes
3339701793,  5b556f1e896a49a, 2, 2, 0, yes
405433901,  CarlaBartolucci, 2, 1, 1, neutral
2365653284,  giulia_molinaro, 15, 4, 11, no
529317309,  cipriani1945, 8, 2, 6, no
465797535,  CesareLanza, 2, 1, 1, neutral
464947115,  FranciZaltieri, 4, 3, 1, yes
501874833,  s_margiotta, 65, 44, 21, yes
720856202,  scaranovinc, 2, 2, 0, yes
925110174,  mirko_cantore, 2, 2, 0, yes
475394911,  GiovanniVerdoli, 1, 1, 0, yes
273360926,  rosariaizzor, 3, 2, 1, yes
786865600115204096,  c_mauz, 21, 9, 12, no
4009855107,  EwaOrlinska, 5, 5, 0, yes
22044386,  biagiomarzo, 9, 5, 4, yes
144778464,  PaolaCasoliBlog, 3, 3, 0, yes
425236969,  jacopocecconi, 5, 5, 0, yes
1272915272,  GZanfanti, 4, 1, 3, no
236565724,  GiuliaGrilloM5S, 31, 0, 31, no
472185426,  RiccardoRogani, 30, 1, 29, no
949926276,  niforcheri, 2, 0, 2, no
3001660931,  UmbertoDe_Marco, 6, 3, 3, neutral
919333159,  TimoRonk, 13, 2, 11, no
1330005582,  ArfioClandestin, 8, 2, 6, no
2891197923,  davidelgaudio, 61, 18, 43, no
697090269859213312,  Io__boh, 15, 4, 11, no
133020703,  polets91, 4, 2, 2, neutral
473274676,  mpace_pace, 3, 1, 2, no
1467171296,  Essere_Orietta, 3, 1, 2, no
1307458242,  FamaMagna, 12, 7, 5, yes
786101538334932994,  SteRocca, 4, 1, 3, no
482938015,  artemisiagl, 4, 1, 3, no
614966455,  SimoneYue, 3, 1, 2, no
221853726,  GDMedici, 6, 2, 4, no
195063290,  OlivieriNicola, 11, 3, 8, no
53349887,  Ultrauseless, 4, 1, 3, no
3137217530,  LaGinuzza, 5, 2, 3, no
2719566132,  FlyingAndrew91, 10, 2, 8, no
178453735,  ohanastrana, 9, 3, 6, no
225484216,  DavideBerry, 3, 1, 2, no
3294527697,  MyVoodooo, 11, 7, 4, yes
2286669109,  GMeledandri, 10, 3, 7, no
1395477444,  JustinScandal, 5, 2, 3, no
749943623467294720,  alessaliani, 9, 5, 4, yes
2348635034,  sayaddhina, 12, 6, 6, neutral
500012385,  stefaniaaversa, 3, 1, 2, no
930476808,  SandorTence, 4, 1, 3, no
437044935,  francisforkekko, 5, 1, 4, no
3377204649,  valentinasheena, 3, 1, 2, no
259047162,  egoasavakit, 7, 3, 4, no
889062380,  Maria_Paulucci, 7, 2, 5, no
1068846679,  jkfgds, 13, 3, 10, no
4873807691,  tirasianicris, 32, 6, 26, no
392934359,  VallySpezzani, 4, 2, 2, neutral
2526923119,  ErneCremonesi, 5, 2, 3, no
298248825,  NatDeGregorio, 14, 3, 11, no
2800037465,  frances18310233, 5, 1, 4, no
36353564,  carlogubi, 30, 9, 21, no
781821141858091008,  BartoloGiusti, 19, 7, 12, no
103544109,  LiberaMenteDonn, 4, 2, 2, neutral
821785003,  FrancescoPanser, 6, 3, 3, neutral
96355801,  marcobreso, 6, 5, 1, yes
757902800256917504,  AntoninoTolu, 3, 0, 3, no
3366458710,  Chirieleisonne, 3, 3, 0, yes
3347451616,  consudsiriparte, 2, 0, 2, no
209007993,  PdSUD, 70, 2, 68, no
591663175,  leonanvehia, 7, 0, 7, no
478647183,  NataleCuccurese, 60, 0, 60, no
2623809318,  DocRicky82, 5, 5, 0, yes
897377131,  sbronz68, 8, 8, 0, yes
276557542,  alexariete79, 11, 11, 0, yes
184015853,  schumyno, 41, 11, 30, no
328915953,  lybra_77, 3, 3, 0, yes
796030193295048706,  Jalan6789, 6, 6, 0, yes
389907701,  ICarravetta, 2, 2, 0, yes
82910300,  battiatino, 5, 2, 3, no
2384687890,  jack_iny, 29, 15, 14, yes
4853628435,  solonews1011, 5, 5, 0, yes
160199059,  Bibolotty, 11, 11, 0, yes
3329102776,  AlessandraDumbo, 8, 5, 3, yes
1191184285,  CocciaMc, 9, 9, 0, yes
1089931591,  miasuocera, 7, 7, 0, yes
1140264841,  LabParlamento, 13, 13, 0, yes
1080493914,  tangodown911, 14, 14, 0, yes
757150618188386304,  ussarialati, 6, 4, 2, yes
757836788949929984,  Ryan_N445, 2, 2, 0, yes
749570125800607744,  YMalvisi, 9, 9, 0, yes
2911434461,  jayelef_64, 5, 3, 2, yes
717773478213103616,  elnacionale, 6, 5, 1, yes
2236569729,  MirkoOtranto, 2, 2, 0, yes
2863193461,  LoCon_14, 4, 3, 1, yes
377620042,  FilippoHV, 1, 1, 0, yes
1464258434,  MiltonBlog, 7, 6, 1, yes
2501808527,  JendoKal, 5, 3, 2, yes
1178518129,  _pp_tm_, 13, 11, 2, yes
855409861,  squittarelli, 1, 1, 0, yes
328935079,  TheExtremista, 16, 15, 1, yes
2276406060,  ziobabbione, 15, 8, 7, yes
1139838132,  OSStefano, 3, 2, 1, yes
534504035,  Hepicuro, 5, 3, 2, yes
438419435,  Noto56, 1, 1, 0, yes
769836393908596736,  antonino_muccio, 2, 2, 0, yes
230534506,  tracceweb, 1, 1, 0, yes
3236058285,  straborghese, 3, 3, 0, yes
365079939,  Irpino1959, 2, 2, 0, yes
290463608,  FMarzucchi, 1, 1, 0, yes
2362415546,  antofeja, 28, 14, 14, neutral
2967451289,  mrtnrlrd, 10, 9, 1, yes
107854945,  paolofaeti, 2, 2, 0, yes
348970276,  S3l13tt1, 2, 1, 1, neutral
582973156,  shinnok81, 7, 7, 0, yes
1016320381,  stefipar, 15, 15, 0, yes
493900329,  fil_pasini, 2, 1, 1, neutral
767809657415036932,  TinoColacillo, 2, 2, 0, yes
50674708,  VillaTelesio, 1, 1, 0, yes
2165389231,  TeoPellegatta, 1, 1, 0, yes
1080606583,  GialloParma, 3, 2, 1, yes
354546605,  Sid_dartha, 2, 1, 1, neutral
52362602,  lucastamati, 10, 2, 8, no
317278377,  brugnolovpl, 7, 5, 2, yes
331918021,  waffusha, 1, 1, 0, yes
721338196639014912,  ALBERTOSEVERIN7, 219, 68, 151, no
291972476,  Karmageddon1, 6, 4, 2, yes
724917989389287424,  PorCalabria, 1, 1, 0, yes
4120047395,  Gugpas1, 2, 2, 0, yes
1393933706,  degusac, 9, 8, 1, yes
318230976,  amastroma, 2, 2, 0, yes
353732760,  GtsrtiscalitR, 1, 1, 0, yes
518660459,  MariaCapozzoli1, 2, 2, 0, yes
2910002235,  1b99d2177feb474, 3, 3, 0, yes
468586800,  MaurizioDArgent, 9, 5, 4, yes
551668367,  pgdegeronimo, 1, 1, 0, yes
370278925,  il_pucciarelli, 6, 3, 3, neutral
87648838,  vfio65, 3, 3, 0, yes
2933874459,  cadolo56, 1, 1, 0, yes
327066793,  zambonialbino, 3, 3, 0, yes
1726027441,  AlexSoze, 8, 1, 7, no
1045188410,  EvaFabio, 9, 8, 1, yes
370074545,  soffinamatilde, 2, 2, 0, yes
3091346249,  Kweedado, 6, 5, 1, yes
1367235362,  FabrizioPel990, 3, 3, 0, yes
2804109824,  bator2013, 6, 5, 1, yes
1013344171,  GaraviniG, 2, 1, 1, neutral
800511027439730688,  Casta_un_SI, 10, 6, 4, yes
736545283576893440,  Marisa25997645, 3, 3, 0, yes
1411184052,  claudiafabbri5, 7, 5, 2, yes
798850577547464705,  FanoPossibile, 11, 1, 10, no
1123709442,  1luisssssss, 6, 5, 1, yes
59720283,  unoenessunoe, 12, 8, 4, yes
2366761139,  FrancSgro, 1, 1, 0, yes
403421880,  PierluMennonna, 1, 1, 0, yes
3390886840,  ViareggioPossi1, 18, 6, 12, no
23054148,  goldielocks75, 14, 4, 10, no
757695815448166400,  delzottogiuse1, 2, 1, 1, neutral
1915667756,  Puckinpolvere, 3, 3, 0, yes
491142862,  laureali, 9, 4, 5, no
485135776,  davidedaffronto, 1, 1, 0, yes
458370341,  AntonioBanfi1, 16, 12, 4, yes
556270195,  sfnnicita, 4, 1, 3, no
427446371,  AndreaCapussela, 5, 5, 0, yes
1080531446,  CCacciarelli, 1, 1, 0, yes
2228748954,  saldabarre1, 5, 4, 1, yes
3425547017,  BersaniLeda, 2, 2, 0, yes
701109512120492032,  ilquintoquarto, 1, 1, 0, yes
2424988655,  FLoxLo, 15, 9, 6, yes
1331157146,  VincenzoRiommi, 1, 1, 0, yes
1122177026,  abarone74, 1, 1, 0, yes
132662640,  alicebrunswig, 2, 2, 0, yes
2526142091,  RobCalvano, 1, 1, 0, yes
776082811849695232,  ffortuzzi, 12, 5, 7, no
2486701467,  UmStillAh__Hitt, 2, 2, 0, yes
2821329929,  kleist13, 9, 5, 4, yes
1065894583,  maxmoret2013, 1, 1, 0, yes
764133596512870400,  GiuliaAnnaPucci, 8, 8, 0, yes
605229354,  NataleRaco, 3, 2, 1, yes
382562043,  Fabiazep, 4, 4, 0, yes
594104697,  AlinaMure, 1, 1, 0, yes
285605392,  valfabbrini, 1, 1, 0, yes
504320117,  belardi_andrea, 2, 2, 0, yes
3008763837,  DeficitMiManchi, 9, 6, 3, yes
258131405,  madegidio, 4, 4, 0, yes
763146166620057600,  ZioKlint, 13, 9, 4, yes
1094831563,  ilVincia, 3, 3, 0, yes
1039534922,  ArchFallez, 9, 9, 0, yes
753889512690950144,  AntonellaC69, 9, 6, 3, yes
3302998720,  peppefarci, 1, 1, 0, yes
2267623882,  MatteoGervasini, 5, 3, 2, yes
731923970124075008,  Lucio1613, 8, 5, 3, yes
418662548,  CarloF0554ti, 50, 20, 30, no
2899554531,  dcgabriele, 7, 6, 1, yes
1070647207,  sergio_de_cola, 1, 1, 0, yes
2997523247,  micheciancia, 5, 5, 0, yes
714736755816185856,  AdelinaMatteo, 20, 3, 17, no
1720116319,  MozzorecchiaM, 3, 2, 1, yes
428083671,  ElenaCarlini1, 1, 1, 0, yes
4893362397,  calzelunghe17, 11, 4, 7, no
1387006716,  emacurro, 58, 18, 40, no
712035142508945408,  Platone9402, 9, 2, 7, no
715674751,  ValeriaPritoni, 3, 3, 0, yes
532132256,  apradi69, 9, 2, 7, no
1046168034,  MinutiV, 13, 3, 10, no
2155877079,  Ntonybee, 1, 1, 0, yes
356997587,  swamilee, 3, 1, 2, no
457615551,  Nove41, 3, 2, 1, yes
1871381000,  TecchiaE, 10, 5, 5, neutral
2746964048,  ParanoicaMente1, 8, 4, 4, neutral
20910977,  lucasofri, 5, 2, 3, no
1258912039,  EzioCalemi, 2, 1, 1, neutral
549330142,  GiPizzochero, 1, 1, 0, yes
1872814807,  AlbertiFranca, 3, 3, 0, yes
303824834,  LorenzoVascotto, 2, 2, 0, yes
3345679875,  cridfrancia, 1, 1, 0, yes
47698840,  flaneurotic, 18, 7, 11, no
493870947,  willerdino, 2, 2, 0, yes
498145030,  dani_sabatini, 2, 2, 0, yes
410345597,  DVmarco, 5, 4, 1, yes
557520605,  MassimoCanalicc, 1, 1, 0, yes
84887445,  daniale64, 6, 2, 4, no
600405571,  ArturoStaropoli, 1, 1, 0, yes
385846198,  SimoneMuffolini, 1, 1, 0, yes
434387464,  emiliofederico1, 25, 4, 21, no
1105726136,  VeraCUPPONE, 1, 1, 0, yes
1331662351,  Andreacritico, 2, 2, 0, yes
223881169,  LEBBY4EVER, 81, 28, 53, no
246453725,  salvdelg, 1, 1, 0, yes
621553,  HariSeldon, 3, 3, 0, yes
400585839,  Erica_sir, 1, 1, 0, yes
3762684742,  albejordan, 23, 20, 3, yes
2176931484,  antonelloidini1, 1, 1, 0, yes
1054399650,  andreap2023, 4, 3, 1, yes
547128441,  FedericaLatta, 1, 1, 0, yes
4284146182,  nothingtoatone, 23, 6, 17, no
705851026369351689,  Maddarabitti16, 1, 1, 0, yes
578852898,  guglielmomeardi, 2, 2, 0, yes
2362578901,  LosTuitteros, 2, 1, 1, neutral
452282353,  FabioValva, 1, 1, 0, yes
110281337,  carloporcari, 1, 1, 0, yes
440128266,  StefanoSciacchi, 9, 6, 3, yes
563734798,  StefanoDuri, 2, 2, 0, yes
421422819,  AngeloDiFalco1, 3, 2, 1, yes
384440283,  Fabriziotonello, 5, 5, 0, yes
1498225681,  gninich, 3, 3, 0, yes
208996172,  rossoredrouge, 4, 2, 2, neutral
730866098967547904,  Stefani05887656, 1, 1, 0, yes
2414609995,  torillo59, 6, 5, 1, yes
398247223,  twiteliana, 2, 2, 0, yes
911756210,  DanielCasolini, 2, 2, 0, yes
229549315,  crispadova, 3, 2, 1, yes
420957091,  Gianc__, 2, 2, 0, yes
537439213,  mmcampagnolo, 5, 5, 0, yes
3425872223,  fracocc, 1, 1, 0, yes
406993879,  ninocarella, 4, 2, 2, neutral
390858404,  giovannifino, 11, 8, 3, yes
493455308,  ronnyraggini, 8, 5, 3, yes
424474105,  ggiombolini, 1, 1, 0, yes
2949601762,  mariateresa_fe, 9, 8, 1, yes
701220226,  nanaosaki_86, 7, 5, 2, yes
322540485,  JanfaJanf, 25, 1, 24, no
118326123,  felixelis, 1, 1, 0, yes
394620314,  Rokkpicciuolo, 12, 11, 1, yes
330706458,  paologriseri, 1, 1, 0, yes
428317487,  robertoberri, 2, 1, 1, neutral
292364008,  AlessandraB18, 3, 2, 1, yes
465765184,  chiaramondi, 6, 6, 0, yes
1032967056,  solagimma, 8, 4, 4, neutral
580184217,  IlDDubbio, 3, 2, 1, yes
84817919,  violetta785, 4, 3, 1, yes
391521149,  VittorioPalumbo, 8, 4, 4, neutral
1291390106,  Canatecza, 3, 1, 2, no
94981476,  fried65, 4, 2, 2, neutral
58198240,  lollocavs, 4, 4, 0, yes
15155803,  vpistorio, 13, 6, 7, no
482064211,  EricaMelloni, 1, 1, 0, yes
3851084128,  PalmieriFulvio, 1, 1, 0, yes
240401072,  giovanpetr, 15, 2, 13, no
299535779,  paolaerra, 7, 2, 5, no
765416956921057280,  trivince49, 3, 1, 2, no
409269945,  giorgiocaravale, 2, 2, 0, yes
416386667,  __Behemoth, 5, 1, 4, no
306920440,  gianlucapezzano, 2, 2, 0, yes
1225148376,  AbbateCaterina, 3, 1, 2, no
32368034,  dannyCVL, 1, 1, 0, yes
1464632462,  pamelaamadeo, 3, 2, 1, yes
2928408579,  BollirRenato, 3, 3, 0, yes
2270460548,  Grosiglioni, 3, 1, 2, no
258862717,  apelle, 6, 4, 2, yes
242071863,  saderjm, 217, 19, 198, no
4228521213,  Alorsondance89, 3, 1, 2, no
1732490672,  alfplata1, 10, 3, 7, no
934197043,  giure99, 13, 7, 6, yes
713744729981263872,  RitaDarrisso, 6, 1, 5, no
3000440278,  FrailAnemone15, 1, 1, 0, yes
297599017,  lomargef, 26, 8, 18, no
425859164,  GugBiondo, 3, 3, 0, yes
573991398,  Vandabio, 2, 2, 0, yes
419415644,  MarinaPlacidi, 19, 12, 7, yes
466456399,  KatiaRisolvi, 2, 1, 1, neutral
542163896,  ClaraMadenna, 2, 1, 1, neutral
903701676,  scelta_civica, 36, 35, 1, yes
2330870210,  jazzmusic52, 5, 2, 3, no
1095383269,  ilaborletti, 16, 6, 10, no
351137105,  Morison59, 22, 20, 2, yes
117506621,  CarlosE_Lozada, 4, 4, 0, yes
944659129,  leolapus, 18, 8, 10, no
175348218,  4lessi0, 3, 3, 0, yes
301894712,  C_Chiri68, 3, 3, 0, yes
57439579,  _av0n, 5, 3, 2, yes
541142373,  LasTomino, 11, 1, 10, no
767688070779002880,  paolatanucci65, 7, 7, 0, yes
459446024,  MGBasolu, 58, 26, 32, no
2190622501,  bettasanlazzaro, 29, 27, 2, yes
4835686540,  giovannisalvuc2, 2, 2, 0, yes
799219817010053121,  stezic63, 2, 2, 0, yes
801810946654085120,  whisperslaura, 7, 6, 1, yes
490598678,  deruvoanna, 2, 2, 0, yes
2205471504,  pertinenziali1, 4, 4, 0, yes
752822927888875521,  S_Bonabitacola, 2, 2, 0, yes
1217652116,  IstTribint, 2, 2, 0, yes
553523926,  luigibeninati, 4, 4, 0, yes
70993476,  antorlacchio, 3, 3, 0, yes
14460250,  giannipittella, 10, 10, 0, yes
38196064,  casarubner, 9, 9, 0, yes
72009402,  squeeze9, 3, 1, 2, no
577161255,  pla_baldax, 4, 2, 2, neutral
1914930552,  mcdigiacco, 7, 0, 7, no
863518554,  GiancarloIannel, 5, 1, 4, no
777828215922581504,  scelgono, 7, 1, 6, no
134724104,  vic_purtusiello, 9, 3, 6, no
2359063466,  EnzoDiSalvatore, 8, 1, 7, no
763718509805305856,  FateOfLight, 11, 0, 11, no
2211388062,  CrassusDT, 26, 2, 24, no
3065958947,  sessa_mrossella, 28, 0, 28, no
784031287749271552,  Silvia63831996, 2, 2, 0, yes
251333816,  alfagamma71, 3, 3, 0, yes
788770532435132417,  frassini4, 16, 13, 3, yes
789461803382300672,  margottina9, 3, 3, 0, yes
1116420750,  Sabrinalfonsi, 1, 1, 0, yes
801919542230470656,  LauraMarra2, 16, 14, 2, yes
461316228,  emmeiemmeemmeo, 5, 3, 2, yes
198103890,  progarchdesign, 1, 1, 0, yes
1247343212,  zarlino, 5, 5, 0, yes
799337143365750784,  FabiocalaFc, 1, 1, 0, yes
1497919640,  PiccoRenata, 1, 1, 0, yes
250588334,  NuovoMille, 4, 4, 0, yes
2816450251,  Businewss_Bot, 13, 10, 3, yes
715597025404968960,  ItaliaStartUp_, 16, 12, 4, yes
1919943146,  annlomb, 1, 1, 0, yes
2744331992,  aventinerome, 4, 2, 2, neutral
42834663,  mindyour, 2, 2, 0, yes
559989744,  MaurizioStumbo, 2, 2, 0, yes
784325817849360385,  nicolalocastro, 4, 2, 2, neutral
2908108096,  barba_zan, 5, 4, 1, yes
98192394,  AleFiorenza, 6, 5, 1, yes
371700790,  CarloTrozzi, 3, 3, 0, yes
11538582,  flaviabarca, 3, 3, 0, yes
851391300,  StefaniaNonno, 6, 3, 3, neutral
201249888,  mindennit, 1, 1, 0, yes
406909833,  vabacca, 1, 1, 0, yes
3351913779,  nicola_picardi, 5, 2, 3, no
417767903,  toscadonati, 1, 1, 0, yes
422955953,  michelebocci1, 1, 1, 0, yes
1371404382,  Alba040504Di, 21, 11, 10, yes
596541835,  TerrasiPaolo, 1, 1, 0, yes
3710021356,  andrearicc_, 1, 1, 0, yes
2886915633,  Puca_pooka, 1, 1, 0, yes
161322335,  Alegaetani5, 2, 2, 0, yes
803174269744254976,  AtacInforma, 3, 1, 2, no
538115088,  aluapelrac, 1, 1, 0, yes
734026507685928960,  LaMaiky77, 3, 3, 0, yes
2723328489,  BeaCajaniCISL, 1, 1, 0, yes
311059477,  Forzaferrarileo, 4, 2, 2, neutral
3503852177,  Barbarossa_78, 1, 1, 0, yes
271466982,  rebirth1968, 1, 1, 0, yes
91304702,  Kakakaz75, 2, 2, 0, yes
3072696814,  CislP, 1, 1, 0, yes
175344790,  SimoneGiacinti, 2, 2, 0, yes
901522400,  Xuxccccccccc1, 1, 1, 0, yes
348550877,  derpassion, 1, 1, 0, yes
190177750,  riccardoagolino, 2, 2, 0, yes
2861409041,  notaioldonegana, 2, 2, 0, yes
582184626,  alessandr_russ, 1, 1, 0, yes
735331447125467136,  annita678, 2, 2, 0, yes
98671961,  eugeniobellomo, 2, 2, 0, yes
513682057,  alessandronata7, 1, 1, 0, yes
781801540193488896,  Arianna24459752, 3, 3, 0, yes
2554661857,  qualis_artifex, 4, 4, 0, yes
486890861,  GiorgioCorcione, 9, 7, 2, yes
3359396477,  AMariabilotta, 2, 1, 1, neutral
389670194,  paola_lucci, 3, 2, 1, yes
2976581543,  Cisl_Lazio, 1, 1, 0, yes
738311035,  Odisseo111, 12, 1, 11, no
1048258778,  MarcoMangiante, 1, 1, 0, yes
1573303110,  Stefiriam, 1, 1, 0, yes
23806811,  Ciaffone, 1, 1, 0, yes
1427398915,  anto_gaudioso, 6, 3, 3, neutral
430622753,  ANGELACHIDDEMI, 3, 1, 2, no
303443930,  paprikashrimps, 2, 1, 1, neutral
1890293305,  Lellacaroni, 8, 4, 4, neutral
104841172,  vitolongo1979, 3, 1, 2, no
151572582,  ldentama, 14, 1, 13, no
442808538,  donpas52, 10, 4, 6, no
2770811619,  marasco_l, 3, 1, 2, no
796033040443129860,  goemilianogo, 94, 5, 89, no
1485090944,  TonyMarti, 3, 2, 1, yes
494245231,  KiraGtx7, 10, 2, 8, no
2290036284,  SimonePallat, 2, 1, 1, neutral
946745624,  MarioMauro, 12, 7, 5, yes
2971151043,  Bocchino1Renna, 11, 8, 3, yes
3327004810,  ErmonnoSoave, 5, 3, 2, yes
3087139251,  19TIZIANO72, 12, 5, 7, no
1960098824,  a_ilacqua, 18, 4, 14, no
418511087,  RaffaeleRutigli, 3, 1, 2, no
366475120,  MontanarAndrea, 3, 2, 1, yes
2416323679,  VisionRivoluzio, 10, 1, 9, no
131494824,  patrikkka, 16, 7, 9, no
275805969,  GvRutigliano, 4, 1, 3, no
293061825,  PA_Projects, 2, 1, 1, neutral
991096194,  primapopolari, 6, 5, 1, yes
1077435626,  PietroSpadone, 4, 2, 2, neutral
2909929737,  acqu_marina, 63, 8, 55, no
2229203829,  vincenzo_r, 5, 1, 4, no
2634373528,  DemaioVale, 4, 3, 1, yes
1258895678,  PasqualeIzzo7, 4, 1, 3, no
427326829,  andtundo, 7, 2, 5, no
376173255,  RiccardoParzial, 5, 1, 4, no
1364039989,  Rustibella, 2, 1, 1, neutral
1254324948,  maurypracucci, 11, 8, 3, yes
2861099262,  leo1995rossi, 2, 1, 1, neutral
1145911274,  DietaSalute, 13, 10, 3, yes
3190862212,  Ant_testa979, 2, 1, 1, neutral
476627549,  TommasoRicci1, 11, 4, 7, no
1269842413,  LauaraM5S, 9, 2, 7, no
2367644157,  monaro_danilo, 2, 1, 1, neutral
2989253800,  sianda58, 9, 8, 1, yes
2479381757,  suffragio1, 3, 1, 2, no
3091546437,  DinaTramontozzi, 2, 1, 1, neutral
429496671,  Bero_perrone, 5, 1, 4, no
1154012262,  CormaGodra76, 23, 15, 8, yes
435279526,  MariaTeresaMor9, 5, 2, 3, no
289020114,  giambarombi, 10, 9, 1, yes
4636768817,  candura_alice, 3, 1, 2, no
3977951957,  julesbeton, 18, 7, 11, no
1311732848,  HAchmueller, 68, 31, 37, no
59165953,  attila62, 15, 4, 11, no
964719079,  cardella42, 29, 13, 16, no
4039903701,  lucamilello, 25, 9, 16, no
513492134,  RiccoMichele, 9, 1, 8, no
319714191,  manuelfacchetti, 2, 1, 1, neutral
796809654093410305,  Klara112233, 11, 5, 6, no
1058237736,  mariocan4, 12, 1, 11, no
533019074,  ManuPerra56, 15, 5, 10, no
528584272,  MisunNesun, 9, 3, 6, no
732290751380459520,  russo_au, 2, 1, 1, neutral
549597672,  alegelardi, 2, 1, 1, neutral
1269539851,  Massimi50942418, 27, 5, 22, no
2729953324,  giannamerola, 9, 4, 5, no
2353634446,  hans_rott, 33, 31, 2, yes
2662325954,  ludemilio, 3, 1, 2, no
2657542286,  MieiTweets, 10, 2, 8, no
3073945560,  a_purrone, 2, 1, 1, neutral
1262703662,  SalvoLabate, 3, 1, 2, no
3339671398,  MargarethaZel23, 3, 1, 2, no
1499347417,  LaGentenon, 4, 1, 3, no
145771436,  GiulioSCIASCIA, 4, 3, 1, yes
459219907,  tittidsimone, 31, 2, 29, no
1498709755,  AndreaSchin, 13, 4, 9, no
2478946331,  Walter4cs, 21, 4, 17, no
19488600,  Dreffy, 7, 5, 2, yes
777543896519892992,  Daniel_S1979, 6, 1, 5, no
802249485325922305,  liberdem3, 5, 3, 2, yes
6598872,  krazny, 4, 3, 1, yes
872297844,  GaetanoBruno3, 11, 0, 11, no
215762717,  edoardopivanti, 11, 11, 0, yes
634020827,  PieroMe64, 8, 6, 2, yes
1456904898,  nonnamariola, 10, 2, 8, no
479450086,  MMitarotonda, 6, 1, 5, no
3105404607,  d40b708ae47943a, 1, 1, 0, yes
426206234,  robertinofuffol, 6, 2, 4, no
94397549,  Passoni5, 1, 1, 0, yes
2482894143,  rhyna__dochesee, 1, 1, 0, yes
2798071301,  gianpaolodg, 3, 2, 1, yes
1449247608,  caracalla_1, 1, 1, 0, yes
14765797,  albertofileti, 1, 1, 0, yes
4866039789,  luca_leox, 26, 19, 7, yes
2484225431,  Katie__JesterH, 1, 1, 0, yes
2484439702,  DougMilholln, 1, 1, 0, yes
102727300,  RickyPoli, 2, 2, 0, yes
613917828,  ritafrediani, 20, 13, 7, yes
773869687465803776,  adatit1, 30, 16, 14, yes
173081447,  zapppa83, 16, 14, 2, yes
1068084830,  crideste, 7, 5, 2, yes
2475186729,  SlytherlnDearie, 1, 1, 0, yes
2505250465,  larosa_filippo, 1, 1, 0, yes
15424735,  andrealongoni, 5, 4, 1, yes
10832772,  PoldoSbaffini, 1, 1, 0, yes
425695048,  fabiodorigo1, 6, 4, 2, yes
1389786139,  RussiaNewsDir, 2, 2, 0, yes
2820646831,  giornalistidime, 2, 2, 0, yes
1420325533,  BosyWilde, 11, 8, 3, yes
2479941213,  lilredgoosllng, 1, 1, 0, yes
1907659747,  LilithLaSvamp, 1, 1, 0, yes
329516948,  dorzacc, 2, 2, 0, yes
2540926930,  giovanisinistra, 9, 4, 5, no
2364619452,  ItalyinSaoPaulo, 1, 1, 0, yes
742063342584483840,  PinaCall, 9, 9, 0, yes
735876147137892353,  biancalocci, 14, 14, 0, yes
3791205203,  DonataCondorel3, 10, 10, 0, yes
396655131,  achiropitaarcid, 27, 27, 0, yes
789175269667942400,  LuisaAlotta, 17, 17, 0, yes
789773192969748480,  Antonvitprof, 13, 12, 1, yes
729293681832960001,  Savina19354002, 11, 11, 0, yes
976537538,  GiuseppeGuarrel, 2, 2, 0, yes
752152199199879168,  ferrangelo69, 4, 4, 0, yes
430734254,  yleepaolo, 9, 9, 0, yes
788784380860829700,  PassalacquRita, 14, 14, 0, yes
780111522030821377,  raffans3, 10, 9, 1, yes
3115979247,  balloelina, 8, 8, 0, yes
311904025,  GSavasta, 2, 2, 0, yes
799898540789141504,  fracucchiarini, 42, 41, 1, yes
2436692745,  glcsanna, 8, 8, 0, yes
211721790,  VirginiAsleep, 35, 35, 0, yes
3446733917,  Ermelindalobue, 20, 20, 0, yes
787177370646175745,  Laura1r1d3, 10, 10, 0, yes
2415224956,  davide_vetere, 39, 39, 0, yes
3223929605,  annalisacianci3, 25, 25, 0, yes
800074358538399746,  vitranott, 31, 30, 1, yes
806118234810413056,  paolabaffo, 14, 13, 1, yes
212978922,  patricknaples, 189, 188, 1, yes
243207562,  Pietrombusetta, 13, 9, 4, yes
945585757,  g_delleconomia, 3, 2, 1, yes
778993138954305536,  TaniaArancio73, 5, 5, 0, yes
795031432464887808,  DarioSciu, 23, 23, 0, yes
712130834313121792,  MRA17849362, 21, 21, 0, yes
787645210012581888,  gennarogramagl1, 7, 7, 0, yes
2369953109,  sandrino61sm, 12, 12, 0, yes
788456311684030464,  Maria75172840, 11, 11, 0, yes
601607662,  salvomarto24, 7, 7, 0, yes
724962370880176128,  Agata2143, 10, 9, 1, yes
789368501903495168,  ConcettaBongio3, 15, 15, 0, yes
4452313697,  i519csdipalermo, 18, 18, 0, yes
727848510050177024,  AnnaAnnaliuzzi, 18, 18, 0, yes
3042211947,  stellata_notte, 23, 19, 4, yes
188270480,  ilariacostanzo, 69, 65, 4, yes
717326322717089792,  RosaliaBiscegl3, 18, 17, 1, yes
2341476004,  alesoire, 4, 4, 0, yes
788452070185693185,  Ornella11927764, 4, 4, 0, yes
727915266110271493,  pamela_pedone19, 2, 2, 0, yes
3198203200,  kiaralombardi, 47, 46, 1, yes
783266769293180928,  giamb67, 9, 9, 0, yes
799992773298520064,  mccenci79, 8, 8, 0, yes
783270492480368640,  lorypri62, 3, 3, 0, yes
799899028616073216,  Ivaballistreri, 9, 9, 0, yes
52375621,  Lucrylem, 18, 17, 1, yes
802287123470630912,  VIMADAGI, 27, 26, 1, yes
607236289,  lavittima, 8, 5, 3, yes
1131717240,  mariellato, 20, 20, 0, yes
788600690356719616,  barbara_lussu, 5, 5, 0, yes
1333546988,  antonellodema, 4, 4, 0, yes
782217072474554369,  Idonei_Fantasma, 57, 52, 5, yes
788455689421197312,  Rosario62312436, 6, 6, 0, yes
788724782162378753,  ClaudiaMtna, 10, 10, 0, yes
2310569711,  75teres, 12, 12, 0, yes
783220906063790080,  FabioBallariano, 5, 5, 0, yes
893847942,  acquario_s, 2, 2, 0, yes
1069378951,  martosalvo, 6, 5, 1, yes
767436816492429312,  TizianaSavares1, 4, 4, 0, yes
4880621775,  Marilina30780, 5, 5, 0, yes
710171600092598272,  pirandello11, 7, 7, 0, yes
2327905973,  martjne1, 3, 3, 0, yes
946288772,  puorro1970, 16, 2, 14, no
791083493388390401,  GiuseppinaScal6, 2, 2, 0, yes
789028242221109248,  LudaCatalano, 10, 10, 0, yes
726505336996302848,  pellegrinoant11, 11, 11, 0, yes
788686822746517504,  DabbiccoLinda, 7, 7, 0, yes
2804363628,  Margules3, 32, 31, 1, yes
790899021435002880,  roby72falco, 7, 7, 0, yes
214157200,  Ale_Impallomeni, 2, 2, 0, yes
2366761307,  michel78messina, 2, 2, 0, yes
774339263752245249,  Lucyfranzese, 32, 31, 1, yes
801783651977613312,  _MaryPoppins85_, 43, 40, 3, yes
789101135323865089,  Marioammare, 11, 11, 0, yes
2692227380,  stellamizar, 35, 34, 1, yes
789449060696612864,  RobyFa6, 4, 4, 0, yes
727758699587092480,  laura74766380, 12, 12, 0, yes
793426944641597440,  marimamonti, 9, 9, 0, yes
794274429048131584,  giupatti, 28, 27, 1, yes
823461702,  greenmoonjoy, 11, 11, 0, yes
805519117,  MarcoItaliano3, 5, 3, 2, yes
744252966501236736,  miki4111951, 22, 14, 8, yes
31091958,  gilbertoromboli, 17, 9, 8, yes
366180331,  miciobigio, 10, 3, 7, no
328335015,  JacqTw, 7, 3, 4, no
414090977,  AlfonsoSolimeo, 3, 3, 0, yes
2348733589,  Consuelemarano, 5, 4, 1, yes
2843887516,  zatta_mario, 15, 6, 9, no
77863297,  UL_Ui9__jiiiE, 11, 3, 8, no
801348354760474624,  MarcoPardini10, 16, 6, 10, no
2260822969,  sonnyscrivano, 19, 6, 13, no
781954997806370822,  lauratrema37, 63, 11, 52, no
801876745976770560,  Massimo07092269, 6, 0, 6, no
964093010,  CCantam, 4, 0, 4, no
462882815,  benedettidanilo, 11, 0, 11, no
727938981120323585,  MilaScura, 14, 8, 6, yes
1462583917,  giannisanna65, 8, 3, 5, no
420923031,  marfio47, 6, 0, 6, no
553445128,  massimodambros4, 8, 0, 8, no
786276460080209920,  DMALAGIGI2, 58, 11, 47, no
253028771,  gianpileri, 2, 2, 0, yes
413935857,  kkxall, 13, 3, 10, no
288951786,  massimobrunelli, 2, 1, 1, neutral
772151913567625216,  GloriaMarulan11, 7, 3, 4, no
2942061736,  FrancoOmoore, 10, 3, 7, no
2984198033,  silviadimarco70, 266, 8, 258, no
2149665647,  Desely1, 21, 11, 10, yes
254943511,  ilGiannisigG, 8, 5, 3, yes
537554676,  GiuManc, 17, 1, 16, no
795538130,  lluca66, 16, 8, 8, neutral
798610520785952770,  AlessandraRanza, 20, 13, 7, yes
1011327860,  GTriglione, 8, 2, 6, no
3001456207,  diegodevivo1212, 18, 10, 8, yes
766644219930873860,  pistolesi_laura, 148, 47, 101, no
3395020235,  ignaziodeltrap1, 48, 9, 39, no
2571102050,  fulviogilardi, 11, 7, 4, yes
705383060842352640,  pascolare, 3, 2, 1, yes
4502730676,  Giusi53Giusi531, 6, 4, 2, yes
4143635368,  MirkoJerod, 10, 4, 6, no
422652467,  Paff87, 4, 3, 1, yes
48142731,  profumodimosto, 3, 1, 2, no
1213692008,  patrinavacchi, 29, 7, 22, no
3322620622,  scluzza, 216, 101, 115, no
436557042,  LiviaVentimigli, 7, 3, 4, no
707686902,  vale_vigliaturo, 4, 2, 2, neutral
1044957452,  salvo_loiacono, 4, 3, 1, yes
740562673566396416,  MariaVenera4, 15, 1, 14, no
2151446108,  angela22016617, 2, 1, 1, neutral
388512493,  cappe83, 42, 39, 3, yes
420464238,  alex752828, 18, 8, 10, no
3069520923,  GarbatellaRM, 4, 3, 1, yes
750480775615750144,  adelio_colombo, 10, 5, 5, neutral
2228160606,  ubbius07, 2, 1, 1, neutral
59081373,  magister1udi, 3, 2, 1, yes
70650884,  rickshady, 8, 4, 4, neutral
120283895,  rodolfoivana, 15, 8, 7, yes
449849375,  genovesergio76, 8, 7, 1, yes
3435397192,  AscoliLina, 5, 3, 2, yes
4170027736,  fartaco, 8, 3, 5, no
3115015726,  AgrimanoTeo, 9, 7, 2, yes
553401472,  antonio_pagana, 4, 3, 1, yes
188521082,  francescorussot, 27, 6, 21, no
136603615,  fulvio64, 3, 2, 1, yes
744614823456038913,  bellodenotte81, 2, 1, 1, neutral
432937614,  luigimariano66, 5, 2, 3, no
331064588,  SimoLombardo, 2, 2, 0, yes
28528873,  sinistraelib, 30, 21, 9, yes
2817204236,  Valentina89x1, 24, 11, 13, no
37631819,  NichiVendola, 29, 20, 9, yes
3019867043,  antoniolosc, 5, 0, 5, no
2226249739,  riorosso2001, 3, 1, 2, no
164592843,  IvanAustraliano, 2, 0, 2, no
532157140,  Cede66De, 3, 0, 3, no
868595989,  reteCgil, 3, 0, 3, no
2288626020,  iLoveFiom, 2, 0, 2, no
2179948113,  Pierfanze208, 10, 2, 8, no
542094808,  WSchiavella, 4, 0, 4, no
1278347502,  pepdecr, 2, 0, 2, no
358677461,  XIIIr3d, 2, 0, 2, no
225453862,  v_pugliese, 3, 0, 3, no
331005596,  robersperanza, 5, 0, 5, no
804304134,  CGILModena, 9, 2, 7, no
490232626,  pattygrasso, 12, 1, 11, no
326152237,  mebufalino, 6, 2, 4, no
315102536,  StefanBernstein, 10, 4, 6, no
756950860471660545,  carolis_daniela, 15, 12, 3, yes
73912465,  lucafiori, 2, 1, 1, neutral
384437545,  Lapocao, 5, 2, 3, no
398570282,  Maax70, 19, 7, 12, no
3317322689,  ACCA501, 2, 1, 1, neutral
702690830,  Beatrix_aka_BM, 17, 8, 9, no
17053149,  Bluelake76, 20, 10, 10, neutral
226335102,  ElFelpone, 2, 1, 1, neutral
376869096,  alelagattarossa, 7, 3, 4, no
994100862,  El_Duraminga, 6, 4, 2, yes
722491989925699584,  LuciaA1612, 2, 1, 1, neutral
2822217403,  ilsartino, 26, 2, 24, no
169030747,  cpieragostini, 2, 1, 1, neutral
2888678625,  Diavoletto699, 24, 3, 21, no
3132931045,  BorioniMario, 6, 6, 0, yes
725435362634547200,  IlsuonomeBob, 2, 2, 0, yes
2253493568,  rivmar43, 2, 2, 0, yes
416884560,  PaoloBoral, 4, 4, 0, yes
1076707988,  Lucien_Mick, 11, 3, 8, no
381518652,  MarcellaCarlisi, 7, 1, 6, no
1179865562,  La_Frencis, 4, 2, 2, neutral
187196983,  _una_tragedia, 8, 1, 7, no
3866842575,  Delprofilo, 6, 3, 3, neutral
494172683,  mostra76, 4, 2, 2, neutral
1008382820,  16blu, 24, 5, 19, no
482862951,  BarbaraRabitti, 2, 1, 1, neutral
97938993,  papariello, 5, 1, 4, no
2768667015,  PTinchi, 18, 4, 14, no
777222642961092609,  Patrizi81343276, 5, 1, 4, no
995785856,  MatteiSalvio, 2, 1, 1, neutral
351541451,  gerardo_naddeo, 5, 2, 3, no
56336773,  iBaggino, 5, 2, 3, no
763583929798524928,  CurreliGiovanni, 2, 1, 1, neutral
2494115132,  francocarbone10, 19, 10, 9, yes
1685323645,  emiurpi, 3, 2, 1, yes
2774578942,  zorat67, 32, 5, 27, no
4919661688,  sabrinaooooooo, 34, 19, 15, yes
3296497990,  luidamato, 35, 11, 24, no
2494175436,  ALE70495242, 9, 2, 7, no
254242037,  cavadavi, 13, 4, 9, no
421723841,  GiulioGasparini, 36, 15, 21, no
730962018,  massimoricciut, 21, 19, 2, yes
272941891,  mastrociclista, 36, 15, 21, no
788974585266012160,  RossiniMarco2, 2, 1, 1, neutral
462414072,  Elisa_BV, 20, 1, 19, no
989695621,  nonvotorenzi, 15, 4, 11, no
1241565397,  niccneime, 18, 1, 17, no
768133193291722752,  Vallancufo, 14, 5, 9, no
465921722,  ZanellaRina, 19, 6, 13, no
436627859,  sbrigaSil, 3, 2, 1, yes
707348966241865728,  pippoct1, 9, 3, 6, no
3310593215,  gerria63, 4, 1, 3, no
881165648,  aliotta_katia, 12, 5, 7, no
843573301,  giorgiopaoloni1, 12, 2, 10, no
3543518537,  ercivettone1, 22, 4, 18, no
3926735649,  SandroPop1, 17, 3, 14, no
49044510,  gdivona, 7, 3, 4, no
598558484,  pierluigibertol, 17, 9, 8, yes
742634833541750784,  Mariagr36436003, 8, 1, 7, no
2342101993,  Apollo_MX5, 34, 16, 18, no
1863767611,  S_cala_B, 3, 2, 1, yes
435825241,  geomiglio, 5, 1, 4, no
2376644398,  cozzoli_poli, 14, 3, 11, no
318379212,  tiziana_moro, 6, 1, 5, no
411530100,  armandoluongo10, 8, 3, 5, no
2347482439,  _tommyemme_, 9, 3, 6, no
634434387,  borlacch, 53, 2, 51, no
2966682251,  656bf7db2e4c462, 12, 6, 6, neutral
2501935183,  FrancoFiori, 4, 3, 1, yes
1429964996,  Lucky61mass, 5, 2, 3, no
504658270,  margheritamart4, 46, 12, 34, no
754738926083010560,  AnagniAtama, 24, 3, 21, no
398283245,  EnryMontanari, 25, 24, 1, yes
2831706034,  simonabrenna1, 4, 2, 2, neutral
1870641289,  robertocorti4, 26, 9, 17, no
2518901866,  gianni_azzali, 54, 15, 39, no
329734973,  sjpowa, 12, 4, 8, no
1320668719,  AndreaCilento, 17, 11, 6, yes
4517031628,  M_Marty99, 1, 1, 0, yes
794617750639562753,  rockond1, 16, 13, 3, yes
169510626,  LUCIADIMARCO2, 6, 4, 2, yes
2399247913,  scorsettipaolo, 8, 7, 1, yes
477871080,  arman1646, 1, 1, 0, yes
3192098591,  vicla55, 20, 19, 1, yes
405102464,  GiuseppeMaianet, 1, 1, 0, yes
831364490,  sandro_frigerio, 1, 1, 0, yes
473029382,  TommasoCerutti, 1, 1, 0, yes
605157794,  dus_marco, 2, 2, 0, yes
146798765,  JattoniDallAsen, 7, 4, 3, yes
56459334,  Silvio_Tedeschi, 2, 1, 1, neutral
2737028641,  beteljeuse1969, 6, 3, 3, neutral
1216209774,  delucamaura, 1, 1, 0, yes
745051820238704640,  ProfetaFassino, 3, 2, 1, yes
2942592556,  FaGiordi, 1, 1, 0, yes
2838593745,  MFArtusi, 1, 1, 0, yes
440152678,  elimuse, 14, 4, 10, no
378241251,  Purnell69, 1, 1, 0, yes
2922966989,  capantonio69, 1, 1, 0, yes
792729282544013312,  DeputatiLega, 61, 24, 37, no
407860171,  AndreaCHIECO, 6, 4, 2, yes
1337288432,  SalvatoreDiGen4, 29, 29, 0, yes
427794432,  anto_caccamo, 2, 2, 0, yes
478988094,  andreastraf, 8, 5, 3, yes
24871028,  A_Laccisaglia, 2, 2, 0, yes
846098538,  MoschiniIrene, 2, 2, 0, yes
3428628063,  AnnWalthour, 1, 1, 0, yes
460992881,  BarbaraRita2, 2, 2, 0, yes
1296222936,  angelasciorio, 1, 1, 0, yes
707363503494012928,  Espinakka, 1, 1, 0, yes
1083889141,  _stefano_23, 5, 5, 0, yes
2629123617,  SimonettaAdami, 31, 1, 30, no
204814083,  fazzogb, 2, 1, 1, neutral
3195669568,  donfriol, 1, 1, 0, yes
776430344841101312,  catenaaurea66, 4, 3, 1, yes
81116943,  CiroGravino, 5, 4, 1, yes
4577632036,  martino_loi, 9, 9, 0, yes
143415269,  CiccioRatti, 4, 1, 3, no
13815432,  l_alberto, 4, 3, 1, yes
27612304,  carlopedata, 2, 2, 0, yes
405919398,  domenicovarano, 15, 9, 6, yes
4722904947,  cri_1907, 1, 1, 0, yes
379446229,  elio_benvenuti, 3, 3, 0, yes
1072138536,  Vincenzo2483, 11, 5, 6, no
454971045,  indahouse22, 2, 2, 0, yes
806063876722819072,  d4rkw0rldn3t, 3, 3, 0, yes
167058261,  SimonaVicari, 5, 5, 0, yes
58512089,  ilprediletto, 1, 1, 0, yes
991982018,  DBoltri, 4, 3, 1, yes
118513045,  PiramideRossa, 15, 9, 6, yes
1360418947,  GrazianoSampaol, 1, 1, 0, yes
734053598884139008,  Stefano32847521, 8, 7, 1, yes
31694616,  PieroCastellano, 1, 1, 0, yes
403011403,  dariocafiero2, 1, 1, 0, yes
4061316509,  domenicot69, 3, 3, 0, yes
1647323389,  Rafrir, 1, 1, 0, yes
450948816,  nellyardito, 2, 1, 1, neutral
2981594310,  lalojimjuarez, 16, 16, 0, yes
791200692803366912,  tonjomannaja, 10, 5, 5, neutral
798086044352708609,  carlasalvalagg, 2, 2, 0, yes
4703605746,  1966tato, 36, 19, 17, yes
1571044039,  beren117, 3, 3, 0, yes
296721949,  MarcoTosatti, 16, 9, 7, yes
62814733,  MarcoVcaronE, 2, 1, 1, neutral
533268748,  paolominervino, 2, 2, 0, yes
3054090717,  gesscuo, 5, 4, 1, yes
3403569412,  pepe_ronci, 2, 2, 0, yes
2198114532,  RTitaliana, 2, 2, 0, yes
979100648,  MalaspinaDavide, 6, 5, 1, yes
279924449,  FarinaAV, 1, 1, 0, yes
2178699621,  cladesimone95, 2, 2, 0, yes
4850234663,  TinaBussi1, 2, 2, 0, yes
803737951683416064,  danielepais_, 9, 2, 7, no
136982977,  francofera, 3, 2, 1, yes
898249717,  LaRossB, 1, 1, 0, yes
2563503384,  TizTallaro, 1, 1, 0, yes
889057141,  afgibi, 2, 2, 0, yes
713303560352571392,  ale_lisandra93, 5, 5, 0, yes
1161192493,  deluccif, 1, 1, 0, yes
1034417863,  a_imbriani, 49, 30, 19, yes
588180335,  mammadiduebimbi, 7, 7, 0, yes
4220893533,  matti01985, 14, 11, 3, yes
452226860,  DlxMorgana, 148, 75, 73, yes
2852396193,  JakFrance, 3, 3, 0, yes
3170255502,  AleCapu82, 1, 1, 0, yes
4843948937,  RomanoAlain, 1, 1, 0, yes
2914303918,  mtama2112, 7, 6, 1, yes
939878528,  prioloangelolor, 2, 1, 1, neutral
374509955,  nuova_creatura, 8, 7, 1, yes
415475075,  Cinziadinunno, 2, 2, 0, yes
3015242813,  71Conti, 54, 28, 26, yes
115660475,  diegoapples, 1, 1, 0, yes
96696594,  WIK1978, 22, 2, 20, no
1325555809,  nickhavannah, 1, 1, 0, yes
1224876578,  GianniRuggiero3, 5, 4, 1, yes
319063113,  Paolodipinto, 2, 2, 0, yes
26760224,  sragugini, 2, 2, 0, yes
703166170484994048,  PensieriPace, 2, 2, 0, yes
242259406,  feligammella, 3, 2, 1, yes
4653395295,  da4cf9149f314e5, 3, 2, 1, yes
1575477577,  Gio_Furnari, 3, 2, 1, yes
1289010565,  mr_mahoo, 1, 1, 0, yes
479477842,  DanieleTaverna, 9, 6, 3, yes
3339984820,  chirudome91, 3, 2, 1, yes
2257836094,  c_terracini, 3, 2, 1, yes
465415975,  Tiz_Faniz, 34, 14, 20, no
715094002706563072,  gost_rider1957, 1, 1, 0, yes
196111778,  expat_gio, 6, 5, 1, yes
405532578,  giuseppepeda, 1, 1, 0, yes
4845740405,  sciallafax, 7, 7, 0, yes
838488505,  Forcelux71, 1, 1, 0, yes
706060433363435520,  tillatitta, 5, 4, 1, yes
315184117,  MonicaRubino1, 2, 1, 1, neutral
788734164166144000,  Annalis5657, 1, 1, 0, yes
408710262,  gen_182, 6, 3, 3, neutral
461032513,  graziella_fiore, 17, 8, 9, no
2343281118,  oggiscrivo, 31, 22, 9, yes
424498086,  Carloricci63, 1, 1, 0, yes
1357198874,  giordanougl, 75, 4, 71, no
1327867518,  mila_lucisano, 4, 3, 1, yes
500053935,  lucianasavarese, 5, 3, 2, yes
730098624907071488,  fede_200_, 15, 8, 7, yes
4300930595,  VitoVitodefra, 5, 3, 2, yes
548301865,  SergioGaspOne, 1, 1, 0, yes
3053413413,  Re_Dei_Retweet, 1, 1, 0, yes
2210292976,  GiorgiaBurzz, 3, 3, 0, yes
1074119437,  claudio_dea, 1, 1, 0, yes
4782289645,  LoryBudano2, 1, 1, 0, yes
1541538872,  Alevt86, 4, 2, 2, neutral
755320994131247104,  CarpeDiem_Macc, 36, 31, 5, yes
196560266,  pierdario, 36, 5, 31, no
2884685647,  prefettogelati, 5, 5, 0, yes
805786401807667201,  dear_illegal, 21, 11, 10, yes
224310474,  ciafella, 6, 2, 4, no
230518730,  PilotadiGuerra, 3, 2, 1, yes
750598095478616064,  chiara8_99, 1, 1, 0, yes
1374172550,  NICODASCOLA, 1, 1, 0, yes
6866812,  dbatrade, 1, 1, 0, yes
144141513,  MARIAKATENA, 2, 2, 0, yes
705303498,  Nik_Jaeger, 1, 1, 0, yes
2148839571,  ilPFmax, 7, 5, 2, yes
475827565,  The_Joker_IT, 14, 12, 2, yes
1053075751,  GAnziano, 4, 3, 1, yes
4807461064,  NinoSalamone2, 1, 1, 0, yes
4856265497,  MarkAless, 2, 2, 0, yes
877487952,  112_ITALIA, 1, 1, 0, yes
851471263,  christi38428233, 30, 18, 12, yes
2867547191,  gooblin73_83196, 2, 2, 0, yes
3971101125,  pieULssl, 1, 1, 0, yes
428610062,  alex24ore, 1, 1, 0, yes
3386772711,  adriana_cirdei, 3, 1, 2, no
527318573,  matteogeorge83, 3, 2, 1, yes
3234201647,  Andreacm1899, 5, 2, 3, no
2850824954,  Upupa234, 4, 3, 1, yes
2753392599,  44fb7c68fddd4e4, 2, 1, 1, neutral
53052632,  UranoRebel, 4, 4, 0, yes
264351373,  ferramari50, 8, 2, 6, no
772736079925510145,  moretta_55, 3, 3, 0, yes
2336069819,  mika_bertocchi, 6, 4, 2, yes
490478414,  FRANCESCOCORDO, 1, 1, 0, yes
1043376626,  DahirWsm, 7, 5, 2, yes
128687771,  GiuxFrancolino, 3, 3, 0, yes
335267459,  momarte1, 1, 1, 0, yes
3044737421,  CesiRediroma121, 2, 2, 0, yes
2401638882,  MercatoC, 2, 2, 0, yes
354505675,  furio1951, 2, 2, 0, yes
563747770,  IginoDeRossi, 2, 2, 0, yes
1071139633,  cordella_f, 1, 1, 0, yes
709037877456408576,  anppevvf, 1, 1, 0, yes
533473166,  luigideluca_vf, 1, 1, 0, yes
3405289558,  qhayhrn, 3, 2, 1, yes
755894033046700033,  stemaggipinto, 1, 1, 0, yes
403669677,  fioreesposito1, 4, 4, 0, yes
2859433319,  schietta_mente, 3, 2, 1, yes
1398070730,  onoratoroberto, 2, 1, 1, neutral
800043720473276417,  AntonelloGrasp, 1, 1, 0, yes
1469612947,  FT46LoveCatania, 12, 7, 5, yes
56487920,  SarevokFC, 9, 5, 4, yes
2333910126,  rosinadentini, 1, 1, 0, yes
1926275773,  vvfveneto, 1, 1, 0, yes
796082165792514048,  domer49, 1, 1, 0, yes
520666162,  e_astuto, 2, 2, 0, yes
1554450631,  ScoutsPompiers, 1, 1, 0, yes
2885489783,  koffyknightsbr1, 3, 3, 0, yes
702594325625085952,  emergenzavvf, 1, 1, 0, yes
1021729232,  PhobiaHomo, 3, 2, 1, yes
161297440,  fortautore, 1, 1, 0, yes
4221418967,  Babet01667270, 1, 1, 0, yes
511976782,  joselitacapponi, 1, 1, 0, yes
457610500,  CiroFire, 1, 1, 0, yes
803621027536175104,  Sog_Att_CNVVF, 1, 1, 0, yes
2192524651,  M4r14P40l4, 1, 1, 0, yes
765545322365976576,  silvano_piero, 1, 1, 0, yes
433224751,  Rojas3299, 3, 3, 0, yes
2167899593,  CAMARDELLAGio, 16, 11, 5, yes
3348001973,  enelfondohcf, 1, 1, 0, yes
4836483195,  CalcioCroton, 1, 1, 0, yes
761190317127327744,  Paul9milano, 5, 2, 3, no
410589376,  POST1T, 9, 5, 4, yes
801913119266242560,  PierluigiGrioni, 1, 1, 0, yes
30273564,  ansa11, 1, 1, 0, yes
467701158,  neonacura, 1, 1, 0, yes
553772651,  orion756, 15, 12, 3, yes
3550261402,  codeghino10, 5, 5, 0, yes
599138109,  Vialedeiciliegi, 1, 1, 0, yes
3240896825,  EliasTikka, 2, 1, 1, neutral
816959106,  miliziachristi, 11, 11, 0, yes
3309783615,  simo_kitty, 28, 25, 3, yes
458671915,  enzostrano69, 1, 1, 0, yes
56705049,  p4rri, 1, 1, 0, yes
170684718,  Pierodeluca, 5, 5, 0, yes
262709701,  ondaquadra, 2, 2, 0, yes
419112828,  Martinscake, 1, 1, 0, yes
317223195,  frakas82, 1, 1, 0, yes
997179386,  sergiosafcz, 1, 1, 0, yes
1158529614,  mgraziadago, 2, 2, 0, yes
3017311317,  edvigefreri, 2, 2, 0, yes
2751905579,  garaur1, 1, 1, 0, yes
1042338378,  ValerioMunzi, 1, 1, 0, yes
451473769,  07Emmedi, 8, 6, 2, yes
724223563687972865,  realtitti, 1, 1, 0, yes
50976602,  MarinaVirtuelle, 1, 1, 0, yes
3115852689,  cignaluis, 3, 3, 0, yes
470358667,  gilamanna74, 2, 2, 0, yes
1081132770,  federicogiuse, 4, 1, 3, no
1233975200,  marise325, 19, 10, 9, yes
4343971877,  TgrRaiToscana, 9, 8, 1, yes
101752682,  angelo1941, 3, 2, 1, yes
1976450136,  buonfi71, 11, 5, 6, no
545381246,  trittolemo, 3, 2, 1, yes
407747764,  Marco_chp1, 9, 5, 4, yes
2191020414,  amicuccip, 11, 9, 2, yes
929249360,  xblunotte, 35, 12, 23, no
2207121327,  a17drea_, 8, 5, 3, yes
3017974510,  raffaela_modena, 6, 5, 1, yes
246855217,  gasciotti, 4, 3, 1, yes
1584071732,  bertini_chris, 1, 1, 0, yes
749902875187376128,  CampagneinLotta, 1, 1, 0, yes
163799053,  mattegrigo, 1, 1, 0, yes
2752943530,  AavofeRunner, 2, 1, 1, neutral
402740534,  dinomonti1, 4, 2, 2, neutral
588247720,  Maxitaly69, 7, 5, 2, yes
2947606421,  luciano_trop2, 6, 2, 4, no
633728787,  Keope, 14, 5, 9, no
234920295,  stefano85ita, 11, 8, 3, yes
75931540,  SlappyGold, 12, 8, 4, yes
3396842451,  DelmonteRinaldo, 3, 3, 0, yes
2786985789,  ETFifty4, 1, 1, 0, yes
2611695712,  ALBERTICESARE, 4, 2, 2, neutral
803539173898653697,  Gabriel54258751, 67, 33, 34, no
469516428,  pierocalaciura, 11, 1, 10, no
513481732,  coccocolacri, 1, 1, 0, yes
756908583648976897,  soniacarboni_, 7, 2, 5, no
593623163,  Marsala5Stelle, 30, 4, 26, no
1413932858,  Danielestark_, 13, 8, 5, yes
587723491,  polivittorio, 3, 3, 0, yes
4910367893,  OndaUrto, 5, 3, 2, yes
1072276639,  alessandrapira5, 1, 1, 0, yes
140012862,  antoniodinanni, 7, 7, 0, yes
874363932,  astroungarico, 1, 1, 0, yes
1056178597,  gianlu_1977, 5, 4, 1, yes
1251740306,  panty2006, 4, 2, 2, neutral
794455102325145600,  DivinaCommediaQ, 8, 4, 4, neutral
1461615506,  EugenioDelBono, 6, 5, 1, yes
426181894,  AmbaAradam, 2, 2, 0, yes
1595843437,  FLanghi, 4, 3, 1, yes
529282046,  FabrizioCaiazza, 2, 2, 0, yes
258788799,  elvinmax, 1, 1, 0, yes
775770350386814977,  jackthegoodboy2, 1, 1, 0, yes
421810729,  Petecchio, 9, 4, 5, no
1286694829,  vigodepier, 1, 1, 0, yes
380810188,  Ema_BRIGANTE, 1, 1, 0, yes
305650360,  agenziaimpress, 5, 4, 1, yes
1151711312,  mauro17673, 3, 3, 0, yes
614407423,  giovmar39, 12, 8, 4, yes
1062983670,  domenic1964, 1, 1, 0, yes
3640747095,  cicerbito1, 8, 2, 6, no
14867447,  Ildiserbante, 2, 0, 2, no
96851178,  LambertoRoberti, 3, 0, 3, no
370673217,  DomenicoMaduli, 2, 1, 1, neutral
1420443511,  anodo59, 39, 2, 37, no
416534525,  ASSOLIBERA, 21, 3, 18, no
2161187708,  MarioDerotti, 7, 3, 4, no
2843387003,  MassimoMegali, 9, 3, 6, no
517529981,  gilibertocapano, 5, 1, 4, no
916326246,  Albertozani4, 17, 2, 15, no
794072831906775040,  SocciF48, 8, 1, 7, no
1227483440,  AngeloFrisoni, 15, 6, 9, no
805854102039117824,  Loredanazucche5, 2, 0, 2, no
1619722123,  TCiolino, 3, 2, 1, yes
424142793,  ilaria_desantis, 9, 9, 0, yes
603531704,  ViolaRemedi, 15, 6, 9, no
3371026409,  Fra_nnic, 18, 5, 13, no
941290927,  lucio_massardo, 3, 1, 2, no
1273382059,  LaClaus85, 2, 1, 1, neutral
53868926,  GongoGorillo, 11, 8, 3, yes
944519454,  BoldrinDaniela, 21, 16, 5, yes
792675932414803968,  angy_Bubu, 6, 3, 3, neutral
243858269,  MarioCoraggio, 2, 1, 1, neutral
1904698302,  abramiagiuseppe, 3, 1, 2, no
354165740,  tisvampu, 7, 4, 3, yes
3996258160,  RotellsA, 14, 4, 10, no
2443006233,  AngyFra89, 5, 3, 2, yes
2229696720,  GiacumboRomeo, 2, 1, 1, neutral
2728800485,  me_dotti, 8, 4, 4, neutral
4074398955,  olitgiorgio, 3, 1, 2, no
2754433723,  oscarvalle1984, 41, 15, 26, no
3034313507,  GoldenLady886, 3, 1, 2, no
2427155309,  FRuighi, 8, 3, 5, no
96389952,  giulianobacca, 34, 7, 27, no
789477506646671360,  chiarasinc, 21, 9, 12, no
430033435,  GIGLIOLA11, 36, 9, 27, no
469369667,  PaoloMazzanti1, 4, 1, 3, no
369400294,  LauraGriesi, 3, 2, 1, yes
1926741584,  paroleprecise, 20, 1, 19, no
2956605346,  tartaruga981, 2, 1, 1, neutral
1000254661,  nicoladingegno, 2, 1, 1, neutral
1002172878,  EnricoBonotto, 4, 1, 3, no
752675748,  frapaper48, 9, 3, 6, no
839739973,  28febbraio, 5, 2, 3, no
287246577,  SigAshok, 2, 1, 1, neutral
490356500,  Maucon73, 2, 1, 1, neutral
795912820592410625,  utawind, 6, 1, 5, no
420575419,  fabiotelesca1, 3, 1, 2, no
47578036,  MicK_ele, 10, 6, 4, yes
404988328,  patriziaegle, 8, 6, 2, yes
1022728274,  barbini_aldo, 2, 1, 1, neutral
421332919,  mattibear1, 13, 8, 5, yes
4866444225,  veleniciociari, 3, 1, 2, no
471949441,  gdirico, 8, 4, 4, neutral
34649922,  danielenossa, 5, 2, 3, no
547051962,  NINURTA75, 18, 11, 7, yes
596821309,  pizzi_cristina, 15, 7, 8, no
3156038764,  f2bd4ade62064dd, 2, 1, 1, neutral
247289076,  FabrizioCrocini, 4, 1, 3, no
902528365,  Maurizio0691, 4, 3, 1, yes
974726732,  rubia721972, 19, 17, 2, yes
350216056,  FranckFixFire1, 6, 1, 5, no
1203189763,  LiberoAndreani, 7, 2, 5, no
2936119349,  Cri_Stark, 8, 2, 6, no
788752905985781760,  CuriaRosario2, 2, 1, 1, neutral
2181825023,  strevza75, 8, 6, 2, yes
507212094,  gabbo1979, 10, 3, 7, no
147726261,  vincilomb, 5, 3, 2, yes
439397412,  KKFabioKK, 9, 4, 5, no
749985750121340928,  bianca78538948, 3, 2, 1, yes
3108090405,  AmedeoLionello, 7, 1, 6, no
423726677,  barbujani, 15, 3, 12, no
2995763703,  Greg_Wonder, 12, 4, 8, no
469249349,  NicolaAri, 5, 3, 2, yes
2598012474,  Stattefermo, 13, 6, 7, no
780714403217846272,  Vjloris1o, 12, 4, 8, no
4106012295,  lu_c01, 18, 4, 14, no
2939040203,  ugoilbrugo11, 3, 1, 2, no
958750693,  mannoiv, 28, 2, 26, no
41153062,  Streetfightman, 5, 4, 1, yes
90183892,  carmelomusicsax, 4, 2, 2, neutral
407050794,  Mirko_Nano, 14, 4, 10, no
777879171993337856,  Siano5Stelle, 13, 1, 12, no
776479770502651904,  giovanni5439, 12, 3, 9, no
555963386,  FilippoSimone1, 2, 1, 1, neutral
2243936725,  la_donzelletta, 19, 14, 5, yes
2218061814,  MuzziGiancarlo, 2, 1, 1, neutral
792094761637257217,  JoDreamer1960, 3, 1, 2, no
486443971,  tarzia5W, 8, 3, 5, no
481095617,  savelli50, 3, 2, 1, yes
2333790099,  DelleCaveGiovy, 3, 1, 2, no
1351237069,  GaudianoGiorgio, 24, 5, 19, no
215549448,  Rossano68, 5, 3, 2, yes
2435959670,  mileneluzi, 16, 4, 12, no
737715899554226176,  matatolucia, 7, 4, 3, yes
2870641254,  GIUSEPPETRILLO, 5, 1, 4, no
1039546381,  alessandrazedd2, 7, 1, 6, no
963221024,  AttilioGugiatti, 5, 3, 2, yes
1334549226,  francinizzeton, 7, 1, 6, no
2429503261,  GiulioRaim, 4, 3, 1, yes
806736632,  noneedtofollow1, 2, 1, 1, neutral
436661637,  VincentVega46, 4, 1, 3, no
2316186746,  newsmarijuanait, 2, 1, 1, neutral
1283150444,  xmpierinix, 4, 2, 2, neutral
3359085957,  POSSIBILE5_0GE, 5, 1, 4, no
3978799463,  possibileLig, 15, 1, 14, no
1238864268,  calabraghe, 5, 1, 4, no
255417494,  damianobeltotto, 6, 2, 4, no
3946391800,  UnipolGroup_PR, 2, 1, 1, neutral
409309523,  massimo_giglio, 5, 3, 2, yes
396496206,  nicolasavoia, 4, 2, 2, neutral
855366954,  g_tabacchi, 2, 1, 1, neutral
919361378,  VerdeLuna2014, 2, 1, 1, neutral
590781553,  ValeriaRubello, 2, 1, 1, neutral
766141202,  giada_online, 4, 2, 2, neutral
238268991,  monkeyniehaus, 17, 11, 6, yes
801152682702622720,  limar1964, 3, 1, 2, no
101060119,  waltermassa72, 3, 1, 2, no
4015312877,  DonnerVdonner, 4, 3, 1, yes
595566285,  Giusep_Sciretta, 4, 0, 4, no
1158016266,  MorenoDeAmicis, 2, 1, 1, neutral
3293496178,  Magocla59, 7, 3, 4, no
454185506,  albertolapenna, 12, 1, 11, no
3037077532,  Ipercritic, 9, 4, 5, no
4915900165,  seanedwardlouis, 28, 10, 18, no
791392103876202496,  RomaReporting, 10, 4, 6, no
405644134,  alessandrasard1, 1, 1, 0, yes
3906735870,  antonellatonon1, 28, 4, 24, no
151945537,  pocaluce, 1, 1, 0, yes
801313759,  LeonardoRevenge, 18, 11, 7, yes
394787464,  DavidErmini1, 7, 7, 0, yes
57249412,  adriano1970, 15, 3, 12, no
2594797000,  fdamelio22, 6, 1, 5, no
2290115024,  TEKNOEDILPISA, 2, 1, 1, neutral
3091373500,  ConfindustriaVi, 2, 2, 0, yes
1900493299,  IndustriaVi, 2, 2, 0, yes
403012790,  leodreyfus, 4, 2, 2, neutral
50292364,  dedinus, 2, 1, 1, neutral
129223592,  magogeppe, 6, 6, 0, yes
2417471190,  FABIOMACC72, 4, 3, 1, yes
3001785407,  Lex17368142, 2, 1, 1, neutral
54589319,  ArdilladelBoske, 1, 1, 0, yes
1087279381,  Alfaomegatre, 6, 6, 0, yes
309800578,  giovannidevivo, 3, 3, 0, yes
1369658370,  maruscopetribis, 10, 3, 7, no
2877804497,  mammasi68, 81, 30, 51, no
66545080,  giuliodilorenzo, 3, 3, 0, yes
497949362,  abianchinive, 7, 6, 1, yes
424590567,  giudicialex, 1, 1, 0, yes
547936685,  markorusso69, 9, 5, 4, yes
475175542,  angela_roveda, 2, 2, 0, yes
407598164,  mmarilli38, 47, 22, 25, no
15229872,  planetarysound, 1, 1, 0, yes
277259401,  _NAVY_____, 1, 1, 0, yes
1638100706,  LudovicaMarsala, 1, 1, 0, yes
2828477103,  juanroman1980, 18, 13, 5, yes
11198782,  niente, 3, 3, 0, yes
1362473617,  giovanni_barba, 9, 5, 4, yes
984751405,  Beli_Tsar, 1, 1, 0, yes
129515952,  Gigebi, 5, 5, 0, yes
1459983516,  LucaRanalletta, 1, 1, 0, yes
3707117237,  rosy1167, 1, 1, 0, yes
453288373,  acerba_follia, 3, 1, 2, no
532229126,  GiuseppeNoc, 1, 1, 0, yes
791034319301140480,  vitodisweetgirl, 18, 6, 12, no
229584880,  WestSer, 5, 3, 2, yes
2375003982,  Dea5stars, 9, 3, 6, no
2625445767,  CaninoRosita, 6, 5, 1, yes
778646509,  RGroni, 5, 5, 0, yes
351919802,  lucafrasca, 6, 5, 1, yes
94361919,  lilianafisk, 2, 2, 0, yes
2430601185,  stefanocarlo2, 3, 2, 1, yes
776405760242622468,  studiomilano2, 1, 1, 0, yes
1219750104,  telesca_sandra, 2, 2, 0, yes
361790675,  Maeriposa, 7, 5, 2, yes
358626243,  robymark1, 2, 1, 1, neutral
2209811628,  ANIMAL_GENOCIDE, 2, 2, 0, yes
401619375,  MLuisaPaglia, 1, 1, 0, yes
1124777892,  AlbertoTroncone, 2, 1, 1, neutral
958633201,  an12frnc, 5, 5, 0, yes
1641054956,  LilianaGenovesi, 1, 1, 0, yes
49397445,  evaigra, 11, 3, 8, no
1125112531,  mikytavolo13, 3, 3, 0, yes
628772007,  raffmancio1, 13, 3, 10, no
708425080645279745,  Benedettascagl5, 93, 37, 56, no
473362623,  MORVGAN, 1, 1, 0, yes
789079655257149440,  dana90003, 1, 1, 0, yes
794893367050207232,  tamem00495300, 1, 1, 0, yes
794901164559101952,  sazo69958000, 3, 2, 1, yes
794902089138900992,  sazan09162700, 1, 1, 0, yes
709361586734014465,  coco24245755, 1, 1, 0, yes
767661650811969536,  staralexander7, 1, 1, 0, yes
784801242199490560,  vaskopetrake, 1, 1, 0, yes
404820209,  MaraLupano, 7, 5, 2, yes
370090430,  Lucachannel, 1, 1, 0, yes
1013535530,  Romanista1976, 21, 7, 14, no
734571818846191616,  leighaa35, 3, 3, 0, yes
285144708,  Farquad2, 3, 3, 0, yes
524224872,  miciomannaro, 5, 5, 0, yes
240658286,  Nntt26, 1, 1, 0, yes
1729765459,  ania_joe, 7, 6, 1, yes
1180297218,  MikyMichele65, 2, 1, 1, neutral
779316037774929921,  costdem16, 2, 1, 1, neutral
1021540020,  SannSany, 4, 3, 1, yes
1056293419,  CodegaMatteo, 1, 1, 0, yes
560546180,  cirofiorenzano, 5, 2, 3, no
912336356,  MartusiaPerito, 1, 1, 0, yes
255499883,  reflejo3c, 2, 1, 1, neutral
2270541645,  itatwt, 6, 2, 4, no
765901369547063296,  liberidipensar, 2, 1, 1, neutral
34705503,  mariospray, 9, 6, 3, yes
2901324173,  gianfrancoianni, 2, 2, 0, yes
747327834494898176,  NEXITIUS, 10, 6, 4, yes
4860759339,  robbibernaroli, 4, 4, 0, yes
211603206,  dsantoro, 4, 3, 1, yes
531122547,  agostinovarchi, 1, 1, 0, yes
303451363,  giosalamone, 1, 1, 0, yes
4077751847,  DiCive, 2, 2, 0, yes
514686219,  Chiara_Pili, 1, 1, 0, yes
802664860744089601,  LuxFuit, 7, 4, 3, yes
421363907,  EllyValentini, 7, 4, 3, yes
2575087541,  lucaderenzo, 2, 2, 0, yes
3401227875,  lilysei, 40, 22, 18, yes
769535256,  BonattiFederico, 2, 2, 0, yes
3310422237,  jxgiuliano, 40, 8, 32, no
327542565,  luxurymodels, 8, 8, 0, yes
1895251016,  marfisalaura, 2, 1, 1, neutral
1037049997,  algirone, 3, 1, 2, no
359096965,  licprospero, 38, 19, 19, neutral
1017508194,  rosanna66886427, 7, 4, 3, yes
1479828265,  theskindesigner, 7, 1, 6, no
295322256,  vincenzo_tanzi, 3, 3, 0, yes
3038785617,  FashionmailW, 38, 3, 35, no
2819591819,  claudiab0364, 12, 6, 6, neutral
1088754122,  ilnital, 1, 1, 0, yes
798453173216280576,  francebita, 4, 4, 0, yes
2722863047,  emanuelaneri14, 6, 3, 3, neutral
801499650222129153,  deeplyfree3, 31, 8, 23, no
542702402,  FedericoValeri7, 1, 1, 0, yes
2319044498,  avvrosspisano, 1, 1, 0, yes
332959014,  Katrinee1, 18, 16, 2, yes
704588493683462144,  children57, 1, 1, 0, yes
1655311418,  egoteabsolvo1, 13, 6, 7, no
4074792743,  vivaglianimali, 10, 4, 6, no
346074726,  bullboss63, 1, 1, 0, yes
3183738556,  frillici_andrea, 15, 8, 7, yes
109034099,  BigBigio, 31, 1, 30, no
39610983,  clacapocchi, 8, 4, 4, neutral
1367868512,  irenegiolitti, 10, 8, 2, yes
934047600,  paolafern75, 1, 1, 0, yes
598374852,  CristianoManfre, 9, 6, 3, yes
1346600790,  eurodisastro, 3, 2, 1, yes
1915578642,  mimmoalba1, 17, 9, 8, yes
1374460555,  KopenScott47, 6, 3, 3, neutral
1289326484,  gvnn1977p, 7, 4, 3, yes
3077127425,  Giorgio72x, 1, 1, 0, yes
487711174,  festinalente3, 15, 8, 7, yes
394780039,  gimmisantucci, 9, 7, 2, yes
452909538,  OmarMonestier, 3, 3, 0, yes
894292836,  areyou0, 1, 1, 0, yes
454311330,  MattiaPertoldi, 1, 1, 0, yes
1001463980,  lucianorubini1, 7, 5, 2, yes
226196762,  IlyRedPassion, 1, 1, 0, yes
770926273484972032,  Peppejcjc1, 2, 1, 1, neutral
3373853703,  Sinapsii, 19, 9, 10, no
488674564,  trefelix, 2, 1, 1, neutral
2301325605,  NicolaCante, 2, 2, 0, yes
788110441545334785,  maria391030, 1, 1, 0, yes
474854274,  gio1984_, 3, 2, 1, yes
29220492,  fabioflos, 3, 3, 0, yes
405500662,  infedeIe, 9, 8, 1, yes
4173642952,  Mitramacco, 4, 2, 2, neutral
975722095,  _procolo, 1, 1, 0, yes
1311687600,  BerardiLina, 42, 16, 26, no
519601450,  Berdo76, 1, 1, 0, yes
2472146552,  FaBiSqU, 3, 3, 0, yes
330318130,  LucaMontefiori, 2, 2, 0, yes
164223102,  quanitella, 13, 6, 7, no
1147328154,  GiovArtiUD, 3, 3, 0, yes
1513168501,  danyrap98, 4, 4, 0, yes
948400525,  giardinamc, 2, 1, 1, neutral
220729165,  farmetti, 14, 3, 11, no
3364459210,  supergattino, 2, 2, 0, yes
872449159,  robeugol, 1, 1, 0, yes
409252331,  SereMasetto, 2, 2, 0, yes
444931260,  stlerario, 4, 3, 1, yes
1043099688,  profluigimarino, 10, 4, 6, no
4787684421,  e0c430b78be949f, 5, 1, 4, no
712941879113949184,  fr_ee11dom, 7, 6, 1, yes
721112026,  TommasoDassi, 6, 4, 2, yes
428182028,  CFracassi, 1, 1, 0, yes
712711445,  stevelaces, 2, 2, 0, yes
116190223,  Geipeg, 33, 15, 18, no
782687052479340545,  IdohateSJWs, 2, 2, 0, yes
142475262,  tremat, 1, 1, 0, yes
486084757,  MarcelloFiorenz, 1, 1, 0, yes
82210282,  SENSIMILLIEA, 1, 1, 0, yes
618985031,  UILperiferic, 13, 7, 6, yes
117156334,  enricoadami, 2, 1, 1, neutral
436230438,  GiuseppeZane, 7, 3, 4, no
589091079,  ConfartiUdine, 2, 2, 0, yes
79154476,  Giorgio_Nordo, 2, 2, 0, yes
17912290,  curious_corn, 2, 1, 1, neutral
343428085,  Rita_Pavone_, 3, 2, 1, yes
2804233346,  alkhimiyah, 10, 6, 4, yes
2410208021,  enricof88, 1, 1, 0, yes
1154934108,  maxsparvieri, 4, 3, 1, yes
779673493847801856,  EsmelucreziaII, 3, 3, 0, yes
321264725,  It_Pol, 8, 3, 5, no
707269014200909826,  gertdalpozzo12, 4, 4, 0, yes
1448008590,  paolodeg82, 2, 2, 0, yes
1510780328,  IsabellaDeMonte, 7, 7, 0, yes
775697742949675008,  sandrian60, 2, 2, 0, yes
464755043,  BRaffaele77, 7, 2, 5, no
294485532,  donatoboccia, 1, 1, 0, yes
1083812281,  alessmarinelli, 3, 3, 0, yes
836055234,  MeloniVito, 14, 5, 9, no
265310795,  ilmontagnardo, 9, 3, 6, no
484010722,  CarlaMarotta, 24, 24, 0, yes
3306600977,  rosamunda2giugn, 3, 2, 1, yes
52172571,  carlosmessier, 1, 1, 0, yes
82093783,  farfalladiferro, 11, 9, 2, yes
360584733,  carlolovati, 1, 1, 0, yes
728444164929511425,  serrachiani, 1, 1, 0, yes
792801019625439234,  Mario41017004, 5, 4, 1, yes
800998519,  flavilar, 1, 1, 0, yes
721406424333455361,  ACacerosdubon, 1, 1, 0, yes
1616497069,  caddeo82, 2, 2, 0, yes
96987099,  il_piccolo, 5, 4, 1, yes
553620307,  GianlucaFanni, 1, 1, 0, yes
722504292263964673,  Tonysmi84070351, 1, 1, 0, yes
2625302733,  barbaralai84, 6, 2, 4, no
108958320,  abollis, 5, 3, 2, yes
2193903789,  georgerivoli, 1, 1, 0, yes
217795515,  eibbaf, 2, 2, 0, yes
256207484,  carriolarossa, 6, 4, 2, yes
2627013992,  marco_disca, 3, 2, 1, yes
26555279,  Telethonitalia, 1, 1, 0, yes
2857162997,  rafrom1973, 4, 2, 2, neutral
2888891609,  MirasoleCarlo, 7, 2, 5, no
707184555887861760,  robbedda, 155, 86, 69, yes
418869348,  DanieleDfc, 1, 1, 0, yes
972753542,  PoClaudia, 2, 2, 0, yes
320936739,  NotizieInAgenda, 2, 2, 0, yes
206732202,  maxnonmolla, 1, 1, 0, yes
483307241,  QuintilioC, 2, 2, 0, yes
861373158,  ManuelRizzi1, 12, 4, 8, no
75238797,  Natasha12483, 2, 1, 1, neutral
85060556,  biancacle, 13, 3, 10, no
798136006516109312,  loureed66, 1, 1, 0, yes
249124899,  IlTorto77, 2, 2, 0, yes
535729333,  badmonta, 17, 12, 5, yes
605499197,  PaolaRossiAdila, 1, 1, 0, yes
484052954,  DBuzzulini, 1, 1, 0, yes
1114503342,  irismoretti, 6, 4, 2, yes
3352828348,  Antorosty, 1, 1, 0, yes
1122236275,  marioriggio2, 1, 1, 0, yes
709664394620346368,  PatriziaLaBian3, 2, 1, 1, neutral
608237901,  FabioGentile7, 1, 1, 0, yes
4884557896,  shardana22, 11, 7, 4, yes
724957881045491712,  maiocchirosann5, 6, 6, 0, yes
216654360,  ombroman, 3, 2, 1, yes
3418726954,  romifivestars, 17, 7, 10, no
2239750970,  duno_van, 6, 4, 2, yes
4386339226,  NicolettaTitoli, 17, 9, 8, yes
282996856,  MorenoPisano, 3, 3, 0, yes
495386998,  ritchie_1969, 6, 4, 2, yes
2611334140,  djoycici, 8, 5, 3, yes
276026459,  avatar1dory, 3, 2, 1, yes
778888759983108096,  fedemanca1, 1, 1, 0, yes
406545803,  littlecow4, 9, 2, 7, no
343458847,  Marco_Montini, 43, 27, 16, yes
12893192,  franzfume, 6, 5, 1, yes
899901025,  ornella20211, 20, 12, 8, yes
3349820218,  salvespo56, 7, 6, 1, yes
332849354,  babus75, 5, 2, 3, no
461903387,  evymenna, 2, 0, 2, no
2997783909,  MainaMainafr, 4, 1, 3, no
2482345727,  clalurid74, 28, 3, 25, no
205203605,  nandosigona, 3, 1, 2, no
1879755822,  __MyPepsi__, 4, 1, 3, no
4889377726,  Marilen00160544, 12, 0, 12, no
527277129,  MichelaMirani, 8, 0, 8, no
708307651269148673,  SaverioPortol, 2, 2, 0, yes
457494349,  maxfog99, 2, 2, 0, yes
404979028,  bebo_alberto, 8, 4, 4, neutral
79223440,  dpennati, 4, 3, 1, yes
2166381300,  marini_ro, 21, 19, 2, yes
1308083862,  InfolabLeone, 2, 2, 0, yes
313517712,  Sara_6277, 15, 10, 5, yes
3041981709,  DeDarioeriani, 3, 3, 0, yes
783292222846427136,  vanessinayo, 17, 17, 0, yes
800724388068749313,  _Giustizia_, 3, 2, 1, yes
1041926774,  azcivile, 3, 2, 1, yes
2944098779,  milazzomiki, 2, 2, 0, yes
1267591759,  StephyGall, 7, 4, 3, yes
1222676508,  infrantumi, 4, 4, 0, yes
3002704193,  ricettefv, 2, 2, 0, yes
804255964178345984,  funcoolers67, 11, 7, 4, yes
62901570,  cpersiano, 8, 2, 6, no
3025368046,  ClaraMutsc, 48, 18, 30, no
94402971,  ivanve1, 2, 2, 0, yes
385094385,  paolopoggi1, 4, 4, 0, yes
1449073304,  7lecs, 6, 3, 3, neutral
588507242,  GiordanoSottosa, 14, 3, 11, no
425728632,  severomagiusto, 23, 13, 10, yes
422205561,  Philip__B, 9, 9, 0, yes
1361815838,  magrotto68, 9, 4, 5, no
425135784,  Stefano_Rufini, 7, 4, 3, yes
3900401302,  TinoAngo, 4, 4, 0, yes
2822310640,  TizianoAdorni, 39, 4, 35, no
1209210108,  clabianchicla, 10, 4, 6, no
389400082,  Mi_nOetk, 3, 3, 0, yes
55020430,  fenkji, 6, 5, 1, yes
150961613,  Giusva82, 5, 5, 0, yes
268894777,  Alexium75, 2, 2, 0, yes
3001898993,  msolferino60, 6, 2, 4, no
925087639,  truemonitor, 2, 2, 0, yes
714876220249358338,  AntonioPignata6, 96, 95, 1, yes
456110418,  ACarovani, 3, 3, 0, yes
2449267214,  gbolo95, 5, 5, 0, yes
3590404697,  MauroV1968, 4, 4, 0, yes
408277343,  CirchiDavide, 8, 4, 4, neutral
779641199040798721,  JerryGa24411807, 11, 4, 7, no
947367140,  avvcavalcanti, 4, 4, 0, yes
1013151366,  Roxy21Mi, 23, 15, 8, yes
518637482,  SergioDellOmod1, 4, 3, 1, yes
4824190702,  lorena_pacelli, 4, 4, 0, yes
1493149598,  Mauro_Col, 4, 4, 0, yes
764848401032810496,  Siss_etta, 4, 2, 2, neutral
755077129554059264,  BastaUnSiRc, 7, 7, 0, yes
1635753799,  GVNVNCR, 33, 18, 15, yes
744655172211728384,  glucosio2, 16, 12, 4, yes
865964642,  Paolina118, 5, 2, 3, no
183966415,  topazio1982, 3, 3, 0, yes
391246325,  Brus_Uillis, 31, 11, 20, no
3419595551,  salmont57, 4, 4, 0, yes
416922961,  AAtheMerciless, 9, 8, 1, yes
1165469972,  FSfredda, 5, 4, 1, yes
261384105,  robertoboggiani, 6, 5, 1, yes
3080186967,  MvStufamarcia, 7, 5, 2, yes
725073326163501057,  RossellaBarile, 7, 7, 0, yes
89190395,  paolo_antonioli, 7, 6, 1, yes
3235663600,  vasnova2002, 2, 2, 0, yes
3303594136,  zarafrancesco55, 13, 11, 2, yes
734847868830355457,  CittadinoITL, 2, 2, 0, yes
257935829,  fiore_capasso, 3, 3, 0, yes
1595653056,  mariangelader, 36, 30, 6, yes
972096859,  FawkesFeniksas4, 3, 3, 0, yes
1233945602,  loribastianoni, 4, 4, 0, yes
398002229,  PNDelogu, 2, 2, 0, yes
513444329,  MercPat, 10, 3, 7, no
578393872,  maggtn, 9, 8, 1, yes
4545680897,  biagiogatto77, 3, 3, 0, yes
2318032643,  sa_ga13, 18, 10, 8, yes
798086349316378624,  butthead1983bz, 28, 17, 11, yes
781503623306051588,  BastaUnSiLauria, 3, 3, 0, yes
494844364,  Lory_Twins, 7, 6, 1, yes
480493084,  AndreaGiua, 2, 2, 0, yes
464855487,  vlasec_ciotto, 7, 7, 0, yes
715887797165535233,  valentina_allia, 5, 5, 0, yes
2875485406,  nasydan, 8, 7, 1, yes
749779490,  annaritaventuri, 17, 7, 10, no
1642481467,  BobStasi, 3, 3, 0, yes
1353369536,  rweisshaar, 2, 2, 0, yes
753557703444824064,  DonnaBea9, 5, 5, 0, yes
717321779904126976,  ricco_annarita, 9, 9, 0, yes
2763929843,  Dolci_Ricami, 12, 12, 0, yes
788451050458083328,  Scifab3, 19, 18, 1, yes
4075384109,  silvano747, 4, 3, 1, yes
702597457490927616,  Rossellatfa, 16, 16, 0, yes
1222227577,  veratto_A, 13, 7, 6, yes
325692761,  LucianoCrolla, 5, 5, 0, yes
1303163371,  ciairo85ciro, 6, 6, 0, yes
1610524585,  StefanoGrado, 3, 3, 0, yes
125804319,  MICHELAMACCIONI, 3, 3, 0, yes
3198157894,  Terteresax, 3, 3, 0, yes
1090446402,  DaveFiore78, 3, 3, 0, yes
2523901625,  rossettobagnato, 11, 10, 1, yes
715487343608659968,  carmelamaria197, 2, 2, 0, yes
2361259802,  cicchettopinna, 2, 2, 0, yes
172337683,  collefesta, 4, 3, 1, yes
2199548284,  tota_mif, 17, 11, 6, yes
407494932,  davide73_italy, 48, 15, 33, no
2751236704,  ludovicafivesos, 3, 3, 0, yes
248847422,  mary0377, 3, 3, 0, yes
4922341,  AndrewRm, 6, 3, 3, neutral
2224974581,  GabrieleCarrer, 4, 4, 0, yes
510611092,  vico_dimi, 6, 5, 1, yes
1307085218,  Avevaragionemin, 5, 3, 2, yes
259205516,  claudiajo8, 6, 6, 0, yes
252984226,  laika60, 2, 2, 0, yes
778644518,  NordmannRoger, 5, 5, 0, yes
432009958,  danilamonteverd, 13, 4, 9, no
296197775,  LBaggiani, 6, 6, 0, yes
1009028191,  claudionucara, 30, 4, 26, no
2969343543,  WesJuve32, 5, 3, 2, yes
1305672871,  perriniottavio, 2, 2, 0, yes
742469305976098817,  Gfranco5Stelle, 24, 10, 14, no
1139640792,  social_politico, 2, 2, 0, yes
502101156,  AngeloTimpano, 2, 2, 0, yes
397436135,  Silvio_Viale, 17, 15, 2, yes
533024781,  hazachen, 2, 2, 0, yes
578705554,  micrus009, 4, 4, 0, yes
69418369,  marcellobiscosi, 2, 2, 0, yes
29182906,  fvitale, 11, 10, 1, yes
2343224241,  GianlucaBosia, 2, 2, 0, yes
789398693963112448,  Mandolesi_Giu, 3, 2, 1, yes
2877794140,  Loran23Loran, 2, 2, 0, yes
897806558,  chevassunse, 2, 2, 0, yes
52203471,  EskimoMrc, 2, 2, 0, yes
188074055,  moussamomo, 2, 2, 0, yes
1180597874,  lupus_in_tabula, 9, 4, 5, no
1367365670,  AlbertoCalle4, 3, 3, 0, yes
370940742,  MircoRota, 25, 20, 5, yes
2781460023,  emanuelecorall3, 2, 2, 0, yes
356192231,  bega1969, 3, 3, 0, yes
194632941,  francescorea, 7, 3, 4, no
2513339808,  IlKazuma, 30, 23, 7, yes
228372698,  alicearienta, 2, 2, 0, yes
3865428028,  Andreaf2008F, 10, 9, 1, yes
2340205333,  andrea65t, 7, 5, 2, yes
1002265298,  Valevaledg, 3, 2, 1, yes
2719470235,  alde68, 14, 13, 1, yes
2400871240,  ilciapo, 6, 4, 2, yes
63708772,  vinciandrea, 4, 4, 0, yes
711943370227191808,  nina__pasadena, 2, 2, 0, yes
1284161928,  GiuliaFapranzi, 5, 4, 1, yes
798807953671266305,  donatone59, 10, 8, 2, yes
2317619202,  souchak, 3, 3, 0, yes
792825362329788417,  MassimilianoEgo, 10, 4, 6, no
368271151,  Giuseppe_Lumia, 2, 2, 0, yes
2495303823,  antovilla1944, 2, 2, 0, yes
421347689,  assurdbanipal, 19, 15, 4, yes
2587940700,  TwTunda, 8, 3, 5, no
1220951875,  APatrignan, 5, 3, 2, yes
3255935603,  FabioAppetiti, 7, 7, 0, yes
251106558,  pescarese73, 3, 2, 1, yes
2865365393,  bilbao_77, 12, 10, 2, yes
989677994,  PeppeL2, 7, 5, 2, yes
2263675613,  FrancescaPontan, 10, 9, 1, yes
534891036,  SESchimmenti, 2, 2, 0, yes
346411027,  Carontemm, 4, 3, 1, yes
2609794984,  MMamichm, 14, 14, 0, yes
709828600351092738,  aarceri991, 3, 2, 1, yes
2322849823,  mariandres2014, 31, 7, 24, no
2638214938,  Drughinotw, 6, 3, 3, neutral
2843485965,  ArtizzuFederico, 2, 2, 0, yes
751149104236027904,  angeluccimarian, 22, 11, 11, neutral
2182828334,  ClaudioSpalazz1, 2, 2, 0, yes
266235426,  AnnaRinaldi78, 2, 2, 0, yes
3437538514,  sciablu_iride, 7, 5, 2, yes
297037226,  Luzuer, 3, 2, 1, yes
113306198,  tati1na, 4, 4, 0, yes
154479746,  fangbianmen, 2, 2, 0, yes
4133259777,  ChiaraKiry83, 14, 13, 1, yes
740428546192080896,  AntonellaCerra3, 8, 6, 2, yes
142643965,  teppuz, 19, 10, 9, yes
248156296,  MTULLIOM, 2, 2, 0, yes
3024669184,  AnonRibelle, 5, 5, 0, yes
1394635735,  76enz, 3, 3, 0, yes
200608632,  Andre123go, 3, 3, 0, yes
2803713648,  stefanodonno75, 3, 3, 0, yes
385930662,  FraMarotta, 2, 2, 0, yes
2504129001,  KiverkD, 23, 6, 17, no
799352721254051844,  GiGiWolf119, 18, 5, 13, no
1103777761,  UldericoSavini, 2, 2, 0, yes
772092560319873024,  EU_AL3XR, 2, 2, 0, yes
3321893073,  MauroMacedonio, 6, 5, 1, yes
463118989,  OASIDEICELTI1, 7, 3, 4, no
3090685900,  omarrosa7433, 6, 3, 3, neutral
779384713865756673,  MarioRicella, 12, 6, 6, neutral
799177228672237568,  trent175633512, 23, 9, 14, no
501757210,  BozzettiMario, 8, 4, 4, neutral
768815150837145600,  MonicaR09972686, 58, 30, 28, yes
491057885,  calibra71, 20, 10, 10, neutral
1960545097,  RiefoliSal, 6, 2, 4, no
1370502229,  LaRotaRosaMaria, 4, 2, 2, neutral
780092964244783105,  pintirre, 40, 19, 21, no
275754256,  TommyBrain, 4, 2, 2, neutral
1117120286,  vittoriomaietta, 17, 9, 8, yes
717298250462662659,  Matteo31121962, 32, 13, 19, no
1060790502,  a_d_cavallo, 2, 1, 1, neutral
627383485,  emilianariccobo, 30, 3, 27, no
2179686791,  maxcagliostro1, 4, 2, 2, neutral
791309619478032384,  tw1tt3rIT, 7, 4, 3, yes
1527884816,  AnninaDeiana, 2, 1, 1, neutral
2985347933,  2015Ciro, 16, 8, 8, neutral
583920508,  fcamastra, 27, 13, 14, no
3387206505,  BonniSabba, 44, 22, 22, neutral
1971725324,  damcoc, 2, 1, 1, neutral
987136146,  annatorre7, 9, 3, 6, no
799754734315782144,  Angel2204518215, 426, 213, 213, neutral
992597312,  GiulyRamo, 4, 2, 2, neutral
2940621262,  TwinStar755, 17, 8, 9, no
2319687721,  Pep_olyglot, 2, 1, 1, neutral
2336493886,  santone1973, 2, 1, 1, neutral
2715371230,  akumal2001, 4, 1, 3, no
2283943289,  SaraCannea, 39, 20, 19, yes
433671269,  LucaPagliarini, 35, 17, 18, no
4904809815,  raffaellacandi, 2, 1, 1, neutral
793725735047405568,  Natiolive69, 38, 19, 19, neutral
432303135,  GiovanniParillo, 2, 1, 1, neutral
2362829526,  CarmineChiola, 18, 9, 9, neutral
801153862715535360,  NewJ3rsy, 10, 5, 5, neutral
2342306520,  semanthica, 28, 14, 14, neutral
770500091773845504,  SaraVasconvolta, 21, 11, 10, yes
3928749496,  anarchodroid, 92, 47, 45, yes
522567091,  FFTaurus, 45, 18, 27, no
805061228125192192,  Michele19067555, 4, 2, 2, neutral
2875322452,  aricci314, 29, 16, 13, yes
255662125,  lalessiuccia, 2, 1, 1, neutral
13799582,  festadellarete, 2, 1, 1, neutral
1417495747,  PTrombettoni, 14, 7, 7, neutral
177616381,  Alessandropn, 5, 4, 1, yes
426532936,  donanto83, 3, 2, 1, yes
229880702,  ACareddu, 2, 1, 1, neutral
452294805,  massimogrossi2, 23, 8, 15, no
2166946440,  Boshimane, 2, 1, 1, neutral
2312996169,  mar_eth1, 13, 10, 3, yes
2369487383,  maxtasso4, 2, 1, 1, neutral
789075138193088512,  gogoo122121, 16, 8, 8, neutral
789109498753478656,  gogooo570, 9, 5, 4, yes
794903071713325056,  jakena7, 17, 7, 10, no
108027420,  giacomojackpini, 2, 1, 1, neutral
178009034,  PAT_R_IC_K, 2, 1, 1, neutral
2525782668,  frattocchiano, 6, 3, 3, neutral
2511415512,  antonio_ansp, 559, 275, 284, no
2544957299,  salvops17, 48, 23, 25, no
1065306211,  Robylaff72, 12, 6, 6, neutral
500040155,  BacchinF, 2, 1, 1, neutral
827245560,  ikigailogan, 13, 7, 6, yes
254092558,  Roberto_Ricci, 12, 4, 8, no
783740138660700160,  Antonio_Double, 370, 183, 187, no
706171154092924928,  doubleff23, 14, 7, 7, neutral
789419320984166401,  Peonia249, 5, 3, 2, yes
2174691850,  mirellaladini, 89, 42, 47, no
733026190689210368,  daniele011960, 63, 28, 35, no
101028336,  kumhofer, 4, 2, 2, neutral
310907747,  MaurizioBosatra, 20, 10, 10, neutral
4654914975,  ValerioValent14, 2, 1, 1, neutral
1012818918,  JohnMcN03, 18, 11, 7, yes
2472900764,  CristinaPomari, 8, 4, 4, neutral
1052908075,  Anty82a, 7, 3, 4, no
49283289,  lucaspeed, 2, 1, 1, neutral
2356966725,  DavideScotti433, 67, 30, 37, no
926117844,  cinziadanko, 8, 4, 4, neutral
122497273,  gaietta88, 189, 97, 92, yes
776366037566623745,  hellraiser13666, 20, 4, 16, no
4181504669,  NinnoCn, 5, 2, 3, no
1033253838,  Finaleallegro, 10, 5, 5, neutral
107537984,  andreapiovesana, 6, 3, 3, neutral
3833101347,  Piffo22, 14, 7, 7, neutral
774283739027369984,  Octrebor, 4, 2, 2, neutral
2354558477,  ingcent, 2, 1, 1, neutral
4909482065,  Christian7426, 4, 3, 1, yes
97035161,  axl38, 20, 9, 11, no
774956803578818560,  gaffeiva, 2, 1, 1, neutral
3041069908,  cakx9massimoba1, 15, 8, 7, yes
1100740075,  epalermo79, 5, 1, 4, no
1353994580,  IavaroneEnzo, 8, 4, 4, neutral
2873826494,  aldorossi31349, 4, 3, 1, yes
793807324469137408,  alexcekbond, 2, 1, 1, neutral
1538732857,  Giancagt6, 3, 2, 1, yes
560913530,  ScDavide, 2, 1, 1, neutral
516686815,  PaoloAlePassala, 2, 1, 1, neutral
1608809730,  42yocom, 5, 2, 3, no
4470002068,  RaffaeleTonacci, 86, 43, 43, neutral
805387375270576128,  quantmint1, 21, 7, 14, no
2982639635,  rmedosi, 49, 22, 27, no
1369127191,  valerioaver, 3, 1, 2, no
2266409233,  GiovanniBagolin, 5, 2, 3, no
1260385676,  ale_mariano1986, 11, 5, 6, no
3369139678,  Lella3ago, 2, 1, 1, neutral
879705577,  NiccoloRussell, 4, 2, 2, neutral
2554496029,  peppeguido98, 6, 3, 3, neutral
704620937220657152,  barluiru, 2, 1, 1, neutral
1390178377,  basten69, 4, 2, 2, neutral
2585035709,  glucchy, 42, 21, 21, neutral
845605358,  AnnaCuocci, 2, 1, 1, neutral
1077740636,  NiMartina, 23, 8, 15, no
91528810,  claudioxone, 64, 32, 32, neutral
2257427185,  Gianpy_Serra, 10, 5, 5, neutral
137939617,  ren862, 9, 4, 5, no
1482397633,  filippoblu_, 32, 8, 24, no
456601013,  Musta_H, 6, 3, 3, neutral
1048380457,  Damiano__89, 18, 10, 8, yes
1002454920,  AstolfoCipro, 2, 1, 1, neutral
1326880621,  cappellini_c, 32, 15, 17, no
790249160779919361,  comeprofondo14, 24, 12, 12, neutral
1379254362,  annatvivoli, 371, 186, 185, yes
321322214,  Rocx53, 2, 1, 1, neutral
207070244,  ItsFearless, 23, 11, 12, no
721604843861880832,  lucas180278, 6, 3, 3, neutral
396640825,  SalvaDella, 4, 2, 2, neutral
200888646,  Tony_Skid, 33, 13, 20, no
1628691145,  SweetSabryy, 2, 1, 1, neutral
463201042,  V_campogomez, 4, 1, 3, no
3036230170,  marisa_s_43, 14, 7, 7, neutral
382029804,  viviengonzales, 26, 7, 19, no
309784041,  dome_nico_73, 12, 4, 8, no
1446871488,  _cogico, 17, 7, 10, no
381958875,  CarmineTedeschi, 5, 1, 4, no
798531277116862464,  shankarnathbaba, 42, 21, 21, neutral
528946243,  FabrizioDosi, 2, 1, 1, neutral
1607823997,  AlbertoIonna, 4, 3, 1, yes
798978150772441089,  Pablo77702272, 12, 7, 5, yes
729359824312504320,  LVK469, 14, 7, 7, neutral
61011257,  rossijames, 41, 11, 30, no
366713180,  gerrybru, 6, 3, 3, neutral
1314231894,  gianni_mancino, 13, 2, 11, no
453313639,  gianbioca48, 2, 1, 1, neutral
732013309877227523,  granato_serena, 10, 5, 5, neutral
418508915,  GiuseppeCrisaf1, 15, 7, 8, no
225604191,  afgianas, 7, 3, 4, no
3012368733,  XsLovatic, 4, 3, 1, yes
743898591597559808,  stemmis, 15, 7, 8, no
831478200,  PietroCuppari, 2, 1, 1, neutral
416398770,  filippomazzone, 13, 6, 7, no
3050231175,  vmoretto76, 4, 2, 2, neutral
1066344667,  stefaniabrogi, 93, 47, 46, yes
4626223881,  giorgiomarinel4, 6, 1, 5, no
494118797,  GenuardiAnna, 2, 1, 1, neutral
1382823301,  Sandrogallo4, 6, 2, 4, no
2949556252,  ApPannace, 6, 3, 3, neutral
2202073456,  AlessiaDoppido, 2, 1, 1, neutral
775801548794363904,  giufascella, 3, 2, 1, yes
347500628,  claudialta, 5, 3, 2, yes
3342581884,  teocorbe, 22, 12, 10, yes
4316205317,  Rosario90255372, 16, 8, 8, neutral
3365947815,  7alasdelalma, 4, 2, 2, neutral
2250146109,  francescafiloc2, 10, 6, 4, yes
573053896,  luciamicci1, 2, 1, 1, neutral
2180545696,  macrimerc, 20, 11, 9, yes
493497596,  sm_Adela, 6, 1, 5, no
3345309321,  Giampie06701097, 18, 9, 9, neutral
738075829540917249,  Geniotopo, 8, 4, 4, neutral
4181848462,  venetoraptor, 10, 5, 5, neutral
408474577,  altSaulin, 4, 2, 2, neutral
483066930,  piranha__64, 6, 3, 3, neutral
3221712009,  albyalbytao, 90, 45, 45, neutral
1138051976,  Roob_en, 2, 1, 1, neutral
96516447,  robertolotito, 40, 11, 29, no
3887691934,  PasdaranFiSud, 39, 20, 19, yes
3324827889,  mazzi_am, 5, 3, 2, yes
396697525,  marciroma, 4, 3, 1, yes
706566447397523456,  oscar_colitti, 2, 1, 1, neutral
4416586894,  Brasilian58, 23, 12, 11, yes
2823221331,  s_minucci, 2, 1, 1, neutral
1261872931,  cescomari, 26, 6, 20, no
3723192855,  HabbajFaouzi, 41, 18, 23, no
2985518519,  46Trento, 2, 1, 1, neutral
3323388298,  Almerin07589759, 2, 1, 1, neutral
779003172803211264,  TARZIALUIGI, 4, 2, 2, neutral
2167116718,  GherardoMarengh, 42, 20, 22, no
118348341,  dany118d, 6, 2, 4, no
464045620,  GianniGatz, 49, 25, 24, yes
1972786862,  MariucciaPoli, 10, 5, 5, neutral
767276669925224449,  IvanPezzei, 5, 3, 2, yes
4382850335,  MassimoPiccion6, 24, 12, 12, neutral
144226252,  niccolo_avico, 7, 2, 5, no
341358459,  ElenaZaccheroni, 8, 4, 4, neutral
778703906356330496,  Jeckfolla, 50, 25, 25, neutral
1593767335,  Manu6667, 10, 5, 5, neutral
4149229876,  erikascotti73, 2, 1, 1, neutral
119678008,  ErnestoPerani, 3, 2, 1, yes
1256727248,  TWs_Laura, 181, 88, 93, no
762774778767892484,  emizarre, 5, 2, 3, no
769434494789091328,  gegeelia, 19, 8, 11, no
802293571693019136,  hikky93, 29, 13, 16, no
215463197,  Giuseppe9191, 4, 2, 2, neutral
733383127381487617,  Alcor48018, 69, 35, 34, yes
791454317945520128,  Viviana_Agliata, 2, 1, 1, neutral
370171470,  RZaZa9, 2, 1, 1, neutral
4415743515,  sufferingNpain, 22, 11, 11, neutral
1022753149,  20rosa20, 4, 2, 2, neutral
515548298,  puntog66, 18, 9, 9, neutral
724630872964665344,  Luigiconti_, 38, 19, 19, neutral
84648241,  quagio, 5, 3, 2, yes
1117740126,  therealsoshow, 2, 1, 1, neutral
4181920601,  GrossiSilvano, 3, 2, 1, yes
739128484937801728,  njkkjn7, 11, 3, 8, no
710801352,  nuovaprovincia, 2, 1, 1, neutral
3424522888,  losgomberotutto, 2, 1, 1, neutral
434285809,  SaFeShark, 2, 1, 1, neutral
179824150,  Anikka_bb, 2, 1, 1, neutral
797134962453581824,  ilBuonGustaio, 43, 16, 27, no
2617684187,  BrupieBruno, 7, 4, 3, yes
3155682418,  ChiodiDonatella, 21, 7, 14, no
298186616,  Rikku_75, 9, 4, 5, no
2234822984,  perlatiziana, 142, 70, 72, no
801393192490991616,  enxotria, 2, 1, 1, neutral
3140224961,  rossmessina70, 12, 6, 6, neutral
2410594372,  bohmahboh, 2, 1, 1, neutral
2566010600,  FABIO_SARACCO, 2, 1, 1, neutral
409859925,  nicodsn, 2, 1, 1, neutral
2523284704,  daniborghi90, 3, 2, 1, yes
314540853,  Spazioalchimia, 10, 4, 6, no
380466302,  Matteo_Cecchin, 50, 24, 26, no
521614836,  CarloTramonte, 4, 2, 2, neutral
1350769627,  MetelloB, 12, 6, 6, neutral
3377670292,  vittoriospadan1, 2, 1, 1, neutral
3434631431,  AzzariaManzoni, 13, 8, 5, yes
2542038342,  rizzo469, 2, 1, 1, neutral
2419860820,  caffetteriaemo, 35, 24, 11, yes
209249028,  SavioFicorella, 27, 10, 17, no
2569113408,  osprey_26, 2, 1, 1, neutral
887496074,  acle1968, 14, 6, 8, no
1071579716,  43ribelle, 32, 5, 27, no
492688472,  augumedici, 148, 73, 75, no
287153306,  HakunaMatata_92, 17, 8, 9, no
63793571,  Minosse70, 2, 1, 1, neutral
438611835,  SusannaNuti, 3, 2, 1, yes
44948272,  SiyaKhula, 150, 75, 75, neutral
3024781929,  ciafapino, 6, 3, 3, neutral
255939314,  saveriodf, 14, 7, 7, neutral
791035487255486464,  francy_marine, 5, 3, 2, yes
216696569,  fernapiensa, 6, 4, 2, yes
189801758,  sliubi, 62, 29, 33, no
3202971339,  CascioliEdoc, 7, 4, 3, yes
1041134352,  pincerijunior, 23, 14, 9, yes
3297871286,  TristoInCroce, 4, 2, 2, neutral
2940755837,  PavMau, 64, 32, 32, neutral
517385690,  NeriRicky, 32, 16, 16, neutral
2249959502,  gpcep, 57, 28, 29, no
3050698037,  FabioDiSomma98, 9, 5, 4, yes
936708194,  libeccio10, 8, 6, 2, yes
3349425333,  susannav888, 94, 47, 47, neutral
778470150336942081,  giuseppeevacuo, 11, 5, 6, no
496758923,  angelocerminara, 6, 3, 3, neutral
4214140767,  giolito_barbara, 12, 6, 6, neutral
977896784,  luca97vr, 4, 2, 2, neutral
2430563386,  taricco77, 4, 1, 3, no
328472277,  angelinozamuner, 2, 1, 1, neutral
304246483,  umbertocsn, 2, 1, 1, neutral
1112852892,  ivan_zatarra, 2, 1, 1, neutral
3290663879,  panunzivalerio, 6, 3, 3, neutral
476555720,  alfiorossi1, 21, 11, 10, yes
2814599326,  chiaram9646, 37, 20, 17, yes
4118952904,  nanofrozen, 6, 3, 3, neutral
191440276,  carloleonardi, 2, 1, 1, neutral
712749671031169024,  DvdBruno13, 6, 3, 3, neutral
766657539710783489,  BarbaraBet71, 9, 4, 5, no
779352002233044992,  dylan1979ct, 2, 1, 1, neutral
707523257,  silvacantatore, 2, 1, 1, neutral
2676171233,  HeldGabriela, 7, 2, 5, no
752526583924199424,  Darione18, 2, 1, 1, neutral
353134095,  edilscik, 3, 1, 2, no
3588666377,  Vale322L, 4, 2, 2, neutral
598650191,  silviabl1975, 33, 10, 23, no
723538495248162820,  RoyalmetalLuigi, 2, 1, 1, neutral
1248046735,  Frances62102409, 8, 5, 3, yes
2843769504,  albegiorvalanga, 52, 14, 38, no
774150166584500224,  Laura63A, 10, 5, 5, neutral
702483762580422656,  NadiaAmatucci, 14, 7, 7, neutral
799826440439156736,  LucretiaFalls, 22, 11, 11, neutral
4594905000,  tenebresally, 4, 2, 2, neutral
486693376,  DavideIanny, 3, 2, 1, yes
94829943,  amorina_m, 2, 1, 1, neutral
2962994278,  tter1518, 3, 1, 2, no
3086183274,  saramazzoni1991, 2, 1, 1, neutral
1101476665,  ElyseeMarine, 16, 11, 5, yes
456269021,  Alexmarcos24, 2, 1, 1, neutral
1184045827,  cassinelligeo, 6, 3, 3, neutral
2973008427,  mariastellacam1, 4, 2, 2, neutral
192253996,  brasileiro64, 28, 14, 14, neutral
1243460706,  lcBerto, 2, 1, 1, neutral
501122229,  Guidotti62, 2, 1, 1, neutral
786616233584058368,  temozzico, 4, 1, 3, no
799540275391725568,  TITTY665, 12, 6, 6, neutral
429730405,  RMichey, 4, 2, 2, neutral
96369798,  BARBARAska, 9, 5, 4, yes
217462618,  1vtnetwork, 2, 1, 1, neutral
737966697399865344,  AndreaPorretti2, 3, 2, 1, yes
1902296190,  bancovalentina, 4, 2, 2, neutral
765453260228624384,  Enrico030359, 6, 3, 3, neutral
3180738496,  truncellito_vet, 2, 1, 1, neutral
123986115,  francomastroces, 4, 2, 2, neutral
1147409647,  fber_1971, 2, 1, 1, neutral
2182476063,  RikGiustozzo, 6, 3, 3, neutral
79770812,  lunablanca38, 2, 1, 1, neutral
1316655810,  doranapolitano, 17, 4, 13, no
55303604,  crisdimarco, 12, 6, 6, neutral
426712009,  valegboy, 23, 9, 14, no
356369571,  Ubirou, 2, 1, 1, neutral
2613937934,  Haragyl, 2, 1, 1, neutral
739250450541776896,  virspeziali, 4, 2, 2, neutral
3183670121,  ElisaSirica, 53, 26, 27, no
2494263560,  jomar680721, 9, 4, 5, no
3000604564,  CaesarVinces, 15, 7, 8, no
965866273,  AspideNero, 6, 4, 2, yes
753290282020511744,  TonyPeloblu, 75, 38, 37, yes
2837751261,  gerundioinnuend, 18, 9, 9, neutral
307401545,  LF_S1000RR, 2, 1, 1, neutral
790164996667871233,  gio_figo, 15, 7, 8, no
478542957,  JakyGio, 2, 1, 1, neutral
531851126,  pinuzzu_sgf, 50, 25, 25, neutral
2816638404,  IrtMEP, 40, 26, 14, yes
435645089,  Amarenapx, 5, 2, 3, no
2896201721,  Lucio_Careddu, 2, 1, 1, neutral
2289758560,  Rota3Anna, 4, 2, 2, neutral
478565327,  RoStan888, 2, 1, 1, neutral
152977521,  pietroforoni, 26, 13, 13, neutral
2862555916,  TLazzareschi, 6, 3, 3, neutral
1357813057,  sascha_saghim, 32, 15, 17, no
727517052991365120,  KIachetti, 6, 3, 3, neutral
509309634,  l_zoni, 40, 23, 17, yes
393504284,  BenignoVincenzo, 3, 1, 2, no
454902762,  giusgal, 2, 1, 1, neutral
2236761742,  sancono65, 22, 8, 14, no
437023656,  AnnaCavani, 4, 1, 3, no
3395459769,  ArelloPonch, 7, 3, 4, no
504684904,  HELLB3NT, 2, 1, 1, neutral
2226243518,  StefanoAglio, 8, 3, 5, no
1539407683,  strofuggi, 18, 9, 9, neutral
765687122,  MarcoLenna, 2, 1, 1, neutral
1629008389,  domenicopav, 4, 2, 2, neutral
4768064356,  Pasqual87159647, 6, 2, 4, no
916860277,  BGandiglio, 4, 2, 2, neutral
713292127179026433,  Pendracon, 5, 3, 2, yes
1695650172,  DASSASSINKILLER, 2, 1, 1, neutral
1655773190,  GabrieleCattafi, 2, 1, 1, neutral
305495015,  PietroCiardullo, 2, 1, 1, neutral
740801817555132416,  alecinini, 2, 1, 1, neutral
4221740495,  FabioRossi86, 2, 1, 1, neutral
1925940440,  halnovemila2, 5, 2, 3, no
397503087,  AttilioGhezzi, 6, 3, 3, neutral
2434465310,  idagarberi, 4, 1, 3, no
732899817232433152,  Marino81700713, 2, 1, 1, neutral
3073624366,  tommy_rimini, 6, 1, 5, no
327406661,  SalviniSciacall, 26, 13, 13, neutral
315798667,  Ilarycarraro, 18, 9, 9, neutral
1360056336,  Giorgiana_style, 2, 1, 1, neutral
807395898,  monica13761, 2, 1, 1, neutral
758530712953847808,  jessikahro, 4, 2, 2, neutral
54017862,  sdcaridi, 4, 2, 2, neutral
492663789,  GiulianFaggio, 11, 7, 4, yes
2319333378,  Mikymod59, 2, 1, 1, neutral
2752031038,  Simo_netta_, 7, 4, 3, yes
467274250,  giulymuratori, 7, 3, 4, no
2197620432,  mbartolotta63, 20, 9, 11, no
3851130916,  boixor, 2, 1, 1, neutral
4210012725,  primoelisir, 3, 2, 1, yes
398953619,  zebodo47, 55, 28, 27, yes
3262227694,  zaninifz_, 2, 1, 1, neutral
778386953846816769,  vicdec78, 6, 3, 3, neutral
804058015,  Tarchezio, 10, 6, 4, yes
1220811823,  faber65c, 4, 2, 2, neutral
50548118,  ohworriesme, 2, 1, 1, neutral
510153160,  francescocazzol, 2, 1, 1, neutral
151004331,  snortz76, 2, 1, 1, neutral
467773429,  RossoRiccardo, 2, 1, 1, neutral
2348760096,  MarcoCamillieri, 5, 2, 3, no
611831585,  Roditoptimum, 6, 3, 3, neutral
731346214030069760,  zannidebora, 4, 2, 2, neutral
1917393390,  1966Fantozzi, 2, 1, 1, neutral
2216513304,  CristianDutto, 2, 1, 1, neutral
754728875054227457,  gianniborrelli6, 2, 1, 1, neutral
713429269490302976,  robertosimbolin, 8, 2, 6, no
2273516571,  ilbarone1967, 10, 5, 5, neutral
746986333877469184,  cataur76, 2, 1, 1, neutral
2466650316,  PascucciMC, 36, 18, 18, neutral
326854012,  Edoenonsolo, 13, 6, 7, no
2210129207,  guido_63, 2, 1, 1, neutral
2387816981,  RossanaTrevisio, 9, 4, 5, no
3050183838,  criccicracci, 18, 9, 9, neutral
534762823,  emaonofrini, 2, 1, 1, neutral
1266810164,  ildiopside, 2, 1, 1, neutral
325704431,  pedro_vikinger, 2, 1, 1, neutral
802621800471547904,  lorenzoleghista, 2, 1, 1, neutral
2465494691,  sandra_grimoldi, 3, 2, 1, yes
723515120035438592,  O_Mar_Bubu, 2, 1, 1, neutral
2327856352,  LucaBielli, 2, 1, 1, neutral
521589863,  AlfonsoZito, 7, 5, 2, yes
1186603358,  GCloStli, 47, 20, 27, no
1034897761,  micos60, 34, 16, 18, no
473447862,  GaspariniSonia, 4, 2, 2, neutral
2819864679,  CrispyMcBacca, 8, 7, 1, yes
724463656990289921,  ekaterinaprofne, 2, 1, 1, neutral
877816116,  FrancescoB_93, 4, 2, 2, neutral
239328110,  supercalu77, 8, 4, 4, neutral
820278757,  MicheRossi97, 2, 1, 1, neutral
795274753007357953,  CarloArno3, 2, 1, 1, neutral
377430097,  grancetto, 28, 12, 16, no
489757182,  DBarbaresco, 6, 3, 3, neutral
2316954791,  Mazi1970, 4, 2, 2, neutral
1272137623,  antospi1973, 15, 7, 8, no
759028735739854849,  Daniela191049, 2, 1, 1, neutral
2206299803,  vittori_fabio, 12, 6, 6, neutral
3331168031,  Marco_Samp, 3, 2, 1, yes
3315808409,  Manu_angels2012, 12, 6, 6, neutral
3859630461,  livelifeVale, 18, 8, 10, no
2768212373,  _st31975_, 24, 12, 12, neutral
88215646,  Piggi95, 4, 3, 1, yes
3784465997,  Alberto14481004, 7, 6, 1, yes
705631911473864710,  siriogg, 4, 2, 2, neutral
464477643,  Luca_Sxa, 6, 3, 3, neutral
416583838,  melinacugliari, 27, 13, 14, no
3385890497,  claudeferr, 7, 5, 2, yes
435072776,  nicolasoncini1, 2, 1, 1, neutral
775028523622957056,  RogerbarAD, 4, 2, 2, neutral
1079446351,  Eliseop53, 16, 7, 9, no
4902025942,  LovinEdwards, 2, 1, 1, neutral
555105841,  oio__, 2, 1, 1, neutral
3238930005,  feb6bdff277d49e, 3, 1, 2, no
4914382227,  LibrandiShow, 7, 4, 3, yes
705518691606241280,  Evaluna7716, 2, 1, 1, neutral
549983968,  francescosarto6, 4, 2, 2, neutral
1675750346,  pataamore, 2, 1, 1, neutral
81646967,  AndiNeglia, 14, 8, 6, yes
419301945,  Carcor48, 4, 2, 2, neutral
2376425926,  GuidiSveva, 6, 3, 3, neutral
146779176,  Memetchi95, 2, 1, 1, neutral
40131385,  IacobitaCristi1, 13, 1, 12, no
3568595656,  ItaLianovery, 18, 9, 9, neutral
703674148309098496,  santmikela2, 10, 5, 5, neutral
2447487589,  Silvio4ever, 2, 1, 1, neutral
534375344,  STELOMBARDIFIM, 5, 2, 3, no
496028168,  ChristelVanessa, 12, 6, 6, neutral
478092818,  ETogno, 29, 15, 14, yes
380294340,  PCeccherelli, 8, 4, 4, neutral
3909974067,  soc_rep, 4, 2, 2, neutral
715130347852283905,  SalvatoreUsai3, 9, 4, 5, no
500602731,  mauriziobanimic, 8, 2, 6, no
2299766748,  cunilingus12, 39, 16, 23, no
390151086,  LELLOX46, 10, 5, 5, neutral
2180547666,  Magilla7, 5, 4, 1, yes
2501994231,  varini_chiara, 3, 2, 1, yes
729301866555805699,  sandro954gmail1, 18, 10, 8, yes
2970206104,  100dr1ne, 15, 10, 5, yes
1719985794,  coruccina, 11, 5, 6, no
825507122,  KirolosMater, 2, 1, 1, neutral
1121815128,  VinceCiani, 5, 3, 2, yes
2830900625,  fafailgrande, 15, 5, 10, no
3149053143,  telese3131, 9, 3, 6, no
113085788,  Petrox17, 2, 1, 1, neutral
2622854943,  DarioEssedi, 10, 5, 5, neutral
2767295512,  FenjiHugMe_, 3, 1, 2, no
412512533,  corstefi, 4, 2, 2, neutral
1260518365,  _A_mors, 14, 8, 6, yes
46151945,  QuondamB, 2, 1, 1, neutral
3242769959,  StadekrCthulhu, 2, 1, 1, neutral
877388786,  unGiofane, 2, 1, 1, neutral
52335591,  killerbonz, 2, 1, 1, neutral
417265094,  ritadalpastro, 12, 6, 6, neutral
802653438555422720,  Frances88656599, 6, 3, 3, neutral
803341746021298176,  joxm75, 2, 1, 1, neutral
764028498,  marcofromtower, 2, 1, 1, neutral
444063000,  BandyCrash, 16, 8, 8, neutral
2435797378,  e70693639, 2, 1, 1, neutral
1008915913,  angelaarmenise, 2, 1, 1, neutral
2765059581,  lorenzo_ronco, 10, 5, 5, neutral
565397449,  al3xgu3rra, 2, 1, 1, neutral
498439069,  romanofromitaly, 6, 5, 1, yes
455126171,  UnNueveDosSeis, 6, 4, 2, yes
1389470912,  GSaletnich, 2, 1, 1, neutral
3029285000,  SenesiSergio, 5, 2, 3, no
1527989558,  matrixepoque, 6, 3, 3, neutral
779077333,  andreactrl, 30, 14, 16, no
70969814,  CialeX, 10, 5, 5, neutral
367692964,  adrenaly1, 52, 21, 31, no
3240851836,  GionatanScorza, 3, 2, 1, yes
468441125,  egopor, 2, 1, 1, neutral
335970439,  dluis83, 2, 1, 1, neutral
2396933202,  TheOneSlimShady, 2, 1, 1, neutral
3147058299,  Simo94LP, 2, 1, 1, neutral
2921663680,  ellavandini, 5, 2, 3, no
439487431,  Be_ll_atrice, 12, 5, 7, no
737750588247658496,  GuattaRus89, 8, 4, 4, neutral
714373889204350976,  antonioiuzzolin, 2, 1, 1, neutral
1198029061,  Pinkspacca, 14, 7, 7, neutral
390313526,  mazzucchim, 4, 2, 2, neutral
2492666427,  RegiFre, 2, 1, 1, neutral
2909545485,  BongiornoAlex, 2, 1, 1, neutral
380508321,  Minetz75, 4, 2, 2, neutral
797812715859406848,  molim_, 3, 1, 2, no
3304067812,  luibert37, 4, 2, 2, neutral
2156010480,  bianchinigiusep, 2, 1, 1, neutral
708901838792294400,  RobertoConte19, 2, 1, 1, neutral
2335372808,  buch_1977, 65, 23, 42, no
783740711652978688,  Cangio44, 5, 2, 3, no
756866515,  y_caselli, 3, 2, 1, yes
404987270,  antonio250755, 9, 4, 5, no
734317977546424320,  carlos_del77, 2, 1, 1, neutral
2523613014,  MIRICA1955, 5, 2, 3, no
311434296,  MFondelli, 8, 4, 4, neutral
216308253,  giovannitoma, 7, 1, 6, no
708307156190232581,  BrunaBellavist1, 6, 3, 3, neutral
779645231285301248,  Anto_Casadei, 43, 18, 25, no
621972312,  CHVNELXII, 22, 12, 10, yes
784691339732586496,  MDolce48, 8, 4, 4, neutral
3129780759,  followforchats, 2, 1, 1, neutral
4588875797,  lord_crichton, 2, 1, 1, neutral
137954777,  markchierici, 3, 1, 2, no
804953334000001024,  KnijRob, 8, 4, 4, neutral
419544789,  VioleMore, 3, 1, 2, no
3047536495,  valentixy, 2, 1, 1, neutral
489275706,  Frpaolo66, 2, 1, 1, neutral
723545425958064128,  CorsinoMichele, 2, 1, 1, neutral
4154714363,  NughesAdriana, 20, 9, 11, no
589611827,  Belgium1649, 2, 1, 1, neutral
4704298732,  PigozziMauro, 4, 2, 2, neutral
4516116863,  Frances21907453, 17, 9, 8, yes
2920441331,  Ilfarnese, 3, 1, 2, no
59564555,  emanuelesecco, 30, 16, 14, yes
2725713106,  VSpadetto, 4, 2, 2, neutral
3436645745,  EArgentesi, 4, 2, 2, neutral
704270968252923904,  OcchettiBruno, 4, 2, 2, neutral
1090294315,  ted1929, 4, 2, 2, neutral
1157534816,  EugeniaTimpano, 27, 12, 15, no
4540267581,  f8823d21ddd249d, 30, 15, 15, neutral
2574266145,  laura_petrulli, 144, 70, 74, no
127599374,  mirkoromitelli, 8, 4, 4, neutral
2973007930,  cleofi263, 8, 4, 4, neutral
487072631,  Marco__Cipriano, 2, 1, 1, neutral
4759055535,  marysica62, 17, 9, 8, yes
2962967535,  MaryGuida_99, 2, 1, 1, neutral
3089580527,  _sabrina_sweet, 12, 6, 6, neutral
2473053800,  LucianoRugby90, 12, 6, 6, neutral
4567966949,  NicolettaFiore6, 4, 3, 1, yes
743971027248635904,  Ereticho, 2, 1, 1, neutral
729205752582307841,  MariaPauri, 2, 1, 1, neutral
803867149831995392,  GianlucaVadi, 6, 3, 3, neutral
754423644764381184,  padano1000, 2, 1, 1, neutral
1718496192,  cla_05_, 2, 1, 1, neutral
272842856,  FedericaFor, 30, 15, 15, neutral
3338655335,  paola_amb, 2, 1, 1, neutral
3107574627,  Fprime86, 226, 113, 113, neutral
1642455607,  BerlusconiStop, 11, 7, 4, yes
469714034,  mauriziodiflori, 2, 1, 1, neutral
3435285941,  tlisa709, 4, 2, 2, neutral
2452624252,  Tammyuff, 4, 2, 2, neutral
805351501568811008,  bertusciolze, 4, 2, 2, neutral
2941965455,  bartolidanieli, 15, 8, 7, yes
468286215,  AlessandraVal28, 4, 2, 2, neutral
499672556,  IlSilliDiPrato, 5, 2, 3, no
2352401171,  Niceaml, 8, 5, 3, yes
3047493292,  paneecicoria, 11, 5, 6, no
159845118,  sgviti, 3, 2, 1, yes
3186232611,  marialuongo49, 6, 3, 3, neutral
747978554638483456,  antonio75an, 2, 1, 1, neutral
1293004566,  menassi_marco, 10, 5, 5, neutral
720880802939023360,  Cristian72TO, 54, 27, 27, neutral
860350934,  jiff00, 9, 3, 6, no
996978686,  JL83X, 5, 2, 3, no
41673935,  joerack, 4, 2, 2, neutral
198869860,  joy092010, 10, 7, 3, yes
72069290,  davicecy, 2, 1, 1, neutral
3881628269,  andreapisax, 2, 1, 1, neutral
410312678,  di_sanza, 2, 1, 1, neutral
215355651,  ross1570, 14, 7, 7, neutral
739209087427055617,  DarrenMorrisMGS, 5, 2, 3, no
3005907718,  SuaSignoria, 7, 3, 4, no
756897730069405696,  Maurizio_Cervia, 8, 4, 4, neutral
4743284837,  LisadeClugny, 3, 1, 2, no
803770735957344262,  danilotumatis, 28, 16, 12, yes
855012044,  NicolaGiove2, 14, 9, 5, yes
1106446418,  LuisaWagner7, 4, 2, 2, neutral
476063450,  MiraiNoTenshi, 4, 2, 2, neutral
787324638711939073,  CettinaZimmardi, 2, 1, 1, neutral
594777484,  arusso414, 10, 4, 6, no
1286924108,  carabini20, 6, 3, 3, neutral
52703133,  acimbrico, 2, 1, 1, neutral
609075599,  massimostazi, 6, 2, 4, no
305869411,  ArtEC_DIY, 2, 1, 1, neutral
445050879,  FrancoValle2, 11, 8, 3, yes
4330217543,  VittorioAddona, 2, 1, 1, neutral
769600830567776256,  nicocolo2003, 4, 2, 2, neutral
13307732,  FeniceArde, 2, 1, 1, neutral
2218349510,  christian_trix, 7, 3, 4, no
347360615,  marramaxdriver, 6, 3, 3, neutral
200091336,  fnc40, 14, 6, 8, no
585999327,  FlaviaMonami, 52, 27, 25, yes
1096333074,  MadameVastra7, 4, 2, 2, neutral
4600455197,  annapia_lir, 2, 1, 1, neutral
425254477,  vitocontesi, 14, 6, 8, no
579321714,  robertomauri23, 2, 1, 1, neutral
4874754473,  ERazzani, 16, 4, 12, no
2380329507,  zamboland, 2, 1, 1, neutral
421795843,  rubinoantonio1, 2, 1, 1, neutral
215593566,  Salvatore_1991, 5, 1, 4, no
2978044079,  GelonesePaola, 4, 2, 2, neutral
354003815,  raoulrusso, 11, 4, 7, no
2960484382,  Yper_Patridos, 16, 8, 8, neutral
537202185,  DavideFranchi78, 2, 1, 1, neutral
1065656172,  RitaCosenza, 2, 1, 1, neutral
2886244253,  zisaoscar, 2, 1, 1, neutral
1122590965,  LuigiMalcangi, 2, 1, 1, neutral
2580666506,  MauroCattaneo77, 8, 4, 4, neutral
1336027495,  rastef58, 39, 17, 22, no
1600625269,  Enzo_Bellini, 2, 1, 1, neutral
2277863537,  mimmoguarino83, 49, 25, 24, yes
786333824431034368,  Gigi97540577, 6, 3, 3, neutral
1114354382,  roccodileo3, 13, 5, 8, no
1550227219,  AnnaVanDensky, 4, 2, 2, neutral
3025012821,  gianchialfred, 9, 4, 5, no
555202047,  MarkStrobe, 4, 2, 2, neutral
707978044179410944,  ContentaWalter, 10, 4, 6, no
4794768816,  deezturbo, 2, 1, 1, neutral
2926855889,  zukko66, 2, 1, 1, neutral
746691972459597824,  VinciDibi, 57, 26, 31, no
2763710169,  gjokhilani10, 2, 1, 1, neutral
151983347,  CALEMANR, 13, 11, 2, yes
3079246066,  NeroneroNerox, 11, 5, 6, no
787069568086867968,  sarazaia2420, 20, 10, 10, neutral
1623047287,  Punpun_89, 2, 1, 1, neutral
378862775,  paololozzi, 2, 1, 1, neutral
726121006981599233,  EllyCalvi, 12, 6, 6, neutral
1543776763,  SalviniMichele, 8, 4, 4, neutral
384736805,  marcodefazi, 2, 1, 1, neutral
439492540,  Dan_Siracusano, 2, 1, 1, neutral
2955148689,  Marine2017_Off, 28, 10, 18, no
418820343,  blacklabel_76, 4, 2, 2, neutral
775563174477238272,  stebikeMilano, 5, 1, 4, no
1238556302,  GabrieleMarroni, 4, 2, 2, neutral
2887988230,  Ale79Friul, 20, 11, 9, yes
2717738283,  mercurioricotta, 2, 1, 1, neutral
2840588789,  antonio11921, 3, 2, 1, yes
779388069921292288,  Dhebora1980, 12, 6, 6, neutral
361189915,  PeroneG, 2, 1, 1, neutral
941041278,  paoliblu, 13, 7, 6, yes
1048605840,  altamura63, 14, 4, 10, no
872497166,  Tonino775, 93, 42, 51, no
2737037620,  RaffyTrilli, 4, 1, 3, no
797871034535936004,  aurelio327, 27, 4, 23, no
4129880776,  BoffanoRiccardo, 2, 1, 1, neutral
790620156963725312,  MerlinEleonora1, 18, 9, 9, neutral
381443107,  eugenio_zoffili, 7, 4, 3, yes
190688480,  CervoVolante, 9, 3, 6, no
1872310844,  BenjogattoLaura, 2, 1, 1, neutral
756972694571249668,  rocco542253051, 2, 1, 1, neutral
804410479540105217,  StefanoMerli4, 36, 18, 18, neutral
3119915485,  matteopagano94, 9, 5, 4, yes
2513230784,  giuroc80, 12, 6, 6, neutral
1930820899,  cds1056, 7, 2, 5, no
2409081446,  proudofpupi, 12, 6, 6, neutral
48334852,  MarkAlright, 3, 2, 1, yes
2303516735,  Trumpapper, 9, 7, 2, yes
157294500,  Super_Niky, 2, 1, 1, neutral
253262674,  BSaltamartini, 6, 3, 3, neutral
300155922,  FbBss, 2, 1, 1, neutral
793115977634484225,  vitolillo5, 3, 1, 2, no
773892322618707968,  EmanueleCellin1, 4, 2, 2, neutral
3862091481,  avv_puiatti, 6, 3, 3, neutral
796067064322605057,  SantucciFabi, 2, 1, 1, neutral
2549528592,  BobbiaOdille, 31, 12, 19, no
718086134526509057,  menucciola22, 2, 1, 1, neutral
714792860185403393,  PausaDigitale, 2, 1, 1, neutral
362609843,  claritajl_, 2, 1, 1, neutral
1591649336,  gallantim77, 2, 1, 1, neutral
773378492,  nicoroty_22, 16, 9, 7, yes
803603579705638912,  _Milkobitch_, 2, 1, 1, neutral
3123304071,  IPaolorinaldi, 8, 4, 4, neutral
2780354471,  luigi_pompili, 9, 6, 3, yes
280057090,  marisa66666, 3, 2, 1, yes
423392002,  AntonioFerrulli, 4, 2, 2, neutral
2800443747,  nicola99baldan, 22, 10, 12, no
750266696712192000,  mauriziotir1957, 2, 1, 1, neutral
582087196,  dalilello, 37, 8, 29, no
733681649133727744,  GxPila, 2, 1, 1, neutral
2941915384,  emillyele, 54, 27, 27, neutral
83708002,  paolo_fra, 2, 1, 1, neutral
3339145601,  umbertowp, 2, 1, 1, neutral
4657932088,  EmilioDebilio, 10, 5, 5, neutral
762637499428634625,  Matilde1270141, 4, 1, 3, no
773325167871287297,  kelerofonte, 21, 10, 11, no
1713526081,  FRIEVNDS, 2, 1, 1, neutral
1387672303,  FrescobaldaLa, 2, 1, 1, neutral
65377234,  thickofiter, 28, 15, 13, yes
3125051404,  Rebycini, 4, 2, 2, neutral
765987592621985792,  Deisterlinchen1, 2, 1, 1, neutral
1385654450,  Scquickk, 2, 1, 1, neutral
3432222799,  Elizabe55910681, 2, 1, 1, neutral
801917828999876608,  TommasoMalva, 4, 2, 2, neutral
250140879,  Gradabba, 6, 3, 3, neutral
477678790,  FraStems, 2, 1, 1, neutral
1230871339,  lucas04106001, 17, 8, 9, no
3031452981,  elefury66, 2, 1, 1, neutral
359244949,  richardblk72, 2, 1, 1, neutral
3326977335,  dajesempre, 2, 1, 1, neutral
477276020,  giuliathielen, 2, 1, 1, neutral
2205011249,  GianpieraRasell, 9, 4, 5, no
228485207,  LucianoGenna, 8, 4, 4, neutral
216292667,  ortomaria, 4, 2, 2, neutral
4735423054,  elvialorena50, 20, 9, 11, no
2355147860,  AntonioDomenic, 27, 1, 26, no
85543043,  CarloMartootchy, 9, 5, 4, yes
3715252995,  marlor8301, 3, 2, 1, yes
799987025055256576,  Gigione7471, 4, 2, 2, neutral
402287600,  salvatorecalle1, 5, 3, 2, yes
1003775976,  poste44, 12, 6, 6, neutral
706005164,  rossomaltese, 7, 4, 3, yes
707543821157060608,  sovietkalinka, 2, 1, 1, neutral
2156027566,  ZanardiIlaria, 2, 1, 1, neutral
485987608,  Deboranna79, 11, 6, 5, yes
2843635689,  fra8084, 33, 19, 14, yes
4241045812,  diogene1962, 6, 3, 3, neutral
1238596208,  azzurrantonella, 3, 1, 2, no
366829401,  massimomiami, 2, 1, 1, neutral
478758338,  biondi_danilo, 6, 3, 3, neutral
1042935356,  leleilenia, 6, 3, 3, neutral
796342608700329985,  338_475, 5, 3, 2, yes
560468376,  bilspa, 16, 8, 8, neutral
585391357,  Gabrymalvagia, 35, 19, 16, yes
719146013823537152,  trudu_g, 6, 3, 3, neutral
466853614,  stefano1x79, 10, 5, 5, neutral
725817874602971136,  sghsihhf, 21, 7, 14, no
1000168753,  TuriniPopy06, 2, 1, 1, neutral
421211268,  borgoblue, 2, 1, 1, neutral
2634622329,  auroraman45, 6, 2, 4, no
783021147025793024,  Fabrifiori68_Ul, 4, 2, 2, neutral
2486949783,  3347900969, 6, 4, 2, yes
802137771678830592,  Pietro93284272, 2, 1, 1, neutral
3022216966,  RenzoArgo, 2, 1, 1, neutral
199290543,  YuriVBud, 6, 3, 3, neutral
767698418869428227,  bolzo_73, 5, 3, 2, yes
754250997267070981,  Marco91242087, 4, 2, 2, neutral
2544520294,  armanni0803, 2, 1, 1, neutral
832016611,  luigiiorio5, 6, 4, 2, yes
465046516,  calmoore79, 21, 19, 2, yes
1135414339,  EbBarboni, 4, 2, 2, neutral
187725799,  suchsteefat, 3, 1, 2, no
37907656,  edonis28, 7, 6, 1, yes
119006593,  Girolata20, 6, 3, 3, neutral
2186181725,  erfanfa75, 20, 12, 8, yes
2469092594,  Margherita_PPP, 6, 3, 3, neutral
1646281124,  AValvecchia, 19, 9, 10, no
989463211,  donatellasargen, 2, 1, 1, neutral
3568909456,  Avarello97, 4, 1, 3, no
3079488179,  itscyb, 5, 1, 4, no
635965789,  emiliotosti, 2, 1, 1, neutral
552086712,  Alcatizzone, 2, 1, 1, neutral
4822490579,  tirittittina, 25, 12, 13, no
3053979329,  ElenaOrsi76, 20, 4, 16, no
548335017,  emanuela_bossi, 9, 5, 4, yes
3072664510,  adrianopescaro1, 28, 14, 14, neutral
782622314261196800,  ediononsono, 17, 5, 12, no
805110136180183041,  Commentibus, 3, 2, 1, yes
47368925,  SZ88, 17, 8, 9, no
1931211852,  jensenfreakles, 2, 1, 1, neutral
456756618,  paolorossetti5, 2, 1, 1, neutral
259401999,  AlColasanti, 8, 3, 5, no
89740178,  DavideDrummer, 4, 3, 1, yes
4536320183,  fabriclaclu, 2, 1, 1, neutral
2981533685,  simonacenni, 2, 1, 1, neutral
728612934780358656,  FTerzappi, 6, 3, 3, neutral
453385088,  dipietra_ntonio, 6, 5, 1, yes
379790982,  clik_33, 2, 1, 1, neutral
1830332768,  SergioSavini1, 2, 1, 1, neutral
3070700175,  ndiiorio1, 12, 7, 5, yes
230319200,  cuore22, 12, 7, 5, yes
391279725,  reaman62, 17, 7, 10, no
2867741256,  ugogau, 2, 1, 1, neutral
4243748615,  Alvara67931120, 18, 9, 9, neutral
3015157240,  13eab05765e7451, 2, 1, 1, neutral
395972330,  MassimoAureli, 2, 1, 1, neutral
716631581448867840,  RobyToniRoss, 2, 1, 1, neutral
1328771652,  MatteoSantesso, 2, 1, 1, neutral
1129108278,  CuorediStella, 2, 1, 1, neutral
1522696946,  FraEry8285, 4, 2, 2, neutral
452278230,  FrancescoFivoli, 2, 1, 1, neutral
107005208,  garriele, 2, 1, 1, neutral
799330116027424768,  amedeo_avondet, 5, 3, 2, yes
465867767,  emanueldistafan, 2, 1, 1, neutral
1621271780,  seby_campisi, 2, 1, 1, neutral
2837876374,  trumpservative, 20, 8, 12, no
538690655,  vittorio562078, 2, 1, 1, neutral
331047338,  fabriziohola, 13, 6, 7, no
233643506,  YakovTW, 2, 1, 1, neutral
836273832,  ATurri, 3, 2, 1, yes
729433847398584320,  AnnaYefreni, 14, 7, 7, neutral
3346047160,  AntonioFL97, 29, 14, 15, no
4888398719,  1900maurizio, 6, 3, 3, neutral
2897529063,  PulaWerther, 10, 5, 5, neutral
433537217,  glotwe, 2, 1, 1, neutral
3374111835,  assadr49, 6, 3, 3, neutral
550162323,  hazisflawless, 2, 1, 1, neutral
624359831,  tossina_libera, 23, 8, 15, no
1007092986,  giovanna_edv, 2, 1, 1, neutral
45802866,  rionero11, 2, 1, 1, neutral
758327439558836224,  Valentina7vale, 165, 83, 82, yes
722503050267594752,  poliriccardoo, 2, 1, 1, neutral
591724334,  GianZlatan92, 2, 1, 1, neutral
236362651,  LegaNordMilano, 4, 2, 2, neutral
785591108419981314,  domenicacocuzz1, 13, 7, 6, yes
800969617082552320,  Ketty57664851, 14, 3, 11, no
787062536894021633,  emma48394327, 2, 1, 1, neutral
788301440733315072,  Roberto82262857, 6, 3, 3, neutral
805387616921284608,  francotestoni5, 3, 1, 2, no
4439231793,  CanginilucaLuca, 19, 7, 12, no
448364257,  SimonaBordonali, 16, 8, 8, neutral
3152685730,  2f78f60fdec34ed, 4, 2, 2, neutral
396467960,  RiccardoFurfaro, 2, 1, 1, neutral
733548280424992772,  pantapaola61, 2, 1, 1, neutral
564160458,  Anna93ACMilan, 8, 4, 4, neutral
2343993217,  GiorgioBuquik, 8, 2, 6, no
48687119,  andrealufino, 11, 5, 6, no
3436590851,  GrianneOhmsfor1, 4, 3, 1, yes
4894953053,  dearfrancy00, 2, 1, 1, neutral
1032653606,  francescogussag, 2, 1, 1, neutral
3362139339,  Amedeo_Ferrauto, 10, 5, 5, neutral
4188287956,  GioGio92157704, 8, 4, 4, neutral
709632381825761280,  P_7_R, 4, 2, 2, neutral
3368379478,  Chiara__alba, 2, 1, 1, neutral
3559795402,  Mirko14030168, 4, 2, 2, neutral
841214047,  Tonio05934859, 8, 4, 4, neutral
979960242,  mauri1brescia, 17, 6, 11, no
476910619,  BostonGeorge270, 2, 1, 1, neutral
626877418,  raffi_fr, 2, 1, 1, neutral
549105829,  romolobenedetti, 5, 4, 1, yes
2156339147,  br1daq, 2, 1, 1, neutral
708968225111937024,  elycoltro, 10, 5, 5, neutral
1712656224,  TommasoSchembri, 4, 2, 2, neutral
751515465017679872,  yukomishima2, 2, 1, 1, neutral
493464041,  BeppeViso, 4, 3, 1, yes
1607656196,  generazionenord, 2, 1, 1, neutral
51372388,  lucio_brignoli, 8, 6, 2, yes
2865271140,  barbarafiorito3, 4, 2, 2, neutral
489546240,  saverioontwitt, 17, 7, 10, no
2865768750,  AnnaNardi56, 2, 1, 1, neutral
714101389,  97Giorgiodeluca, 11, 10, 1, yes
2868772072,  f_passerini94, 10, 5, 5, neutral
251509876,  lingiuz, 5, 3, 2, yes
104919938,  benedettiangio, 28, 14, 14, neutral
2238825739,  blueskyg22, 2, 1, 1, neutral
1071858956,  Lilly_Gozzoli, 8, 4, 4, neutral
534584338,  LadyGaga_Art_, 2, 1, 1, neutral
556328289,  serenatrinetta, 4, 1, 3, no
962153256,  mariovella3, 4, 2, 2, neutral
463147024,  Brunoinimer, 3, 2, 1, yes
2851592991,  Max13Mo, 6, 3, 3, neutral
3083498056,  orsinifederico1, 4, 2, 2, neutral
3394261233,  peppe_alagna, 35, 9, 26, no
2928096323,  land4eve, 35, 19, 16, yes
109226009,  Banf85, 6, 1, 5, no
2346769999,  marco4bi, 6, 3, 3, neutral
97199591,  AndreaDianetti, 2, 1, 1, neutral
756853522155638784,  toninoriccardi, 2, 1, 1, neutral
2186975672,  GERMYG65, 8, 4, 4, neutral
1074786902,  gianlucamoena, 4, 2, 2, neutral
753932769147912193,  missmichela19, 3, 1, 2, no
99481346,  Detchoide, 4, 2, 2, neutral
2492853221,  EnricoMossa79, 6, 3, 3, neutral
437493841,  BerettaMattia, 4, 2, 2, neutral
329600452,  antonio4666, 9, 2, 7, no
451483593,  ste78bez, 33, 19, 14, yes
3869948417,  hatley1967, 2, 1, 1, neutral
430095245,  fpezzellacapri, 2, 1, 1, neutral
388719284,  TeleradioNews, 2, 1, 1, neutral
1082618420,  ManueleBua, 2, 1, 1, neutral
800650112,  pzappatore, 3, 1, 2, no
29185148,  maxmilian, 5, 3, 2, yes
538761354,  pippavincenzo, 4, 2, 2, neutral
495277374,  RobertoMaroni_, 8, 4, 4, neutral
2501546732,  bd103018a6b241c, 4, 2, 2, neutral
325016758,  VeronicaRosazza, 3, 2, 1, yes
1440369276,  gambuzzaannunzi, 3, 1, 2, no
797411651670708224,  benedettilucy56, 2, 1, 1, neutral
2351850546,  Dory09347702, 16, 9, 7, yes
576669912,  gianfrancocapo1, 5, 2, 3, no
597464121,  CambaGigi, 7, 6, 1, yes
401450487,  AvvGiuseppe, 2, 1, 1, neutral
3020271189,  PollonSuper, 24, 12, 12, neutral
2334034163,  santos35695291, 3, 1, 2, no
701156077778427905,  gipa23, 2, 1, 1, neutral
312963871,  albevannucci, 6, 3, 3, neutral
3763074677,  LasiAlessandro, 4, 2, 2, neutral
2839533015,  DPizzetta, 8, 4, 4, neutral
2879472009,  maurizanaboni, 12, 6, 6, neutral
4460750969,  1981Harvest, 10, 5, 5, neutral
1088498461,  tibursuperbum49, 28, 14, 14, neutral
2359323311,  expomau, 11, 4, 7, no
3676997313,  foxislovy, 28, 14, 14, neutral
4188419789,  LucaPepi1997, 2, 1, 1, neutral
1926958856,  Orlandi4Orlandi, 2, 1, 1, neutral
736363884815212544,  rascatore69, 6, 3, 3, neutral
795022163594137600,  ennio1955, 4, 2, 2, neutral
1566803234,  FedericaFlajani, 29, 14, 15, no
2311884130,  AndreaM15990623, 2, 1, 1, neutral
128855697,  the_bud_ita, 5, 4, 1, yes
849727410,  RaffaellaFacci1, 8, 4, 4, neutral
709427870419062784,  Paolino_maioli, 42, 17, 25, no
2376897325,  RobertoP009, 16, 8, 8, neutral
4784066715,  Mamoziocag8, 8, 4, 4, neutral
3384511240,  ChryssIorio, 31, 14, 17, no
786909552906268672,  GIOBIS49, 5, 2, 3, no
2938095405,  GlandeSaggio, 8, 4, 4, neutral
3990076173,  tsken_, 2, 1, 1, neutral
791269727830237184,  Ambra76321544, 11, 3, 8, no
768341665862082560,  BeatricePanetto, 30, 15, 15, neutral
1580199242,  MCusma, 24, 12, 12, neutral
738604906114748417,  MarisaDenaro71, 13, 7, 6, yes
721463115955748865,  kudrjashov_acra, 2, 1, 1, neutral
1536031052,  MatteoZorin, 4, 2, 2, neutral
785913407803428865,  francescanat20, 2, 1, 1, neutral
221413552,  SusannaTrippa, 2, 1, 1, neutral
318601197,  EAlessandroni, 14, 4, 10, no
1054799845,  Petrix166, 4, 2, 2, neutral
764045603777155072,  Jay_Scipione, 4, 2, 2, neutral
4229339626,  mugugnoge, 3, 2, 1, yes
805820811890278400,  Giovannagiogii, 2, 1, 1, neutral
133373778,  AlessioColzani, 199, 100, 99, yes
636355979,  CasazzaDavide, 6, 3, 3, neutral
374516440,  anbenciv, 2, 1, 1, neutral
3291919205,  davide_serie1, 8, 4, 4, neutral
3047652054,  ZeroIsTheAnswer, 26, 13, 13, neutral
607517520,  napulegno79, 47, 25, 22, yes
521583209,  gigliottienrico, 2, 1, 1, neutral
3043654139,  ericaferuglio99, 36, 18, 18, neutral
805875706555146240,  ArezzoVota, 6, 3, 3, neutral
805865844198821889,  rickynp98, 4, 2, 2, neutral
4753452742,  FilippoFratus23, 2, 1, 1, neutral
805743265454706688,  alessio_caale, 21, 8, 13, no
491678583,  mcarnev68, 4, 2, 2, neutral
743906868075053060,  davide0602, 6, 3, 3, neutral
2591668977,  BaraldiAle, 2, 1, 1, neutral
448825733,  80bonny, 8, 4, 4, neutral
3046433745,  fastenseat, 5, 2, 3, no
1162661400,  luisamattina1, 10, 1, 9, no
252646626,  gaddons, 2, 1, 1, neutral
3092183353,  brainfart76, 28, 14, 14, neutral
2971919439,  danielecarbon10, 9, 6, 3, yes
774957933285244928,  eliagomiscek, 4, 2, 2, neutral
419108460,  FernandoPetron1, 7, 4, 3, yes
544595395,  marco_cassani, 2, 1, 1, neutral
1262412272,  AnnaPavoni, 2, 1, 1, neutral
600962933,  lovelyirons, 7, 5, 2, yes
813815496,  nikisalvatore85, 10, 5, 5, neutral
454086006,  MarinaArizzi, 2, 1, 1, neutral
736680442624086017,  Cinzia55177212, 24, 12, 12, neutral
634886106,  raffa2704, 8, 4, 4, neutral
871146553,  etienne_saint, 2, 1, 1, neutral
712755285362917377,  stregne, 4, 2, 2, neutral
396914645,  tatemijes, 2, 1, 1, neutral
1284294343,  littoriale, 5, 3, 2, yes
593742754,  rolliwn, 16, 10, 6, yes
150819624,  Csep75, 3, 2, 1, yes
805673295051980800,  UomoNellArena, 16, 7, 9, no
2863674411,  ricamati, 4, 2, 2, neutral
796770054511661057,  Claudio05021959, 3, 1, 2, no
805867690946658304,  Andreeinono94, 2, 1, 1, neutral
414341453,  WaspSalander1, 5, 2, 3, no
2848098711,  felixitade, 2, 1, 1, neutral
1402688845,  miagmarsuren, 7, 3, 4, no
2172743300,  Snoopy16466, 23, 5, 18, no
741571693051826176,  mariomagnatta, 4, 2, 2, neutral
2403408967,  nssommesunjourn, 2, 1, 1, neutral
805848878381731840,  Mattiabindini85, 3, 2, 1, yes
347442566,  bestiucci, 14, 6, 8, no
417204485,  danae860, 2, 1, 1, neutral
304483611,  ilozito, 2, 1, 1, neutral
1898223246,  controtempo11, 2, 1, 1, neutral
805838348422156288,  MartinaGualtie4, 10, 3, 7, no
593533490,  ginkoramingo, 5, 1, 4, no
798248379117617153,  kagia77, 4, 2, 2, neutral
2990194047,  EnzoRossi71, 14, 7, 7, neutral
1048883828,  mirymiry6, 7, 2, 5, no
4483360943,  mattia_bordoni, 2, 1, 1, neutral
386154304,  blueclinch, 9, 6, 3, yes
284057788,  SAAlfredo, 12, 6, 6, neutral
793101117844520968,  chicca2918, 13, 6, 7, no
1593768152,  FrostePaolo, 2, 1, 1, neutral
2172636405,  CintoriVere, 2, 1, 1, neutral
18577800,  _Naglfar_, 5, 3, 2, yes
479810905,  PatriziaRametta, 16, 8, 8, neutral
3148019999,  luciano_paja, 2, 1, 1, neutral
2289645645,  LTrillni, 15, 7, 8, no
1268032573,  spaeknow, 4, 3, 1, yes
495277927,  FaustoStefanini, 2, 1, 1, neutral
479346137,  CristinaDibi1, 5, 4, 1, yes
919308710,  apemarra, 2, 1, 1, neutral
4385116702,  Marilen29933277, 2, 1, 1, neutral
2880664491,  Libico1969, 10, 5, 5, neutral
1347622963,  rupini_ale, 2, 1, 1, neutral
796417291994988549,  brislacciata84, 2, 1, 1, neutral
330533368,  fabiopk2, 6, 3, 3, neutral
2216077174,  LGoggioli, 17, 9, 8, yes
4342029017,  butler3g, 94, 48, 46, yes
582762833,  giardinodidio73, 7, 4, 3, yes
45395213,  clementecuoghi, 4, 2, 2, neutral
2505261984,  app_marco, 10, 5, 5, neutral
806068656899813376,  salvoserra21, 4, 2, 2, neutral
4506785717,  SimonaCappelli8, 2, 1, 1, neutral
2279212276,  RikyDav, 2, 1, 1, neutral
320742062,  aleprt, 2, 1, 1, neutral
445434281,  _nicola_o, 4, 3, 1, yes
4912745338,  elpaso1886, 14, 7, 7, neutral
709840307249090560,  jeanlui007, 13, 6, 7, no
3995075176,  Imperoborbonico, 7, 3, 4, no
796830886494949376,  baldi_mirco, 4, 3, 1, yes
2876529880,  federicagrodazz, 2, 1, 1, neutral
1122324151,  lilisa3D, 2, 1, 1, neutral
805766683797364737,  Giovann52211242, 2, 1, 1, neutral
805848664400859137,  Mara05535002, 2, 1, 1, neutral
1435273993,  MaxFelicitas, 2, 1, 1, neutral
1667790625,  Giampaolo_R7, 5, 1, 4, no
295654900,  clabucar, 25, 15, 10, yes
762962804412473344,  LerdaAntonio, 4, 2, 2, neutral
3393504791,  LunatikaLuna, 12, 6, 6, neutral
444405133,  Franghiskos, 2, 1, 1, neutral
418624595,  GiuseppeBozza, 8, 6, 2, yes
1154034913,  forzaroma2002, 2, 1, 1, neutral
1643461826,  LiMaurizi, 10, 5, 5, neutral
499883234,  railorai, 4, 2, 2, neutral
492175524,  katesparu, 7, 3, 4, no
1366614380,  enimar68, 4, 2, 2, neutral
421319924,  AlainVizier, 4, 2, 2, neutral
626381356,  ChiarelliDavide, 7, 5, 2, yes
82072785,  monicaercoli, 7, 4, 3, yes
2229866449,  GiorgioBanino, 8, 5, 3, yes
1015562190,  FabioGurioli, 2, 1, 1, neutral
2178149111,  CheccoBasa, 14, 7, 7, neutral
805929256186478592,  Gustreeta, 2, 1, 1, neutral
1483071638,  ElisaTasca, 5, 3, 2, yes
2316519053,  gaspero1953, 7, 3, 4, no
1487030509,  malinmau, 20, 10, 10, neutral
237177542,  iLcarlisi, 4, 2, 2, neutral
758021553883869184,  pgruppillo, 2, 1, 1, neutral
2382406316,  andean96, 2, 1, 1, neutral
562282172,  fedegiunto99_, 5, 3, 2, yes
2417683973,  SanPaolo7, 12, 4, 8, no
716716952325066752,  vinnie_esposito, 6, 3, 3, neutral
2444080147,  salvatorenarbo, 4, 2, 2, neutral
613567387,  gattogeloso, 4, 2, 2, neutral
1085581699,  gcostanzo85, 6, 3, 3, neutral
612814880,  MaurizioTotiBur, 7, 4, 3, yes
2951425072,  cicciagatta, 10, 5, 5, neutral
2741801260,  mancinigia, 2, 1, 1, neutral
1910996822,  DiCelloVale, 10, 5, 5, neutral
748861284695805953,  antonella_pica, 16, 8, 8, neutral
1145470195,  emiliettaangiol, 2, 1, 1, neutral
3389194761,  1bef1104678c49c, 2, 1, 1, neutral
3043617377,  gsoricaro, 16, 5, 11, no
4885797333,  PamelaFlorio, 6, 3, 3, neutral
802954987596877824,  stets83, 3, 2, 1, yes
3304016343,  BluemoonTs, 4, 2, 2, neutral
798464978273660928,  Raffa_D95, 3, 2, 1, yes
1420741807,  MatteoCadamuro, 3, 2, 1, yes
1425755594,  gabmrocca, 3, 1, 2, no
793534459899412480,  CristinaChiell2, 2, 1, 1, neutral
970274028,  andreac841, 31, 15, 16, no
2910439048,  loredanapetric2, 8, 3, 5, no
761271882,  franci_vezzosi, 2, 1, 1, neutral
805790377148121089,  gigitrinco, 4, 2, 2, neutral
428446593,  abrtrt, 4, 2, 2, neutral
860205385,  MARIELLA7172, 18, 7, 11, no
490624174,  Maaaggie92, 4, 2, 2, neutral
1671233035,  marziapittolo, 2, 1, 1, neutral
2267288613,  chiarapellegri9, 12, 6, 6, neutral
2877949007,  bar_yuri, 3, 2, 1, yes
790663292150743041,  RiccardoXx1, 6, 3, 3, neutral
216686073,  LauraMadrigali, 4, 3, 1, yes
2845689105,  casfer1955, 6, 3, 3, neutral
3979912491,  GigiLaffitte, 2, 1, 1, neutral
734110428788297728,  corinne_casha, 2, 1, 1, neutral
711948130279923714,  Francescoeletti, 4, 2, 2, neutral
376303691,  marcoalfredo3, 5, 4, 1, yes
96734471,  TizianaTifari, 2, 1, 1, neutral
277931662,  ElisabethValzan, 4, 2, 2, neutral
2494488768,  ada_edo, 2, 1, 1, neutral
400752847,  dusk0703, 4, 2, 2, neutral
805875630994837506,  tittysorry, 2, 1, 1, neutral
213991891,  ironshopping, 2, 1, 1, neutral
796311583077044225,  leandrodimilano, 110, 56, 54, yes
601591672,  Maxima2570, 6, 3, 3, neutral
397488853,  andreamoroni2, 2, 1, 1, neutral
2429008391,  BettaSperandio, 3, 2, 1, yes
747890067239206912,  Angelo63153903, 2, 1, 1, neutral
1278026173,  LuisaPolliSamec, 4, 2, 2, neutral
341389452,  ilparlamentare, 3, 1, 2, no
805682417755443200,  ocirneenolim, 4, 2, 2, neutral
935428136,  albermar83, 5, 3, 2, yes
706587264562937856,  enzodinoia84, 2, 1, 1, neutral
427671284,  Diabolikit, 10, 3, 7, no
795704371891863552,  eileen_sartori, 8, 4, 4, neutral
3124621335,  EricSilve7, 2, 1, 1, neutral
1374222312,  Iceberg822, 26, 13, 13, neutral
1271977076,  mariodomenicoto, 7, 2, 5, no
2172767249,  Massimo1983VR, 2, 1, 1, neutral
1284301519,  dottbellue, 6, 1, 5, no
4834714805,  guido110170, 10, 3, 7, no
402902848,  paolopulichino, 2, 1, 1, neutral
462930293,  PiattoThomas, 2, 1, 1, neutral
1916166230,  migliopax69, 2, 1, 1, neutral
950500700,  OberdanBenanchi, 9, 3, 6, no
2196264912,  irisblu59, 10, 5, 5, neutral
434309073,  PaolaKambo, 14, 7, 7, neutral
105277763,  lucianoserrone, 9, 4, 5, no
1221075104,  Ananseilsaggio, 2, 1, 1, neutral
545063550,  AntonioCincotta, 18, 9, 9, neutral
526632038,  briele72, 8, 4, 4, neutral
107193314,  Lui_Cella, 2, 1, 1, neutral
149233295,  cristiana2c, 2, 1, 1, neutral
764832934322929664,  simogiari59, 2, 1, 1, neutral
2252032623,  PaoloTiscornia, 4, 1, 3, no
249685018,  ilsuonatoredi, 25, 12, 13, no
221812643,  maxdercole, 3, 1, 2, no
3293657688,  DonatellaRaveg2, 24, 12, 12, neutral
1511087611,  grizzli2006, 3, 1, 2, no
2823528449,  BobbySoloz, 24, 12, 12, neutral
2167344469,  simogardini, 4, 2, 2, neutral
378095332,  GDallaglio, 2, 1, 1, neutral
3958002443,  MerloolreM, 5, 2, 3, no
250135556,  alehastasiempre, 2, 1, 1, neutral
801459575153184769,  Emanuela1807, 8, 4, 4, neutral
2219871178,  mra_amico, 11, 6, 5, yes
195193212,  vasconvolto82, 9, 5, 4, yes
58762054,  agipa, 5, 1, 4, no
268382554,  repiz_1958, 2, 1, 1, neutral
739927804427575296,  MarioColucci6, 6, 3, 3, neutral
3044636879,  vatu54, 3, 1, 2, no
2367834092,  AnnaCorsaroAdv, 5, 3, 2, yes
2316157360,  SCerquaglia, 2, 1, 1, neutral
801860821257191424,  Roberta16189266, 12, 6, 6, neutral
760795645871583232,  maurizi82002283, 10, 5, 5, neutral
225811646,  mrsefossiaria, 4, 2, 2, neutral
3357091883,  NegrettoDaniele, 30, 17, 13, yes
773650035716268032,  leone488, 2, 1, 1, neutral
3263800121,  pattyantonelli1, 15, 7, 8, no
357459418,  LucaGiaquinto, 24, 12, 12, neutral
499035724,  remogaino, 7, 4, 3, yes
425865474,  carmineflorio, 10, 8, 2, yes
479395136,  Roccia9, 6, 3, 3, neutral
836428490,  123stoka, 10, 4, 6, no
4483480636,  oui2oui3, 37, 18, 19, no
3435602351,  30Greeneyes, 4, 2, 2, neutral
479698567,  LorenzoPratesi1, 4, 2, 2, neutral
3407128227,  Fnc18Grm, 8, 4, 4, neutral
4259786632,  godibarbara457, 2, 1, 1, neutral
1014016028,  PesciAngelo, 14, 7, 7, neutral
3308383353,  Carlo45511102, 8, 5, 3, yes
2767355170,  picciotto6, 32, 18, 14, yes
3091707250,  cervino2015, 12, 6, 6, neutral
522038645,  ilgrilletto59, 2, 1, 1, neutral
4643077173,  peppeferri6311, 4, 2, 2, neutral
771434547762368512,  mediomeditatore, 110, 58, 52, yes
465422938,  generalelee74, 2, 1, 1, neutral
385890505,  GioGalgano, 15, 3, 12, no
2177486466,  vallinicola, 3, 2, 1, yes
747560489220177920,  CarniaFidelis, 8, 4, 4, neutral
3343231708,  ivansala61, 2, 1, 1, neutral
801999187319595008,  haakbusunmar191, 2, 1, 1, neutral
1418554027,  vietvinc, 3, 1, 2, no
805810964142718976,  187_338, 3, 1, 2, no
2291003508,  unmortoqls, 2, 1, 1, neutral
165022493,  danygila86, 3, 2, 1, yes
2867536148,  3381fff874b1479, 2, 1, 1, neutral
741735684445208577,  aalesandroo, 3, 2, 1, yes
766375475166011392,  Antonel13452492, 6, 3, 3, neutral
771625791314546688,  PRainisio, 4, 2, 2, neutral
571143617,  PB_twitero, 2, 1, 1, neutral
105853342,  francy_95, 2, 1, 1, neutral
1082718704,  leo_tomarchio, 75, 29, 46, no
2396639005,  Rita49865673, 18, 8, 10, no
2874898612,  lomestars, 4, 2, 2, neutral
719158696983588864,  aperegina88, 6, 3, 3, neutral
805468243410427904,  gammacromatica, 2, 1, 1, neutral
430569658,  avv_migliozzi, 14, 7, 7, neutral
791240691816988672,  nonkonforme, 2, 1, 1, neutral
413022837,  marchesemaria1, 7, 4, 3, yes
3428472718,  PatriotesLibres, 38, 20, 18, yes
801445435407798272,  lovingbricks, 21, 10, 11, no
526662292,  GennyFormisano, 4, 2, 2, neutral
331881841,  In4BoysArms, 74, 41, 33, yes
4819626052,  Rosbarbara70, 5, 3, 2, yes
1227144498,  Alexct9, 27, 15, 12, yes
497926684,  NovelliAnna, 3, 2, 1, yes
515615524,  andrea_viero, 30, 15, 15, neutral
2185225461,  LorenzoLanfrit_, 4, 2, 2, neutral
485599573,  MatteoOhayoo, 4, 2, 2, neutral
470069972,  cicciuz09, 2, 1, 1, neutral
403711807,  cgm959, 2, 1, 1, neutral
3318552736,  neveragain1907, 44, 22, 22, neutral
849459919,  MauroLiberale, 2, 1, 1, neutral
3949915942,  annavis08, 9, 5, 4, yes
770268919055671296,  TheSurne, 6, 3, 3, neutral
281170467,  FiammaCarugo, 4, 2, 2, neutral
772559732196438016,  innioni, 2, 1, 1, neutral
111299323,  OnTheRoad83, 10, 5, 5, neutral
3037744342,  Va_Bore, 7, 3, 4, no
3347613405,  oltreimuri, 7, 2, 5, no
2753887168,  marta_raciti, 2, 1, 1, neutral
490790247,  manuelcomme, 11, 6, 5, yes
613491836,  marziacomes, 2, 1, 1, neutral
99273846,  Stefrigna, 2, 1, 1, neutral
89070452,  lifter4fun, 2, 1, 1, neutral
2315669589,  GioGiozan, 16, 8, 8, neutral
479421317,  lupetto030, 4, 2, 2, neutral
410803921,  Lidi_smile, 2, 1, 1, neutral
1926843566,  ChMarz71, 5, 4, 1, yes
1524554196,  AMonserrato, 2, 1, 1, neutral
2954986355,  Roberto16111962, 7, 6, 1, yes
501669408,  enricoxp, 18, 7, 11, no
4208727496,  717_366, 5, 4, 1, yes
3202473352,  marco_hokuto, 23, 13, 10, yes
1279870898,  AlanSbara, 2, 1, 1, neutral
1534670706,  MicheleDiGiusto, 3, 1, 2, no
1394732834,  8cycling, 11, 6, 5, yes
601861520,  BPioltelli, 2, 1, 1, neutral
800444469455691776,  pierce18042003, 4, 2, 2, neutral
4523308156,  MrTrix007, 2, 1, 1, neutral
478810298,  ArenaRosario, 10, 5, 5, neutral
129199658,  aleman007, 12, 6, 6, neutral
436998900,  giorgisdp, 2, 1, 1, neutral
2911176083,  alfiogiuffrid11, 7, 4, 3, yes
397555068,  NicoloPanarotto, 12, 7, 5, yes
760770547022237700,  loveisbritin, 2, 1, 1, neutral
2899686898,  eddyleemason, 12, 10, 2, yes
4329256703,  Ginetto1959, 12, 5, 7, no
735306703,  juve_nomade, 2, 1, 1, neutral
45859888,  Aladdinsane60, 9, 4, 5, no
2305033538,  franco4561, 2, 1, 1, neutral
2875156827,  Sorrybyme, 5, 1, 4, no
1068405199,  okmacy, 87, 34, 53, no
45540643,  pigmalione89, 6, 3, 3, neutral
461016354,  Filo2385Filippo, 2, 1, 1, neutral
913261728,  cianoseraf, 6, 3, 3, neutral
1090504092,  Biancarosabesso, 2, 1, 1, neutral
805714800621850624,  Sparviero8, 4, 3, 1, yes
2547681274,  EMialich, 4, 2, 2, neutral
703564034709327877,  GingerPopy, 2, 1, 1, neutral
355060090,  NamelessVagrant, 5, 3, 2, yes
583167596,  TrolletoIsDead, 2, 1, 1, neutral
1379361852,  CamillePolicard, 2, 1, 1, neutral
428934086,  Love_You_Bitter, 2, 1, 1, neutral
2418774046,  michi73477154, 58, 27, 31, no
375625467,  _ritasi, 6, 2, 4, no
2487798168,  coscorb, 14, 6, 8, no
789833483275341824,  MaggiaLuca, 52, 26, 26, neutral
464473444,  marcocapelletti, 4, 2, 2, neutral
2368728417,  MartinaSchiavo6, 2, 1, 1, neutral
264356690,  lifesimo, 17, 9, 8, yes
538505408,  cagossik, 12, 7, 5, yes
240026757,  StudioPutignani, 4, 2, 2, neutral
417227921,  giuppi78, 15, 3, 12, no
34607171,  magnino, 12, 4, 8, no
1881117248,  MariangelaScato, 9, 7, 2, yes
3290337525,  sonia0197, 8, 4, 4, neutral
459977317,  mariagrazia1vol, 13, 5, 8, no
3298252493,  SOSITALY2015, 3, 2, 1, yes
785180126862532608,  65Laky, 2, 1, 1, neutral
2886058330,  tonydelconte, 2, 1, 1, neutral
3236461487,  giovannipaolo77, 3, 2, 1, yes
740153729291329536,  tilda1964, 2, 1, 1, neutral
552291348,  MTorresendi, 14, 7, 7, neutral
763479199,  jeck1979, 14, 7, 7, neutral
2223407550,  eniobertolini, 34, 3, 31, no
1077199572,  EmilioStocchi, 8, 4, 4, neutral
4235688612,  DidonatoJasmin, 6, 3, 3, neutral
751770688629907456,  maiolani_oriano, 13, 7, 6, yes
3404100412,  ferroromina9, 6, 3, 3, neutral
270449964,  Kassandra14_08, 4, 2, 2, neutral
3433044406,  AlissiaAndreos2, 2, 1, 1, neutral
2870870995,  danyace2014, 7, 3, 4, no
805706844165513216,  Andrea23614169, 2, 1, 1, neutral
801436023389650945,  1df490b06e054f4, 2, 1, 1, neutral
392169271,  EmilioBrambilla, 20, 8, 12, no
1035311467,  raffaelevelotti, 8, 7, 1, yes
721699643776704512,  ArieteC1, 6, 3, 3, neutral
4713725061,  rengia_benito, 3, 1, 2, no
550972074,  FL2611, 2, 1, 1, neutral
3351756621,  Davide_Siti, 2, 1, 1, neutral
997601341,  GM_Gimmy90, 4, 2, 2, neutral
718712462858694657,  Enoloit, 2, 1, 1, neutral
749672107190157312,  EmanuelaPriori7, 3, 2, 1, yes
324936579,  AZambrino, 12, 10, 2, yes
2318216051,  RipleyEmy, 14, 6, 8, no
788290166146404352,  MaryPalumbo4, 4, 2, 2, neutral
2404586361,  jrgfloor, 6, 3, 3, neutral
727103416682553344,  lampadeincotone, 3, 2, 1, yes
140287042,  osolemio73, 3, 2, 1, yes
1080924907,  GiordanaQ, 4, 2, 2, neutral
805803948686852096,  macchinetta1980, 4, 2, 2, neutral
1039675664,  enricoorsetti, 7, 3, 4, no
3881850688,  TamarraDurso, 8, 4, 4, neutral
796297006926925824,  Dominique1958KR, 6, 3, 3, neutral
4901996812,  geste84, 10, 5, 5, neutral
1916734963,  fabrymc4, 22, 11, 11, neutral
2565953471,  talebano1968, 7, 2, 5, no
1889899333,  MoiaVilmer, 8, 4, 4, neutral
3305696997,  alemarag, 13, 6, 7, no
4863603099,  pindacamp, 5, 1, 4, no
1566023431,  Fuoridalleuro, 16, 10, 6, yes
58244717,  paolofederici, 10, 8, 2, yes
2780151284,  PaoliniPiera, 2, 1, 1, neutral
805710328625590272,  Piombo_Morbido, 15, 5, 10, no
1044887318,  paolo6555, 16, 7, 9, no
2393772904,  ellyleoci86, 4, 3, 1, yes
3032825368,  CristinaBilec, 2, 1, 1, neutral
1181458416,  maur0demichelis, 8, 4, 4, neutral
1918228609,  RudeDogzz, 2, 1, 1, neutral
2357502873,  Paperkisss1980, 12, 8, 4, yes
1555488049,  PutzoluSandra, 43, 3, 40, no
777436258767368192,  polemicotweet, 3, 1, 2, no
408784370,  Dario_90ME, 5, 3, 2, yes
3298746532,  SanSanokkio, 7, 1, 6, no
2669985998,  GMagnano72, 2, 1, 1, neutral
284527396,  lagunarerosso, 6, 3, 3, neutral
605653016,  BlancStefan, 26, 7, 19, no
833742794,  barbarina811, 4, 2, 2, neutral
716422928,  davilla58, 85, 41, 44, no
488894721,  Antonello_Bassi, 16, 10, 6, yes
803658403503570944,  Alessan67425879, 2, 1, 1, neutral
455282304,  suckmycas, 2, 1, 1, neutral
2775758153,  Vodkbrendon, 2, 1, 1, neutral
3421902544,  verna_luciana, 28, 14, 14, neutral
375612194,  l_Assurda, 2, 1, 1, neutral
776352314,  PaolaTerribile, 6, 3, 3, neutral
431779105,  GiancolaBarbara, 4, 2, 2, neutral
131565005,  _ItsGiorgia, 2, 1, 1, neutral
236332690,  salatina67, 5, 3, 2, yes
776366439632605185,  2016blackdog_, 30, 17, 13, yes
307537574,  andreapezone, 15, 9, 6, yes
2444670310,  dino_aldo, 6, 3, 3, neutral
460853894,  laurarossidue, 2, 1, 1, neutral
760156337405849601,  AnneRobin91, 2, 1, 1, neutral
2402653372,  gioacchinobpb12, 6, 3, 3, neutral
2883001715,  donewhoknows, 6, 4, 2, yes
2561992290,  yronladi, 9, 4, 5, no
3212603657,  BertozziMatilde, 2, 1, 1, neutral
464019132,  moiraDT, 2, 1, 1, neutral
2604249164,  roma9na, 2, 1, 1, neutral
758352397139841024,  ilarianicola19, 2, 1, 1, neutral
801934415526002688,  Alessan41583443, 59, 29, 30, no
1257582146,  fabiovecchi24, 3, 1, 2, no
797905198811381760,  robertosterlicc, 7, 3, 4, no
1272524299,  ANGELONIOSI, 5, 2, 3, no
1538486852,  Riccbergna, 2, 1, 1, neutral
430010328,  Ema_Di_Matteo, 2, 1, 1, neutral
2784502136,  valman54, 16, 5, 11, no
1185642630,  paolocolp, 6, 5, 1, yes
2713508733,  bruno7_d, 2, 1, 1, neutral
1489541214,  GianlucaBuffone, 6, 3, 3, neutral
957072042,  MaxiZut, 2, 1, 1, neutral
1238167818,  EMILIOMARINI1, 2, 1, 1, neutral
416758608,  kilojhi, 3, 1, 2, no
2870842681,  chihuaua1, 6, 3, 3, neutral
721792865265979394,  Flavian60702462, 2, 1, 1, neutral
803933169573625856,  Avv_Mauda, 12, 6, 6, neutral
776841420602761216,  Mario460674241, 2, 1, 1, neutral
596846893,  Wildchild_d1, 2, 1, 1, neutral
748416033334132736,  Nain44955104, 15, 6, 9, no
2204769767,  2306lizzy, 4, 2, 2, neutral
1039731007,  clizia16, 8, 4, 4, neutral
597545163,  dyd74, 8, 3, 5, no
2785851725,  GgGasparlin, 14, 8, 6, yes
387001644,  lorgabry, 2, 1, 1, neutral
290106499,  AlbeFuma, 4, 2, 2, neutral
834267554,  omniamunda, 15, 5, 10, no
3127917023,  174e73c4a4574a6, 2, 1, 1, neutral
2933685736,  emanuelaluca1, 8, 4, 4, neutral
802619024894992384,  82_semola, 5, 3, 2, yes
522208816,  LaraFilippini, 2, 1, 1, neutral
984929054,  esenoc, 2, 1, 1, neutral
942010068,  perrellicoach, 54, 19, 35, no
2571088997,  cristian_paroli, 12, 6, 6, neutral
797135342474248192,  gbrandolinigio1, 2, 1, 1, neutral
525200575,  Liiii94, 3, 2, 1, yes
720345343133630464,  ALESSAN021, 2, 1, 1, neutral
723010238090252288,  100KM5, 7, 5, 2, yes
860222119,  B64040, 16, 8, 8, neutral
96383439,  sergiofenizia, 28, 16, 12, yes
135813465,  lellina1977, 3, 2, 1, yes
22827984,  Ele781, 6, 3, 3, neutral
2397083955,  MarcoPoleggi, 18, 9, 9, neutral
3243937305,  Zambuzzz, 10, 2, 8, no
779052911024308224,  VentinaD, 4, 2, 2, neutral
3290121591,  figachesbatti, 6, 3, 3, neutral
2997762291,  EffeBi90, 12, 8, 4, yes
2958883751,  artiglio02, 18, 9, 9, neutral
742030086703026176,  salvo93aba, 3, 2, 1, yes
501759202,  LidiaGay, 2, 1, 1, neutral
915559825,  giuliazuki, 2, 1, 1, neutral
767721179180392449,  Rollerely1, 2, 1, 1, neutral
312013377,  giorgio_vitali, 2, 1, 1, neutral
2183243896,  CasaliNadia, 6, 3, 3, neutral
4076054254,  patty210697, 4, 2, 2, neutral
908519516,  Piergue_EU, 4, 3, 1, yes
898577958,  LegaDonatella, 2, 1, 1, neutral
439073471,  LuigiCasc, 9, 3, 6, no
3011001645,  apicozzo, 8, 6, 2, yes
800356874977579008,  Macno8, 15, 9, 6, yes
3295208099,  MrPrinci65, 4, 2, 2, neutral
582671427,  karvra, 4, 2, 2, neutral
2814514121,  GiovyBronzato, 4, 2, 2, neutral
1062662900,  Gortoe, 2, 1, 1, neutral
2964938091,  m_dazzi, 23, 7, 16, no
756886608465502208,  Luigi54913423, 2, 1, 1, neutral
2362146442,  Mf7Arkglmiguel, 8, 4, 4, neutral
3063412516,  firedpt3, 4, 1, 3, no
3369156047,  sapienza121, 23, 12, 11, yes
736566716210262016,  terry50mm, 20, 14, 6, yes
1461433142,  PieroIenaroC, 20, 10, 10, neutral
356072527,  LilyPrigion, 2, 1, 1, neutral
3901751716,  IleniaVirzi, 2, 1, 1, neutral
456499367,  TuriSalvo44, 4, 2, 2, neutral
805808765257875456,  raffale_giusti, 4, 2, 2, neutral
767040529100079104,  Pinella1949, 29, 8, 21, no
231354329,  Agness11, 2, 1, 1, neutral
3409053184,  nickconte92, 12, 7, 5, yes
4924743345,  antoarcu, 8, 2, 6, no
225178719,  mario19633, 11, 5, 6, no
1911007232,  DandriaGennaro, 4, 2, 2, neutral
755313289,  gongolo11, 13, 4, 9, no
3597402316,  marangonluke, 84, 42, 42, neutral
444053011,  enricorlando, 4, 2, 2, neutral
1951780466,  ronchiimport, 11, 9, 2, yes
1916947843,  napoleone57, 7, 6, 1, yes
376388605,  bimbo_gigi, 12, 6, 6, neutral
383639966,  michele020776, 27, 14, 13, yes
760549090291834880,  Lastoria1897A, 7, 4, 3, yes
2800242858,  mba_nico, 3, 1, 2, no
1848211086,  IfUSeekSimone, 6, 3, 3, neutral
599259883,  chiaravilla5, 2, 1, 1, neutral
341335638,  nellomarrazzo, 16, 6, 10, no
2700638454,  tomastertom3, 2, 1, 1, neutral
802454590608330752,  LoStudenteSvevo, 7, 2, 5, no
23788197,  stefanodigitale, 2, 1, 1, neutral
1058764218,  GiacomoGnutti, 4, 2, 2, neutral
388194972,  GaetanoScafa, 5, 2, 3, no
799724972210065408,  RobyRoberta20, 9, 5, 4, yes
779816993079820289,  BarbieB05, 2, 1, 1, neutral
19388402,  Albmag, 2, 1, 1, neutral
732472848128712704,  NaTelNik, 6, 3, 3, neutral
299127869,  onofriofofo, 3, 2, 1, yes
717287801696477184,  Stefani87197612, 2, 1, 1, neutral
772162036386193412,  haw19681, 2, 1, 1, neutral
2761738287,  lombardo_pippo, 6, 4, 2, yes
802247908708024320,  DanieleBenedini, 4, 2, 2, neutral
229112968,  AGNotizie, 6, 2, 4, no
339805718,  79_CHRISTIAN, 8, 4, 4, neutral
2361820835,  SilviamartucciL, 2, 1, 1, neutral
3059131623,  agatamicia, 31, 11, 20, no
4690956236,  walterinobert, 2, 1, 1, neutral
1037554130,  tigredoro61, 2, 1, 1, neutral
803066672462565376,  anakerhar1973, 2, 1, 1, neutral
1851551826,  ale81cs, 12, 6, 6, neutral
858249276,  lilly0971, 6, 2, 4, no
289688493,  Spartaco_8, 3, 1, 2, no
774007495249518592,  Barbara48207500, 15, 8, 7, yes
803979535586836480,  Komlan_Apaloo, 2, 1, 1, neutral
3130622027,  19justice69, 84, 41, 43, no
2161999837,  VincenzoAcanf96, 6, 4, 2, yes
4892410624,  SPontegradella, 2, 1, 1, neutral
4904858837,  beatricebram, 6, 3, 3, neutral
303122543,  AgostinaLeone, 3, 2, 1, yes
248734017,  dantechip, 19, 7, 12, no
2945541934,  nicodagu, 2, 1, 1, neutral
788012181598113792,  criscarboni77, 5, 2, 3, no
131176211,  theamerigo, 3, 2, 1, yes
2803138163,  _D_e_b_o_r_a_h, 2, 1, 1, neutral
94528769,  ettoreametis57, 19, 10, 9, yes
78567974,  tempoweb, 8, 4, 4, neutral
345815234,  mattianavacchia, 2, 1, 1, neutral
406194632,  __ItsAurora, 2, 1, 1, neutral
550470396,  adolfobumeliana, 2, 1, 1, neutral
793469352871858176,  kafyipel, 9, 4, 5, no
787512125610655744,  rocco22772495, 11, 3, 8, no
270839361,  matteosalvinimi, 3, 2, 1, yes
2900789860,  Noiconsalvini, 6, 3, 3, neutral
13514762,  LegaNordPadania, 6, 3, 3, neutral
2822957753,  pellegrini38, 5, 3, 2, yes
2987790683,  ilfuoriuscito, 4, 2, 2, neutral
397251469,  sesy1947, 6, 2, 4, no
762765934922792960,  laurakira16, 2, 1, 1, neutral
2969224684,  lubale271081, 10, 4, 6, no
257363296,  mangiapeloG, 4, 2, 2, neutral
137120635,  lauramjj58, 9, 5, 4, yes
207356178,  Spaghetti3332, 3, 2, 1, yes
529487504,  AotearoaSilvia, 5, 3, 2, yes
3172267571,  vale_cipolla, 8, 4, 4, neutral
485107842,  marti_j32, 6, 3, 3, neutral
2573757023,  CeglieMariella, 16, 8, 8, neutral
1195912231,  miki72plud, 5, 4, 1, yes
737954261292748800,  paolachioma, 2, 1, 1, neutral
1882975495,  pierino5861, 6, 3, 3, neutral
426908100,  robertopoggi1, 5, 1, 4, no
2752812933,  luigimoretti98, 2, 1, 1, neutral
2157985906,  alessandrogul, 4, 2, 2, neutral
2789594932,  joshxxler, 2, 1, 1, neutral
485124432,  mariagraziafusa, 2, 1, 1, neutral
429085080,  piera_bz, 13, 10, 3, yes
419888220,  va_loc, 2, 1, 1, neutral
750292500364009472,  IvanTomeo1, 16, 8, 8, neutral
2197196008,  valeria_fiorito, 2, 1, 1, neutral
349649017,  romanabarba, 15, 3, 12, no
223898609,  mariagrosso, 3, 2, 1, yes
2373026109,  OFelicit, 4, 2, 2, neutral
954347947,  carcani_sn, 16, 3, 13, no
1562770316,  CrisVendite, 10, 6, 4, yes
3375604709,  ailinon80, 16, 7, 9, no
756540680839782400,  RobertoSavasini, 4, 2, 2, neutral
418785308,  EdoSottoriva, 6, 3, 3, neutral
431042658,  andrea_piras86, 8, 3, 5, no
204456385,  calderamat, 11, 4, 7, no
1498271646,  HappyBeauty2013, 18, 9, 9, neutral
2892694835,  natalia_n4t4li4, 6, 3, 3, neutral
242079429,  ricky111986, 4, 2, 2, neutral
1435712192,  GiorgioGuidiDes, 2, 1, 1, neutral
495756483,  CMoscarini, 2, 1, 1, neutral
786491581503156225,  informationeu, 7, 3, 4, no
780318269995638784,  Blackred621, 7, 3, 4, no
1921072717,  camillabaldo99, 2, 1, 1, neutral
784753884917075968,  gaialimoni2, 6, 3, 3, neutral
1414099207,  pietromariatisi, 4, 2, 2, neutral
590813398,  DiegoLonati, 4, 2, 2, neutral
769636951104360448,  toni_z13571766, 17, 16, 1, yes
714415509790400512,  MAHKAH21, 34, 17, 17, neutral
3367845131,  giodema1947, 2, 1, 1, neutral
801049687298113536,  sesto_empirico, 23, 2, 21, no
296536037,  cinadabrescia, 2, 1, 1, neutral
360082796,  Trotula46, 10, 5, 5, neutral
789492030850342913,  Laralaralaretta, 14, 7, 7, neutral
1608221749,  RobyRoby149, 2, 1, 1, neutral
4558486577,  macsomastro, 2, 1, 1, neutral
492179581,  Elagibe, 4, 2, 2, neutral
522228631,  CSegattini, 15, 8, 7, yes
799585875931910145,  NinaKadk1, 2, 1, 1, neutral
1131511106,  simasr1927, 2, 1, 1, neutral
802982245401300993,  _sabrina94_, 4, 2, 2, neutral
358847239,  nandoercole, 15, 4, 11, no
756767143203594244,  VittiShikoku, 2, 1, 1, neutral
760585433470427136,  SabrinaTiacci, 2, 1, 1, neutral
503574025,  MauraFabbri, 4, 2, 2, neutral
2262555456,  davlogaldo, 6, 3, 3, neutral
260770236,  Buleca, 2, 1, 1, neutral
316768141,  PpaoloCeli, 12, 6, 6, neutral
2163487923,  sichioman, 11, 7, 4, yes
778468643008950272,  giuseppeevacu, 55, 29, 26, yes
3396914326,  Vale_elulu, 2, 1, 1, neutral
713068423127908352,  iacopinomarial2, 2, 1, 1, neutral
1734567211,  mattino5, 10, 6, 4, yes
3834367960,  fabriziobizz1, 15, 4, 11, no
764056964821348353,  leonessa1967, 3, 1, 2, no
512547601,  CaioGracco1, 6, 3, 3, neutral
395297366,  joemaya89, 2, 1, 1, neutral
2295167733,  trifola56, 6, 3, 3, neutral
719486052675821568,  Ottimista331, 3, 2, 1, yes
949977877,  annafortuna5, 2, 1, 1, neutral
753992900736913408,  Pierlu50, 2, 1, 1, neutral
3288686555,  Giulia9501, 12, 6, 6, neutral
29164255,  sluchetti, 15, 8, 7, yes
1106516964,  Susy_1968, 3, 1, 2, no
3407777645,  2Lyon2France, 3, 2, 1, yes
606302510,  kingGiuls, 3, 2, 1, yes
320739148,  LazarusRising_, 2, 1, 1, neutral
120713042,  savonarola51, 5, 2, 3, no
456082255,  ritac22, 7, 4, 3, yes
1314567997,  davide92_, 11, 3, 8, no
2979863884,  area_paolo, 9, 2, 7, no
499742829,  MaryCasillo, 4, 2, 2, neutral
724637713765421056,  susanabona65, 2, 1, 1, neutral
24319564,  IeSslo, 5, 2, 3, no
1199673588,  BrunozanonR, 34, 25, 9, yes
1326518220,  zanon_graziella, 2, 1, 1, neutral
2296705165,  andrea_ziro, 8, 4, 4, neutral
3303871432,  scrivipicchi, 57, 3, 54, no
781315176,  veronicafili, 7, 3, 4, no
805561734190821376,  pacillichiara, 4, 2, 2, neutral
426903849,  Lillusinfabula, 11, 6, 5, yes
2191680460,  nonnoteo_, 17, 11, 6, yes
3039647428,  EssemmeStudio, 2, 1, 1, neutral
806849047,  EnricoSpadaro7, 4, 2, 2, neutral
989275308,  sguido55, 4, 2, 2, neutral
764071712950550528,  tonyeldoret, 6, 2, 4, no
805548736676040704,  MatteoCucchi93, 2, 1, 1, neutral
607468987,  FerrantiXCIV, 5, 2, 3, no
1604186864,  zamfe, 2, 1, 1, neutral
1296505926,  serra_puddu, 5, 3, 2, yes
3343278628,  Tec_Ambientali, 7, 4, 3, yes
799492756158738433,  debora92133203, 27, 18, 9, yes
2664509675,  IamaShurtugal, 2, 1, 1, neutral
425774798,  giovanni1039, 7, 3, 4, no
805550472992002048,  Tony_Miraglia, 4, 2, 2, neutral
2829230812,  schiesa81, 6, 3, 3, neutral
719103580247076864,  Fabiobuongio, 87, 44, 43, yes
444551766,  Greekstudent12, 5, 2, 3, no
85793992,  bygip, 4, 1, 3, no
97014296,  PaoloMontenero, 2, 1, 1, neutral
3025353091,  enzolarocca123, 3, 1, 2, no
3581003417,  silviofanfy, 2, 1, 1, neutral
47170794,  GiallucaD, 13, 3, 10, no
2232857707,  Fdc0375Y9T7KZ10, 6, 3, 3, neutral
1044907412,  ACeschia, 11, 5, 6, no
19781325,  irene_rnd, 2, 1, 1, neutral
2166575990,  inter_lele, 4, 2, 2, neutral
29968376,  mikele76, 18, 9, 9, neutral
4872606058,  fotosandro, 2, 1, 1, neutral
1103991408,  simdom98, 2, 1, 1, neutral
364947294,  RinoRiezzo, 6, 2, 4, no
1475611711,  eurodisgusto, 5, 3, 2, yes
782377401955287040,  Davide_1504, 8, 4, 4, neutral
432268178,  andrea_ballario, 3, 1, 2, no
2245181865,  CatozziEc, 2, 1, 1, neutral
2328829536,  babyspettri, 4, 2, 2, neutral
1303488596,  lauragiuliaD, 2, 1, 1, neutral
1308538676,  AlbertoZoratti, 2, 1, 1, neutral
151524010,  Mario_Menegante, 2, 1, 1, neutral
2186994061,  Simy_Calo, 3, 2, 1, yes
1524991735,  GDM1897, 4, 2, 2, neutral
796082544215212032,  coriolano2011, 2, 1, 1, neutral
4245136732,  CarpaniAlberto, 2, 1, 1, neutral
1327131925,  MassimoMomento, 3, 2, 1, yes
1037394888,  Marinina14, 14, 7, 7, neutral
805551147176042501,  AlessiaArcadio, 2, 1, 1, neutral
1248607890,  GGiusypoletti, 8, 4, 4, neutral
2604119560,  cristinagarbar2, 2, 1, 1, neutral
731829818845728768,  benaltrist, 4, 2, 2, neutral
621016785,  ValeriaCn12, 5, 4, 1, yes
793787716727140353,  salvodepianof2, 6, 1, 5, no
72522293,  susymurzi, 23, 11, 12, no
798269524663533572,  Anarconazional1, 7, 5, 2, yes
46355142,  guglielmo75, 8, 4, 4, neutral
893203832,  niallshickey, 8, 4, 4, neutral
2203253941,  NickMyOnlyOne, 5, 3, 2, yes
461493236,  avvdeflorio, 4, 2, 2, neutral
428360358,  xlondondream, 4, 2, 2, neutral
771305044394151936,  fabriziofois025, 8, 4, 4, neutral
805536748306628608,  giullaare, 2, 1, 1, neutral
430230572,  AdamSic58, 8, 6, 2, yes
2348283413,  AllegraBress, 4, 2, 2, neutral
1968968935,  SURESNESRBM, 13, 6, 7, no
618189727,  Ssia_, 2, 1, 1, neutral
708479171702476800,  maxshark80, 10, 5, 5, neutral
757676234977443841,  raff51578670, 2, 1, 1, neutral
2710203335,  Dani_Mazzo_bike, 13, 7, 6, yes
1710210360,  gianfrancodema8, 12, 6, 6, neutral
802942712324456448,  delh_tata, 2, 1, 1, neutral
1176004074,  RuslanaOpika, 3, 1, 2, no
746830680257077248,  luisa_balbi, 3, 2, 1, yes
318488169,  NCIngegneria, 8, 3, 5, no
950190842,  lazy_is_nice, 15, 8, 7, yes
737918135584620545,  Domenic10399585, 33, 17, 16, yes
4888195521,  CaimiMichela, 2, 1, 1, neutral
790675660926808064,  frasilvestrona, 5, 2, 3, no
780148860,  Fironm, 8, 4, 4, neutral
1451417796,  Palma304Paolo, 15, 7, 8, no
1123670707,  rabaus, 5, 3, 2, yes
1702932332,  Fede_Forlani, 2, 1, 1, neutral
565613864,  DavidePizzetti, 4, 2, 2, neutral
427200832,  elismar_3, 2, 1, 1, neutral
802487031121244160,  masgelmi, 8, 4, 4, neutral
321252271,  fcolombo73, 12, 4, 8, no
4055118377,  paolomarin28, 2, 1, 1, neutral
1147447590,  LiberoVichi, 2, 1, 1, neutral
2308536067,  ansaldo77, 6, 3, 3, neutral
1250116818,  CandianiStefano, 2, 1, 1, neutral
355193943,  Auraraba, 2, 1, 1, neutral
612067046,  MaurizioMoro3, 2, 1, 1, neutral
798504344178003968,  peppepiz, 2, 1, 1, neutral
2946017621,  giovip1948, 5, 2, 3, no
1550852124,  paolariccardi83, 5, 3, 2, yes
366511130,  walganger, 9, 5, 4, yes
2346783988,  DanyTriggiani, 2, 1, 1, neutral
23475322,  andreadosio, 9, 7, 2, yes
798280589426180098,  LibertaPensare, 2, 1, 1, neutral
116750021,  linetta53, 22, 16, 6, yes
850947740,  FerruccioColoru, 3, 2, 1, yes
379109556,  MaxB70, 2, 1, 1, neutral
934466887,  MartaPerego88, 12, 6, 6, neutral
528846336,  falcions85, 16, 9, 7, yes
2985859289,  simonettarodol1, 12, 5, 7, no
483352788,  sonnen74, 14, 6, 8, no
2356927941,  CareSpitFire, 4, 2, 2, neutral
589513542,  Migmax79, 2, 1, 1, neutral
238538685,  peppinobruno, 5, 4, 1, yes
786635776046010368,  Donamargher1958, 2, 1, 1, neutral
28954941,  voxday, 4, 2, 2, neutral
1862079170,  Last_Kitten, 2, 1, 1, neutral
4196365162,  FiginiOfficial, 11, 6, 5, yes
402871629,  MatteOvi, 2, 1, 1, neutral
257156397,  LaAntoStellina, 4, 2, 2, neutral
467198533,  SalvaBorrelli, 4, 2, 2, neutral
130928680,  Simone_Inteli, 2, 1, 1, neutral
777453230318059521,  CarmineSinigag5, 7, 4, 3, yes
1931938928,  RakynHint, 7, 4, 3, yes
797420247741505536,  LioceMichela, 6, 3, 3, neutral
306887785,  gioiaannamaria, 6, 3, 3, neutral
764759260098072580,  Eugenio10493137, 2, 1, 1, neutral
3988102589,  FirstOnHisName, 8, 3, 5, no
2325832484,  PascalLafont, 10, 5, 5, neutral
801836450773954560,  MarikaManuela, 2, 1, 1, neutral
52019772,  Grasiento, 2, 1, 1, neutral
2902050336,  FWollisch, 4, 2, 2, neutral
1257848173,  Stefanoboh, 23, 7, 16, no
760787622235107328,  Riccard15061911, 6, 3, 3, neutral
419778202,  monicavianello, 12, 6, 6, neutral
751194313661513729,  gowanlor, 7, 4, 3, yes
799160749532807168,  xiloveinter, 2, 1, 1, neutral
805786143795060737,  peppescalia93, 2, 1, 1, neutral
1030042124,  caralho71, 6, 3, 3, neutral
801860864500449284,  Claudie58418371, 10, 6, 4, yes
3946230814,  CarolinaCi59, 2, 1, 1, neutral
2501545436,  antoniopuleo019, 4, 2, 2, neutral
2412990951,  OpenFaber, 3, 1, 2, no
2628534651,  ospina_u, 2, 1, 1, neutral
4582495415,  claudio_willy, 2, 1, 1, neutral
2195885998,  raniavito, 2, 1, 1, neutral
164382929,  Pie_84, 4, 1, 3, no
1593113011,  kris_kros83, 2, 1, 1, neutral
455994196,  sonycast93, 2, 1, 1, neutral
94966761,  alfmar1959, 4, 3, 1, yes
998799806,  pierluigideanna, 2, 1, 1, neutral
739526875500908544,  GioCarlo6, 2, 1, 1, neutral
2748285723,  18061976fg, 2, 1, 1, neutral
3450310997,  rikkmusiclover, 2, 1, 1, neutral
857508649,  LampoMar, 4, 2, 2, neutral
1275002341,  totodu611, 6, 3, 3, neutral
899730438,  Emanuele97Manca, 2, 1, 1, neutral
1490029824,  77amorebello77, 10, 5, 5, neutral
61051865,  stefano_baldi, 2, 1, 1, neutral
2872552455,  vahithiana, 3, 2, 1, yes
787002672855539712,  nastiainpastell, 2, 1, 1, neutral
72546841,  Andrew_Hunting, 3, 1, 2, no
704986438,  michele_tin, 28, 13, 15, no
84417965,  euguccioni, 4, 2, 2, neutral
517833419,  vale_egidi, 2, 1, 1, neutral
442189588,  Crilin_Official, 10, 5, 5, neutral
102155168,  beforeYouGo78, 4, 2, 2, neutral
794676312103415808,  AuriAury53, 8, 3, 5, no
2364563704,  brishan80, 12, 5, 7, no
700592900544053248,  simonamoma1971, 6, 2, 4, no
1831592647,  RikiGiordano, 2, 1, 1, neutral
33501253,  guglielmopicchi, 6, 3, 3, neutral
1367151799,  samantasperanza, 5, 3, 2, yes
2907570489,  rinaldogenova, 3, 2, 1, yes
3144136294,  genovesechrist1, 5, 1, 4, no
187961842,  kaizer75, 2, 1, 1, neutral
2442105406,  robertabg72, 45, 21, 24, no
3414864718,  UmbertoStr, 15, 7, 8, no
2762679177,  adriparravani, 2, 1, 1, neutral
2999834315,  aledeluca1900, 2, 1, 1, neutral
79170343,  marcoreds07, 7, 4, 3, yes
470527968,  FABIOMARANI, 2, 1, 1, neutral
41898965,  egidiosabbadini, 2, 1, 1, neutral
2673272289,  J4C0P0P14ZZ4, 2, 1, 1, neutral
2350495204,  Maurizi93527415, 8, 4, 4, neutral
2372154501,  roal_139, 12, 4, 8, no
4173718821,  B_brigida78, 2, 1, 1, neutral
217895854,  Aquilaceleste1, 2, 1, 1, neutral
140066629,  Lucy_822, 15, 6, 9, no
2847311877,  ragunap56, 2, 1, 1, neutral
908951064,  luca_carioli, 7, 4, 3, yes
1226074158,  CGhila, 3, 1, 2, no
2487106705,  remigiopassarin, 2, 1, 1, neutral
1053839395,  Leonida_480, 24, 12, 12, neutral
255148646,  SilviaSere, 2, 1, 1, neutral
2791644545,  99a43db3e4644ff, 10, 4, 6, no
2197813964,  SoftVsc, 27, 13, 14, no
440190188,  mirrycirry2, 6, 3, 3, neutral
801762901769981952,  Bmc90672827, 12, 5, 7, no
1095633631,  nhamhed, 2, 1, 1, neutral
805409336373690368,  andrevam83, 16, 9, 7, yes
805704118031581185,  goghero_roberto, 14, 7, 7, neutral
455991791,  AndyCasiraghi, 5, 3, 2, yes
71304426,  mario_tirone, 4, 2, 2, neutral
1037459442,  5koll, 2, 1, 1, neutral
115558584,  Andyphone, 20, 11, 9, yes
273051700,  Makkone62, 9, 5, 4, yes
424401692,  fitzkarraldo5, 12, 9, 3, yes
1075134938,  Bronz2013, 2, 1, 1, neutral
3081790409,  djrembambeat, 2, 1, 1, neutral
335444528,  perekke999, 2, 1, 1, neutral
970877232,  mapica92, 5, 4, 1, yes
505051921,  LuigiTaumaturgo, 4, 2, 2, neutral
391241156,  claireJesuella, 2, 1, 1, neutral
4218819297,  Pettirosso81, 5, 3, 2, yes
358348320,  Federock81, 3, 2, 1, yes
414627859,  RobertoGobetti, 4, 2, 2, neutral
1295979390,  vincent_cerullo, 3, 1, 2, no
448288021,  alegiglio12, 2, 1, 1, neutral
391885865,  Barone1969, 2, 1, 1, neutral
2740841451,  Crabbyrain, 4, 2, 2, neutral
421438797,  BigTommyBig, 2, 1, 1, neutral
598189709,  Ferraina72, 2, 1, 1, neutral
2350025536,  lcncoppola, 2, 1, 1, neutral
747076722680528896,  Paola25640021, 6, 3, 3, neutral
865157592,  CogoAndrea, 2, 1, 1, neutral
1601665908,  Hr8232Ste, 2, 1, 1, neutral
452350924,  maximilanbuono, 2, 1, 1, neutral
2250100331,  CDany1968, 2, 1, 1, neutral
3322995999,  dado27029, 2, 1, 1, neutral
805751550937366528,  Claudio20176137, 2, 1, 1, neutral
1727875608,  giotta_marg, 4, 2, 2, neutral
1420244702,  rodolfostweets, 4, 2, 2, neutral
117863568,  anglotedesco, 5, 2, 3, no
414672025,  BCallipari, 2, 1, 1, neutral
519323528,  ElisaPax, 2, 1, 1, neutral
3653292675,  Phoenyx_87, 8, 4, 4, neutral
724840591331364864,  AGL10M, 2, 1, 1, neutral
2874974035,  marelligiacomo1, 8, 4, 4, neutral
2212226706,  DemFerr, 5, 3, 2, yes
756811786603663360,  gaboalberto80, 2, 1, 1, neutral
514712257,  2pesi2misure, 7, 3, 4, no
507715196,  ricryky, 4, 2, 2, neutral
3080297069,  bonfantiannamr, 2, 1, 1, neutral
1189743062,  acaputo70, 8, 5, 3, yes
3668295616,  JackPetru, 2, 1, 1, neutral
623193414,  yamap888, 6, 3, 3, neutral
2861271427,  ivanotenneriel1, 2, 1, 1, neutral
1657210158,  phil_rab, 2, 1, 1, neutral
1367116628,  XTopGearUKfan, 2, 1, 1, neutral
722899925978247169,  BacuzziTende, 2, 1, 1, neutral
982932835,  adrianabiffis, 20, 5, 15, no
717479185900576769,  marabelli75, 46, 23, 23, neutral
1244857718,  APastarini, 16, 4, 12, no
805886005886799872,  cholo2o17, 2, 1, 1, neutral
2462314591,  domenicacuziol, 8, 4, 4, neutral
557246302,  partenopeoswiss, 13, 6, 7, no
805885023983386627,  ubi_64, 2, 1, 1, neutral
2811563782,  Lastproud, 12, 6, 6, neutral
511569049,  SaraMuggittu, 9, 2, 7, no
1325259006,  paolocarucci6, 4, 2, 2, neutral
4076025623,  VezzaArianna, 17, 10, 7, yes
2853615520,  stendmamarco, 2, 1, 1, neutral
2305161806,  giusepp62820081, 4, 2, 2, neutral
783366855952064516,  giovannibacci36, 28, 13, 15, no
4833255767,  SaymoNDev, 2, 1, 1, neutral
130287541,  giopaolo78, 2, 1, 1, neutral
303873878,  FrancoMenci, 6, 3, 3, neutral
544376886,  lorenzosimo95, 16, 8, 8, neutral
496112346,  katrina1868, 22, 11, 11, neutral
4348068081,  pasqualedn94, 2, 1, 1, neutral
1013596488,  Caimano_Bianco, 2, 1, 1, neutral
1039846340,  GaetaCarlo, 5, 4, 1, yes
634892475,  VaiVieni, 22, 6, 16, no
396792186,  travaglioli, 2, 1, 1, neutral
1416485676,  claudio1novi, 2, 1, 1, neutral
2584467354,  CeramicheMusa, 4, 2, 2, neutral
790113096,  mattiabignotti, 4, 2, 2, neutral
1613251314,  Realmatte79, 9, 5, 4, yes
3393519423,  ombre_e_luci, 11, 8, 3, yes
3054702835,  k0dypaytner, 2, 1, 1, neutral
1068943938,  NatGermain, 6, 3, 3, neutral
485613378,  Rickytoro89, 2, 1, 1, neutral
610702664,  rogipaolo, 2, 1, 1, neutral
805714384664350722,  nik_stefano, 4, 2, 2, neutral
1080340506,  maxgalucio, 4, 2, 2, neutral
2956272873,  MRDOCCIA2015, 2, 1, 1, neutral
614259382,  conmatteorenzi, 6, 2, 4, no
2485596211,  IeeeMatteo, 6, 3, 3, neutral
108408660,  nasonekkkk, 2, 1, 1, neutral
373419503,  CassolaRobby, 8, 4, 4, neutral
3115909773,  GiuliaGarau3, 4, 2, 2, neutral
4382544027,  StefanoRaso3, 9, 3, 6, no
3902887697,  gianfrancotafu1, 3, 1, 2, no
3064929801,  A__UniqueFantas, 2, 1, 1, neutral
760996394085806080,  _pako_r, 4, 2, 2, neutral
2282069041,  maura_telefoni, 8, 4, 4, neutral
600836847,  IlariaCrr, 5, 3, 2, yes
153508813,  fabrizio1204, 2, 1, 1, neutral
101773481,  erpiffe, 2, 1, 1, neutral
4162822336,  Estiqaatsii, 2, 1, 1, neutral
255590800,  Tacco75, 2, 1, 1, neutral
4782734060,  CollesiCarlo, 5, 4, 1, yes
2195968707,  carlo_conforti, 2, 1, 1, neutral
713555902385795073,  WomenForTrump16, 4, 1, 3, no
727620218,  flamjr, 2, 1, 1, neutral
4774077809,  nadiadani72, 2, 1, 1, neutral
572654418,  di_rago, 6, 4, 2, yes
731165050883477513,  FctHerve, 8, 4, 4, neutral
307304083,  Gullolo, 2, 1, 1, neutral
3231673353,  m71433369, 2, 1, 1, neutral
897704491,  BrunelloEnrico, 2, 1, 1, neutral
2584971675,  francescopallu1, 2, 1, 1, neutral
2525924002,  paolo34722, 28, 14, 14, neutral
1551743478,  4SNYC, 3, 2, 1, yes
3062028275,  AndOr1957, 6, 3, 3, neutral
2458003712,  ciaoRenzi, 5, 4, 1, yes
805925755649724420,  adolfomontagna7, 2, 1, 1, neutral
262649381,  angelomagda, 6, 2, 4, no
801486367544999936,  GabriVr99, 4, 2, 2, neutral
3134709671,  bc0adfdba36f40e, 2, 1, 1, neutral
4185928505,  Faby1Lino, 13, 9, 4, yes
782343436217253888,  Mokadoor73, 4, 2, 2, neutral
3118329634,  GiacomoTrent, 2, 1, 1, neutral
799387885627699200,  federico_march, 2, 1, 1, neutral
3252748049,  fraempolirossi, 4, 2, 2, neutral
2712636045,  yhesum, 10, 5, 5, neutral
3010384533,  pdaniele6717, 46, 23, 23, neutral
429292267,  SabrinaPerugini, 2, 1, 1, neutral
2269438757,  studioprt_andre, 2, 1, 1, neutral
243702611,  clau2590, 2, 1, 1, neutral
2751395237,  DarkheartLilith, 2, 1, 1, neutral
482288941,  ingridbertuzzo, 2, 1, 1, neutral
778337270927589376,  nabocarabelli, 2, 1, 1, neutral
1360232750,  RobertoGiorni1, 2, 1, 1, neutral
4468274056,  tonelli2324, 12, 6, 6, neutral
389638623,  Riccardo_Urbani, 6, 3, 3, neutral
3130653400,  GavinoStara, 8, 5, 3, yes
699020578955661313,  lanzaluc, 12, 6, 6, neutral
2894830065,  DaForli, 7, 4, 3, yes
980662908,  marcoreggio72, 2, 1, 1, neutral
1300064047,  Antonio_28_8, 3, 2, 1, yes
3310355760,  malvaverbasco3, 14, 9, 5, yes
524568184,  skvorrechnik, 2, 1, 1, neutral
2359304625,  verrign, 4, 2, 2, neutral
1278366872,  StefanoZan8, 2, 1, 1, neutral
784408093199392768,  sabiavincenzo41, 2, 1, 1, neutral
3971583363,  maddalenagiann4, 4, 2, 2, neutral
4791845897,  GIANLUCASARDU3, 6, 3, 3, neutral
123983186,  RO23o3, 18, 9, 9, neutral
744453072601161728,  mariantferrante, 14, 4, 10, no
1372284787,  fadapo, 2, 1, 1, neutral
705550688,  MarcelloBozzett, 2, 1, 1, neutral
2895918321,  Seve191, 6, 3, 3, neutral
594855576,  GianlucaPagnon1, 9, 5, 4, yes
3878305648,  _kikasole_, 4, 2, 2, neutral
3291933754,  Marranna57, 6, 1, 5, no
844286359,  CdzpilLeotn, 5, 3, 2, yes
2766650681,  MattiaCiccola97, 3, 2, 1, yes
3009661173,  pierluigimazz, 3, 2, 1, yes
2367130164,  3CorsaroNero, 4, 2, 2, neutral
1286897317,  yubileo1, 8, 3, 5, no
1344746178,  maggipat, 6, 1, 5, no
2184516083,  CalamoFrancesco, 2, 1, 1, neutral
763745508905062400,  colombisilvano, 5, 3, 2, yes
776661546533519360,  tizianocamp, 2, 1, 1, neutral
467741436,  ILTEO_3, 2, 1, 1, neutral
2570957394,  semedada, 25, 6, 19, no
771412104364589056,  eugenio33792245, 2, 1, 1, neutral
427266614,  SqueriAndrea, 6, 4, 2, yes
717797844934082560,  sharingan33333, 4, 2, 2, neutral
1011351750,  alice_ARP_, 11, 6, 5, yes
2858986984,  giudittafab64, 4, 3, 1, yes
4908499649,  rosydl_1510, 15, 6, 9, no
379911441,  JosipTitoBroz, 2, 1, 1, neutral
347935119,  Bolixxx, 2, 1, 1, neutral
420409929,  andrealievore, 4, 1, 3, no
410999940,  albertochiodi, 2, 1, 1, neutral
2233536302,  robertoluciani6, 3, 2, 1, yes
168493532,  gmoniaci, 3, 1, 2, no
3308177390,  maurisa03, 3, 2, 1, yes
2498148194,  BETTONITIZIANA, 15, 6, 9, no
1086610302,  alb_ponti, 4, 2, 2, neutral
804064166118035465,  silvia230674, 4, 2, 2, neutral
721961955079102464,  papavero8, 11, 4, 7, no
22651555,  danieleviotti, 5, 3, 2, yes
1887780103,  Bruno_ilDuro, 6, 3, 3, neutral
2978631550,  AnnaPergolotti, 8, 4, 4, neutral
288854744,  versusluxlucis, 14, 7, 7, neutral
3332720836,  lilianagandolf2, 107, 55, 52, yes
972517489,  lm6sei, 2, 1, 1, neutral
866186785,  69magnus69, 4, 2, 2, neutral
1937739145,  PeterPanAbarth, 2, 1, 1, neutral
803924261450694657,  Gagiann, 2, 1, 1, neutral
2761525565,  volitans57, 2, 1, 1, neutral
1070582773,  GiuseppeDabliu, 6, 3, 3, neutral
3006382739,  WaniaPortesan, 2, 1, 1, neutral
2250869745,  FlavioVigna, 4, 2, 2, neutral
1063015987,  rossmandozzi, 4, 2, 2, neutral
1071054073,  kamarov5, 3, 2, 1, yes
734702972257632256,  thelumpur, 4, 2, 2, neutral
4915455880,  Proffantonio000, 12, 6, 6, neutral
370223450,  salvoflo, 12, 5, 7, no
154312263,  sanzogni, 8, 4, 4, neutral
754736825038692352,  Pecce80, 4, 2, 2, neutral
741394259996246016,  llagamiteuta, 2, 1, 1, neutral
748469128961351680,  CiroC70, 2, 1, 1, neutral
3058272267,  treppunti, 2, 1, 1, neutral
465446000,  caterinacasolar, 6, 3, 3, neutral
3687479603,  infopastore1, 12, 5, 7, no
942400728,  massimoxxx71, 6, 3, 3, neutral
1012205810,  And_CL, 20, 10, 10, neutral
2767354107,  perfectman28, 5, 3, 2, yes
515816348,  sabrinapaulett1, 2, 1, 1, neutral
733682452602998784,  alessia_cheeks, 4, 2, 2, neutral
585776607,  mauro_just, 7, 4, 3, yes
710209510263136257,  annamaria7456, 5, 3, 2, yes
1033539973,  Baldo90Gian, 7, 4, 3, yes
159463958,  HenryDvThoreau, 18, 9, 9, neutral
3207511185,  MariaElenaBozz1, 21, 7, 14, no
4233982072,  DoralvinoSena, 6, 3, 3, neutral
536317621,  franchino985, 6, 4, 2, yes
2360784420,  flavirostris, 6, 2, 4, no
29939358,  biancazzurra, 2, 1, 1, neutral
2355576961,  luigi_porcu, 17, 12, 5, yes
2593011755,  Maxcorba72, 2, 1, 1, neutral
2247093145,  fabiottofab, 7, 2, 5, no
4690285087,  Rospecita, 3, 2, 1, yes
452444300,  AlessioErcoli, 4, 2, 2, neutral
2600444834,  LegaNordPaderno, 6, 3, 3, neutral
2273740121,  fabriziolupi73, 8, 2, 6, no
494442505,  StePassia, 17, 12, 5, yes
419500576,  robegalli, 5, 1, 4, no
488843157,  Twtwtd, 2, 1, 1, neutral
2361085733,  DidimoChiavico, 7, 4, 3, yes
739124324003643392,  Boselligrg65, 10, 5, 5, neutral
754299309236117504,  intersilvia48, 4, 1, 3, no
3704155397,  cg91_cristina, 8, 4, 4, neutral
733743331218427904,  AngeloScelfo2, 14, 7, 7, neutral
2194497177,  GerriGuagliardi, 2, 1, 1, neutral
779791109916688384,  testinabuffa, 10, 5, 5, neutral
433227573,  Rinoga1, 3, 1, 2, no
3657009263,  Junioborghese1, 20, 11, 9, yes
3707558963,  alain_mottet, 2, 1, 1, neutral
726021120701378560,  FestolaiE, 3, 2, 1, yes
426177940,  Sim2509, 5, 4, 1, yes
1254526646,  ColombiColombi, 6, 3, 3, neutral
799937623309565952,  annagreco66, 4, 2, 2, neutral
743187888205078529,  CasariniR, 5, 2, 3, no
459317666,  MariaChiaraMia, 2, 1, 1, neutral
440739435,  davide_pezza, 10, 3, 7, no
524475101,  MarziaT89, 2, 1, 1, neutral
2299665593,  FiorenzoPasquin, 22, 12, 10, yes
1354757180,  Gedeone71, 3, 2, 1, yes
2984790724,  gli_smitho, 8, 4, 4, neutral
500775119,  VINCENZOPIRAIN1, 4, 2, 2, neutral
311097861,  Nicoletta20, 2, 1, 1, neutral
4456835435,  lamera_andrea01, 2, 1, 1, neutral
1098501367,  LetiziaGamberin, 58, 28, 30, no
2329023188,  mbyasana, 3, 2, 1, yes
1384017114,  danielesordi27, 23, 9, 14, no
4915761266,  Maurizi47420741, 2, 1, 1, neutral
3131977982,  manuguidoeg, 2, 1, 1, neutral
396743688,  micio1975, 12, 5, 7, no
29469037,  cettilipari, 10, 8, 2, yes
2943742474,  CarlottaCeraulo, 6, 1, 5, no
4906090593,  anitamonicam, 2, 1, 1, neutral
1934633809,  60_klaus, 4, 2, 2, neutral
456843561,  xhoransguitar_, 2, 1, 1, neutral
2980701230,  MafcasaC, 12, 6, 6, neutral
1587713820,  allebarro9988, 6, 3, 3, neutral
778717606085734404,  macriga3, 31, 16, 15, yes
1557557558,  aspettaaspetta, 14, 8, 6, yes
783978818994307072,  Wertigo6, 10, 5, 5, neutral
192527030,  matteocapecci, 6, 4, 2, yes
915385926,  cuprum49, 13, 5, 8, no
1162248949,  BigbBruno, 3, 2, 1, yes
136661991,  FrancesBean87, 4, 2, 2, neutral
4833362038,  Big_Bounce88, 2, 1, 1, neutral
713489735428124672,  jackhinson45, 2, 1, 1, neutral
17833020,  roberto_p, 2, 1, 1, neutral
462763787,  Papslupo, 2, 1, 1, neutral
208096106,  ElenaAntonutti, 4, 2, 2, neutral
4414257029,  masha_quodaf, 2, 1, 1, neutral
1049954743,  NPetrozzi, 4, 2, 2, neutral
4919338605,  ContrinoSonia, 2, 1, 1, neutral
813501954,  salineddi, 2, 1, 1, neutral
2421033249,  GPettoruti, 7, 3, 4, no
3022753349,  patrizia_lat, 7, 2, 5, no
725592726025154562,  Anielloportier1, 16, 6, 10, no
387317575,  snuffle_21, 2, 1, 1, neutral
2945794889,  dgallo1982, 9, 3, 6, no
1266543716,  GiaVincenzo, 4, 3, 1, yes
12946492,  paolodiazzi, 3, 1, 2, no
2871007730,  _grisdel_, 6, 2, 4, no
3030709558,  danydat1973, 2, 1, 1, neutral
329766972,  Maximo_Catena, 5, 2, 3, no
1361683034,  BrunoContebruno, 4, 1, 3, no
799947797319524352,  ispravnikovagl, 2, 1, 1, neutral
799974811468464128,  tatyanasign, 2, 1, 1, neutral
753909960568934400,  cellajjr, 2, 1, 1, neutral
749469043,  Gab_Buonanno, 2, 1, 1, neutral
554703131,  tuter71, 6, 3, 3, neutral
3153579224,  ErnestoNatali, 2, 1, 1, neutral
93719647,  gianlucagrossi, 10, 4, 6, no
289213386,  triplatau, 2, 1, 1, neutral
972003932,  ItaloPantaleone, 4, 1, 3, no
488749288,  MauroSutto, 4, 2, 2, neutral
500122789,  Diego_Maugeri, 25, 12, 13, no
24405108,  avvocatosocial, 5, 4, 1, yes
574661802,  GuccMassimo, 2, 1, 1, neutral
765484843580948484,  BrunellaPerosi2, 30, 15, 15, neutral
14854072,  a_barabotti, 4, 2, 2, neutral
1176935226,  ervenrossetti, 28, 14, 14, neutral
2765029378,  nadiamarino12, 2, 1, 1, neutral
243797423,  matteofficial7, 6, 3, 3, neutral
469580096,  dandrea_dandrea, 9, 4, 5, no
3183733485,  Runner70Fabio, 2, 1, 1, neutral
541061136,  lucazecchi1, 2, 1, 1, neutral
713420058735874048,  Franc6612Sniper, 2, 1, 1, neutral
1387466808,  di_monica75, 3, 1, 2, no
17043013,  x150163, 10, 6, 4, yes
765296385700880384,  RobinHo494112, 29, 15, 14, yes
782793637,  DavideSchiesari, 3, 1, 2, no
474738435,  paolodebellis, 2, 1, 1, neutral
505985485,  simoneferrigo, 4, 2, 2, neutral
995642131,  gio66_, 16, 6, 10, no
2363057508,  DamyEku, 27, 15, 12, yes
3369644489,  EdWarnerGK, 3, 1, 2, no
330466142,  nonguardare, 14, 7, 7, neutral
1482694699,  pakoerosa, 6, 4, 2, yes
3186952517,  Raffyfabiola, 5, 3, 2, yes
41689819,  actually_mitty, 8, 4, 4, neutral
529390496,  vdipasquale1978, 2, 1, 1, neutral
2472634306,  neo_dymium, 6, 2, 4, no
2676241551,  FornoNicoletta, 2, 1, 1, neutral
802257747089747969,  TrafalgarLaw993, 24, 12, 12, neutral
551753939,  Fieseler156, 6, 3, 3, neutral
702931234,  kironzola83, 16, 8, 8, neutral
2354862727,  elylon73, 24, 12, 12, neutral
862630590,  magni52, 4, 2, 2, neutral
345889075,  countryroads_, 2, 1, 1, neutral
1976455508,  AgAntonio1987, 4, 3, 1, yes
183283202,  GCugini, 7, 3, 4, no
2177455281,  JassiTappu, 12, 9, 3, yes
376346903,  51rolando, 2, 1, 1, neutral
482699264,  SFaricelli, 4, 2, 2, neutral
2189147798,  19Viper, 4, 2, 2, neutral
992998202,  capricornofede, 6, 2, 4, no
1008333511,  AlidaDodaj, 7, 6, 1, yes
717022003354583040,  Rosy1162, 16, 7, 9, no
3245335695,  AlessandraMado4, 6, 3, 3, neutral
792845943175544832,  NoescapeXX, 5, 3, 2, yes
776475984673505280,  domen904, 2, 1, 1, neutral
2290924705,  roberto_marcato, 6, 1, 5, no
51107478,  FabsNYC, 5, 2, 3, no
927399679,  melotuitto, 9, 5, 4, yes
1111810363,  TadeuszZawadzki, 10, 5, 5, neutral
728688476560953346,  Revenge810, 2, 1, 1, neutral
1393349078,  PeppaPerla, 2, 1, 1, neutral
2846724899,  ClaraGiorgianni, 9, 5, 4, yes
2257971076,  MonicaFacchin, 2, 1, 1, neutral
856094503,  KaosCalvo, 4, 3, 1, yes
428994978,  crisverardo, 2, 1, 1, neutral
1971485982,  GaiaC1985, 2, 1, 1, neutral
761818936614805504,  65prontotopo, 6, 1, 5, no
22053686,  CPayra, 2, 1, 1, neutral
3324994840,  mcicconetti04, 12, 6, 6, neutral
476123551,  DelfyDe, 4, 2, 2, neutral
825344622,  Ciucheba, 2, 1, 1, neutral
703967488866971649,  elettricmen, 2, 1, 1, neutral
4743526894,  AutismoMe, 2, 1, 1, neutral
789150741650747392,  politikro, 6, 3, 3, neutral
2758218200,  tulipano_95, 21, 10, 11, no
537966128,  pietro581982, 2, 1, 1, neutral
385132187,  asromamioamor, 15, 5, 10, no
440007375,  danilopitotti, 2, 1, 1, neutral
3035086786,  Stefano47232368, 3, 2, 1, yes
387317019,  falcorapace, 2, 1, 1, neutral
710097855600533505,  Giustinafiore1, 4, 2, 2, neutral
882473480,  bellia1950, 6, 1, 5, no
2813412750,  gcesarepaperini, 3, 1, 2, no
3044957079,  IIITALIA, 6, 1, 5, no
496410360,  MicheleMontagn2, 5, 3, 2, yes
327663056,  mariagraziatr, 9, 6, 3, yes
636836854,  EmanuelaTortini, 4, 2, 2, neutral
440146174,  Cinzia_Cy, 4, 3, 1, yes
1885715875,  RinnovamentoRPI, 9, 5, 4, yes
871790466,  FabriRandy, 6, 3, 3, neutral
350442512,  alycolombo, 4, 2, 2, neutral
400701610,  larosasteve, 7, 3, 4, no
748548630370521088,  bolyoussefbol, 2, 1, 1, neutral
776049461244129280,  mistervz1, 7, 4, 3, yes
525677912,  DanielaSita, 2, 1, 1, neutral
4067818708,  moreno_dasoghe, 3, 2, 1, yes
803689767170875392,  Ste6Bre, 6, 3, 3, neutral
486949275,  CZagli, 9, 5, 4, yes
734575718,  saviane_simone, 2, 1, 1, neutral
756969583286910978,  MTurbanto, 2, 1, 1, neutral
2191647477,  meni_luca, 2, 1, 1, neutral
429977509,  GiusyPlv, 2, 1, 1, neutral
198633968,  NevaBAlessio, 13, 6, 7, no
977118906,  antobruscjno, 2, 1, 1, neutral
715695040899710976,  r_fh_v, 6, 3, 3, neutral
1104348050,  Polis1Mirante, 2, 1, 1, neutral
1670142325,  DavideDosSantos, 2, 1, 1, neutral
1020900392,  gierrecrossteam, 2, 1, 1, neutral
282516991,  melo795, 4, 2, 2, neutral
538438773,  Eleonorabolly, 4, 2, 2, neutral
2821544499,  ZirafaRosario, 2, 1, 1, neutral
4771794274,  tocciangela1, 2, 1, 1, neutral
3093271402,  denis_saullo, 5, 2, 3, no
292063590,  carmelino75, 5, 2, 3, no
798181337433829376,  carlo34620830, 33, 7, 26, no
4441401076,  DZiruddu, 2, 1, 1, neutral
1272944370,  themaxy7, 8, 4, 4, neutral
205343190,  jonharrop, 2, 1, 1, neutral
872371680,  LiberoBubu, 4, 2, 2, neutral
48105077,  ddb231174, 2, 1, 1, neutral
1870936627,  LN_Lombardia, 2, 1, 1, neutral
1090201351,  mari_boh, 2, 1, 1, neutral
338578564,  gcambise, 4, 2, 2, neutral
793539264944467969,  FrEe_ThOuGhTs_1, 4, 2, 2, neutral
3077660185,  llorrrr111, 2, 1, 1, neutral
799566206239997952,  sonotimothy, 2, 1, 1, neutral
2363074416,  LegaNordMantova, 2, 1, 1, neutral
1231622995,  roberto18458, 4, 2, 2, neutral
340421086,  ermocolle, 2, 1, 1, neutral
1033288196,  VitoGiacobbe, 2, 1, 1, neutral
83396222,  Freddieafk, 3, 1, 2, no
4727119703,  mimmosid1, 2, 1, 1, neutral
146035482,  justlozucchelli, 3, 2, 1, yes
1353236228,  Giangidorsi, 4, 2, 2, neutral
846160848,  nadia_rag, 2, 1, 1, neutral
2182550725,  manuelamydream, 12, 6, 6, neutral
634088476,  Marco__Galli, 2, 1, 1, neutral
289838495,  dbareanet, 2, 1, 1, neutral
386154304,  bluesoluction, 11, 7, 4, yes
624137916,  stefaniabinucci, 38, 19, 19, neutral
2479914550,  a_austoni, 8, 4, 4, neutral
520377638,  maurogrosa, 26, 14, 12, yes
785481697462718465,  Stefy46e, 46, 31, 15, yes
447402626,  discarm, 2, 1, 1, neutral
1168703221,  rachele_bianchi, 5, 3, 2, yes
1254617204,  moschez, 4, 2, 2, neutral
4813826602,  Denise__87, 14, 7, 7, neutral
587623592,  EmanuelaLanati, 8, 4, 4, neutral
2406602790,  Bellis_Pietro, 2, 1, 1, neutral
2312096674,  DCORADELLO, 7, 5, 2, yes
418190204,  Begna77, 3, 2, 1, yes
714457631151296512,  mauromonti_ho, 3, 1, 2, no
701835995226968064,  Antonel93665749, 3, 1, 2, no
61180848,  carlindrianin, 2, 1, 1, neutral
794189382542589952,  JosephaLady, 3, 2, 1, yes
69573622,  elisaconte8, 2, 1, 1, neutral
2660179878,  ivangallo80, 5, 1, 4, no
798850938647683073,  kekkopalumb, 2, 1, 1, neutral
77705614,  gianlucaco, 2, 1, 1, neutral
3325181297,  MeMb90, 6, 3, 3, neutral
396563069,  winni_vincent, 5, 2, 3, no
718807833463123969,  Giomil2, 3, 1, 2, no
748396519024369664,  arnaldo_furioso, 4, 2, 2, neutral
2545066061,  GPeccolo, 8, 4, 4, neutral
1886063070,  EuroMasochismo, 3, 1, 2, no
754403068725301249,  peppe844, 10, 4, 6, no
1060051315,  vardema38, 2, 1, 1, neutral
1285422270,  MTurcheria, 4, 2, 2, neutral
708529654,  IngOddo, 7, 5, 2, yes
797117758538477568,  fabio80ave, 8, 4, 4, neutral
737142202481016832,  chidambara09, 5, 1, 4, no
442018464,  MatteoVenuto, 2, 1, 1, neutral
2679895724,  PINKROSEIT, 22, 11, 11, neutral
803010732,  stefanocimarell, 6, 2, 4, no
740257403178999808,  annabul62, 10, 2, 8, no
70353394,  Appalto, 11, 5, 6, no
376852479,  Monsa90, 6, 4, 2, yes
3381839055,  cereda1966, 2, 1, 1, neutral
4924054049,  Secondome2, 2, 1, 1, neutral
483235585,  srsilvy, 3, 2, 1, yes
434442622,  __LorenzoIorio, 3, 2, 1, yes
3556563795,  LucaIovine6, 2, 1, 1, neutral
2346948298,  glauco_santi, 3, 2, 1, yes
281573123,  jechil, 5, 3, 2, yes
417928621,  julianadelima22, 2, 1, 1, neutral
361808481,  Nemomnis, 10, 6, 4, yes
411800592,  GianlucaC_1986, 4, 2, 2, neutral
446445046,  SamueleMarcora, 26, 13, 13, neutral
1358915466,  ADUSBEF_Tanza, 5, 1, 4, no
1022925253,  marzia121394, 14, 7, 7, neutral
1061734838,  CrisPerazzolo, 2, 1, 1, neutral
1935212131,  amorosoyeah, 2, 1, 1, neutral
531664037,  xmaarcd, 2, 1, 1, neutral
2704662807,  figliolaraf45, 13, 2, 11, no
447067861,  BeppeFranco, 2, 1, 1, neutral
800566259561574401,  ValerioVolpi6, 13, 3, 10, no
1213959710,  FraSpro, 6, 3, 3, neutral
4523452875,  marcuskanebeard, 2, 1, 1, neutral
712430129763512325,  Aquilanik69, 19, 11, 8, yes
747288606608240644,  BrunaCo68441339, 2, 1, 1, neutral
617683,  caludio, 2, 1, 1, neutral
2898802661,  Retr0head, 4, 2, 2, neutral
33672617,  MarcoBellavia, 10, 5, 5, neutral
3344669734,  fraunetwork, 11, 5, 6, no
846045162,  TerryEmpyre, 26, 12, 14, no
794218079878266880,  biasetabon, 6, 2, 4, no
80525175,  KiaraLovisetto, 2, 1, 1, neutral
2735109711,  SalaminaSilvia, 59, 30, 29, yes
3290570284,  iolanda_pitti, 7, 3, 4, no
435153058,  l_taran, 6, 2, 4, no
2900737540,  amandascacchi, 7, 4, 3, yes
459517718,  musicante56, 2, 1, 1, neutral
587286512,  Ilpescatoredi, 4, 2, 2, neutral
734976214163726336,  GiusyCortese5, 4, 1, 3, no
527697823,  cassiocherea, 2, 1, 1, neutral
768313926459195392,  Laurasonoio3, 2, 1, 1, neutral
1702025438,  QueVincenzo, 7, 2, 5, no
2887871913,  1956Beatrice, 10, 5, 5, neutral
1035409813,  CarrienyNadia, 2, 1, 1, neutral
3064457183,  GBSanviti, 6, 3, 3, neutral
829177532,  PolinaKurochkin, 3, 2, 1, yes
497424753,  LupoErmes, 2, 1, 1, neutral
363401195,  LUCALANGELLA1, 3, 1, 2, no
340838889,  Nobucodanasar, 4, 2, 2, neutral
1520428920,  Sarha_Palermo, 2, 1, 1, neutral
1435200194,  AndreaGiaccone, 4, 2, 2, neutral
3438025775,  seth201227, 3, 2, 1, yes
788768928751349760,  ImmaConFurore, 6, 3, 3, neutral
3346507493,  GCapobianc, 2, 1, 1, neutral
3325251946,  cla76canepa, 17, 8, 9, no
74301788,  alex6882, 4, 3, 1, yes
4706971294,  NickCst89, 4, 2, 2, neutral
1036560565,  AFoccardi, 13, 8, 5, yes
778009182708662272,  Cristia72085893, 8, 4, 4, neutral
1632312498,  MarikaBoschetti, 4, 2, 2, neutral
789216204590309376,  Ha81630358, 2, 1, 1, neutral
443458193,  anTonycriscuolo, 4, 2, 2, neutral
784477672944635904,  nue2209, 2, 1, 1, neutral
3324571887,  maurodelfavero1, 8, 1, 7, no
360577953,  MatPretzel, 2, 1, 1, neutral
2289972189,  francorol1, 9, 3, 6, no
119595905,  brenosalvador, 3, 2, 1, yes
3577040423,  pgceccoli, 4, 2, 2, neutral
2950133739,  serventi58, 7, 4, 3, yes
962724564,  mancardi1, 3, 2, 1, yes
1565438304,  anoichtomyalo, 2, 1, 1, neutral
275434452,  aldebaran1973, 8, 4, 4, neutral
1603000872,  italiankonrad, 2, 1, 1, neutral
701456941894266884,  CristianoTomma2, 5, 4, 1, yes
780444222,  voghera57, 2, 1, 1, neutral
987298224,  micherutigliano, 2, 1, 1, neutral
583894749,  toniomonda, 10, 5, 5, neutral
548252030,  LucaMatera1, 2, 1, 1, neutral
2773268453,  73luke73, 11, 8, 3, yes
2389161486,  Roberta_P68, 4, 1, 3, no
702339929,  caleffi252, 2, 1, 1, neutral
2169476813,  CBorgonetti, 18, 9, 9, neutral
4053925588,  MauroB06, 2, 1, 1, neutral
789223655825891328,  castyseba, 4, 2, 2, neutral
4000962629,  SamueleDegradi, 4, 3, 1, yes
2715689925,  DelgadoSveva, 4, 2, 2, neutral
2349319657,  cap750, 6, 3, 3, neutral
328571750,  valentinacerri1, 2, 1, 1, neutral
759383486730043392,  stefsab1953, 11, 6, 5, yes
403629825,  3Ghigo, 2, 1, 1, neutral
713848672514129920,  axelaxel09370, 2, 1, 1, neutral
785027790961778688,  nerobastard, 5, 2, 3, no
789046049788821504,  IaconoLia, 3, 1, 2, no
1034360414,  cantoni_ilaria, 4, 2, 2, neutral
732223510546767872,  DyamesZ, 2, 1, 1, neutral
418776445,  alessandracam04, 3, 2, 1, yes
1586673164,  colatre1, 13, 4, 9, no
801087171516137472,  francescocorrad, 2, 1, 1, neutral
418772810,  IvanoBressan, 15, 3, 12, no
2837054753,  salento90, 10, 5, 5, neutral
2184340668,  AngeloERipamont, 2, 1, 1, neutral
1262346223,  bfmprivate1, 2, 1, 1, neutral
318030346,  dimafab67, 5, 1, 4, no
1257792655,  alberto_zanella, 2, 1, 1, neutral
794575248343650304,  Lelevia18763, 3, 2, 1, yes
3000195293,  MelaniaStylly, 3, 2, 1, yes
335910785,  Frenzgyn, 2, 1, 1, neutral
164472951,  paradisonewfs, 2, 1, 1, neutral
1123214964,  delmastrosimone, 2, 1, 1, neutral
2943393603,  pidioiscariota, 15, 8, 7, yes
454314015,  MarcoArmani3, 2, 1, 1, neutral
491233877,  Mrbass69, 4, 2, 2, neutral
962049919,  vsb516, 2, 1, 1, neutral
700407039290433537,  isa_pausini, 2, 1, 1, neutral
440896779,  RosarioMancino, 6, 3, 3, neutral
2588023931,  angscalzi76, 5, 3, 2, yes
3420330395,  Igor_Kvashnin, 10, 5, 5, neutral
2594391310,  AntoPistore, 8, 4, 4, neutral
598092190,  kikkaferrari, 2, 1, 1, neutral
397853516,  ferroice40, 20, 8, 12, no
862825945,  AnaRoselli1, 13, 9, 4, yes
482329441,  saravo28, 6, 3, 3, neutral
423416522,  claudioarch01, 5, 2, 3, no
114142301,  viniesrk, 2, 1, 1, neutral
4563172516,  gcrescenzo95, 6, 3, 3, neutral
802097584332558336,  CassandraSere, 7, 3, 4, no
760072132680384512,  malpensamxp, 3, 2, 1, yes
790097962978467840,  GabrieleBeglio2, 6, 3, 3, neutral
882872700,  Maxkent55, 20, 10, 10, neutral
761151413330255872,  CorradoPluchin1, 5, 2, 3, no
2339096091,  BryanHollis2, 3, 2, 1, yes
701156972364701696,  MarcolandoM, 7, 2, 5, no
214127409,  marcomiglio, 4, 3, 1, yes
355110852,  ramone2263, 3, 2, 1, yes
418628923,  pcolombin, 9, 5, 4, yes
543597645,  HeelLeClech, 13, 9, 4, yes
2365607444,  MaxMusolin, 2, 1, 1, neutral
723218846669279232,  verdesmeraldo66, 2, 1, 1, neutral
740557397668794372,  minni_arnaldo, 4, 2, 2, neutral
723774902,  BrogliaMarina, 8, 4, 4, neutral
2407034685,  CcopparoCopparo, 7, 4, 3, yes
2282636046,  PRATIMANUELA, 2, 1, 1, neutral
2166276905,  AIannello53, 2, 1, 1, neutral
3167105703,  LinaManiglio, 8, 4, 4, neutral
805856142337445888,  matteoeatparty, 2, 1, 1, neutral
22130055,  davidepelagotti, 2, 1, 1, neutral
418657781,  evaloveless, 2, 1, 1, neutral
804413937907208192,  Alessan04156164, 31, 15, 16, no
721768323013308416,  frensis_a, 2, 1, 1, neutral
4825492343,  SamyOfficial10, 7, 4, 3, yes
377957560,  Youzaofthecloud, 3, 2, 1, yes
335259143,  gianluigimusso, 2, 1, 1, neutral
805799470793363456,  Svitoreon, 3, 1, 2, no
186390637,  AndreBellins, 9, 5, 4, yes
1133933233,  Federico2361, 2, 1, 1, neutral
246735877,  iltaba74, 2, 1, 1, neutral
2984349707,  furlrobyn, 2, 1, 1, neutral
2225786343,  armandopiu, 8, 3, 5, no
1241451222,  federic42966780, 12, 6, 6, neutral
2208789310,  rumar55, 7, 3, 4, no
1224996284,  Sercit1, 10, 8, 2, yes
103707187,  Samu_Brignone, 2, 1, 1, neutral
411368819,  ByronLaura, 3, 1, 2, no
525868277,  alexeia65, 2, 1, 1, neutral
2157546163,  nbshay, 6, 3, 3, neutral
800979325042495492,  paolopietro9, 5, 1, 4, no
956046367,  marcococchieri1, 2, 1, 1, neutral
3086975528,  lorella1959, 13, 6, 7, no
806116418827784192,  sarakarinas, 2, 1, 1, neutral
102516490,  EarlMountChrist, 14, 4, 10, no
3757693157,  egicon, 6, 3, 3, neutral
705131585650233345,  Alessan17976637, 4, 2, 2, neutral
2834429895,  VenturiStefano2, 6, 3, 3, neutral
702953522602635264,  Osservacritico, 3, 2, 1, yes
31443063,  daniele_schiavo, 2, 1, 1, neutral
154179790,  alexya_01, 4, 2, 2, neutral
2686959970,  metaurense, 3, 2, 1, yes
237680524,  massimoardu, 9, 5, 4, yes
732631010505035777,  danfrige, 2, 1, 1, neutral
805896020160839680,  Lory34817318, 2, 1, 1, neutral
801315350759571457,  listentothehowl, 2, 1, 1, neutral
338887809,  aquilotti2005, 2, 1, 1, neutral
2876447163,  Gigiu2014, 3, 1, 2, no
4257980746,  ilSansev, 2, 1, 1, neutral
997512960,  murgiante, 2, 1, 1, neutral
585531943,  RiccardoVerbena, 4, 2, 2, neutral
520451294,  roxsasso, 2, 1, 1, neutral
1386459625,  Antoine_Beretto, 4, 2, 2, neutral
462825642,  Renzafedi, 2, 1, 1, neutral
2972871628,  mostardapazza, 2, 1, 1, neutral
912884119,  LucaDuci, 2, 1, 1, neutral
15493824,  GraziaCiraulo, 2, 1, 1, neutral
1200217218,  RiccardoTornabe, 2, 1, 1, neutral
544221226,  rosyrock47, 7, 2, 5, no
1156872888,  dimabof, 2, 1, 1, neutral
524735883,  lieberboy2, 16, 9, 7, yes
480257030,  MARYVIGOLO, 4, 2, 2, neutral
459441699,  massybox32, 7, 5, 2, yes
1070696468,  danigre74, 9, 5, 4, yes
1227597085,  vincenzo_fulco, 2, 1, 1, neutral
2513123235,  assuntabolognes, 2, 1, 1, neutral
234659784,  gocedimemoria, 7, 3, 4, no
137003322,  cardmyk, 5, 1, 4, no
1104681986,  nutella_e, 2, 1, 1, neutral
200648626,  gabrieleporri, 10, 2, 8, no
1283299418,  Lo_speziale, 7, 2, 5, no
2985400847,  bonatiriccardo, 12, 5, 7, no
1330971246,  mr_gianf, 6, 3, 3, neutral
355815507,  GiGeena, 2, 1, 1, neutral
721825898492768256,  aleemeror, 5, 3, 2, yes
405646675,  MarcuAlina, 6, 3, 3, neutral
780690044730220544,  fierdlametera, 5, 2, 3, no
364734939,  PDiotti, 2, 1, 1, neutral
4485269080,  andrea_cavucci, 7, 1, 6, no
415071140,  caorle44, 6, 1, 5, no
1074692840,  MariGuidi1, 12, 6, 6, neutral
3387927328,  GironeInsulti, 2, 1, 1, neutral
566597018,  Real_Pantheist, 2, 1, 1, neutral
3816278301,  ismaela75987549, 2, 1, 1, neutral
3011969224,  MarcDuteil, 2, 1, 1, neutral
144804860,  incorreggibile, 4, 2, 2, neutral
2370723536,  aiardi1, 5, 2, 3, no
579867137,  ddcommerciale, 9, 3, 6, no
1647815504,  giudylove9, 2, 1, 1, neutral
776184950068539392,  mortimerquigle1, 4, 2, 2, neutral
780108429989933056,  SpigolonRomina, 3, 2, 1, yes
764509784,  GmailRocco, 3, 1, 2, no
2396856942,  MarcelloBotzo, 6, 1, 5, no
740628601,  BenettonAlberto, 2, 1, 1, neutral
754537377402683392,  LINO57424564, 6, 3, 3, neutral
574615765,  domex69, 2, 1, 1, neutral
945543793,  c77cadornino, 2, 1, 1, neutral
2853912412,  36cee214f12a482, 3, 2, 1, yes
124567136,  p4ul12, 4, 2, 2, neutral
799316434581078016,  Angelo82815190, 4, 2, 2, neutral
410892254,  CicciBignotti, 7, 1, 6, no
2540154332,  Sabrina_Simbula, 6, 3, 3, neutral
800326102170222593,  Paolo34600052, 6, 3, 3, neutral
270383019,  Michele_Alle, 4, 2, 2, neutral
21585856,  sallydibben, 6, 3, 3, neutral
198635466,  toti797979, 4, 2, 2, neutral
733258234069458945,  EnricoGaido, 9, 5, 4, yes
458708195,  GLucaTempesta, 5, 3, 2, yes
16905927,  mercedesbresso, 4, 2, 2, neutral
395520606,  LuciaDellaCeca, 7, 4, 3, yes
801741532218925056,  Luca_illy, 3, 1, 2, no
3707276548,  Dario3174, 2, 1, 1, neutral
3080004435,  gianni_damore, 11, 4, 7, no
792762283697004544,  iovotoNoSicilia, 8, 4, 4, neutral
792352719499657216,  VotaSalviniRoma, 8, 4, 4, neutral
792385901586477056,  iovotoNoUk, 8, 4, 4, neutral
791569798790582272,  LegaperItalia, 9, 4, 5, no
792349473548697600,  votaSalviniFI, 9, 4, 5, no
799185920939401217,  votasalviniumbr, 8, 4, 4, neutral
799197884361166848,  PremierSalvini, 8, 4, 4, neutral
799171599828131840,  VotaSalviniSici, 8, 4, 4, neutral
792394614665801728,  IovotoNoFrancia, 8, 4, 4, neutral
771997084039929856,  nessuno150757, 5, 1, 4, no
802966505084297216,  Andrea_Recussi, 6, 5, 1, yes
815134452,  sergiolinari1, 3, 1, 2, no
441483457,  iamfrankie79, 5, 2, 3, no
3852509535,  ruggieri1969, 2, 1, 1, neutral
757644822748524544,  is918214, 4, 2, 2, neutral
798254657982316544,  fabiocomo1, 2, 1, 1, neutral
34051388,  investe, 6, 3, 3, neutral
800828943540617216,  Luca12157120, 8, 4, 4, neutral
811059932,  LaraTelli, 3, 2, 1, yes
2787878581,  BarbascuraX, 3, 1, 2, no
2842875700,  Jamuninda, 9, 7, 2, yes
800431749691949056,  robertoXXVIII, 2, 1, 1, neutral
428515597,  G_Valditara, 30, 11, 19, no
612741838,  daniel_italy, 7, 4, 3, yes
520552470,  Sandro_Marci, 2, 1, 1, neutral
504993602,  giustribuzio, 5, 3, 2, yes
785540126277570560,  sindaciperilno, 10, 3, 7, no
1386643028,  alessioguaita1, 2, 1, 1, neutral
1052352102,  SaborPepe, 16, 5, 11, no
526450548,  mariomcc14, 14, 7, 7, neutral
3336826373,  boscoaa, 2, 1, 1, neutral
1030566912,  i_giovannigra, 11, 3, 8, no
1914960499,  RVestri80, 44, 9, 35, no
2349893558,  brasov4, 9, 2, 7, no
800327474106101761,  ConcettaSardo, 8, 7, 1, yes
3723326176,  giancapiccione, 21, 12, 9, yes
801407727608229888,  Mariann04499294, 2, 1, 1, neutral
101180833,  sulcismassi, 2, 1, 1, neutral
1249188547,  HowGio, 2, 1, 1, neutral
366565632,  MarcoBombagi, 4, 2, 2, neutral
581973855,  FedeGarofalo, 3, 1, 2, no
2732822847,  segale57, 4, 2, 2, neutral
4012699222,  lorenzodoredor1, 2, 1, 1, neutral
479864876,  Yvstagram24, 5, 3, 2, yes
782902869125107712,  NemoRai2, 2, 1, 1, neutral
456534097,  GretaCarpani, 2, 1, 1, neutral
513497583,  TwittGiorgio, 12, 4, 8, no
340499894,  SimoneParigi, 2, 1, 1, neutral
573590858,  EmoDanesi, 2, 1, 1, neutral
1668627061,  Chicca_Fee, 2, 1, 1, neutral
478637914,  DarioSG77, 2, 1, 1, neutral
2732066485,  menneag2, 2, 1, 1, neutral
803711058779271168,  Iose14432990, 5, 2, 3, no
2787508709,  giovannipispico, 15, 7, 8, no
131539907,  JulianShaft, 2, 1, 1, neutral
360836115,  luciano_cent, 2, 1, 1, neutral
197381599,  Marzia_M, 5, 2, 3, no
596584630,  albesanocarr, 2, 1, 1, neutral
837322579,  maxceand, 4, 2, 2, neutral
2862176308,  SyannacSyanna, 2, 1, 1, neutral
1027404487,  MSator, 18, 10, 8, yes
29460968,  Borlandelli, 10, 6, 4, yes
3179936722,  ruffatomassimo2, 8, 4, 4, neutral
2772505510,  max_luise, 3, 1, 2, no
51075496,  Luca_Gas, 2, 1, 1, neutral
2256910438,  fb76GC, 2, 1, 1, neutral
2364603574,  SoccorsiG, 22, 3, 19, no
1040080075,  asofort, 8, 3, 5, no
734861008494284802,  DanielRosserti, 2, 1, 1, neutral
2427478331,  marisa_pace, 3, 1, 2, no
795330348544561152,  raffaelegalass5, 6, 3, 3, neutral
804333475616669697,  AnonimusUff, 7, 4, 3, yes
360854210,  davide9610, 2, 1, 1, neutral
2203598177,  noeminiall, 4, 2, 2, neutral
3025617939,  melomitru, 2, 1, 1, neutral
183188797,  MrsAlleD, 2, 1, 1, neutral
537525524,  valeriosaitta1, 2, 1, 1, neutral
438650704,  AndreaDanield, 2, 1, 1, neutral
1073181979,  AmiconeL, 2, 1, 1, neutral
144164308,  hanndea, 4, 2, 2, neutral
511895027,  r_giada, 9, 5, 4, yes
891793094,  t_1950, 2, 1, 1, neutral
398249487,  HarrisonPala, 4, 2, 2, neutral
1250205410,  Matilde_Miriam, 6, 3, 3, neutral
803249243242766336,  StefanoV1973, 2, 1, 1, neutral
488405515,  Fraettam, 2, 1, 1, neutral
68410341,  ilCoppi, 3, 2, 1, yes
633960487,  nioi_walter, 6, 4, 2, yes
742027791990968320,  angeloanauel, 13, 6, 7, no
1108981674,  RitaPasella, 7, 4, 3, yes
632324504,  EttaLisetta, 4, 1, 3, no
1069157588,  FioreDiLoto01, 2, 1, 1, neutral
2533331341,  RuskaBln, 2, 1, 1, neutral
1254834728,  AndryspeedPiva, 8, 4, 4, neutral
785907890011840513,  CBrunonanni, 5, 2, 3, no
743129759228547073,  Fede_Gras_2001, 2, 1, 1, neutral
2312712778,  DarGo33, 4, 2, 2, neutral
782560226117550080,  raffyclarelli74, 2, 1, 1, neutral
770373972013768704,  Lorego77, 2, 1, 1, neutral
592100212,  VTansella, 2, 1, 1, neutral
2273249119,  _elysun, 4, 1, 3, no
2841263939,  Bernattia, 6, 2, 4, no
415056338,  mariavilll, 2, 1, 1, neutral
2829581531,  Cristopher_2015, 2, 1, 1, neutral
2449219440,  trevisani_mauro, 6, 3, 3, neutral
2361959873,  CiroSterchele, 15, 3, 12, no
70833127,  ErsteKrieger, 2, 1, 1, neutral
782658311812321280,  SRemoVotaNO, 4, 2, 2, neutral
797161661283045376,  RoMario975, 4, 1, 3, no
3230455617,  lialagiulia, 4, 2, 2, neutral
2375301992,  DaniMazzaferri, 4, 1, 3, no
3292928026,  fabrizioesabri, 4, 2, 2, neutral
1565412319,  RecineMichele, 17, 7, 10, no
779268696942477312,  NickBirbante, 6, 3, 3, neutral
49522536,  MPOLESEL, 6, 3, 3, neutral
533588637,  gustadoloz, 2, 1, 1, neutral
4244881703,  MartinoGerry, 15, 8, 7, yes
497752969,  LorenzoSchiliro, 7, 3, 4, no
752617406191767552,  Arzente_LV, 5, 2, 3, no
28620133,  mattiacantalu, 2, 1, 1, neutral
3248553891,  gioiananardi, 2, 1, 1, neutral
429784273,  Matteotrab, 4, 3, 1, yes
773264636695248897,  Vincenz11168285, 4, 2, 2, neutral
805247118,  simonepeppe61, 4, 2, 2, neutral
803177377337638912,  benitovitas, 2, 1, 1, neutral
493887925,  VincenzoCarr, 12, 6, 6, neutral
3479763803,  GFubi, 2, 1, 1, neutral
772134035736948736,  Faiella18, 4, 2, 2, neutral
68161227,  fabiogigli, 6, 2, 4, no
304203375,  Flavioptrainer, 3, 2, 1, yes
231824254,  Tellusfolio, 11, 6, 5, yes
970936674,  Nikgood58, 5, 3, 2, yes
1066352318,  nosilence51, 2, 1, 1, neutral
627317336,  30mirella51, 29, 14, 15, no
1227799914,  FulgieriAntonio, 14, 8, 6, yes
738491898688622592,  Simonet09059430, 43, 19, 24, no
3296712448,  alby07088, 4, 2, 2, neutral
4846861661,  CtoLily, 4, 2, 2, neutral
139404669,  manuelaiati, 2, 1, 1, neutral
4128320595,  folletto1966, 2, 1, 1, neutral
1537629752,  guiller_rrc, 2, 1, 1, neutral
2594626578,  europafreunde, 2, 1, 1, neutral
3662356395,  stregatto1965, 88, 32, 56, no
3482352141,  ritamattiello70, 2, 1, 1, neutral
2554846117,  UomodiMelma, 3, 1, 2, no
405430528,  fra_c22, 10, 1, 9, no
512510277,  Angel1978A, 2, 1, 1, neutral
439546722,  AngeloCerchiara, 2, 1, 1, neutral
761859689646854144,  Claudiomerlo8, 10, 5, 5, neutral
33869513,  IL_Ronca, 2, 1, 1, neutral
498952433,  ChryTheking, 10, 3, 7, no
1540881331,  MissSamyJu, 6, 3, 3, neutral
918959929,  Dragunov79, 4, 2, 2, neutral
219273566,  giuanlortista, 9, 1, 8, no
464551146,  LiaZanchetta, 4, 2, 2, neutral
276685772,  twinsnutz, 8, 5, 3, yes
1235548266,  Paolo63pa, 3, 1, 2, no
2978229425,  miky1945, 14, 9, 5, yes
787939607199543296,  Pierino1900, 2, 1, 1, neutral
328966256,  claraspada, 11, 4, 7, no
845878441,  AAlbertomarco, 8, 4, 4, neutral
4827579454,  Roberto83438248, 2, 1, 1, neutral
271466783,  LoMassi, 4, 1, 3, no
2273438286,  I_liveOnTipto, 2, 1, 1, neutral
108876723,  gaetiannone1971, 5, 1, 4, no
1396824866,  mikpedicini, 10, 5, 5, neutral
348079509,  primula_57, 3, 2, 1, yes
230054388,  il_Parods, 5, 3, 2, yes
995457626,  LippolisA, 12, 5, 7, no
588560361,  WemFolgstDu, 2, 1, 1, neutral
4320139042,  MaurizioPablo28, 2, 1, 1, neutral
2371021127,  Straygat67G, 4, 3, 1, yes
102998244,  wizardxp, 2, 1, 1, neutral
238514182,  reglaci, 2, 1, 1, neutral
106993932,  gab_er, 4, 2, 2, neutral
797018028160466944,  Luisana483, 4, 2, 2, neutral
737691796701097985,  peppinobordone1, 3, 1, 2, no
789571984090890241,  Roby87843303, 4, 2, 2, neutral
1221955844,  sintesi160, 13, 3, 10, no
548276767,  RonnyBandiera, 6, 1, 5, no
485772542,  Sonoinnocentema, 2, 1, 1, neutral
798918340999872512,  arrigocalaon, 2, 1, 1, neutral
798573571723423744,  IvanLyon9, 3, 1, 2, no
2595713404,  TorelliJessica, 2, 1, 1, neutral
733973547006201857,  adriano_lubrano, 2, 1, 1, neutral
3090189012,  savi_con, 3, 1, 2, no
2188028648,  gp1val, 12, 6, 6, neutral
4853860876,  claudina_1992, 4, 2, 2, neutral
783745267707281408,  Pietronucciogm1, 7, 1, 6, no
3026180648,  Barolo016, 2, 1, 1, neutral
3332678698,  tiziana06914338, 2, 1, 1, neutral
4646366962,  MariaFe21645042, 2, 1, 1, neutral
2354315379,  roberto_corazza, 5, 2, 3, no
3242759890,  bartsara44, 2, 1, 1, neutral
711343781644255233,  Katiushja2, 11, 3, 8, no
1578013482,  Fa36536897, 3, 2, 1, yes
1257876535,  marbot62, 2, 1, 1, neutral
2850858044,  claudiogiusepp4, 4, 2, 2, neutral
458561527,  GFratantonio, 5, 4, 1, yes
941538781,  marisaantonell1, 4, 2, 2, neutral
233531154,  mayfrayn67, 13, 6, 7, no
4525011809,  tonipiazza67, 12, 3, 9, no
1250057473,  DeDeniseam, 4, 2, 2, neutral
40433343,  NikeSkywalker, 2, 1, 1, neutral
4480785615,  MatteoCast1996, 3, 2, 1, yes
1209522866,  EttoreFieram, 9, 5, 4, yes
804131581996711936,  iko95, 4, 2, 2, neutral
4220464763,  anastasiassenza, 8, 4, 4, neutral
3909811461,  RosellinoX, 2, 1, 1, neutral
779986090707021824,  willybion, 13, 3, 10, no
3207456845,  GiorgioMoltedo, 8, 2, 6, no
2347588247,  arciros, 6, 5, 1, yes
990990421,  dinofarnesi, 4, 2, 2, neutral
48314078,  joike94, 2, 1, 1, neutral
56341776,  rtl1025, 18, 9, 9, neutral
1362506611,  ToneZanin, 2, 1, 1, neutral
1427892332,  LegaNordBiella, 2, 1, 1, neutral
2775356381,  ion_iuliana, 2, 1, 1, neutral
2193774492,  roberto_ruscio, 17, 8, 9, no
2517329992,  BannoCinzia, 2, 1, 1, neutral
1019978210,  giuliaantoniaz1, 2, 1, 1, neutral
2376789387,  PattyRav, 4, 2, 2, neutral
779789249407254528,  cicciogiovinazz, 8, 4, 4, neutral
394604317,  JackalBourne, 6, 3, 3, neutral
1157260398,  MirabileNino, 3, 1, 2, no
775433824419323904,  Paraski4, 5, 4, 1, yes
3231784599,  340_746, 6, 5, 1, yes
554418383,  Matteo_Mossini, 4, 2, 2, neutral
2755415371,  FCesarani, 2, 1, 1, neutral
2903764937,  515e0cb5b1624f3, 4, 2, 2, neutral
137656374,  StefanoAugeri, 6, 3, 3, neutral
375762278,  M_GHISA, 2, 1, 1, neutral
124827192,  fedebonny86, 2, 1, 1, neutral
781079934953545728,  DonnaROSANNA3, 2, 1, 1, neutral
541061131,  cristianbattis3, 8, 3, 5, no
1935534786,  IlPrimatoN, 3, 2, 1, yes
1196533130,  farneseantonio, 3, 1, 2, no
4209118828,  fiorialsole15, 8, 1, 7, no
2238482374,  russoDomenico12, 2, 1, 1, neutral
2921948057,  zazagab2, 47, 22, 25, no
2509032243,  marialuisa6512, 4, 2, 2, neutral
3399828537,  gaiaiero, 2, 1, 1, neutral
703201383151894528,  Gianni0254, 2, 1, 1, neutral
1696619809,  a70199617, 17, 2, 15, no
1282936026,  maluborghesan, 7, 4, 3, yes
35700426,  vincenzostante, 6, 3, 3, neutral
7844932,  francescorusso, 2, 1, 1, neutral
863413130,  ivanmartelli, 5, 2, 3, no
1693239398,  althione, 4, 2, 2, neutral
2464644067,  raimond47200525, 2, 1, 1, neutral
334314844,  AntonioAumenta, 2, 1, 1, neutral
888895441,  flagstarr, 7, 3, 4, no
1446113083,  BonaldiGregorio, 11, 6, 5, yes
3310777829,  NicoloTiziana, 15, 10, 5, yes
3060221337,  EfrullaFrulla, 10, 5, 5, neutral
730213884,  MgpBiella, 2, 1, 1, neutral
3242262521,  agmiami731, 4, 2, 2, neutral
2369421951,  molinello29, 4, 2, 2, neutral
755104913139568643,  1956080Stefano, 2, 1, 1, neutral
851981688,  anna_dtt, 5, 3, 2, yes
1381292604,  scrici58, 4, 2, 2, neutral
999071468,  manuel_shinobi, 4, 3, 1, yes
714874000900534272,  MMicsey, 4, 2, 2, neutral
1542748586,  giucal1964, 2, 1, 1, neutral
419721045,  sabrinasimone1, 2, 1, 1, neutral
529431381,  BRUGALISIMONE, 28, 8, 20, no
749314056981508096,  TheSweetPi, 2, 1, 1, neutral
172034177,  lollozeta_, 4, 2, 2, neutral
1679279490,  AmelieBaldwin, 6, 3, 3, neutral
1435095462,  DonazzanElena, 7, 4, 3, yes
3314962654,  erfoggiadezeman, 8, 3, 5, no
780691170,  LucaChi1974, 4, 2, 2, neutral
418208091,  Roby_Carrara, 2, 1, 1, neutral
705451641,  AndreaMonfroni, 28, 4, 24, no
83580262,  Pippo_1, 8, 4, 4, neutral
559409782,  VinGalante, 5, 1, 4, no
787716989578084352,  MassoniLuca, 6, 3, 3, neutral
1213703198,  rosamariadiperi, 2, 1, 1, neutral
3107605546,  paolasinger70, 13, 5, 8, no
1640889865,  LRiccomini, 2, 1, 1, neutral
1127641164,  bararcella, 2, 1, 1, neutral
491284250,  FabioMassiConti, 5, 2, 3, no
1064367553,  SundanceDAmore, 18, 8, 10, no
592180278,  CALAMBAI, 2, 1, 1, neutral
553669897,  adrianoastarita, 2, 1, 1, neutral
795739255440048128,  mortisia2708, 6, 2, 4, no
1863592734,  BagoniaSonia, 2, 1, 1, neutral
2766295492,  matteoferrari99, 6, 3, 3, neutral
2324568928,  LascioTd, 2, 1, 1, neutral
24378422,  vitielg, 2, 1, 1, neutral
789186232668467200,  DanieleLomarti1, 2, 1, 1, neutral
802627578733481986,  adrianadevita3, 2, 1, 1, neutral
531605585,  ilariacerullo, 3, 2, 1, yes
3257520543,  masoni_pm, 10, 5, 5, neutral
628761443,  BrandonBecket, 3, 2, 1, yes
719506179140018176,  jdelduca_92, 6, 4, 2, yes
2229837643,  RubenBelloSi, 2, 1, 1, neutral
4872700582,  AntonelloMorel3, 7, 4, 3, yes
591983888,  GioLombar, 21, 5, 16, no
1177715444,  RobertoMannone1, 4, 2, 2, neutral
3948938717,  gabrieleparati1, 4, 3, 1, yes
4850517705,  saunetta1, 2, 1, 1, neutral
864123438,  maxtrot68, 6, 1, 5, no
719307983856001029,  GoldenFauvi, 3, 1, 2, no
38693247,  1Tipsy, 7, 4, 3, yes
2257560786,  ValerioC1, 3, 1, 2, no
969973250,  noeuro1, 5, 3, 2, yes
1278423985,  trecchinese, 7, 2, 5, no
1160092471,  EMAVR77, 2, 1, 1, neutral
2751256629,  BerziLiliana, 28, 6, 22, no
2469663349,  Massimo_Bals, 6, 3, 3, neutral
339843569,  mauriziomatte, 4, 2, 2, neutral
749278841785479168,  Marteulet, 2, 1, 1, neutral
4851132789,  valy79y, 2, 1, 1, neutral
107881446,  gianjohn, 2, 1, 1, neutral
712081496,  beppemicelli, 16, 7, 9, no
2161237879,  Almita_1985, 2, 1, 1, neutral
1349576227,  kekkoevo80, 2, 1, 1, neutral
77031813,  Linus2k, 8, 3, 5, no
3931969841,  Ardito80054160, 73, 36, 37, no
2461382070,  Andrea87818276, 10, 8, 2, yes
2166645995,  swordy05, 9, 2, 7, no
757586822134394880,  CesareBianco, 2, 1, 1, neutral
1032520350,  tommaso_addabbo, 17, 1, 16, no
115034368,  IoMirka, 4, 2, 2, neutral
772396926197170176,  spinapatrizia65, 2, 1, 1, neutral
2756645690,  antonellafrezz5, 5, 2, 3, no
559165254,  RomoloRicapito, 2, 1, 1, neutral
3033453713,  Oznets12, 2, 1, 1, neutral
2221381507,  PANGKAKISTOS, 2, 1, 1, neutral
1242047258,  BoboZangief, 10, 2, 8, no
254579597,  vudi56, 2, 1, 1, neutral
751102441828020224,  Riccard54101795, 4, 2, 2, neutral
460290015,  tininaeli, 9, 6, 3, yes
390151887,  Gim_95, 6, 3, 3, neutral
384214851,  Gio_Deiu, 12, 3, 9, no
946207634,  SweetAle13, 2, 1, 1, neutral
417962415,  GrimoldiPaolo, 6, 3, 3, neutral
722008053491580928,  mauro_vani, 2, 1, 1, neutral
594042443,  MarcoTorlai, 2, 1, 1, neutral
2996708971,  LucaIfurfaro962, 6, 3, 3, neutral
1311402762,  Alexis97De, 8, 7, 1, yes
124518866,  aldotti, 7, 4, 3, yes
763880083,  notanartist__, 2, 1, 1, neutral
736745744,  M_Montigiani, 6, 3, 3, neutral
725269025144619008,  Na1007751, 4, 1, 3, no
1112459726,  PKDorange, 2, 1, 1, neutral
27416132,  DanteCattaneo, 6, 3, 3, neutral
30561007,  bisco1974, 2, 1, 1, neutral
407179725,  MikieTitti, 5, 2, 3, no
215270850,  elsoeta, 2, 1, 1, neutral
2773376409,  ContiSamuele88, 5, 3, 2, yes
769543337527345152,  Sig_Bertrand, 26, 10, 16, no
783929423053676544,  massaald, 2, 1, 1, neutral
1228116608,  nubongio, 12, 6, 6, neutral
1079765420,  sickboy982, 4, 2, 2, neutral
4848941248,  giopad66, 13, 6, 7, no
804647162508431360,  Paulus_55, 2, 1, 1, neutral
3567241335,  vincnicola, 5, 4, 1, yes
1833795264,  tacchini31, 4, 2, 2, neutral
722044342177775617,  DianaRoberta__, 5, 4, 1, yes
787573024774090752,  gosarto, 2, 1, 1, neutral
1227226388,  MelchiorreMario, 5, 2, 3, no
4920749673,  Ninaepepe, 2, 1, 1, neutral
4489541657,  Somebody_gg, 2, 1, 1, neutral
794654387998224385,  PaulDirac_137, 2, 1, 1, neutral
2980893041,  lezza_marisa, 2, 1, 1, neutral
2906893858,  elisabe33314234, 3, 2, 1, yes
429743373,  GambaMauro, 8, 4, 4, neutral
1066673862,  kokkowest, 2, 1, 1, neutral
956000863,  massinard, 2, 1, 1, neutral
3496160069,  Cece_Drake96, 2, 1, 1, neutral
778160744487682048,  stefdag22, 3, 2, 1, yes
420396535,  valentinamanca2, 2, 1, 1, neutral
1190777503,  LucaCaprioli1, 2, 1, 1, neutral
987258930,  vincenzodaddett, 10, 7, 3, yes
405732729,  DaniloCrovo, 2, 1, 1, neutral
1009031150,  SOLCALIENTE2, 13, 2, 11, no
1060178672,  giuseppemule95, 2, 1, 1, neutral
1211152422,  valerio_SFC, 2, 1, 1, neutral
846418970,  BettinoGuerra, 8, 4, 4, neutral
3254334755,  bastabuonismo, 10, 5, 5, neutral
3972216981,  gigi2101981, 2, 1, 1, neutral
2183357423,  MMonteca, 3, 2, 1, yes
517889607,  grusso48, 2, 1, 1, neutral
1119223279,  CLAUDIACOLOMB12, 4, 2, 2, neutral
3337199013,  LauraNalon, 2, 1, 1, neutral
443987259,  simonadegliangi, 8, 4, 4, neutral
2305403337,  vitulloa911, 3, 1, 2, no
2910818007,  ildisinformatto, 5, 2, 3, no
481217655,  Tullio7, 8, 4, 4, neutral
2717886797,  Padedom, 2, 1, 1, neutral
404821428,  AndreaNex70, 3, 2, 1, yes
2361317193,  tittistama, 5, 2, 3, no
1291556816,  bromByron, 5, 2, 3, no
2618363746,  Giolin_06, 2, 1, 1, neutral
636328779,  AlexBazzaro, 7, 4, 3, yes
1219626002,  AlvaroDelfi, 5, 2, 3, no
799044661931282436,  IronPill87, 2, 1, 1, neutral
784447428,  Jack81Co, 22, 11, 11, neutral
142094294,  margarita270946, 2, 1, 1, neutral
3301166702,  Massi7Massimo, 2, 1, 1, neutral
1238866574,  ZanardiniMattia, 7, 4, 3, yes
951799134,  ilbarprimavera, 2, 1, 1, neutral
2415388679,  michelaeffe, 2, 1, 1, neutral
1154197549,  FrancescoCio81, 5, 3, 2, yes
762316646061072384,  AnnaScoes18, 2, 1, 1, neutral
2798997526,  AndreaCarpinato, 4, 2, 2, neutral
4278721157,  nicoleettag64, 4, 2, 2, neutral
4354748297,  Ivo41250876, 2, 1, 1, neutral
2266096538,  EttoreViglione, 7, 3, 4, no
2322759391,  nonnoseo, 2, 1, 1, neutral
4716854800,  suslanas4, 7, 4, 3, yes
2357343035,  PaoloPdv, 12, 5, 7, no
2545744808,  Francesco_Ax, 2, 1, 1, neutral
371140710,  dianatonelli, 14, 10, 4, yes
110454337,  gianvitosibilio, 13, 6, 7, no
804332031589187584,  MariaVi13574696, 2, 1, 1, neutral
4868607605,  vltptt, 4, 1, 3, no
4729543995,  cinematita, 4, 2, 2, neutral
774327465133084672,  GIAMMI_LUNA, 3, 1, 2, no
2434445726,  MigazziP, 2, 1, 1, neutral
745004825738346496,  cesy8285, 7, 3, 4, no
2215848484,  PaccianiMarco, 2, 1, 1, neutral
50334591,  Lady_ofShalott_, 5, 4, 1, yes
426200281,  mcarda90, 8, 3, 5, no
4380015196,  olivgrotti, 2, 1, 1, neutral
207596405,  francescoprsc, 2, 1, 1, neutral
39454080,  piercamillo, 5, 3, 2, yes
1535099419,  angy_bm30, 2, 1, 1, neutral
471445189,  FrancescoRaugei, 2, 1, 1, neutral
2339286812,  Grande_Milano, 2, 1, 1, neutral
96341266,  Reds64, 2, 1, 1, neutral
787676742668484609,  Quimau2, 4, 2, 2, neutral
305031022,  Endeavour88, 2, 1, 1, neutral
417196979,  DiGiovanniMarco, 2, 1, 1, neutral
736257667568635904,  AntonellaLaTor6, 3, 2, 1, yes
2196158901,  satyagrahaaa, 3, 1, 2, no
774949362141110272,  comande_gaetano, 2, 1, 1, neutral
2703902763,  sebastianopoles, 6, 3, 3, neutral
1095058850,  _corAnt, 2, 1, 1, neutral
247791800,  spicca63, 2, 1, 1, neutral
469584786,  GioDiGiugno66, 11, 5, 6, no
222567428,  IsilAcehan, 2, 1, 1, neutral
219708508,  filippotozzi67, 4, 3, 1, yes
303174527,  Adri_uk, 5, 3, 2, yes
553143096,  mofornari, 8, 4, 4, neutral
2297706446,  michele19721, 14, 8, 6, yes
67420706,  RobGallaurese, 5, 2, 3, no
800249610706898944,  vivian_borgese, 2, 1, 1, neutral
495455342,  Ivanka2424, 2, 1, 1, neutral
4275415887,  maxhorses1, 40, 20, 20, neutral
1596129524,  hddade, 7, 6, 1, yes
421427371,  alpi_enrico, 4, 2, 2, neutral
371865254,  Estrafill, 9, 4, 5, no
776187229421113344,  Cristin41953506, 2, 1, 1, neutral
2656989582,  PuiseenToi, 4, 2, 2, neutral
1002869839,  DanieleCerri2, 2, 1, 1, neutral
3012592037,  daguannomassimo, 8, 4, 4, neutral
1172313152,  maremma38, 2, 1, 1, neutral
110123858,  josefruffa, 8, 4, 4, neutral
298986616,  Lordsandreic, 2, 1, 1, neutral
784821801935339521,  _uomorista_, 2, 1, 1, neutral
2987416611,  BordoniCarlo, 2, 1, 1, neutral
732375253,  angelo_cotroneo, 4, 2, 2, neutral
549413577,  drbertolini, 2, 1, 1, neutral
754240772833177600,  mariagraziasari, 2, 1, 1, neutral
937216831,  ASiculella, 3, 2, 1, yes
517937329,  vincenzoromana1, 11, 9, 2, yes
802602440726081536,  sKelly_Carmen, 2, 1, 1, neutral
733133940,  Lorenzo_Ghe, 12, 6, 6, neutral
435100367,  alessandroronch, 4, 2, 2, neutral
763403289237000192,  gianluca_crosta, 2, 1, 1, neutral
31103417,  jozmile, 8, 4, 4, neutral
1092992922,  PIERZINGALE, 2, 1, 1, neutral
497145487,  111ste, 8, 4, 4, neutral
801827462757883905,  MughiniMick, 2, 1, 1, neutral
1504710145,  mauronycity, 13, 6, 7, no
391424539,  MatteoGusberti, 7, 6, 1, yes
770365997891084288,  stevefinn001, 16, 9, 7, yes
2720826652,  CanevazziCarlo, 17, 2, 15, no
3172911100,  FraGallo86, 2, 1, 1, neutral
512024482,  cicchitto, 2, 1, 1, neutral
268182887,  Raneristefano, 3, 1, 2, no
880408916,  simone0010, 2, 1, 1, neutral
521831835,  IvanGrozny3, 2, 1, 1, neutral
420600920,  daniele_1266, 2, 1, 1, neutral
1683864650,  VanessaGraciani, 2, 1, 1, neutral
2238886936,  LinoPolipo, 2, 1, 1, neutral
3135125350,  interasssa, 2, 1, 1, neutral
2372381341,  burney_gumble, 11, 5, 6, no
531517876,  marcotor94, 2, 1, 1, neutral
524236416,  GiuseppeSpadone, 30, 6, 24, no
77336255,  gincarbone, 8, 3, 5, no
82600347,  luigiscerre, 4, 3, 1, yes
421148475,  FabrizioSchia, 2, 1, 1, neutral
244574767,  florianoiodice, 3, 1, 2, no
414016969,  ilmago66, 4, 2, 2, neutral
803469156645478400,  boyterprave1987, 2, 1, 1, neutral
3918792623,  robertabenazzi1, 2, 1, 1, neutral
777532224564523008,  riccardo_king10, 2, 1, 1, neutral
1438089144,  RPettorruso, 4, 2, 2, neutral
295799719,  CesareG2011, 4, 2, 2, neutral
1322710969,  JejaNovelli, 5, 2, 3, no
803884627400282112,  moon_girljk, 5, 4, 1, yes
3243194073,  andymaga50, 3, 1, 2, no
124433584,  Iosonolagomma, 2, 1, 1, neutral
792709410955067393,  Veronic57465889, 18, 9, 9, neutral
364174525,  ELerrepi, 2, 1, 1, neutral
729680942382583808,  aurorasanches12, 2, 1, 1, neutral
42333436,  kriellopsi, 2, 1, 1, neutral
741329461652684800,  luca942499221, 2, 1, 1, neutral
3417231561,  viceservio2, 2, 1, 1, neutral
758705775950827521,  ioilmario, 2, 1, 1, neutral
758680435161530368,  79RobertoGatto, 6, 3, 3, neutral
411402818,  mikigio71, 2, 1, 1, neutral
746723827648978945,  Mimmo80571401, 2, 1, 1, neutral
964924026,  luciani_antonio, 2, 1, 1, neutral
50588269,  mik3llo, 9, 3, 6, no
800082680708640768,  BuzzoniTatiana, 2, 1, 1, neutral
703332162871955458,  fedecaps, 2, 1, 1, neutral
787588319957966848,  Michele78814171, 24, 8, 16, no
143128694,  Maxxie_, 7, 6, 1, yes
568307670,  pgallani, 2, 1, 1, neutral
273023163,  roberta7373, 2, 1, 1, neutral
426036083,  enzoaguanno, 4, 2, 2, neutral
738637670,  maestraserena, 4, 2, 2, neutral
1229823600,  marcipaladino, 2, 1, 1, neutral
2927647053,  tizianagribaud1, 2, 1, 1, neutral
259731992,  polomarco67, 3, 1, 2, no
706132390591262721,  elmevecio, 3, 2, 1, yes
632087849,  mauromusetto, 2, 1, 1, neutral
470349216,  vitalozzo2012, 5, 1, 4, no
1667528750,  michi_pacchioni, 2, 1, 1, neutral
742053173213401088,  sacco_bianca, 2, 1, 1, neutral
798498443484340225,  Gianbat60350658, 5, 3, 2, yes
181613237,  McMazzo, 2, 1, 1, neutral
798624989142519808,  WinsSilent, 4, 2, 2, neutral
525280994,  rmagone, 3, 2, 1, yes
2860530848,  GAlidori, 4, 1, 3, no
4597983803,  simonemartini99, 4, 2, 2, neutral
1443168548,  gcarloantonini, 2, 1, 1, neutral
2862651441,  VelenoTreo270, 2, 1, 1, neutral
4220059354,  Jarod_Ohm, 3, 2, 1, yes
576523,  kromeboy, 2, 1, 1, neutral
817379509,  patti_annamaria, 7, 4, 3, yes
490629565,  MassironiAndrea, 2, 1, 1, neutral
3129702251,  Cristian_archeo, 3, 2, 1, yes
759900620,  LucaSandrinelli, 2, 1, 1, neutral
2858742939,  cellamare1969, 2, 1, 1, neutral
4655621236,  lillagranata2, 4, 2, 2, neutral
4180638383,  Riccardo957, 2, 1, 1, neutral
746228612639035395,  WinnVince, 2, 1, 1, neutral
550034780,  AleForna91, 2, 1, 1, neutral
802291381,  nugat73, 2, 1, 1, neutral
160213845,  SteveP0P, 4, 2, 2, neutral
551303014,  VerdBiancRoss, 15, 8, 7, yes
3313248831,  Thegirl_onthego, 2, 1, 1, neutral
3377922353,  previati64, 6, 3, 3, neutral
2271553504,  marcosantoro67, 7, 3, 4, no
774540707197493248,  nicolaedora, 3, 2, 1, yes
430937726,  Jey0780, 8, 4, 4, neutral
363006275,  giulia270596, 6, 3, 3, neutral
127302531,  Robycop51, 8, 4, 4, neutral
195057236,  attilioluigi, 4, 1, 3, no
217530645,  Bart_Scnd, 6, 3, 3, neutral
537389666,  sylado24, 2, 1, 1, neutral
2981614870,  orianaxsempre, 4, 2, 2, neutral
390707665,  ma72ya14, 2, 1, 1, neutral
387855536,  babbo100, 4, 1, 3, no
2455915345,  tiz_mic, 16, 1, 15, no
2979566235,  mnardi34, 6, 3, 3, neutral
64179835,  evarix, 2, 1, 1, neutral
749600161899438080,  IvonneMarconi, 2, 1, 1, neutral
4194868005,  LauraGaleazzi2, 2, 1, 1, neutral
373233542,  andrea_cheli, 2, 1, 1, neutral
2333490399,  CasiLory, 28, 14, 14, neutral
3361295967,  carducci_maria, 6, 3, 3, neutral
798939482,  FaietaAngelo, 6, 4, 2, yes
702770643335561218,  sanvitom, 11, 6, 5, yes
1883512489,  pdbpietro, 2, 1, 1, neutral
1335222746,  frant42, 2, 1, 1, neutral
3202597630,  iltempopassato, 11, 9, 2, yes
975895578,  pmontina, 3, 1, 2, no
1259906438,  Newshub_Ireland, 6, 3, 3, neutral
2906132536,  fabiocompiani61, 3, 2, 1, yes
348334390,  carlorusso1, 2, 1, 1, neutral
2477022054,  villapaul65, 3, 2, 1, yes
1336864753,  LAMBRENEDETTO, 2, 1, 1, neutral
2483582362,  StefanoCComi, 8, 3, 5, no
2791413571,  LuanaSileoni, 4, 2, 2, neutral
539895182,  FLAVIONEBENTIVE, 2, 1, 1, neutral
2769211305,  mancini1972, 2, 1, 1, neutral
1180622503,  ppsfollower, 8, 3, 5, no
306123184,  mimmoef, 3, 1, 2, no
460408863,  dtolux, 8, 3, 5, no
244444250,  catilina50, 2, 1, 1, neutral
703243429258641408,  antoshlove, 2, 1, 1, neutral
2768646491,  LorenaLory55, 2, 1, 1, neutral
2147679839,  MarioRaciti92, 3, 2, 1, yes
390266324,  robertocosta31, 9, 7, 2, yes
881088181,  giusepp45368782, 2, 1, 1, neutral
798612590284931072,  Farota20161, 3, 1, 2, no
802183609822146560,  ClaudianoVe, 8, 3, 5, no
604249475,  Dimauro1957Di, 13, 9, 4, yes
474688731,  Patriziahorses, 3, 2, 1, yes
711096585418088448,  DigrivettaFr, 13, 7, 6, yes
283152050,  MirkoVilla, 8, 4, 4, neutral
11534652,  GattoFelix, 8, 4, 4, neutral
3335478268,  figliolaraf67, 7, 3, 4, no
338548347,  bulldog_inglese, 4, 2, 2, neutral
906858110,  chiseloricorda3, 5, 1, 4, no
1081141530,  NaikeBasso, 2, 1, 1, neutral
226904146,  Lostudiomartini, 2, 1, 1, neutral
4703289975,  MrWizardSuper, 2, 1, 1, neutral
105157266,  mamola81, 6, 3, 3, neutral
755983570859089920,  giannibertozzi3, 2, 1, 1, neutral
4871813147,  LuciaVa12, 9, 4, 5, no
2385727578,  PiescoTonino, 6, 5, 1, yes
3061816905,  tiziana_1966, 4, 2, 2, neutral
2210419316,  TrimixdiverIt, 7, 3, 4, no
2533349664,  colpyD, 2, 1, 1, neutral
50373692,  floppersi, 6, 4, 2, yes
4513753401,  LibralonEddi, 4, 2, 2, neutral
2437027374,  Angelo_Pacifici, 5, 2, 3, no
2987909105,  annina1958, 2, 1, 1, neutral
799887615335903236,  MarcelloBonell4, 6, 2, 4, no
599969384,  LidiaBonomi, 10, 5, 5, neutral
4062072245,  CarmeloSamp, 2, 1, 1, neutral
579147580,  Ed96webchannel, 16, 6, 10, no
378483932,  innanoettam, 4, 2, 2, neutral
799682512301633536,  Andrea76798053, 4, 2, 2, neutral
525472430,  stefanoCere, 5, 3, 2, yes
2940585718,  fracasto, 12, 4, 8, no
803206566652637184,  AntoniGiardino, 2, 1, 1, neutral
4266384617,  lellus1969, 4, 1, 3, no
771607371936215041,  sergiorusso1986, 27, 20, 7, yes
4078323682,  ilpzini12, 6, 2, 4, no
254998344,  vivielotta, 35, 7, 28, no
1338584736,  massjmj, 4, 2, 2, neutral
3504753795,  dublinoIII, 4, 2, 2, neutral
396703822,  aquila1608, 6, 3, 3, neutral
2611865982,  SteToniolo97, 3, 2, 1, yes
22487487,  LuPapaLuciani, 2, 1, 1, neutral
1461493826,  cubazuelaP, 2, 1, 1, neutral
1212664380,  livio_pic, 2, 1, 1, neutral
55163750,  bella_99, 2, 1, 1, neutral
360591422,  cloddye, 2, 1, 1, neutral
3344207110,  marcogui63, 7, 5, 2, yes
2283370683,  m4urocontu, 2, 1, 1, neutral
802467873193070592,  Pandora8211, 2, 1, 1, neutral
774029536690307073,  nurgiachi, 12, 7, 5, yes
932875058,  il_Mura, 2, 1, 1, neutral
3236668955,  stergydp, 2, 1, 1, neutral
2946803811,  RonzioR, 6, 3, 3, neutral
2505587934,  salvovitale61, 8, 4, 4, neutral
2238009622,  quintospagnoli, 2, 1, 1, neutral
787874743437430784,  PintoGiu, 2, 1, 1, neutral
751104484969947136,  andirollo, 7, 3, 4, no
2897057014,  VScrimieri, 3, 1, 2, no
3358483828,  lorenzo_antigo, 5, 4, 1, yes
772163082609102848,  jolanda36957858, 2, 1, 1, neutral
253531074,  fringuello, 4, 2, 2, neutral
2886824073,  osservatore2004, 20, 10, 10, neutral
4551592522,  Gelso22, 6, 2, 4, no
1270220318,  CleoDamiano, 2, 1, 1, neutral
732186103013347328,  Robertobis83, 2, 1, 1, neutral
733309640,  arabellara, 4, 2, 2, neutral
2921904327,  emanuele_piana, 8, 4, 4, neutral
4196386522,  danielesoldi68, 2, 1, 1, neutral
804377461114961924,  agorestfra12, 2, 1, 1, neutral
2866602010,  FrancoSforzi, 5, 3, 2, yes
2527569119,  FelicitMario, 2, 1, 1, neutral
4073641030,  soloarte71, 2, 1, 1, neutral
2684536234,  VTaccola, 2, 1, 1, neutral
802937898739888128,  cosimoc36, 13, 7, 6, yes
431978037,  GiacaloneUgo, 13, 7, 6, yes
306786102,  fallas2002, 2, 1, 1, neutral
3205783282,  cristina6618, 2, 1, 1, neutral
1124940318,  DegaetaniG, 12, 6, 6, neutral
1213184078,  PalumboMina, 3, 2, 1, yes
399998388,  diogene8, 2, 1, 1, neutral
286168631,  diotimauri, 9, 3, 6, no
916913713,  BirboLuciano, 2, 1, 1, neutral
762934873057292288,  4gennaro10, 29, 2, 27, no
528607077,  RobertaThiene, 2, 1, 1, neutral
84676170,  GRANDEVORTICE, 2, 1, 1, neutral
752804996211740672,  adelmiopisano5, 2, 1, 1, neutral
378231049,  aletomase, 2, 1, 1, neutral
120594409,  rainbownebula, 2, 1, 1, neutral
3184558807,  Cardsfan1010, 2, 1, 1, neutral
864657686,  RPatan, 6, 3, 3, neutral
4193296599,  tactdef1, 2, 1, 1, neutral
339849935,  UrsoVale83, 4, 2, 2, neutral
3050688682,  claluc79, 8, 4, 4, neutral
93846109,  lucafabbri84, 2, 1, 1, neutral
2221149008,  ClaudioBurghi, 2, 1, 1, neutral
56692333,  marieinal, 2, 1, 1, neutral
3179203371,  marcopetro63, 2, 1, 1, neutral
757647165049151490,  avvcestra, 2, 1, 1, neutral
3433661590,  mario_brignoli, 2, 1, 1, neutral
1692580633,  MicheleSimone25, 2, 1, 1, neutral
627894231,  elyos72, 2, 1, 1, neutral
459415484,  MorisVerdiani, 8, 6, 2, yes
244270709,  alexbeldi, 3, 1, 2, no
429127192,  gattozeki, 7, 2, 5, no
1635661050,  pary1977, 6, 3, 3, neutral
397064533,  Aliskavstrane, 2, 1, 1, neutral
946023379,  AndreaMsg71, 12, 5, 7, no
930694034,  InesLattanzi, 4, 3, 1, yes
1201318460,  nonadela1, 2, 1, 1, neutral
3017889172,  OddisGildo, 2, 1, 1, neutral
803918224316317696,  erba_digrace, 2, 1, 1, neutral
4187702435,  nuvoletta67, 16, 8, 8, neutral
1247376786,  davidemastro83, 2, 1, 1, neutral
15398961,  B3rto_, 2, 1, 1, neutral
3255232402,  Alessandro_b70, 5, 3, 2, yes
282722731,  clakiwi67, 2, 1, 1, neutral
2385584841,  critbn90, 5, 3, 2, yes
805547424731250689,  angrande1, 4, 2, 2, neutral
1647573919,  onedsxfcovers, 5, 3, 2, yes
385828572,  erTifosetto, 3, 2, 1, yes
547675991,  decastelnau2, 2, 1, 1, neutral
457635346,  vecchioleviatan, 3, 2, 1, yes
2743455844,  BassBasset, 5, 3, 2, yes
2730779482,  taewoons, 2, 1, 1, neutral
1667966527,  kidrauhlabbey, 6, 3, 3, neutral
115496935,  amerycarlson, 2, 1, 1, neutral
373601415,  crisg68, 2, 1, 1, neutral
760569912154873856,  EmperorsGuard1, 6, 3, 3, neutral
938933701,  ivobartot1, 7, 1, 6, no
3230927109,  leoperri995, 5, 2, 3, no
784280066,  SergioSierra67, 58, 42, 16, yes
4497910049,  votonneya, 8, 6, 2, yes
799387124,  Rychh22, 2, 1, 1, neutral
738647187047976960,  DiTuffio, 2, 1, 1, neutral
2179896303,  edikampo, 4, 2, 2, neutral
2700598373,  Stefanobampi, 2, 1, 1, neutral
1227191976,  MSimonaBellini, 7, 4, 3, yes
2986509245,  AuroraLukino, 2, 1, 1, neutral
2170637596,  BorghesiStefano, 6, 3, 3, neutral
1037619156,  AndreaRaffaell2, 2, 1, 1, neutral
501207662,  platini967, 2, 1, 1, neutral
2969563023,  ta_tosini, 6, 4, 2, yes
1469499852,  DeborahMecenero, 2, 1, 1, neutral
2340347324,  maurovoerzio, 5, 3, 2, yes
335939683,  Jack_Shep_, 2, 1, 1, neutral
32406847,  johnnygirardi, 3, 2, 1, yes
379192955,  ElisaGhi, 3, 2, 1, yes
2328718163,  avonmylife, 4, 2, 2, neutral
3317354183,  gabsybn, 10, 2, 8, no
347360273,  PR0gresista, 2, 1, 1, neutral
3057142827,  1975Rigoni, 2, 1, 1, neutral
3075686139,  markfener1986, 13, 3, 10, no
456554589,  ASciandrone, 3, 1, 2, no
1618563331,  asta_fabio, 5, 4, 1, yes
182493032,  SommoShinigami, 3, 2, 1, yes
2192983340,  mtrullallero, 6, 4, 2, yes
420635476,  FrancoCappellet, 3, 2, 1, yes
598726224,  RobertoGerin, 2, 1, 1, neutral
132585811,  marcocampo, 3, 1, 2, no
1671410479,  taranto_angela, 5, 3, 2, yes
2321610591,  Simoanto94, 2, 1, 1, neutral
801492044057313280,  Tina60561936, 6, 3, 3, neutral
729328485701947393,  walkindaddies, 6, 3, 3, neutral
463894664,  danielasupino, 9, 5, 4, yes
3258031089,  marukosocial, 4, 1, 3, no
1069372458,  giulyettatweet, 4, 3, 1, yes
1650297781,  FrancescaFvl, 2, 1, 1, neutral
768184039572443137,  KyoneRick, 4, 2, 2, neutral
4835701203,  Frances35954761, 2, 1, 1, neutral
3288611127,  francysca89fra, 4, 2, 2, neutral
533275974,  RobiArmstrong, 2, 1, 1, neutral
245832583,  stefaniabertone, 2, 1, 1, neutral
364208968,  _pigna_, 3, 2, 1, yes
319552093,  Pietrobiella, 2, 1, 1, neutral
1201501471,  BenniLandini, 4, 2, 2, neutral
3945774635,  Filadelf0, 5, 3, 2, yes
619856478,  NelloSesso, 14, 7, 7, neutral
3427938423,  simonarusso930, 2, 1, 1, neutral
1688872309,  Celine94_, 2, 1, 1, neutral
146544730,  Magic197710, 6, 2, 4, no
772483831664443393,  SickHero85, 6, 3, 3, neutral
1080915097,  DavideCR7Bruno, 4, 2, 2, neutral
4173212049,  vandersimo_87, 2, 1, 1, neutral
712755282942697473,  AmYiBing, 2, 1, 1, neutral
2764307580,  pinetto9, 2, 1, 1, neutral
3689630715,  flyingchick747, 2, 1, 1, neutral
2507210803,  freshxxair, 2, 1, 1, neutral
2991958845,  paolamglr, 4, 2, 2, neutral
456158572,  AntonioSheva7, 2, 1, 1, neutral
247384198,  heroinesmile7, 2, 1, 1, neutral
504615297,  arctikal, 2, 1, 1, neutral
341976519,  MarcoRousseau1, 2, 1, 1, neutral
712297106036428800,  corsara75, 6, 3, 3, neutral
793889733227212800,  antimo7_, 2, 1, 1, neutral
3898149261,  tinamaat, 17, 9, 8, yes
3159761662,  64_michy, 17, 8, 9, no
471506102,  SacconeGianluca, 8, 4, 4, neutral
222118492,  diaugustopa, 13, 11, 2, yes
955736970,  F89Mirko, 3, 2, 1, yes
707867254671724544,  spruzza95, 2, 1, 1, neutral
50602686,  SignoreDelFeudo, 6, 3, 3, neutral
481252404,  peppelomonaco79, 2, 1, 1, neutral
433707567,  Andreamn1001, 2, 1, 1, neutral
3606545315,  nitty0gritty, 2, 1, 1, neutral
602297450,  fabriziobianca1, 4, 3, 1, yes
127651603,  PatriziaMaci, 5, 3, 2, yes
2505947904,  TommasoMucelli, 2, 1, 1, neutral
2960376742,  ginsengin, 7, 4, 3, yes
2756373567,  imisstomlinson, 6, 3, 3, neutral
552048005,  fabricitarella, 4, 2, 2, neutral
3296142998,  Eurix_, 2, 1, 1, neutral
632332554,  Bottarello, 4, 1, 3, no
605357607,  chiara_abed, 2, 1, 1, neutral
736205254560231424,  MiglioratiNino, 23, 3, 20, no
364437357,  GabrieleCipri, 2, 1, 1, neutral
100746621,  __nene__xD, 4, 2, 2, neutral
374549239,  Lampo79, 7, 6, 1, yes
3347572912,  Clarabeella5, 9, 7, 2, yes
1243604144,  fantasyfederica, 3, 2, 1, yes
2982299829,  SalvaPichierri, 4, 2, 2, neutral
713200241424646144,  _VincentC_, 4, 2, 2, neutral
3297666816,  4ragazzi1D, 4, 3, 1, yes
1716924578,  FlaviaManca, 2, 1, 1, neutral
307012060,  saretta_R23, 2, 1, 1, neutral
635439783,  carlocolleluori, 6, 3, 3, neutral
459305375,  gillymilano, 7, 4, 3, yes
396882006,  LucaMatTomadini, 6, 3, 3, neutral
312217465,  MsPeggy_Carter, 19, 10, 9, yes
777783044,  AVimciguerra8, 2, 1, 1, neutral
428095023,  nihtrem, 10, 5, 5, neutral
159876750,  matteowolk, 4, 3, 1, yes
3458559863,  cvrpenoctem, 2, 1, 1, neutral
421753222,  paolotwix, 9, 2, 7, no
326849076,  Lauinpigiama, 9, 6, 3, yes
805547439734358016,  alfonso1221981, 2, 1, 1, neutral
100013557,  RaiSantacroce, 2, 1, 1, neutral
1004115164,  Barbara_2105, 3, 2, 1, yes
542895669,  Lorbertal, 3, 1, 2, no
159791142,  lollofaber, 7, 3, 4, no
372831370,  BellicaDiazepam, 2, 1, 1, neutral
110722335,  MCEL88, 5, 2, 3, no
526760969,  glennascaul, 2, 1, 1, neutral
580999765,  orangecondor, 2, 1, 1, neutral
2788286600,  AlbertBonav91, 2, 1, 1, neutral
25289817,  pimpumpam, 5, 2, 3, no
885427039,  Hollyalina, 3, 2, 1, yes
1095820980,  RossPellecchia, 3, 2, 1, yes
454998564,  roronoapier, 2, 1, 1, neutral
479382795,  Paololotti08, 6, 4, 2, yes
495141839,  menga93, 2, 1, 1, neutral
2224989113,  BeppeMarzola, 5, 2, 3, no
785480625960656897,  Pipesandflowers, 34, 17, 17, neutral
28998953,  elyswifty, 9, 4, 5, no
3148503490,  crespan21, 4, 2, 2, neutral
236958489,  mony712, 2, 1, 1, neutral
1206110173,  Mattefiamma, 2, 1, 1, neutral
1593971712,  lauratsepesh, 2, 1, 1, neutral
777088269003677696,  nastynoema, 4, 2, 2, neutral
575229086,  KERCELTE, 2, 1, 1, neutral
2763566608,  AngelAlonso_30, 8, 4, 4, neutral
3227839018,  AdamantinaCecia, 2, 1, 1, neutral
2968308615,  ems283, 2, 1, 1, neutral
1174346844,  RenzettiValter, 4, 2, 2, neutral
724744069566574592,  arianna_gronchi, 3, 2, 1, yes
2197190503,  FantaLorenz, 2, 1, 1, neutral
1086641828,  sembronio, 15, 6, 9, no
47172123,  ginosgro, 2, 1, 1, neutral
3971921722,  ManuelMazzacz, 8, 4, 4, neutral
1082400372,  GreLibra, 15, 8, 7, yes
440209726,  riccardomeneghi, 2, 1, 1, neutral
291616519,  giulialovatic, 2, 1, 1, neutral
4472744842,  vittoascio, 2, 1, 1, neutral
2584054678,  MarcoKojack, 9, 8, 1, yes
479746244,  PietroCalvia, 2, 1, 1, neutral
35819412,  grazianig, 2, 1, 1, neutral
906165092,  _betty48, 4, 2, 2, neutral
249316723,  sordiispicciu, 7, 4, 3, yes
1552378394,  LucaLucapmagic, 4, 2, 2, neutral
330904043,  Oroboros78, 2, 1, 1, neutral
729774550951546881,  b_vicecapo, 3, 2, 1, yes
3141569843,  RelliRellilu70, 5, 2, 3, no
2187974406,  auellexo, 2, 1, 1, neutral
333617520,  DiazyArturo, 2, 1, 1, neutral
2261924345,  AlessioBerlese, 4, 3, 1, yes
1657894116,  texier42, 2, 1, 1, neutral
1412705316,  lucianoarius, 8, 4, 4, neutral
2391556182,  isabellacapozzi, 2, 1, 1, neutral
4117933222,  Jcolrefe76, 2, 1, 1, neutral
2189753447,  syriano61, 2, 1, 1, neutral
2285543102,  MTomaselli97, 4, 2, 2, neutral
2177374102,  StefaniaPistola, 4, 2, 2, neutral
2225433889,  Xavier_V_A, 6, 3, 3, neutral
1932231254,  LdmMedola, 19, 6, 13, no
454722444,  Isa_PrT, 2, 1, 1, neutral
378799977,  MaimoneGiuseppe, 4, 2, 2, neutral
2991750274,  guittone1934, 2, 1, 1, neutral
2539899820,  espinls, 2, 1, 1, neutral
2478290402,  GianniZangra, 2, 1, 1, neutral
603484616,  NicoAiazzone, 2, 1, 1, neutral
2885125256,  01nikks, 4, 2, 2, neutral
235738391,  gipsyrunner, 3, 2, 1, yes
4797636358,  ces_98_, 2, 1, 1, neutral
3436788910,  gunsnpizza, 2, 1, 1, neutral
4142510392,  melo63aviatore, 2, 1, 1, neutral
75845981,  _hmatt, 2, 1, 1, neutral
433424010,  ClerMonster, 2, 1, 1, neutral
1057423616,  stefanowrites, 4, 2, 2, neutral
255164517,  GioDanni13, 4, 3, 1, yes
1216186945,  allegragiacchin, 7, 4, 3, yes
3375632974,  fede93g, 2, 1, 1, neutral
3159734217,  clarabosisio, 2, 1, 1, neutral
1041661344,  ALottici, 2, 1, 1, neutral
1712610582,  marcopheasant87, 27, 19, 8, yes
851568350,  ArjunaLucatum, 2, 1, 1, neutral
2224269363,  gianpigemo, 4, 2, 2, neutral
2371518598,  2394c670255b4d8, 2, 1, 1, neutral
796115663530115072,  M4rcoRoss, 2, 1, 1, neutral
3578738958,  MoniQueMoniCat, 13, 8, 5, yes
2999973344,  carlomartellone, 3, 2, 1, yes
2677934870,  mriemann1, 2, 1, 1, neutral
1310724078,  PL_Meriguet, 4, 2, 2, neutral
504740393,  WilmerBergamo, 6, 3, 3, neutral
2293440428,  debe58_debe, 11, 6, 5, yes
1723124094,  panze19, 4, 2, 2, neutral
2603584007,  nicholasdaigoro, 2, 1, 1, neutral
518991807,  NancySquitieri, 3, 1, 2, no
1636496670,  SilvestroNero, 2, 1, 1, neutral
763454895865331712,  Framarani2002, 2, 1, 1, neutral
212630588,  Gemiferra, 7, 4, 3, yes
749279252,  FlavioCotturone, 2, 1, 1, neutral
1252443098,  ehisofi, 2, 1, 1, neutral
2988907113,  lucyinvthesky, 4, 2, 2, neutral
486994488,  chemondoo, 6, 3, 3, neutral
3207784403,  LicusatiPaolo, 2, 1, 1, neutral
605828340,  DORAMARIAPENALO, 4, 2, 2, neutral
265002050,  keiichi__kun, 4, 2, 2, neutral
21826264,  rob1cox, 2, 1, 1, neutral
715621095710265345,  MikeRisvoltino, 2, 1, 1, neutral
802695536759476224,  ance66giuliana, 3, 2, 1, yes
2997609233,  xxImNotAfraidx, 2, 1, 1, neutral
94092819,  Andreacocco87, 6, 3, 3, neutral
1188669456,  Dylan_Castorri, 14, 7, 7, neutral
500633142,  gordonzar, 4, 2, 2, neutral
3906671655,  pigolla79, 8, 4, 4, neutral
1059820524,  monigiammi, 3, 2, 1, yes
395218906,  Corriere, 18, 13, 5, yes
2388245224,  vettore_antonio, 7, 5, 2, yes
105278485,  xtuamadre, 2, 1, 1, neutral
749355813228142592,  Giusepp87897234, 4, 1, 3, no
155839600,  ElleD24, 4, 3, 1, yes
2262262781,  Biebss99, 3, 2, 1, yes
2517354856,  Bartolomeoroma, 5, 3, 2, yes
736676121580871680,  BagapeG, 6, 3, 3, neutral
2854853057,  EnricoVellucci, 9, 3, 6, no
895869750,  sognoziam, 5, 3, 2, yes
339750427,  erikaofthestate, 2, 1, 1, neutral
1874309022,  manugasperoni, 3, 2, 1, yes
2781815686,  fabio_laini, 2, 1, 1, neutral
140024375,  Jabberwocky_95, 9, 4, 5, no
1164188192,  Verduccii, 3, 2, 1, yes
315266120,  alebarbirato_, 2, 1, 1, neutral
3332219884,  pushlooop, 8, 4, 4, neutral
2867963191,  seicesso, 2, 1, 1, neutral
800718511081275392,  cassiopaei, 4, 2, 2, neutral
898194878,  mansi_sky, 6, 3, 3, neutral
2413562079,  charles0299, 4, 2, 2, neutral
3845571497,  theskydemons, 2, 1, 1, neutral
703711187456937984,  annabella20072, 2, 1, 1, neutral
130822947,  FabioPandiscia, 5, 2, 3, no
797036042838802432,  GiovanniMusum13, 2, 1, 1, neutral
1079983244,  ChimentiStefano, 2, 1, 1, neutral
403077847,  melipare, 2, 1, 1, neutral
787324511330918400,  pieduantonio, 14, 4, 10, no
105591225,  karellik, 2, 1, 1, neutral
396748129,  MarcoMateri, 2, 1, 1, neutral
987525541,  fabiotamburi, 16, 8, 8, neutral
2926988855,  carmengabriell3, 4, 2, 2, neutral
176771140,  sistimik, 8, 4, 4, neutral
3158540328,  Carmine60C, 4, 1, 3, no
1722370458,  ZiAttilio, 7, 4, 3, yes
1534748126,  uboot96km, 10, 6, 4, yes
704317090749161473,  SalvatoreVestut, 5, 2, 3, no
3915475522,  Mario29347982, 2, 1, 1, neutral
2855090175,  IV00IV3, 2, 1, 1, neutral
2338465050,  Stefania_cochi, 8, 2, 6, no
2903545671,  dracul473, 28, 5, 23, no
2309104363,  bravelion83, 8, 4, 4, neutral
734629633577095169,  vcVitoCorleone, 37, 21, 16, yes
3438437289,  baldoParigi, 2, 1, 1, neutral
203869937,  DemsMug, 12, 6, 6, neutral
3064788837,  ElvyGasp, 3, 2, 1, yes
766709913666150400,  Tiz91946574, 3, 2, 1, yes
766372571180888064,  TotiGambino, 2, 1, 1, neutral
994626132,  maxcrespino, 4, 1, 3, no
2650759522,  LaMarisa57, 2, 1, 1, neutral
1232067242,  Giovaguerrato, 8, 4, 4, neutral
795312936906555392,  AngelicaFranza, 2, 1, 1, neutral
297866031,  babbominkia, 22, 3, 19, no
445473517,  anpellizzari, 7, 4, 3, yes
1039969014,  LOV3RUNS0UT, 4, 2, 2, neutral
79984224,  s1fab, 10, 2, 8, no
923278688,  anto_baccaro, 2, 1, 1, neutral
1418004319,  MarioSettimom, 10, 9, 1, yes
775303692224458752,  PalmamyraMyra, 6, 3, 3, neutral
4187607101,  lato_roberto, 8, 4, 4, neutral
25105210,  cirofronteddu, 3, 2, 1, yes
1461760566,  MLZanese, 9, 7, 2, yes
4924288984,  ingdargen, 2, 1, 1, neutral
784631489468268544,  ilconte1983, 2, 1, 1, neutral
3095355645,  1971itimpa, 10, 5, 5, neutral
38739769,  LaCapaRouja, 10, 5, 5, neutral
543479198,  johnjcobra, 2, 1, 1, neutral
3143655058,  purposiebss, 6, 3, 3, neutral
2505433479,  lucaberetta78, 5, 1, 4, no
710859095503409152,  Califfha, 2, 1, 1, neutral
2908931319,  AuroraBlasigh, 2, 1, 1, neutral
1039674703,  leoncinakelly, 6, 2, 4, no
2371516647,  valenologia, 10, 5, 5, neutral
388741637,  lallafrancesco, 4, 2, 2, neutral
429118641,  leonidnikitin, 4, 2, 2, neutral
1045072200,  CoppolaMery, 2, 1, 1, neutral
3181210090,  secundafacie, 2, 1, 1, neutral
3099880259,  1968micky1968, 4, 2, 2, neutral
1428133460,  info_dp_ing, 2, 1, 1, neutral
1176687842,  CrocFabio, 8, 1, 7, no
3063728541,  Alberto_Oggero, 4, 2, 2, neutral
991898202,  AnnaBartorelli2, 4, 3, 1, yes
1311060530,  FalcomataE, 2, 1, 1, neutral
702133410505089024,  UgolinLuigi, 2, 1, 1, neutral
2265309088,  CcbuRomina, 4, 2, 2, neutral
473757745,  andrea46_andrea, 2, 1, 1, neutral
790275258,  Frau77Frau, 2, 1, 1, neutral
359841194,  carboneraricc, 2, 1, 1, neutral
279056147,  giubler, 2, 1, 1, neutral
417690170,  pinosantarsiere, 5, 4, 1, yes
4909253914,  DnlCsz, 3, 1, 2, no
151578963,  MichelePovoli, 4, 3, 1, yes
4823693991,  Fatima7632, 3, 2, 1, yes
3208643200,  forti66, 3, 1, 2, no
51312569,  mlperezven, 16, 9, 7, yes
753206130365624320,  NadyJimbo, 8, 4, 4, neutral
4013061826,  TgleichThomas, 2, 1, 1, neutral
396684732,  danielh984, 4, 2, 2, neutral
733707640161861632,  whitearrow09, 31, 16, 15, yes
377249236,  JMacAndrew, 2, 1, 1, neutral
2867906470,  antoninomagro76, 4, 3, 1, yes
2902464075,  dariovella66dv, 2, 1, 1, neutral
536769582,  teresa3345, 8, 4, 4, neutral
4181953696,  BenamatiMassimo, 2, 1, 1, neutral
3954682097,  renabulgari, 3, 1, 2, no
3221567302,  marypenny73, 14, 7, 7, neutral
397153198,  IAzzimonti, 3, 1, 2, no
2206491557,  taobutterfly, 2, 1, 1, neutral
1676410177,  GiaBi58, 2, 1, 1, neutral
432766701,  RobertoParigi, 10, 4, 6, no
143264776,  SteveTheRat, 3, 1, 2, no
156838708,  lakota72, 2, 1, 1, neutral
3397089436,  WTF1807, 2, 1, 1, neutral
2687611909,  poveraitaliaorg, 7, 4, 3, yes
2342515113,  ITempera, 2, 1, 1, neutral
2724148806,  mail20115, 5, 2, 3, no
31082952,  eVolux, 4, 2, 2, neutral
2823377296,  GesualdoN, 6, 5, 1, yes
4827510405,  78_robyus, 2, 1, 1, neutral
1040176664,  niccoli79, 2, 1, 1, neutral
2626177428,  paolerei, 8, 1, 7, no
2467961561,  93607bc97c2b480, 10, 2, 8, no
161283617,  artkaridiss, 2, 1, 1, neutral
1008510270,  pippo121949, 3, 2, 1, yes
337321550,  FusionFai, 6, 2, 4, no
804398406286381056,  SimoneG77488308, 4, 1, 3, no
2522802540,  marcosangu79, 2, 1, 1, neutral
444084612,  rosellaraffi, 4, 3, 1, yes
1085979823,  pola1945, 3, 1, 2, no
2420989306,  NicolaBeltra66, 2, 1, 1, neutral
787403090668482562,  Ale55190374, 2, 1, 1, neutral
136692380,  danielelapalma, 3, 2, 1, yes
2848456047,  lucialuce64, 9, 6, 3, yes
2894413583,  jessicaitalia3, 2, 1, 1, neutral
1229872982,  tina_martel, 4, 2, 2, neutral
554353486,  arfio73, 2, 1, 1, neutral
130459956,  Diabolus_Teoh, 2, 1, 1, neutral
726161324355510272,  Federic22429687, 3, 1, 2, no
386145254,  VPasciucco, 23, 12, 11, yes
2378922296,  SalaroliC, 2, 1, 1, neutral
2946106409,  AntoScopp, 2, 1, 1, neutral
2262017616,  Libri_da_legg, 4, 2, 2, neutral
1604201599,  StAy61, 2, 1, 1, neutral
1462093196,  LucianaServi, 2, 1, 1, neutral
2189126966,  dianestark91, 6, 3, 3, neutral
738633894,  antoniodelconte, 5, 3, 2, yes
117139111,  Caflockton, 2, 1, 1, neutral
1013040007,  LorenzoBodini, 4, 2, 2, neutral
71293003,  brendonrex, 3, 1, 2, no
4187056599,  Giank1970, 12, 1, 11, no
426593578,  salvomangiafico, 2, 1, 1, neutral
763761138047877120,  piermariofine1, 4, 2, 2, neutral
487914598,  ivanruffini, 10, 6, 4, yes
767813180491960324,  titta8789, 2, 1, 1, neutral
705535523243352064,  annucciagendusa, 4, 2, 2, neutral
237012591,  Dangerste, 4, 3, 1, yes
76383375,  morganticlaudio, 4, 2, 2, neutral
828812155,  AndreaBarocci, 7, 2, 5, no
840165980,  silviagenn, 4, 2, 2, neutral
421797452,  BrieBus, 2, 1, 1, neutral
273908234,  ariannabill, 2, 1, 1, neutral
2396455223,  speecri69, 2, 1, 1, neutral
700879880,  picchiasebino05, 2, 1, 1, neutral
729811127354445824,  Grifoncina1985, 8, 4, 4, neutral
2893720967,  sarar06_sr, 4, 2, 2, neutral
701364672834965504,  ninajustina194, 2, 1, 1, neutral
1563566005,  MecchiaMauro, 2, 1, 1, neutral
1162209535,  monellovagabon1, 2, 1, 1, neutral
36376600,  federicovr, 2, 1, 1, neutral
432603093,  biluffo, 4, 2, 2, neutral
2336792358,  RenzoMedici, 3, 1, 2, no
3697325602,  LizzolaMaria, 3, 2, 1, yes
2531978413,  daniela69823070, 2, 1, 1, neutral
3179628894,  alfx76, 2, 1, 1, neutral
2274653489,  MyraCrystall, 2, 1, 1, neutral
3409087257,  TorriAlesandro, 2, 1, 1, neutral
2984184838,  celtica60, 2, 1, 1, neutral
91429105,  ggg19621962, 3, 1, 2, no
2420540543,  tangelini1971, 6, 3, 3, neutral
293044655,  fabriziosecchi1, 4, 3, 1, yes
3000350134,  rosprimavera10, 2, 1, 1, neutral
2402581961,  Sieger73, 4, 1, 3, no
485713784,  RitaPirro, 3, 1, 2, no
975087818,  salvo242, 2, 1, 1, neutral
258486606,  hitman7779, 2, 1, 1, neutral
326964467,  jaimecastellan4, 2, 1, 1, neutral
796332127059058688,  jediroda, 6, 2, 4, no
468677530,  Harsiesi, 2, 1, 1, neutral
67305532,  8Abby4, 4, 3, 1, yes
2472029332,  oriente_andrea, 5, 2, 3, no
811424202,  shameless213, 10, 5, 5, neutral
977060935,  Francesco_Marta, 2, 1, 1, neutral
2397709991,  FedericoSalatin, 2, 1, 1, neutral
3079236778,  alerossini2000, 4, 2, 2, neutral
255109459,  VallyBalboni, 2, 1, 1, neutral
465858567,  _Vandroiy_, 2, 1, 1, neutral
4794908243,  charlespurple, 2, 1, 1, neutral
744861919450963968,  dontealberto, 2, 1, 1, neutral
4737722657,  lamponeseriale, 2, 1, 1, neutral
1418055780,  SaulGobbo, 7, 6, 1, yes
2668839155,  andrea66769767, 4, 2, 2, neutral
1327978434,  karinajaszczyns, 4, 2, 2, neutral
1013753576,  betta_andrioli, 10, 7, 3, yes
744217460862246912,  smeri72, 4, 2, 2, neutral
533186486,  Perrone98, 2, 1, 1, neutral
749672796964478985,  francescoch1, 2, 1, 1, neutral
438707846,  Enzo_Riccio, 2, 1, 1, neutral
382299511,  acister64, 2, 1, 1, neutral
2802616144,  Calltoart, 2, 1, 1, neutral
1360691059,  ECC1958, 2, 1, 1, neutral
2832044372,  VirnaZanellati, 2, 1, 1, neutral
1052948882,  HermanLong2, 2, 1, 1, neutral
385383074,  ericaferrari94, 4, 2, 2, neutral
789609471211438081,  Elvis_1971, 3, 1, 2, no
412872296,  MyoHoChiMin, 2, 1, 1, neutral
1015460040,  FabianaTau, 4, 2, 2, neutral
3377736287,  marcmarat, 2, 1, 1, neutral
712952987430350848,  moreno19651993, 6, 3, 3, neutral
4122261700,  MSpreafi, 2, 1, 1, neutral
2764765443,  MasinMasinn, 6, 4, 2, yes
3152325916,  wlalega, 8, 5, 3, yes
396666538,  vane2978, 2, 1, 1, neutral
2258992916,  Frank61Franco, 2, 1, 1, neutral
389087761,  Sasha_Zurich, 5, 2, 3, no
502904251,  PSanesi, 7, 4, 3, yes
2582196879,  Mateushssouza, 2, 1, 1, neutral
4228423811,  ilcoglione, 8, 4, 4, neutral
842320472,  fmazzoni7, 3, 2, 1, yes
776767134844219392,  annasolerosso, 4, 2, 2, neutral
755807871640674305,  Rossellapollast, 2, 1, 1, neutral
1099126754,  Oscar_Tilli_San, 4, 2, 2, neutral
3102670235,  SaloniaDavide, 4, 2, 2, neutral
803410022243962880,  3SIMONER4, 9, 4, 5, no
804780883894996992,  GattellaG, 4, 2, 2, neutral
1320936355,  LaRobyMI, 6, 4, 2, yes
367045287,  mauriziofiduci, 2, 1, 1, neutral
4245105094,  Yrr100, 9, 3, 6, no
796059980,  RampiniG, 2, 1, 1, neutral
503389433,  giannibresil, 2, 1, 1, neutral
1159915009,  darianichele, 5, 1, 4, no
4774849822,  itsjodie_, 2, 1, 1, neutral
1207677883,  DTurchino, 4, 1, 3, no
2232915432,  frankfz750, 4, 2, 2, neutral
788040280222171136,  mt1620mt, 5, 3, 2, yes
2781237202,  linosegna, 2, 1, 1, neutral
805029282485587968,  ffico321, 2, 1, 1, neutral
1063996592,  RGnopi, 3, 2, 1, yes
705097204223098880,  marmoeada, 2, 1, 1, neutral
2348869926,  PieCiccimarra, 2, 1, 1, neutral
313196161,  nonnociccetto, 9, 1, 8, no
1270383558,  MichParadiso, 4, 2, 2, neutral
65977946,  chiiicco, 13, 3, 10, no
2264537521,  niri64, 3, 1, 2, no
719917582904651776,  StefanoMiki, 2, 1, 1, neutral
1361149975,  pabbona, 2, 1, 1, neutral
801902050254721025,  on_off_on_off_, 12, 7, 5, yes
3579249255,  dicasp_youtube, 6, 4, 2, yes
3328162088,  Oh_Pazzo, 2, 1, 1, neutral
602157500,  frc_f, 2, 1, 1, neutral
779754070965948416,  alessiodesanti, 4, 2, 2, neutral
1704671215,  giada_mazzon, 4, 2, 2, neutral
1860240812,  Eurorave79, 2, 1, 1, neutral
789446990996369408,  MaraBellonioOFF, 6, 3, 3, neutral
788047479640129536,  anamrmatasel, 4, 2, 2, neutral
47304538,  wefranci, 4, 3, 1, yes
472465567,  Fabrytweet78, 2, 1, 1, neutral
565558862,  magni_matteo, 6, 3, 3, neutral
983049733,  ForenseO, 2, 1, 1, neutral
790278017025241088,  Giulio9812, 2, 1, 1, neutral
6138052,  loska, 6, 3, 3, neutral
1132098312,  mindlesswellick, 5, 4, 1, yes
113102542,  Edoteque, 2, 1, 1, neutral
7048432,  colas, 6, 2, 4, no
320149891,  mrSciama, 2, 1, 1, neutral
290758240,  _neve, 3, 2, 1, yes
528890147,  P_Vardon, 2, 1, 1, neutral
779026892,  stre7_1899, 11, 6, 5, yes
3393834010,  sheamilkovich, 6, 5, 1, yes
729670117185998848,  ______MWM______, 4, 2, 2, neutral
304010529,  robydistrade, 12, 10, 2, yes
2379390857,  piereks6, 28, 14, 14, neutral
805744743766458368,  mirkorimedio92, 2, 1, 1, neutral
367685828,  BeppeBlueMan, 2, 1, 1, neutral
943563758,  francescalanzas, 5, 3, 2, yes
3094077212,  Milo54Matte, 5, 2, 3, no
204905169,  mezzopienoeu, 2, 1, 1, neutral
2341105102,  FranTalassi, 2, 1, 1, neutral
469215508,  sf2126, 2, 1, 1, neutral
2527434074,  evibenti, 4, 1, 3, no
2734118716,  dany942010, 3, 2, 1, yes
547770646,  UmbertoDeMaria, 2, 1, 1, neutral
401507232,  MaMaurizi9, 3, 2, 1, yes
3362047301,  FranciJuventino, 2, 1, 1, neutral
536664363,  Livia_Morosini, 2, 1, 1, neutral
561396102,  giuliamontini_, 2, 1, 1, neutral
91565008,  BHXG90, 4, 2, 2, neutral
417114132,  mrSERGIOMOTTOLA, 4, 2, 2, neutral
805692881054953476,  amedeodimarco88, 4, 2, 2, neutral
732683754167271425,  IL_Bazzo87, 2, 1, 1, neutral
489606682,  Fi197de, 4, 2, 2, neutral
1106506602,  Gufo2013, 2, 1, 1, neutral
3164117122,  mrboo80, 5, 1, 4, no
739407931922386944,  QuicklyyyM8, 2, 1, 1, neutral
573691144,  giovgiocilibert, 8, 5, 3, yes
1964763626,  rob_ciccare10, 2, 1, 1, neutral
2507808147,  _ercker, 9, 6, 3, yes
123920914,  Libero_official, 5, 2, 3, no
193761039,  FedeMilano, 2, 1, 1, neutral
384341923,  RobertaFranz, 2, 1, 1, neutral
2854770215,  miquiz86, 3, 1, 2, no
787902572,  sweetieimi, 8, 4, 4, neutral
714573065385078784,  toninxs, 2, 1, 1, neutral
85662211,  PostcardPainter, 3, 2, 1, yes
127604601,  federbaros, 4, 2, 2, neutral
88757384,  mcastagnaa, 2, 1, 1, neutral
326726141,  MauroVanDerV, 2, 1, 1, neutral
465739646,  ivan_cast7, 3, 1, 2, no
258343512,  andre170280, 2, 1, 1, neutral
704404141305688065,  LucioA2010, 4, 2, 2, neutral
50300052,  ilpres, 6, 3, 3, neutral
292241201,  castaRMCF, 2, 1, 1, neutral
229142623,  NinoBalistreri, 2, 1, 1, neutral
1642335008,  DeriuDomenico, 2, 1, 1, neutral
751315632134717440,  Er_Bipolare, 6, 2, 4, no
3221180806,  Ruggiero489Pako, 4, 2, 2, neutral
743531036,  investigator113, 12, 6, 6, neutral
2305879171,  satirist_indian, 2, 1, 1, neutral
2742489819,  gbpasini, 4, 1, 3, no
2899054587,  andreatrignano, 4, 2, 2, neutral
1359525138,  amicofracito, 2, 1, 1, neutral
561580743,  MaryJaneLover95, 2, 1, 1, neutral
2488453649,  ely_eonora, 4, 3, 1, yes
2247747523,  GrumpyLore, 7, 6, 1, yes
348373763,  pnkdrew, 2, 1, 1, neutral
463622439,  davqua5, 2, 1, 1, neutral
1015143096,  AleNico1985, 5, 4, 1, yes
801529533379805190,  paolobruschi6, 4, 2, 2, neutral
481197376,  merygueinozzo, 2, 1, 1, neutral
2484113331,  pota_pota96, 2, 1, 1, neutral
4220954363,  AnnaMazzoni5, 2, 1, 1, neutral
481381153,  Angela_Lucinda, 2, 1, 1, neutral
380830787,  Sky0255, 2, 1, 1, neutral
2380531864,  GMatteacci, 4, 2, 2, neutral
1890103093,  MarySpadaro2, 2, 1, 1, neutral
578232486,  AngeloCatanista, 4, 3, 1, yes
2842193896,  hibiscus121, 2, 1, 1, neutral
2498964015,  chetis73, 2, 1, 1, neutral
717532001,  FrancoCallegar1, 8, 2, 6, no
490529086,  ritaadivinaf, 3, 1, 2, no
1061399972,  Criss16_, 5, 4, 1, yes
458594886,  KarenCarboni, 2, 1, 1, neutral
1593270115,  Tony47560189, 7, 4, 3, yes
2894747885,  michelepetrocch, 3, 2, 1, yes
240317733,  sergiodemichiel, 3, 2, 1, yes
2304092885,  P_Giov_yohnny, 2, 1, 1, neutral
2404629743,  toreilde, 2, 1, 1, neutral
194315771,  vale_pa89, 8, 4, 4, neutral
17733231,  MarcoBuqs, 2, 1, 1, neutral
4841935931,  MannaiLoredana, 2, 1, 1, neutral
48979295,  ilbonaiuti, 4, 2, 2, neutral
3023202976,  StefScorpion, 8, 4, 4, neutral
3412344964,  Sergio58395876, 2, 1, 1, neutral
351703720,  xbeshax, 2, 1, 1, neutral
498766319,  GretaSmara, 2, 1, 1, neutral
655073,  javame, 2, 1, 1, neutral
381419274,  sandrosedita, 18, 3, 15, no
514596090,  fabio_issimo, 2, 1, 1, neutral
546182782,  grefriso14, 4, 2, 2, neutral
544497189,  giorgiamennuni, 2, 1, 1, neutral
2515438775,  alessio198884, 10, 9, 1, yes
1067061,  rone, 2, 1, 1, neutral
1304463078,  peppemiragli, 5, 3, 2, yes
262199092,  _neardeath, 2, 1, 1, neutral
1016142582,  puteriolukas, 6, 3, 3, neutral
594618106,  Ila185, 2, 1, 1, neutral
1719395881,  eivissporlavida, 2, 1, 1, neutral
3230739898,  alessandra5025, 2, 1, 1, neutral
1133836538,  freyermalou, 8, 4, 4, neutral
137319132,  TayMariola, 3, 2, 1, yes
424422290,  lukyno72, 2, 1, 1, neutral
296179009,  pietro_l, 3, 2, 1, yes
407608942,  CaterinaMonte, 4, 2, 2, neutral
382690046,  MCavariani, 13, 9, 4, yes
519885825,  simobiondo10, 2, 1, 1, neutral
939157082,  FinallyRoberta, 2, 1, 1, neutral
805550404373188608,  ANNAMM76, 2, 1, 1, neutral
2730182561,  bea_belotti, 2, 1, 1, neutral
876986610,  Venicebeach77, 2, 1, 1, neutral
283580593,  MarinoBuzzi, 2, 1, 1, neutral
1344717780,  IsrafilElRafa, 2, 1, 1, neutral
799386769082945540,  PetraccaFabio, 2, 1, 1, neutral
4436365575,  grazi2777, 18, 6, 12, no
827410892,  grulliver, 2, 1, 1, neutral
3298972078,  stoiko76, 5, 2, 3, no
3387776842,  beam_of_light__, 2, 1, 1, neutral
4864902358,  Anonym_74, 5, 4, 1, yes
722390391731974144,  Sara01127070, 5, 3, 2, yes
1680697170,  Gianni_Bitonti, 46, 9, 37, no
99184394,  heart5terre, 2, 1, 1, neutral
786241444193468416,  Cate04135018, 8, 4, 4, neutral
1040408522,  PatrickFN63, 2, 1, 1, neutral
1871652506,  jeandaureille, 2, 1, 1, neutral
2991660165,  opera_stories, 2, 1, 1, neutral
573743846,  marino_giuseppe, 5, 2, 3, no
291837985,  Francesc01B, 2, 1, 1, neutral
3325021203,  max_caliendo, 2, 1, 1, neutral
1482937470,  merissmile, 3, 1, 2, no
2481535589,  metbresci, 2, 1, 1, neutral
2269734236,  bestpalcez, 3, 2, 1, yes
3116784161,  patrio123456, 2, 1, 1, neutral
1215622322,  99_gianlu, 2, 1, 1, neutral
4814307257,  terry_smeraldi, 2, 1, 1, neutral
194581478,  SheisGiu, 5, 3, 2, yes
4762981463,  FrancescoRidol2, 4, 2, 2, neutral
1147654514,  avv_possamai, 2, 1, 1, neutral
240226308,  MaurizioCampia, 2, 1, 1, neutral
2331213631,  MartinBergara92, 2, 1, 1, neutral
2482185637,  pgannat, 2, 1, 1, neutral
33845343,  Savanagirl, 3, 2, 1, yes
113047084,  ldedanne, 2, 1, 1, neutral
934718624,  Tiziano_mrn, 2, 1, 1, neutral
447383139,  iceeke65, 4, 2, 2, neutral
408917512,  Gaetan001, 2, 1, 1, neutral
436128176,  leleram, 4, 2, 2, neutral
319234711,  iKissBieberLips, 3, 1, 2, no
2432707060,  isequiser96, 2, 1, 1, neutral
130478454,  maurix979, 2, 1, 1, neutral
765223385320263680,  Biancospino_16, 4, 3, 1, yes
3426352180,  CoqResistant, 4, 2, 2, neutral
2877719301,  DavideCapezzera, 5, 3, 2, yes
429094402,  pepedondo, 3, 1, 2, no
1888151310,  ahmedsam001, 2, 1, 1, neutral
721654034080391168,  GMNA74, 2, 1, 1, neutral
538088781,  Gedeo, 8, 4, 4, neutral
294848207,  franzscudetto, 2, 1, 1, neutral
630422990,  TONTONBLEUMARIN, 4, 2, 2, neutral
521576025,  DavideDentiD2, 2, 1, 1, neutral
757338148087205888,  Titty8010, 6, 5, 1, yes
448909282,  LuisaBevilacqu1, 2, 1, 1, neutral
711291279884292096,  DavidsSala, 2, 1, 1, neutral
2276303197,  mikaelsovn, 5, 2, 3, no
244550766,  bartalex86, 2, 1, 1, neutral
163971436,  kissmeciastin, 5, 3, 2, yes
751223917352783873,  j_identitario, 2, 1, 1, neutral
599343100,  solox_te, 3, 2, 1, yes
730511071136645121,  Jimmy81859127, 21, 11, 10, yes
398213393,  Xhanderrr, 2, 1, 1, neutral
318524279,  omnis16, 6, 1, 5, no
2890548707,  Sorryuncazzo, 2, 1, 1, neutral
1318423074,  TheRealPoci, 13, 3, 10, no
1910176993,  silvio_garofalo, 9, 8, 1, yes
2861073281,  KenRenar96, 9, 5, 4, yes
231907795,  missluv2spin, 2, 1, 1, neutral
500644577,  Andrea_Dalgri, 2, 1, 1, neutral
365975700,  AndreaRundeddu, 14, 7, 7, neutral
334149677,  Maniheli, 5, 3, 2, yes
3291958301,  PatrykMarin, 5, 3, 2, yes
831927362,  salvatoregiovi2, 4, 3, 1, yes
458391837,  DvNiky, 2, 1, 1, neutral
96189702,  nelluccia, 2, 1, 1, neutral
2891386504,  ISensibili, 2, 1, 1, neutral
2882900169,  crisalide1984, 3, 2, 1, yes
4420225815,  itapacifici, 3, 2, 1, yes
1168974246,  PivaPaola, 2, 1, 1, neutral
2357363460,  Giuseppe2406, 14, 7, 7, neutral
213601053,  _ilFailla, 6, 4, 2, yes
156939096,  hheartyou, 5, 3, 2, yes
2180851222,  lopezgnecco, 2, 1, 1, neutral
597503789,  ValentinaSigyn, 2, 1, 1, neutral
70231705,  FrBagnasco, 2, 1, 1, neutral
830621611,  DAgostiniElisa, 2, 1, 1, neutral
763638409885782016,  saradontsocheap, 4, 2, 2, neutral
2271749877,  meyer_mp, 4, 2, 2, neutral
760480211343466501,  Fidelio_is_weer, 2, 1, 1, neutral
110121082,  maktness, 2, 1, 1, neutral
1336854852,  piroaerox, 2, 1, 1, neutral
1311638582,  StinaInzaghi, 4, 2, 2, neutral
1706397632,  briganti_andrea, 6, 2, 4, no
794560492337594368,  Andwecan1, 7, 3, 4, no
797603969828798464,  Alberto_Pand, 2, 1, 1, neutral
3073392429,  TronRoberta, 2, 1, 1, neutral
25372496,  Mantaly, 2, 1, 1, neutral
3187935401,  MicheleLAURENC1, 2, 1, 1, neutral
2507151588,  ATernelli, 2, 1, 1, neutral
746286023961874432,  markolisi04, 3, 2, 1, yes
444537543,  cabassifrontoni, 4, 3, 1, yes
117345204,  davidesurf, 2, 1, 1, neutral
734869080,  MassiCollicelli, 4, 2, 2, neutral
3095218810,  silviasweet93, 6, 3, 3, neutral
81575939,  hellomynameisra, 2, 1, 1, neutral
2185680298,  grromagnoli98, 2, 1, 1, neutral
4898473762,  PicconiFN, 2, 1, 1, neutral
97994808,  LeaVergatti, 2, 1, 1, neutral
187896196,  ACabas, 3, 1, 2, no
2959034728,  PancioAle, 2, 1, 1, neutral
4653742216,  leo_barbensi, 2, 1, 1, neutral
4196176283,  cuculoantonio, 2, 1, 1, neutral
2347753713,  covamanera, 2, 1, 1, neutral
496861769,  OFinocchiaro, 2, 1, 1, neutral
4504076788,  Domenic72202160, 2, 1, 1, neutral
4081845855,  alberto19651965, 6, 4, 2, yes
2533204824,  CibaoFollowback, 2, 1, 1, neutral
791716043299356672,  pampaaar, 2, 1, 1, neutral
1064212633,  AscanioGardini, 2, 1, 1, neutral
1655956146,  MarleGreys, 2, 1, 1, neutral
2613133313,  garatch_for2, 4, 2, 2, neutral
787182731453140992,  braidamilan, 8, 4, 4, neutral
3145549001,  TreviCharles, 2, 1, 1, neutral
214114344,  speedluk, 4, 2, 2, neutral
260398077,  mauri660, 2, 1, 1, neutral
1108335294,  78_valeri, 2, 1, 1, neutral
1137734263,  mary90534003, 2, 1, 1, neutral
4513243461,  savianododo, 2, 1, 1, neutral
57044863,  sonounalieno, 2, 1, 1, neutral
815961534,  GiovanniEmme1, 2, 1, 1, neutral
2587168175,  cheansia27, 2, 1, 1, neutral
233522934,  natapronta, 12, 6, 6, neutral
245969509,  noitre32, 5, 2, 3, no
820524282,  trapezioverde, 5, 3, 2, yes
426188717,  Richardinho91, 2, 1, 1, neutral
868692835,  eudaimouis, 6, 4, 2, yes
600280322,  santoiannienzo, 2, 1, 1, neutral
3089159795,  marisaaloisi, 3, 2, 1, yes
2967986675,  alessiaemma2014, 2, 1, 1, neutral
1951047476,  pillolina2, 7, 1, 6, no
4822567191,  NantroPologa, 8, 4, 4, neutral
803663611713490946,  Sefira34163251, 5, 3, 2, yes
377346300,  LucaBufalieri, 2, 1, 1, neutral
778643052873285632,  michaelvegini, 7, 3, 4, no
195722616,  Umbe_23, 4, 2, 2, neutral
2356790750,  cavacava1975, 3, 1, 2, no
3309749434,  ColajLjuba, 3, 1, 2, no
796190908379172864,  catania1967, 2, 1, 1, neutral
2881810367,  PeppeYodice, 2, 1, 1, neutral
1021852446,  GiovanniCian, 9, 5, 4, yes
791418320,  mozzarellawin_, 8, 4, 4, neutral
4432904595,  reaITeflonDon, 2, 1, 1, neutral
249697063,  bellasicilia78, 5, 2, 3, no
791003645051559940,  Giorgia2610, 2, 1, 1, neutral
796601553616596992,  Scandalisti_com, 10, 5, 5, neutral
216073612,  AnnaxLGxTS, 5, 4, 1, yes
771016542553268224,  luigivanti, 2, 1, 1, neutral
3341373333,  Louis90ita, 5, 3, 2, yes
16367196,  SilverWarrior, 2, 1, 1, neutral
805387375270576128,  QuantMint_, 15, 8, 7, yes
566233412,  bissipissola, 2, 1, 1, neutral
2433797526,  myhomeisloueh, 2, 1, 1, neutral
627170183,  _iStef91, 3, 2, 1, yes
4725196222,  gnotul66, 6, 3, 3, neutral
1279017373,  itsjotw, 3, 2, 1, yes
1608713004,  TheRealOrco, 7, 4, 3, yes
165867822,  lio1897, 2, 1, 1, neutral
490548353,  ohmyramsey, 3, 1, 2, no
2938850691,  __Ozymandias_, 2, 1, 1, neutral
3362685705,  Sa_Amoruso, 7, 4, 3, yes
845804107,  Russ_Warrior, 4, 2, 2, neutral
3436043151,  chiara19726712, 2, 1, 1, neutral
3328932137,  LionOfVenice, 2, 1, 1, neutral
2300213626,  andrelettrico, 2, 1, 1, neutral
538108617,  alelu210, 3, 2, 1, yes
398299994,  Jole6048, 4, 2, 2, neutral
711972196646670336,  MarcoRo73622903, 4, 2, 2, neutral
2343322979,  araldifran, 4, 3, 1, yes
128176490,  linodg74, 2, 1, 1, neutral
184729817,  vito_barraco, 2, 1, 1, neutral
485573357,  SalvatoreSaleon, 2, 1, 1, neutral
4256636603,  Dani76Nilo, 2, 1, 1, neutral
2245688323,  GiglioliCarlo, 6, 2, 4, no
2324049793,  sambuccoa, 12, 2, 10, no
271374908,  laaraj1, 2, 1, 1, neutral
634690513,  MgpPiemonte, 2, 1, 1, neutral
1539414133,  lulami64, 2, 1, 1, neutral
805333672001961984,  dongiogi, 11, 5, 6, no
4885937632,  SMaliqati, 4, 3, 1, yes
2894383587,  matilde4747, 3, 2, 1, yes
805553284337586176,  Grower757, 4, 1, 3, no
1272666296,  monacelt, 3, 1, 2, no
299172027,  ninopuccio, 2, 1, 1, neutral
3419909445,  giuledda, 5, 3, 2, yes
1969190317,  MatrixCanale5, 40, 35, 5, yes
243569730,  spromano, 2, 1, 1, neutral
1056268357,  AntoineMellies, 2, 1, 1, neutral
1105580412,  dastjpopino, 2, 1, 1, neutral
257180831,  marinaralla, 2, 1, 1, neutral
1921110236,  babifra77, 3, 2, 1, yes
452096877,  Show_No_Mercy, 7, 4, 3, yes
214822092,  ilterracinese, 5, 4, 1, yes
1849696574,  EfkaRama, 4, 2, 2, neutral
391485689,  StefanoFeltri, 16, 14, 2, yes
3225964143,  travolgentemen1, 2, 1, 1, neutral
1726637880,  NatalePica, 2, 1, 1, neutral
1570489244,  GiordanoGiardi, 4, 2, 2, neutral
1857561044,  VitoDellEdera, 4, 2, 2, neutral
396762705,  MicheleAngelo7, 5, 3, 2, yes
454448419,  GabrieleScafati, 2, 1, 1, neutral
3365786625,  christianPRFG, 4, 3, 1, yes
3912008141,  gianni76468778, 7, 6, 1, yes
608379751,  LucaPalazz0, 5, 3, 2, yes
410193975,  braccialer, 4, 2, 2, neutral
385456063,  carlodaverona, 44, 16, 28, no
3346219811,  BrianMin_, 2, 1, 1, neutral
388330414,  Lorenzuolo, 4, 2, 2, neutral
2916281104,  Arctic_Bitch_, 4, 2, 2, neutral
51401698,  NicFer80, 4, 3, 1, yes
96763117,  pantarea, 2, 1, 1, neutral
120927887,  ninomusumeci, 2, 1, 1, neutral
2984766304,  LancellottiDav, 2, 1, 1, neutral
416542224,  Ntonio71, 4, 1, 3, no
83830961,  RLabianco, 2, 1, 1, neutral
485634584,  GiancarloPasqu1, 10, 1, 9, no
64444386,  notarimattia, 2, 1, 1, neutral
388177934,  AndreaElli73, 2, 1, 1, neutral
3130731489,  OFFICIAL_PEGIDA, 2, 1, 1, neutral
723219535398989825,  max1e6, 2, 1, 1, neutral
88257786,  magellano1, 4, 2, 2, neutral
378224695,  francistheleg, 3, 2, 1, yes
1246722414,  link12000, 2, 1, 1, neutral
2860653386,  fi_mauro, 2, 1, 1, neutral
61152350,  evaludica, 4, 2, 2, neutral
33567548,  ppaurizio, 2, 1, 1, neutral
3309694673,  fede00bucc, 4, 2, 2, neutral
372948910,  carstairsjem, 4, 2, 2, neutral
142514049,  NicoamalaJuve, 2, 1, 1, neutral
99350238,  fabietto80, 4, 2, 2, neutral
525482136,  Enri_Capri, 2, 1, 1, neutral
86825077,  argaii88, 2, 1, 1, neutral
40571885,  marziaJoplin, 2, 1, 1, neutral
3164264061,  zuccherorosa75, 7, 4, 3, yes
109945090,  Cookiemuffen, 2, 1, 1, neutral
105014063,  cannabeanoide, 2, 1, 1, neutral
309308907,  lerivedimorfeo, 2, 1, 1, neutral
501163555,  demomas74, 3, 2, 1, yes
3429163180,  Mak0Zamo, 2, 1, 1, neutral
378247626,  BabyV_Hudgensss, 18, 9, 9, neutral
4699948282,  RM20821, 3, 2, 1, yes
799737866540683264,  Antonio46867254, 2, 1, 1, neutral
2828728746,  bolzonipaola1, 12, 4, 8, no
1513153436,  chriparisio, 4, 2, 2, neutral
901957920,  filomezza, 3, 1, 2, no
3177896819,  itsnavyordierih, 4, 2, 2, neutral
2667549227,  ScarpelliniBG, 2, 1, 1, neutral
976369838,  andrearicatt, 6, 4, 2, yes
498775804,  professioneinfe, 2, 1, 1, neutral
775242420615249924,  criste_98, 2, 1, 1, neutral
3599521275,  RitaAngelelli, 8, 7, 1, yes
515136007,  fagnanof, 2, 1, 1, neutral
424868936,  claudiobertolle, 2, 1, 1, neutral
4627041215,  1437Cesio, 2, 1, 1, neutral
413873933,  stecriv, 3, 2, 1, yes
2764988225,  tatti_giugio, 2, 1, 1, neutral
604520390,  picollosilvano, 5, 3, 2, yes
410972345,  Maria_Giampi, 4, 2, 2, neutral
4193125767,  Campion37163868, 2, 1, 1, neutral
3382294643,  8ecb746f71274a5, 2, 1, 1, neutral
2973540729,  graziellamail, 2, 1, 1, neutral
970462951,  Venusbella06, 11, 8, 3, yes
76620420,  francoandrea, 18, 9, 9, neutral
1142192286,  _manrico, 18, 3, 15, no
2973336951,  grazy19720, 2, 1, 1, neutral
1080152546,  ARIOJUSTUS, 2, 1, 1, neutral
54849589,  bettigiu, 26, 1, 25, no
386988527,  Luminami_, 5, 1, 4, no
3645074302,  ghignodipunta, 2, 1, 1, neutral
455201661,  lobelixII, 2, 1, 1, neutral
2371530239,  man71dev, 48, 40, 8, yes
1965647792,  Massimo_GW, 2, 1, 1, neutral
999340988,  kjarah80, 4, 2, 2, neutral
2221887969,  58116069, 2, 1, 1, neutral
2374479791,  MaraTalenti, 2, 1, 1, neutral
315319679,  29Bruni, 2, 1, 1, neutral
1117095943,  BrolinandZiam, 3, 2, 1, yes
15692032,  giuslom, 9, 5, 4, yes
4140006736,  PizzuttoVanessa, 2, 1, 1, neutral
2797539111,  quintonoimbrog1, 67, 4, 63, no
430591850,  Roberta_Ferrero, 2, 1, 1, neutral
118028997,  kiupys, 27, 16, 11, yes
2810106892,  Denverike_, 3, 2, 1, yes
432764261,  ilkiser, 2, 1, 1, neutral
255392227,  mony863, 3, 2, 1, yes
387089650,  xlosechester, 2, 1, 1, neutral
2765465235,  AlbertoGaleja, 2, 1, 1, neutral
2320672163,  FasanoGeremia, 2, 1, 1, neutral
1183166264,  Antonello_Usai, 2, 1, 1, neutral
708150988,  APizzocchero, 3, 1, 2, no
4277641096,  alexandre_sabo, 2, 1, 1, neutral
176773840,  mariacannata, 2, 1, 1, neutral
706822378,  Davscotellaro, 3, 2, 1, yes
158261785,  _mydreams1D_, 2, 1, 1, neutral
94383557,  benedictosolson, 2, 1, 1, neutral
536416872,  FilomixFilomena, 4, 2, 2, neutral
801386756440473600,  LanfaloniLuana, 2, 1, 1, neutral
581718242,  nassodomenico, 5, 3, 2, yes
128994567,  AdvancedNikita, 2, 1, 1, neutral
795618131507089409,  MarioSicilia2, 3, 2, 1, yes
231132791,  lucacirelli, 2, 1, 1, neutral
532466089,  AriannaPagani2, 2, 1, 1, neutral
952583023,  Lollobast, 2, 1, 1, neutral
550066695,  paolino2009, 2, 1, 1, neutral
2925299842,  remanuel97, 2, 1, 1, neutral
1329958921,  nordkatte, 6, 3, 3, neutral
458744080,  RosyIovine, 8, 4, 4, neutral
463313162,  emyripley, 4, 3, 1, yes
2925894275,  CamiDig10, 2, 1, 1, neutral
1460392712,  DavideMaglione1, 2, 1, 1, neutral
1249955268,  EmanuelePalomb, 3, 2, 1, yes
4537641262,  Alessa1974, 2, 1, 1, neutral
2609395708,  francescor78, 2, 1, 1, neutral
258704458,  anichiniphoto, 2, 1, 1, neutral
711680570431049729,  gschillaci7, 2, 1, 1, neutral
1349273773,  wewereamazing, 3, 2, 1, yes
415004088,  AlbertoRapk, 2, 1, 1, neutral
2470651487,  ElisaEvangelis2, 7, 6, 1, yes
782189550848401408,  simolamura, 2, 1, 1, neutral
730133859086569472,  kierkos2, 2, 1, 1, neutral
1243135074,  FrancescoProi11, 2, 1, 1, neutral
74554081,  GVPiccini, 2, 1, 1, neutral
3538306217,  LoredanaForesto, 2, 1, 1, neutral
2263182386,  ANGELAVARZAR, 2, 1, 1, neutral
452310942,  JulienUgazzi, 2, 1, 1, neutral
1264330477,  FraMasi81, 2, 1, 1, neutral
142293552,  SilasFreitas, 4, 2, 2, neutral
1109641424,  Cucciola975, 4, 2, 2, neutral
1904968262,  Pupo051, 5, 4, 1, yes
1951828382,  Piovegovernolad, 3, 1, 2, no
2930707185,  maaad_attitude, 2, 1, 1, neutral
755917172795404288,  micheladuiz, 2, 1, 1, neutral
1652674339,  NicolMessina, 6, 3, 3, neutral
101489921,  martiferraiuolo, 2, 1, 1, neutral
108009714,  Isabella993, 4, 2, 2, neutral
34551795,  lauramastro, 6, 3, 3, neutral
767385042775601152,  gnoffiland, 6, 3, 3, neutral
520449734,  Marion_M_Le_Pen, 6, 3, 3, neutral
413104905,  Masino_, 2, 1, 1, neutral
519696949,  AlbeNGiuliari, 16, 3, 13, no
804241130430861312,  Robertinafan, 2, 1, 1, neutral
2513097323,  francescap0906, 6, 5, 1, yes
777217021629038592,  fabio_clgt, 6, 3, 3, neutral
426651868,  MarcoDema2, 5, 3, 2, yes
1562419639,  Giadina_Blue, 17, 8, 9, no
712004079791124481,  klarolinebest, 5, 1, 4, no
574680103,  Andrewwww27, 5, 3, 2, yes
431796974,  zuxy71, 4, 2, 2, neutral
774096816,  andreabassutti, 2, 1, 1, neutral
73242287,  radiobocconi, 4, 3, 1, yes
793934770665385984,  Capestrano1456, 2, 1, 1, neutral
375827205,  Garus79, 2, 1, 1, neutral
775343065036943361,  fedecast01, 2, 1, 1, neutral
309933112,  Sergioelm, 5, 2, 3, no
447945408,  Italy_Mauri, 8, 3, 5, no
4697205709,  GioeleFasano, 2, 1, 1, neutral
2621037358,  mehr_mohsin, 4, 2, 2, neutral
412506846,  CrissDi, 2, 1, 1, neutral
2667739481,  fede_capo9, 3, 2, 1, yes
295383484,  Aho2ToMan, 2, 1, 1, neutral
140287920,  TonyPatrone, 2, 1, 1, neutral
3231846833,  fr_souche_jura, 6, 3, 3, neutral
394924192,  vivi6710, 4, 2, 2, neutral
168041428,  jadestuxedo, 4, 2, 2, neutral
792604497629569025,  VascoRo62345648, 22, 11, 11, neutral
870535988,  lubhiana, 4, 2, 2, neutral
797840909626998788,  mauriziodelunas, 13, 6, 7, no
1423781100,  777sieg, 4, 2, 2, neutral
1038138457,  DiegoAmbrosin, 2, 1, 1, neutral
804295388824006656,  doxnotfox, 4, 2, 2, neutral
2184571299,  Daglas_07223, 2, 1, 1, neutral
2785354678,  Cherol86, 2, 1, 1, neutral
603484908,  giannguerr, 3, 1, 2, no
2461474328,  SilviaCinell, 2, 1, 1, neutral
314566134,  sasab2, 2, 1, 1, neutral
529454290,  VaruniGiovanni, 2, 1, 1, neutral
1059025171,  MattSijeGregor, 2, 1, 1, neutral
2174506659,  BiancardiMatteo, 2, 1, 1, neutral
4077977123,  CeciliaOlt, 4, 2, 2, neutral
4883586880,  Franci069679, 2, 1, 1, neutral
3334382897,  Gio_Leo_Mezzo, 2, 1, 1, neutral
489601479,  Nonna_Mela, 4, 3, 1, yes
2481071487,  bissardella, 6, 3, 3, neutral
569311920,  AndreaWhites, 4, 2, 2, neutral
3207310307,  Esiste_Dio, 27, 11, 16, no
434296262,  antitetica1, 2, 1, 1, neutral
702593712489172992,  Paola95516704, 4, 1, 3, no
2288643866,  Franciscovota, 3, 1, 2, no
801133228983812096,  Antonin12349691, 2, 1, 1, neutral
4926458867,  lucio1455, 3, 1, 2, no
1081038630,  rscalt76, 3, 1, 2, no
2527352064,  MDENoUE, 8, 5, 3, yes
3764423603,  amatamente, 2, 1, 1, neutral
4826987211,  London753, 3, 1, 2, no
492529570,  ImPoliticalWill, 2, 1, 1, neutral
1063454497,  fbcardio, 4, 1, 3, no
47092465,  crigabri, 6, 3, 3, neutral
490663130,  riccardodelloli, 2, 1, 1, neutral
2366872745,  fabiobompadre, 3, 1, 2, no
4081240757,  butterMV14, 9, 2, 7, no
454058027,  mirko_gatti, 2, 1, 1, neutral
1716128048,  lauraf1974, 2, 1, 1, neutral
493833883,  MarilenaAll, 8, 3, 5, no
597758871,  EzioDadda, 4, 2, 2, neutral
741172638345789440,  Rossana08921636, 2, 1, 1, neutral
296913774,  MatteoDaRe, 2, 1, 1, neutral
346161795,  Giove09, 8, 4, 4, neutral
307264002,  salviaticomunis, 3, 2, 1, yes
3235938178,  Santocattafi69, 4, 3, 1, yes
726861266732601344,  alberto_divizia, 2, 1, 1, neutral
4228328659,  liviostefano66, 2, 1, 1, neutral
727039199883481088,  matteoldoni, 2, 1, 1, neutral
3421011273,  LJurjatin, 3, 2, 1, yes
786445441,  lomoEffe, 16, 6, 10, no
488856416,  frencysor, 8, 3, 5, no
1511430246,  BerniniSaverio, 2, 1, 1, neutral
396444543,  PAOLOSTARTARI, 2, 1, 1, neutral
3073584657,  DonatoAntonio78, 4, 3, 1, yes
1868341807,  guid_fio, 15, 8, 7, yes
3152402907,  salvatore0414, 2, 1, 1, neutral
492310172,  RobertoRota92, 3, 2, 1, yes
3152516499,  CiVorrebbeHulk, 2, 1, 1, neutral
532909892,  paolina_u, 3, 2, 1, yes
1540767944,  ezeta67, 3, 2, 1, yes
317659038,  adragnawalter, 7, 3, 4, no
3020323600,  Sabrina00297634, 5, 3, 2, yes
794543370530095104,  sblindaman, 15, 4, 11, no
2152343369,  DGeatti, 2, 1, 1, neutral
500790707,  SALVATOREVACCA8, 2, 1, 1, neutral
1080083190,  22vpolo, 2, 1, 1, neutral
868181893,  PopEtik, 2, 1, 1, neutral
153386577,  MariannaCal, 2, 1, 1, neutral
2270632291,  sposatopeppino, 4, 2, 2, neutral
579042189,  KaiserSose143, 2, 1, 1, neutral
410234636,  markoramius62, 8, 5, 3, yes
194217573,  roby800, 7, 4, 3, yes
4429540427,  Officinagioie, 2, 1, 1, neutral
3302109496,  SsakkoSilvia, 6, 3, 3, neutral
788138262581899264,  marti0611, 2, 1, 1, neutral
751411079947907072,  Victorazulon, 2, 1, 1, neutral
805706164466020352,  adry999999, 5, 3, 2, yes
762623677317939200,  Marco91426982, 2, 1, 1, neutral
3126510327,  FurioGarbagnati, 43, 13, 30, no
480629483,  SimoSaletti, 15, 7, 8, no
153196287,  razzataplaz, 2, 1, 1, neutral
46643607,  pap1pap, 2, 1, 1, neutral
407234171,  felicecilfone, 3, 2, 1, yes
3065987998,  spin_ita, 6, 4, 2, yes
1477936178,  damialesslazio, 4, 1, 3, no
162002854,  quotidianopiem, 4, 3, 1, yes
4078214411,  sonomaurizio, 4, 2, 2, neutral
2315712128,  _louissarms, 2, 1, 1, neutral
750456836340457472,  MassimoMonaste1, 2, 1, 1, neutral
1588885189,  xidapi, 2, 1, 1, neutral
1658559944,  AmerigoHeronn, 7, 3, 4, no
555327098,  lucaisnardi, 2, 1, 1, neutral
312888560,  anouchkacohen, 3, 2, 1, yes
520304390,  MarchinoSanchez, 2, 1, 1, neutral
799935085164265472,  AnnunziataLuRai, 4, 2, 2, neutral
261398623,  Momo_glad, 2, 1, 1, neutral
45865363,  luanajfc, 2, 1, 1, neutral
748171339,  Bose_cafe, 2, 1, 1, neutral
453031374,  TrezeWill, 2, 1, 1, neutral
404811072,  Wizard_1979, 5, 2, 3, no
288688607,  msalicegallo, 2, 1, 1, neutral
54865297,  ste_ny, 2, 1, 1, neutral
793129496538931200,  HauteEnergie, 2, 1, 1, neutral
423533699,  gLizzie98, 3, 1, 2, no
3908344585,  LisaTLemoine2, 2, 1, 1, neutral
167009733,  Itscarlotta_, 5, 3, 2, yes
1295227003,  shazdows, 4, 2, 2, neutral
775748030012284928,  Kaos23, 6, 3, 3, neutral
3350936242,  bobi_berga, 14, 11, 3, yes
313962260,  whenthesunsdown, 3, 2, 1, yes
721262035368087553,  menleuropa, 2, 1, 1, neutral
4827366741,  NardellaInforma, 7, 5, 2, yes
309901708,  hooky75, 2, 1, 1, neutral
159032412,  Erika9716, 2, 1, 1, neutral
97700741,  TheLaurieD, 15, 2, 13, no
2693285264,  tasteofrust, 2, 1, 1, neutral
74977946,  RosBram, 4, 2, 2, neutral
484011321,  andreafenili, 3, 2, 1, yes
228185445,  bayramzilan, 3, 2, 1, yes
479633279,  thomaslevy14, 4, 2, 2, neutral
92505635,  EvaIsabelle, 4, 3, 1, yes
569368229,  areip92, 3, 2, 1, yes
2733294556,  GOdany_95, 26, 13, 13, neutral
516624218,  pascaziomarco, 7, 5, 2, yes
603915101,  chershappiness, 2, 1, 1, neutral
90375439,  MAST3RP1ECE, 2, 1, 1, neutral
163595230,  Ale_Landi, 7, 2, 5, no
2613609390,  j21unis, 4, 2, 2, neutral
1577774118,  bestiaebast, 2, 1, 1, neutral
564096282,  AntonioCrispi2, 3, 2, 1, yes
1470771482,  labinis3, 6, 3, 3, neutral
1074133262,  LidyaLidya7, 3, 2, 1, yes
474002963,  lucabaroncini85, 5, 2, 3, no
14270142,  thinkindie, 2, 1, 1, neutral
984744980,  RobertoGiolo, 20, 17, 3, yes
561041001,  pasqualinosarro, 4, 2, 2, neutral
4523716517,  AlbertoSardo3, 2, 1, 1, neutral
420290257,  AntonelloPorcu1, 5, 4, 1, yes
429679335,  antonionicol1, 2, 1, 1, neutral
2876343016,  cogne92, 4, 2, 2, neutral
1036652724,  Giuliosapt, 3, 2, 1, yes
150158919,  LionHearts2016, 2, 1, 1, neutral
95088046,  antoniovincenti, 3, 1, 2, no
1060550197,  anna_d80, 2, 1, 1, neutral
841814256,  Lore_Bellucci, 15, 2, 13, no
227418048,  dylanated, 5, 4, 1, yes
555438378,  Brownie_Cla_AJ, 2, 1, 1, neutral
2332198902,  milandailyphoto, 4, 2, 2, neutral
752239189685665792,  watohal, 3, 1, 2, no
3302939500,  14Wolly, 14, 4, 10, no
3004185915,  DeLaMarcus92, 4, 1, 3, no
1351504668,  EmanuelaIoannon, 9, 5, 4, yes
710954003987873792,  pao_reilly, 2, 1, 1, neutral
744650508506382336,  AbePierluigi, 2, 1, 1, neutral
304467533,  24Mattino, 12, 6, 6, neutral
1078003854,  DAndreamatteoA, 2, 1, 1, neutral
583717975,  MartinaMussone, 2, 1, 1, neutral
767018368947916804,  Luke9816, 4, 2, 2, neutral
3893146701,  Tonybest2001, 2, 1, 1, neutral
1350936138,  linoannunziatac, 4, 1, 3, no
612581789,  CristalFrisoni, 2, 1, 1, neutral
412425317,  Auiz23, 5, 3, 2, yes
576497734,  VeneDaniele, 2, 1, 1, neutral
3525780075,  damatoniccolo, 6, 3, 3, neutral
2751832007,  RobertoDuranti, 2, 1, 1, neutral
86425164,  ariannamattioli, 6, 3, 3, neutral
62500641,  toshi_it, 2, 1, 1, neutral
410891592,  ElenaFiero, 4, 2, 2, neutral
80672878,  giocerag, 4, 3, 1, yes
3412968784,  giogandi, 8, 4, 4, neutral
276187826,  pampilla01, 14, 12, 2, yes
270816789,  JohnKramer91, 4, 2, 2, neutral
780382517715202048,  piersant3, 2, 1, 1, neutral
67564253,  Andreauakari, 22, 18, 4, yes
3133960911,  JeanJacquespp, 2, 1, 1, neutral
2514568559,  Ivanbianchi_, 5, 3, 2, yes
2523593234,  Tritti001, 6, 3, 3, neutral
106731377,  morens3000, 3, 1, 2, no
572915439,  Turi_Migliore, 2, 1, 1, neutral
330449169,  giuliasofiahack, 6, 3, 3, neutral
428272958,  valentinacons, 9, 4, 5, no
324580620,  AlfredoDeVuono, 3, 2, 1, yes
90367970,  claudionasca, 4, 3, 1, yes
432538706,  cicco_lu, 4, 2, 2, neutral
1225676791,  MichelaCimi, 3, 2, 1, yes
1869380918,  matteofotograf, 2, 1, 1, neutral
510420773,  DanieleMaisto83, 2, 1, 1, neutral
402192435,  LuceRosselli, 4, 2, 2, neutral
145252665,  gannemans, 4, 2, 2, neutral
801870469762785280,  TamaraTomb, 2, 1, 1, neutral
548415706,  psychoravn, 2, 1, 1, neutral
2828038536,  heartswontlie, 8, 4, 4, neutral
2559991101,  cuocadicasa, 6, 3, 3, neutral
2271911592,  remedi_remedi, 2, 1, 1, neutral
459609642,  andersonfabio84, 2, 1, 1, neutral
2368943517,  MarcoM_Marinoni, 20, 12, 8, yes
801786631674101761,  lorenzo26356238, 2, 1, 1, neutral
46936327,  NICKPEANUT, 2, 1, 1, neutral
802149375334088704,  DidiPrara, 2, 1, 1, neutral
2501169637,  Mariangelissim1, 14, 7, 7, neutral
529684154,  AlbyWanKenobi, 2, 1, 1, neutral
1104546798,  _louismjle, 6, 4, 2, yes
537152144,  klausxwife, 5, 4, 1, yes
2837586645,  rosaconte10, 4, 3, 1, yes
160870473,  Rossy1973, 2, 1, 1, neutral
773843569,  sanfi96, 2, 1, 1, neutral
382304133,  lazzarinclaudio, 2, 1, 1, neutral
415077457,  AntonioScorna, 3, 2, 1, yes
520480823,  CarmenMorandi1, 4, 2, 2, neutral
490835991,  AndreaGrippoSa, 3, 2, 1, yes
515452860,  _Elena97, 2, 1, 1, neutral
2905685199,  Stefanoo1987, 2, 1, 1, neutral
413426849,  SirDistruggere, 4, 1, 3, no
199147021,  lozanosunwest, 2, 1, 1, neutral
260781512,  Oiziruam87, 6, 3, 3, neutral
730745676,  theartofmadrid, 8, 4, 4, neutral
801896498418118658,  CristianaBures1, 2, 1, 1, neutral
804992913147052034,  aleper77, 2, 1, 1, neutral
1265563273,  AlexaLicata, 2, 1, 1, neutral
603486900,  ChiarAndretta72, 6, 3, 3, neutral
720189879771119616,  ilarioscarnera, 4, 3, 1, yes
2711566290,  Jess_Chiti, 3, 2, 1, yes
67710936,  alessandrorenzi, 3, 1, 2, no
795385390249242624,  DanieleSecurity, 4, 2, 2, neutral
2954902816,  MarcoNa95713630, 7, 4, 3, yes
2578058312,  BullaInterista, 2, 1, 1, neutral
17876752,  paolomaggioni, 6, 3, 3, neutral
775983654023655424,  mattecario, 2, 1, 1, neutral
3324452457,  DorianaVersari, 2, 1, 1, neutral
1164343506,  oldreaming, 5, 3, 2, yes
57275566,  tappartengo, 2, 1, 1, neutral
564054700,  PBismuths, 2, 1, 1, neutral
864814034,  frabbate, 2, 1, 1, neutral
71207038,  cinzia333, 3, 2, 1, yes
255928579,  AULIN3, 2, 1, 1, neutral
2352298477,  leonedatastiera, 3, 1, 2, no
1737135145,  alessandrodarm, 4, 2, 2, neutral
3091679746,  ChiaraMBM98, 3, 2, 1, yes
1004844222,  ggreco66, 5, 1, 4, no
1961447802,  SimoneCostart, 2, 1, 1, neutral
749036785943150592,  munnypapicola, 2, 1, 1, neutral
527881710,  AntonelloEspos, 4, 1, 3, no
771757291376893952,  ChePoiMicaTanto, 2, 1, 1, neutral
4193632539,  genusmigrans, 2, 1, 1, neutral
701695154,  rebeljuventino, 4, 3, 1, yes
3229062813,  katrav_daniela, 2, 1, 1, neutral
2865231138,  princedifra10, 2, 1, 1, neutral
997777309,  marcosbordone, 3, 2, 1, yes
979277401,  Corinzio, 2, 1, 1, neutral
37498972,  homyno, 2, 1, 1, neutral
778112583672930304,  ciuffoepuffo, 3, 2, 1, yes
742804733761556481,  pepethetailor, 2, 1, 1, neutral
1063105506,  tinallyna, 6, 5, 1, yes
939322298,  AlessioCausin, 2, 1, 1, neutral
2426653829,  DrAielloComm, 2, 1, 1, neutral
1375641666,  helenachat, 3, 2, 1, yes
108192933,  designstore2001, 2, 1, 1, neutral
736361638895456256,  joeyloveg, 6, 5, 1, yes
1639281434,  albclaire, 2, 1, 1, neutral
464229124,  PaoloBovio, 2, 1, 1, neutral
513253779,  darioloverde, 10, 2, 8, no
2846919520,  EsterMic93, 4, 3, 1, yes
348460395,  PaoloRicotti, 2, 1, 1, neutral
500067774,  Nicolas15053927, 2, 1, 1, neutral
779967875482324992,  Daniela35115, 10, 5, 5, neutral
752387483191697408,  Danviola2, 2, 1, 1, neutral
543106365,  vPower_RM, 2, 1, 1, neutral
381532659,  JosephCeglia, 3, 1, 2, no
1120440048,  MatteoPanka, 2, 1, 1, neutral
1921230823,  mickopf, 2, 1, 1, neutral
923266004,  AriannaBrazzale, 2, 1, 1, neutral
328064771,  MarionAngeli, 2, 1, 1, neutral
39240661,  manginobrioches, 12, 5, 7, no
908265367,  GVinoso, 2, 1, 1, neutral
4885766027,  EllaParis7, 2, 1, 1, neutral
747516809323122688,  Danilo84312741, 8, 4, 4, neutral
1675484600,  Fralgeri, 2, 1, 1, neutral
421827186,  PaolaGerli, 8, 5, 3, yes
608919395,  marcovaldoparis, 7, 6, 1, yes
375075776,  MarcoPastori, 2, 1, 1, neutral
765230413,  Margigiambi, 4, 2, 2, neutral
271865832,  Serra_nda, 5, 2, 3, no
367696583,  congameatsix, 2, 1, 1, neutral
932699905,  SabatoPaolillo1, 5, 3, 2, yes
2414917243,  DaveLeDingo, 4, 2, 2, neutral
720622101762351104,  non_guido, 4, 1, 3, no
857728206,  PatriziaMilanes, 2, 1, 1, neutral
3057752122,  EdwillOsd, 6, 3, 3, neutral
509485463,  millynomade, 2, 1, 1, neutral
703125442,  davidelorenzin5, 2, 1, 1, neutral
1492031677,  PalladinoElisa, 2, 1, 1, neutral
482495488,  exspectra, 2, 1, 1, neutral
2329795773,  Irene_Scg, 2, 1, 1, neutral
3020056131,  verri_pinuccia, 2, 1, 1, neutral
770587331317403648,  auradormitrice, 4, 2, 2, neutral
754207227435704320,  elia1489, 5, 2, 3, no
1285792975,  AmberIpatia, 2, 1, 1, neutral
229912717,  noemi_rx, 5, 1, 4, no
877730935,  julindasula, 4, 2, 2, neutral
797104188434120704,  GiuseppeBuzzan1, 5, 1, 4, no
4023749218,  imgiuseppes, 10, 5, 5, neutral
753489562996006912,  FCaberlin, 4, 2, 2, neutral
2364476951,  ginevraastor, 2, 1, 1, neutral
776520032885039104,  genere_umano, 5, 3, 2, yes
3256264534,  9cc0645658b6420, 2, 1, 1, neutral
187581685,  tonygajeta, 2, 1, 1, neutral
805570762312744961,  PeppeCastiglio5, 2, 1, 1, neutral
600472524,  twinkparrish, 7, 4, 3, yes
2889953771,  stefano_pozze, 2, 1, 1, neutral
1363805346,  luca_ruaro, 4, 2, 2, neutral
1219503126,  Lunakepassa, 3, 1, 2, no
382158059,  bintou_fall, 17, 9, 8, yes
133039144,  Danyboy1991, 2, 1, 1, neutral
28387794,  giz5923, 4, 2, 2, neutral
242954953,  zizionice, 8, 2, 6, no
1092648980,  VDeVincenti, 2, 1, 1, neutral
779052364930121728,  cazzaro70043, 2, 1, 1, neutral
1558790868,  giocolombo99, 4, 3, 1, yes
312836301,  LasaRoby, 3, 2, 1, yes
761229080461242368,  Tripleteforever, 3, 2, 1, yes
290715819,  danielebruno58, 7, 5, 2, yes
481444917,  Joesvalvolo, 6, 4, 2, yes
476242118,  paolett50, 4, 3, 1, yes
3352174917,  rossa557007, 2, 1, 1, neutral
82379983,  paoloferar, 6, 5, 1, yes
458515686,  emilianiutta, 3, 2, 1, yes
220409183,  simosjhw, 2, 1, 1, neutral
29536477,  ziberiaI, 2, 1, 1, neutral
991736552,  vero96555, 2, 1, 1, neutral
765969613305815041,  GattoGius, 4, 2, 2, neutral
394252990,  Cuccumeccia1971, 2, 1, 1, neutral
574648169,  siriannianna1, 2, 1, 1, neutral
2423184023,  Biagiux, 2, 1, 1, neutral
796631773274836993,  elenar56, 2, 1, 1, neutral
901587390,  andemarc, 2, 1, 1, neutral
587783876,  giada_la, 2, 1, 1, neutral
1028594821,  nedimgucuk, 2, 1, 1, neutral
2199221633,  DMaccarelli, 12, 7, 5, yes
390015232,  giorigamo, 3, 2, 1, yes
3007910247,  Grazia97113044, 2, 1, 1, neutral
168658483,  LauraRomiao, 3, 2, 1, yes
433088639,  AlbyPhone, 2, 1, 1, neutral
524657264,  BrigitteTrotot, 2, 1, 1, neutral
2822969313,  64GreyWolf, 2, 1, 1, neutral
295332740,  cotoletta, 2, 1, 1, neutral
770637903512932352,  dottordottori, 2, 1, 1, neutral
798869859127922690,  MGShootication, 4, 2, 2, neutral
2337615922,  MMaccott, 2, 1, 1, neutral
2322833863,  LoryGiacosa, 2, 1, 1, neutral
863330954,  GUECRI58, 20, 14, 6, yes
2574507679,  giacomo525, 2, 1, 1, neutral
462391467,  MJP1370, 2, 1, 1, neutral
66076818,  lorinodari, 4, 2, 2, neutral
2846405693,  morillima, 3, 2, 1, yes
2151480642,  ludo68100, 4, 2, 2, neutral
142709691,  Andrea938, 2, 1, 1, neutral
14360388,  redfabiuz, 2, 1, 1, neutral
4788602901,  francis_passaro, 2, 1, 1, neutral
2380229249,  pedrazzi_nicola, 2, 1, 1, neutral
729973524308344832,  LussyRava, 2, 1, 1, neutral
1325237478,  8cMLeti, 3, 2, 1, yes
2643664779,  Denni151288, 2, 1, 1, neutral
2272151888,  LiberaSagese, 2, 1, 1, neutral
2987950900,  AimKiut, 14, 1, 13, no
33473494,  daspy1970, 4, 2, 2, neutral
244596457,  Lando51, 10, 4, 6, no
2897976431,  DonatoYSecchi, 2, 1, 1, neutral
128919664,  giasch, 2, 1, 1, neutral
422670896,  crescenzocrisp1, 3, 1, 2, no
2853470165,  _WillOConnell, 2, 1, 1, neutral
763682961376108544,  Greygoose975, 2, 1, 1, neutral
373917939,  CkIndiveri, 4, 2, 2, neutral
447859051,  BiancaBerry88, 2, 1, 1, neutral
4886243230,  TiozzoNicola13, 2, 1, 1, neutral
114268400,  auclairedelune_, 4, 2, 2, neutral
421271650,  fmarchese_, 4, 3, 1, yes
571100152,  BenedettaMonti2, 4, 2, 2, neutral
2368213971,  rosy0794, 6, 3, 3, neutral
575482322,  millywo, 2, 1, 1, neutral
1882839440,  GraziaUsuelli, 12, 6, 6, neutral
743805866453929984,  RenatoBoccalari, 4, 2, 2, neutral
117297806,  MunguntuulO, 6, 2, 4, no
2358404580,  esodata1, 8, 6, 2, yes
98837215,  iaia78, 2, 1, 1, neutral
15057522,  rosby40, 4, 2, 2, neutral
369360844,  ildies10, 4, 2, 2, neutral
494218103,  BoboFranz, 4, 2, 2, neutral
519453043,  FedericoSpeme, 5, 3, 2, yes
140747604,  deHeorot, 2, 1, 1, neutral
735190123076288513,  CigraFd, 2, 1, 1, neutral
2842838170,  togne_98, 2, 1, 1, neutral
618121393,  SummaAndrea, 2, 1, 1, neutral
526667215,  alsalander, 2, 1, 1, neutral
781502912086376452,  AntonellaTripa3, 2, 1, 1, neutral
492359297,  myotaizen, 2, 1, 1, neutral
919784479,  losmattolos, 3, 1, 2, no
22009952,  DebAttanasio, 4, 1, 3, no
702408683,  DarioTosetto, 11, 5, 6, no
602924578,  alexdel1984, 2, 1, 1, neutral
1857123030,  emanuel_pinhas, 3, 2, 1, yes
1565976750,  Michi_Bellucci, 14, 9, 5, yes
3303118563,  caneliberale, 2, 1, 1, neutral
304377242,  AndGug, 6, 5, 1, yes
3074097193,  giulia3320, 4, 2, 2, neutral
2879750159,  mffl41_3, 5, 4, 1, yes
1061262421,  peppe_griffo, 6, 3, 3, neutral
722880468073455616,  mirlinda_meta, 2, 1, 1, neutral
771044121058377728,  giannini93511, 2, 1, 1, neutral
375752861,  fafadiqui, 2, 1, 1, neutral
483212617,  MartaMerico, 2, 1, 1, neutral
619279830,  cascoi34, 2, 1, 1, neutral
2160445253,  Alecroquo, 4, 1, 3, no
4906411318,  corradone69, 3, 2, 1, yes
777649623984898048,  LaSallyGS111, 11, 10, 1, yes
1133557447,  ilarybert, 4, 2, 2, neutral
3534577576,  TeoCassa_13, 2, 1, 1, neutral
757448624,  StanRodi, 10, 5, 5, neutral
1426303376,  Livia_M8, 2, 1, 1, neutral
407093504,  filotesa, 7, 3, 4, no
799976592541974528,  pstreparola, 2, 1, 1, neutral
4204167976,  LoredanaNoe, 4, 2, 2, neutral
2467428376,  lambs88, 10, 5, 5, neutral
3387809782,  Giacomolatona, 3, 1, 2, no
2466776129,  Jale7_V3, 2, 1, 1, neutral
33864051,  elmorisco, 2, 1, 1, neutral
145357840,  arenande, 4, 2, 2, neutral
4144012180,  giulio61moret, 2, 1, 1, neutral
183992472,  tony969696, 2, 1, 1, neutral
4892644048,  Marco28310662, 2, 1, 1, neutral
118851149,  beatrix74, 6, 3, 3, neutral
2934478294,  xavierrothen, 4, 2, 2, neutral
805464418901491712,  Monisa22510749, 2, 1, 1, neutral
805550199691243521,  sonia8330, 2, 1, 1, neutral
3144449331,  besidevhar, 3, 2, 1, yes
592806761,  GiaGiann, 4, 1, 3, no
128258536,  Lord_Berto, 5, 1, 4, no
58778773,  decapoa, 4, 1, 3, no
24428683,  FabioCCampanile, 2, 1, 1, neutral
3313356453,  GiovanniPisan1, 2, 1, 1, neutral
1834394552,  MaricicaBobu, 4, 3, 1, yes
20134451,  margieblondon, 6, 1, 5, no
798412353087868929,  AntoiFan, 6, 3, 3, neutral
418174291,  JackyRose73, 3, 1, 2, no
1385042468,  elisabettares, 7, 2, 5, no
598449387,  NelloAvellani, 4, 1, 3, no
1042862978,  newstown_aq, 5, 3, 2, yes
788441077946646529,  Decugis3, 2, 1, 1, neutral
2784159795,  NiallsmyJack, 2, 1, 1, neutral
1634956195,  ester_longo, 4, 2, 2, neutral
1278790658,  alicledo, 2, 1, 1, neutral
258491297,  lombardoivan, 5, 3, 2, yes
2908444065,  rosina_Vlad, 7, 5, 2, yes
406460133,  angemania23, 2, 1, 1, neutral
105754068,  Simmetry88, 4, 3, 1, yes
3319847693,  newschoolpower1, 4, 2, 2, neutral
1115329789,  Valeri0n117, 4, 2, 2, neutral
514237368,  StefanoBrannett, 7, 3, 4, no
1254398576,  GiangiFalcioni, 5, 2, 3, no
1937236256,  galmuzzimarco, 2, 1, 1, neutral
2332207968,  riinvent, 2, 1, 1, neutral
214595764,  BenedettaMaria, 2, 1, 1, neutral
4643733641,  Chimy27, 4, 2, 2, neutral
483284044,  Maudi2, 4, 1, 3, no
2368673324,  roger12pa, 2, 1, 1, neutral
1545813085,  manuUS10, 2, 1, 1, neutral
228923158,  orlantonino, 2, 1, 1, neutral
2801451225,  tnroller, 4, 2, 2, neutral
599972590,  quercia55, 6, 4, 2, yes
603979596,  DebsFantuzzi, 2, 1, 1, neutral
4261273445,  StrigaroMichele, 2, 1, 1, neutral
1061139054,  GabrieleManzo1, 3, 1, 2, no
3303442557,  ValCrazyDiamond, 2, 1, 1, neutral
754987361637961728,  Elenaj410951, 2, 1, 1, neutral
3157207294,  rikymorra, 5, 3, 2, yes
2252065378,  AlfredoAmbrosi4, 8, 4, 4, neutral
261352880,  claissata, 2, 1, 1, neutral
2804502363,  sandroaz2, 6, 3, 3, neutral
3435663177,  Farquad93, 6, 1, 5, no
805722984350711808,  luciacroc, 6, 2, 4, no
140814256,  pietrinimatteo, 12, 1, 11, no
341169144,  ltosi164, 2, 1, 1, neutral
394269429,  Ariete_16, 2, 1, 1, neutral
1174708682,  cafaro69, 2, 1, 1, neutral
4493227335,  ConchettaDella1, 2, 1, 1, neutral
1412316816,  supergiada88, 2, 1, 1, neutral
3611858271,  BoiaChiTrolla, 5, 3, 2, yes
2920005634,  dottorgiustizia, 27, 17, 10, yes
314471179,  GiorgiAndreuzza, 2, 1, 1, neutral
526826556,  1976sime, 2, 1, 1, neutral
2326879401,  gae_costanzo, 2, 1, 1, neutral
628828448,  Family5Mauro, 3, 2, 1, yes
1218998124,  Gio_Sicily, 5, 3, 2, yes
180100188,  lamponefran, 2, 1, 1, neutral
233929419,  cma41, 2, 1, 1, neutral
526710455,  MimWitcher, 5, 2, 3, no
83094880,  dinovelvet_1999, 4, 2, 2, neutral
733317428,  Enzo6547, 3, 1, 2, no
1889372137,  ggelta2013, 8, 4, 4, neutral
790670703016239104,  Tore49366704, 7, 6, 1, yes
2418756838,  fcolliv, 3, 2, 1, yes
133342361,  ggv84, 4, 2, 2, neutral
1626353725,  mammipia, 2, 1, 1, neutral
792043834343624704,  m100955, 2, 1, 1, neutral
1233729696,  mzanardi22, 2, 1, 1, neutral
787437990,  fennyobsessiasr, 2, 1, 1, neutral
720577220,  PsyMat, 2, 1, 1, neutral
506274421,  SimonaAntenozio, 2, 1, 1, neutral
1367005093,  stillbesideliam, 7, 3, 4, no
3964954600,  Giorgiashugss, 2, 1, 1, neutral
784793062631432193,  Mary70434976, 4, 2, 2, neutral
1123009382,  LennyReddy, 3, 2, 1, yes
2306993641,  ellepi6, 16, 8, 8, neutral
802630058468904960,  mattiaL7, 4, 2, 2, neutral
3709559476,  marianto_dem, 2, 1, 1, neutral
122414199,  elevenshearts, 2, 1, 1, neutral
2433969870,  fedettorico, 3, 2, 1, yes
532347972,  cookshunter, 4, 2, 2, neutral
23578155,  benjistyler, 3, 1, 2, no
779568456911953920,  ErmesSivieri, 4, 2, 2, neutral
385334353,  CandeloriPaolo, 2, 1, 1, neutral
492630360,  vivasimone, 2, 1, 1, neutral
328075132,  che_disagio, 10, 5, 5, neutral
1604118198,  noe_doria98, 2, 1, 1, neutral
240830837,  Mik_Melis, 2, 1, 1, neutral
4792622541,  Colonnello_P85, 2, 1, 1, neutral
311127980,  Cla92Mag, 2, 1, 1, neutral
619105578,  adrianopompe, 4, 3, 1, yes
1604523799,  CarolinaModica, 3, 2, 1, yes
1852480399,  FabioXw, 2, 1, 1, neutral
805398832926388226,  anto67_caccia, 4, 2, 2, neutral
726678306406469632,  ivanprl78, 2, 1, 1, neutral
533612875,  RanaMarty, 2, 1, 1, neutral
18978455,  alemerini, 3, 1, 2, no
1379519166,  BenfenatiArrigo, 6, 2, 4, no
366518575,  GMPartenopeo, 4, 2, 2, neutral
1634049960,  patriote65, 4, 2, 2, neutral
1180392648,  zerotegole, 3, 1, 2, no
2841196901,  e_ferrand, 2, 1, 1, neutral
3344426679,  globe_tweets, 4, 1, 3, no
2809454593,  ErViperetta, 3, 1, 2, no
490472648,  piccolapaola, 2, 1, 1, neutral
629560243,  Dreven22, 3, 2, 1, yes
155319474,  MANUEL1008, 19, 9, 10, no
1444663964,  claudiomore96, 2, 1, 1, neutral
794351930,  villani_andrea, 2, 1, 1, neutral
805074067,  MatteoGarofano1, 3, 1, 2, no
1278607747,  ImhoSpace, 2, 1, 1, neutral
4371174196,  carla04645216, 2, 1, 1, neutral
2312702072,  Buby94D, 2, 1, 1, neutral
783659253848535040,  _MAancheNO, 2, 1, 1, neutral
26781477,  giusegandolfi, 6, 4, 2, yes
743168926893350913,  Ale_CNCC, 4, 2, 2, neutral
105382067,  theliberalscum, 5, 1, 4, no
362676761,  LoBest90, 2, 1, 1, neutral
115625189,  Cla_cc85, 2, 1, 1, neutral
1610265350,  LucaFinicelli, 2, 1, 1, neutral
739729140887216128,  velo_di_maia, 6, 5, 1, yes
91853277,  a_guerci, 5, 2, 3, no
790236538982498304,  Patrizi28375617, 4, 2, 2, neutral
983546060,  StefanoRigon65, 2, 1, 1, neutral
802121029766234112,  VOX_RivasVaciaM, 2, 1, 1, neutral
4030354881,  Ro62939657, 2, 1, 1, neutral
105261167,  parva_chiara, 5, 3, 2, yes
1006159098,  giuliodada, 3, 2, 1, yes
170962625,  buddhaallegro, 4, 2, 2, neutral
347503021,  eliodutto, 2, 1, 1, neutral
378148810,  FadhilaHamici, 5, 3, 2, yes
472463855,  ToniaCestari, 2, 1, 1, neutral
1029145604,  Lorenzo_Merigo, 4, 3, 1, yes
4157712015,  MgabriellaElle, 3, 1, 2, no
3370839443,  viperams, 2, 1, 1, neutral
438258080,  stefanomischia, 2, 1, 1, neutral
2504584925,  gian_giakko54, 2, 1, 1, neutral
722880468073455616,  MirlindaMeta, 4, 2, 2, neutral
216055689,  MrMontefiori, 3, 2, 1, yes
60964513,  misssweetjane, 4, 2, 2, neutral
919417542,  giovannilegena, 6, 3, 3, neutral
286603064,  Giuseppe7Farina, 2, 1, 1, neutral
755683659538137092,  _elgorditoo, 13, 6, 7, no
127650290,  gio_dim, 3, 1, 2, no
538214148,  MasciaBetti, 4, 2, 2, neutral
705432157334929408,  Raffipaffy, 2, 1, 1, neutral
593801807,  Giammossl, 2, 1, 1, neutral
555420716,  SteveBestOne, 8, 5, 3, yes
2629341616,  stopblabla, 4, 2, 2, neutral
250825186,  DaddiLuca, 4, 2, 2, neutral
293713072,  markopolo72, 2, 1, 1, neutral
805678043092185088,  ROCCO80801527, 4, 2, 2, neutral
3008098683,  fragmentis, 2, 1, 1, neutral
3085141448,  4803f72e68454da, 2, 1, 1, neutral
400791209,  denysmaio, 3, 1, 2, no
376883984,  altraPolitica, 2, 1, 1, neutral
780498867984986113,  Segreto12311, 2, 1, 1, neutral
531467831,  EMILIAISABELLA1, 2, 1, 1, neutral
101880083,  MrStinson_, 4, 2, 2, neutral
414063300,  NunziaMorgani, 3, 1, 2, no
3290217551,  KaneJeeperz, 2, 1, 1, neutral
423607574,  bebericotti, 2, 1, 1, neutral
416255353,  ElectraGaunt, 2, 1, 1, neutral
632838468,  schneegurochka, 2, 1, 1, neutral
256920538,  Valetgd, 2, 1, 1, neutral
1961051569,  DjSimoRock, 4, 2, 2, neutral
141991012,  Tombolus, 6, 3, 3, neutral
322490591,  HojohClo, 7, 4, 3, yes
2880116410,  Gioissimo, 3, 2, 1, yes
791753667602972674,  arre_ilenia, 2, 1, 1, neutral
337904322,  gius_saffioti, 5, 4, 1, yes
40940931,  j2lm4u, 2, 1, 1, neutral
3408490792,  alexiadefresa, 2, 1, 1, neutral
1347753530,  ruggeromartel, 3, 2, 1, yes
15377014,  lucco78, 3, 2, 1, yes
2703548855,  dottssamessina1, 5, 3, 2, yes
1222815008,  giusepperollo2, 4, 1, 3, no
3301531378,  Post_Iccia, 13, 9, 4, yes
4135872808,  Isa_Yellow46, 2, 1, 1, neutral
2995577488,  guerriero_alice, 2, 1, 1, neutral
2414142583,  Kennet91, 2, 1, 1, neutral
831801152,  andrea_caputi, 3, 2, 1, yes
1861738447,  LoreBarto96, 2, 1, 1, neutral
1672975260,  ombelsada, 14, 7, 7, neutral
792776292370411520,  SergioZanatta2, 2, 1, 1, neutral
1706948881,  Patty9298, 2, 1, 1, neutral
941531808,  kadreg1, 3, 1, 2, no
309747626,  simonexenrica, 2, 1, 1, neutral
2461914300,  Educafaro00, 2, 1, 1, neutral
739960384573046784,  PPostiore, 2, 1, 1, neutral
723159842420969474,  RVlann, 4, 2, 2, neutral
3320411493,  Elsalvator81, 2, 1, 1, neutral
1880574792,  lorenzicamilla, 2, 1, 1, neutral
2750208883,  MELISSA6918, 2, 1, 1, neutral
993576199,  IgnazioSchitton, 3, 2, 1, yes
458555476,  MicheleZanco, 2, 1, 1, neutral
767413359448842240,  _oinex_, 9, 4, 5, no
281686042,  OhmPorzio, 2, 1, 1, neutral
3399767470,  faustomamberti, 8, 6, 2, yes
2747104671,  nansuccia, 4, 2, 2, neutral
423813966,  rossmerullo, 3, 2, 1, yes
2975246278,  6ff916ddda90441, 2, 1, 1, neutral
3855061223,  Lg16051935Lg, 2, 1, 1, neutral
724565226981568514,  MasperiMatteo, 8, 5, 3, yes
167874062,  alfex46, 2, 1, 1, neutral
992876226,  Chris_DiC, 3, 2, 1, yes
3248222176,  FearTheCera, 5, 2, 3, no
1362407378,  yhiugus, 3, 2, 1, yes
581657593,  AndreaPuma8, 2, 1, 1, neutral
805554600434659329,  nicolaguerra994, 2, 1, 1, neutral
1347344792,  InsalatinaMista, 27, 5, 22, no
2534985472,  R_Chiodo7, 2, 1, 1, neutral
3058404607,  Baglionss, 5, 3, 2, yes
2983907781,  MrGolfman_, 2, 1, 1, neutral
784693862937886720,  cecipierma1, 2, 1, 1, neutral
135869288,  lucawboy, 2, 1, 1, neutral
1161371108,  caviglia_paolo, 2, 1, 1, neutral
403505287,  PalaMatteo, 9, 1, 8, no
3110215779,  giulia0268, 2, 1, 1, neutral
743924448,  karacaracciolo, 9, 8, 1, yes
2734597207,  UglChimiciTa, 2, 1, 1, neutral
341375324,  banfoman72, 2, 1, 1, neutral
2513958050,  anonimatousRD, 2, 1, 1, neutral
610172160,  DomeGian, 3, 1, 2, no
2887852763,  _stringimiNiall, 2, 1, 1, neutral
932234816,  mirigodinoviero, 2, 1, 1, neutral
1116084320,  giancap75, 4, 2, 2, neutral
3484941148,  BlackThemaiz, 5, 4, 1, yes
734670856400560128,  LazZecca, 4, 2, 2, neutral
2163238773,  Andrea69Ronca, 2, 1, 1, neutral
2571531093,  Followback7X, 2, 1, 1, neutral
3031186661,  raccuini, 4, 2, 2, neutral
490660678,  GiorgiaFondrini, 2, 1, 1, neutral
4794239181,  SofiaColetto, 2, 1, 1, neutral
1063497715,  SardusDesigner, 2, 1, 1, neutral
4353158674,  EmilynotRata, 2, 1, 1, neutral
3513368788,  marchi_rosy, 4, 3, 1, yes
256459113,  Nimapel75, 2, 1, 1, neutral
175389691,  Afirelove_xx, 3, 1, 2, no
768254130,  AndreaBuffoli_, 2, 1, 1, neutral
438646749,  Lokiseyes, 4, 2, 2, neutral
2362655878,  Aleorla5, 2, 1, 1, neutral
335123275,  antoleoderossi, 2, 1, 1, neutral
231373853,  EvaPolak_10, 5, 3, 2, yes
359541331,  sicula83, 2, 1, 1, neutral
2169771406,  rosaaggazio, 18, 5, 13, no
103543725,  genevois_rien, 2, 1, 1, neutral
3331482819,  fckmehl, 3, 1, 2, no
515625461,  Marilena77inca, 2, 1, 1, neutral
2349698179,  geom_mellea, 3, 2, 1, yes
430823783,  Ciucellone, 2, 1, 1, neutral
1900353330,  followPagliacci, 5, 2, 3, no
4861701649,  stefanotweetta, 7, 3, 4, no
413025596,  Paosirolo, 7, 6, 1, yes
2305551600,  Ausllyistheway, 5, 3, 2, yes
3078214365,  MaradiniNoemi, 2, 1, 1, neutral
559054823,  LongoSilvana, 7, 1, 6, no
787712829134610432,  PhZer0, 2, 1, 1, neutral
1569692215,  OldSchoolPics_, 2, 1, 1, neutral
758924524146466817,  LiberazioneNaz, 2, 1, 1, neutral
1296458910,  MinestriniSauro, 2, 1, 1, neutral
2513098776,  williceres, 5, 2, 3, no
4783509329,  ImOzXI, 2, 1, 1, neutral
57279615,  studiobugelli, 26, 1, 25, no
2767469651,  alien_anny, 2, 1, 1, neutral
742089966315012097,  Kala0912, 3, 1, 2, no
1447489770,  CivettaSauro, 6, 1, 5, no
1273364526,  valequadri1906, 2, 1, 1, neutral
1015993314,  raffyras, 7, 4, 3, yes
142179135,  nickyo15, 2, 1, 1, neutral
1699728120,  argentofisico, 2, 1, 1, neutral
985298582,  AnnaCongelata6, 5, 2, 3, no
4505442327,  LNSiena, 8, 4, 4, neutral
535220009,  JeanneGriffin3, 2, 1, 1, neutral
1514342701,  papalico9000, 2, 1, 1, neutral
785924885755428866,  Daniele23760189, 7, 4, 3, yes
781061479793647617,  casamonic, 4, 2, 2, neutral
425209016,  NorbertoZapparo, 6, 4, 2, yes
440939489,  roxypiani, 2, 1, 1, neutral
786662183094611969,  Remo433, 4, 2, 2, neutral
3317129771,  ClaBoo93, 10, 5, 5, neutral
614362165,  MaraTahnee, 15, 4, 11, no
1406189706,  TerribilisEst, 7, 1, 6, no
542542254,  andvalentini, 2, 1, 1, neutral
631810976,  mm1064, 3, 1, 2, no
2590034989,  charlygattociar, 4, 2, 2, neutral
134498967,  Jackpot1981, 3, 2, 1, yes
2748628638,  gardena81, 2, 1, 1, neutral
2537460423,  Pucci963, 9, 4, 5, no
705852831404826624,  stefanofiore68, 6, 3, 3, neutral
775681896676265989,  aleprati99, 6, 3, 3, neutral
704554549,  Ste1990xxx, 2, 1, 1, neutral
455367559,  marcoarchimede, 11, 2, 9, no
784308415,  MarcoSardella4, 4, 3, 1, yes
471389414,  agnese_baldan, 2, 1, 1, neutral
2859044374,  ASilvia0303, 6, 3, 3, neutral
1499773538,  AndreaSold, 3, 2, 1, yes
792640100660342784,  maurizzati, 2, 1, 1, neutral
493054513,  deleomarco, 28, 2, 26, no
494253338,  MarCicca, 2, 1, 1, neutral
2205995453,  emmcamp, 2, 1, 1, neutral
720632435306807296,  albertodiladyme, 8, 2, 6, no
777472757579837440,  alessandral74, 2, 1, 1, neutral
29099633,  paneflavio, 2, 1, 1, neutral
3388720763,  NefariusInvicto, 2, 1, 1, neutral
355736706,  ShaileneKris, 2, 1, 1, neutral
2944294475,  MASSIMO097, 3, 1, 2, no
742532068257763328,  joebarri1991, 2, 1, 1, neutral
2437660149,  FovarisDaniele, 3, 1, 2, no
3110056318,  lucafrancini2, 2, 1, 1, neutral
1883118666,  ilCianci, 4, 1, 3, no
158786957,  Francescociv, 2, 1, 1, neutral
1179221580,  MariaCoudless, 8, 4, 4, neutral
76904458,  Rivoltapopolare, 5, 2, 3, no
876541483,  AlbertoBagnai, 15, 9, 6, yes
2242877744,  Fitzcarraldo5, 2, 1, 1, neutral
3039876693,  Filipgiei, 2, 1, 1, neutral
3016732923,  EspanaFN, 2, 1, 1, neutral
375235230,  FabrizioNicolin, 4, 2, 2, neutral
755859225574682624,  silviiavismara, 2, 1, 1, neutral
388546504,  SennaGianMarco, 2, 1, 1, neutral
216670422,  roxannegaravani, 2, 1, 1, neutral
804827612619177985,  _Anchemeno, 4, 2, 2, neutral
1659473750,  remo_checola, 3, 2, 1, yes
45316640,  salvatoremonaco, 3, 1, 2, no
3001154047,  bera7791, 4, 2, 2, neutral
3331589831,  radel79, 2, 1, 1, neutral
3244676116,  MovNazItaliano, 24, 21, 3, yes
3335064958,  abcristina67, 2, 1, 1, neutral
4473417269,  GiuseppeRedo, 2, 1, 1, neutral
467412754,  AlexCioni, 2, 1, 1, neutral
2429265832,  AcCucchi, 2, 1, 1, neutral
2288354839,  8luci8luci8, 4, 2, 2, neutral
4202021733,  GI_EFFE_, 3, 2, 1, yes
4860620442,  VerraUngiorno, 4, 1, 3, no
2200336763,  Dimitriydeang, 2, 1, 1, neutral
263228978,  NicoBattelli, 2, 1, 1, neutral
2873873099,  sardo641, 3, 2, 1, yes
1374582042,  marinella2569, 11, 7, 4, yes
2210208861,  19cava94, 2, 1, 1, neutral
414597993,  lucianovescovi, 2, 1, 1, neutral
549739837,  vincenz0perri, 4, 2, 2, neutral
4694805378,  serapanes, 2, 1, 1, neutral
309625786,  GrecoDario, 2, 1, 1, neutral
790544776923848705,  francegiannu, 4, 2, 2, neutral
55251916,  marettats, 7, 4, 3, yes
570821030,  RizziAugusto, 4, 3, 1, yes
3901613302,  mrxxcarlotta, 12, 6, 6, neutral
794281566834921472,  sbirulottina, 2, 1, 1, neutral
3226713256,  angeloalleva1, 2, 1, 1, neutral
631972232,  eugeniobosio, 2, 1, 1, neutral
386933895,  iapicca_mario, 2, 1, 1, neutral
3094759553,  decimohangar, 5, 2, 3, no
414970005,  Conrad_MI, 8, 6, 2, yes
3034427037,  SerenaDiMarzo, 3, 2, 1, yes
2247766885,  ponentelevante, 6, 3, 3, neutral
1891849693,  BoselliMarisa, 5, 3, 2, yes
125345892,  ViMangione, 4, 2, 2, neutral
721195374812250112,  mirko_a77, 2, 1, 1, neutral
1037837900,  manuelatamburi1, 11, 3, 8, no
722878628250460160,  giuliodessi_, 4, 1, 3, no
585845073,  giulia1250, 9, 3, 6, no
553940585,  CarolinaLussana, 2, 1, 1, neutral
796623849097924608,  naffy81, 4, 2, 2, neutral
183638480,  mastrorobert, 6, 3, 3, neutral
66668184,  RizwanHu554in, 2, 1, 1, neutral
1223801485,  clanguss, 7, 2, 5, no
443932900,  spartachisti, 5, 1, 4, no
785467653175513089,  ohgiuse, 3, 1, 2, no
901691702,  SilviaLovaglio, 6, 4, 2, yes
2327133380,  Cateryna_78, 4, 2, 2, neutral
2850655639,  LuTorres80, 2, 1, 1, neutral
422951125,  AntonioTorel79, 9, 5, 4, yes
765190815467667456,  1897_curva, 4, 2, 2, neutral
3079453121,  MichelFescina84, 36, 18, 18, neutral
2742019060,  RogoraAlberto, 5, 4, 1, yes
896706632,  LinoFioriti, 2, 1, 1, neutral
1370479430,  massimiantonio, 2, 1, 1, neutral
522194539,  GinoVazzana, 6, 3, 3, neutral
585991438,  AlbertoRibolla, 2, 1, 1, neutral
343382353,  GiuliaFassina, 4, 2, 2, neutral
709464972334653440,  ketti62, 2, 1, 1, neutral
443871593,  albonetti11, 2, 1, 1, neutral
3304520524,  Aemilius1977, 12, 5, 7, no
2834342109,  vruggero75, 4, 2, 2, neutral
100602777,  alexfri44, 13, 10, 3, yes
1242194246,  GabryForesti, 2, 1, 1, neutral
1402224894,  Giovani45535947, 4, 2, 2, neutral
1551255427,  tubinoluca, 2, 1, 1, neutral
477633440,  enzapet, 2, 1, 1, neutral
2369010655,  angelerrimo, 34, 10, 24, no
1099024447,  DavolioAndrea, 2, 1, 1, neutral
4555440435,  stefano_salamon, 17, 16, 1, yes
72042051,  Antonvlimburg, 8, 4, 4, neutral
3302920433,  DossenaEmma, 4, 2, 2, neutral
495090591,  renzaric, 6, 3, 3, neutral
2967853233,  mariateresa712, 2, 1, 1, neutral
790655672555798528,  ManuMegghi, 2, 1, 1, neutral
754082430055833600,  FURQUAHART, 7, 1, 6, no
3296213619,  pietrafocale, 2, 1, 1, neutral
107971199,  danielevignati, 2, 1, 1, neutral
613696917,  FabioOrlando75, 2, 1, 1, neutral
236104398,  lillitop, 8, 4, 4, neutral
1040460186,  dantesera, 2, 1, 1, neutral
803320215379542016,  GoddiMichele, 2, 1, 1, neutral
1010816389,  BTTST, 4, 2, 2, neutral
94325428,  canna_santo, 2, 1, 1, neutral
348428503,  iomilanista, 2, 1, 1, neutral
522438498,  BottoDavide, 4, 2, 2, neutral
2872071959,  tysonmauro, 6, 3, 3, neutral
788143728884154368,  nettatentazioni, 2, 1, 1, neutral
708527089,  sansonedaniele, 4, 2, 2, neutral
335435063,  elisabettabuffa, 2, 1, 1, neutral
771943296214106112,  ArmerinaMaria, 5, 4, 1, yes
803329186618281984,  GiuseppinaPanz2, 4, 2, 2, neutral
315042239,  tav_gia, 3, 2, 1, yes
2975488432,  FeniziaRiccardo, 4, 3, 1, yes
166145665,  riccardofenizia, 2, 1, 1, neutral
282755625,  GioMangiola, 2, 1, 1, neutral
2721852965,  biagi1141, 3, 2, 1, yes
795677947428503552,  noRiformaRenzi, 3, 1, 2, no
3069792910,  totodidio, 5, 3, 2, yes
802171434319626240,  maurobarone31, 2, 1, 1, neutral
173971465,  sonomafalda, 6, 4, 2, yes
168194654,  seattle_8, 2, 1, 1, neutral
39772793,  rfigus, 2, 1, 1, neutral
484029847,  nialloneee, 5, 3, 2, yes
2864990376,  roberta_lanzoni, 2, 1, 1, neutral
1179823508,  Idontknow95D, 2, 1, 1, neutral
3181956325,  voxexnihilo, 2, 1, 1, neutral
123589310,  Lauretta76, 3, 1, 2, no
3277348753,  BroheimianGrove, 2, 1, 1, neutral
506402632,  alexiaambro, 2, 1, 1, neutral
472922482,  fsalp, 2, 1, 1, neutral
3322795311,  singingconlodo, 2, 1, 1, neutral
215686278,  SCebetana, 16, 8, 8, neutral
2974644347,  luana22fcim, 5, 3, 2, yes
4903606601,  patriarchian, 3, 1, 2, no
209515537,  lAleph, 2, 1, 1, neutral
4209834735,  aioloanna, 2, 1, 1, neutral
1161001514,  maxximilian69, 2, 1, 1, neutral
102769657,  Priscillasalsan, 2, 1, 1, neutral
3119809342,  K3RU4N, 4, 2, 2, neutral
2199283209,  BuonRossi, 7, 2, 5, no
91642330,  gazzettaparma, 2, 1, 1, neutral
2967719326,  pincopallino551, 6, 5, 1, yes
568209601,  adrianogasti, 5, 2, 3, no
1104209216,  AlfonsoGiambra, 2, 1, 1, neutral
306496514,  Krazy9Kat, 4, 2, 2, neutral
510942285,  giorgiobrusegan, 2, 1, 1, neutral
2885939163,  Glori14Gloria, 2, 1, 1, neutral
964213878,  tabixx82, 2, 1, 1, neutral
2986183990,  NicolaDjPeddy34, 4, 2, 2, neutral
1420952432,  gigisannax, 4, 2, 2, neutral
248721251,  GianlucaCasponi, 7, 4, 3, yes
233942154,  aleisallmine, 2, 1, 1, neutral
784608770,  FlaviusMaximo, 9, 6, 3, yes
1449178296,  LuciaVenosa, 2, 1, 1, neutral
2440253132,  lutherblassett, 7, 3, 4, no
20062932,  janemancino, 2, 1, 1, neutral
373219208,  FrancescaLanfra, 7, 6, 1, yes
4081124067,  anaid1958, 7, 3, 4, no
3047862489,  Butter_Fly_1, 7, 3, 4, no
803122265906958340,  edoardo245, 2, 1, 1, neutral
398959448,  pega1964, 8, 6, 2, yes
718591782972481536,  RomaniaIloveyou, 2, 1, 1, neutral
2692805069,  Tamara85t, 2, 1, 1, neutral
4189187027,  leptismagna22, 2, 1, 1, neutral
762068647766532096,  poyel47, 10, 5, 5, neutral
298503251,  Downsilas, 2, 1, 1, neutral
580042949,  IolandaBaccarin, 8, 3, 5, no
296791433,  sgabry76, 2, 1, 1, neutral
1117905661,  StefanoPonzani, 4, 3, 1, yes
3151359832,  AleSun88, 2, 1, 1, neutral
3437837573,  BosioEnrica, 2, 1, 1, neutral
573887459,  tizianaoldo, 6, 3, 3, neutral
2425812439,  domenic43216047, 4, 3, 1, yes
1112761910,  isabellangelo, 3, 1, 2, no
2734524654,  stefano1981x, 2, 1, 1, neutral
3432636791,  _JuVeMeRdA_, 2, 1, 1, neutral
409787762,  TrovatoMassimo, 2, 1, 1, neutral
481431712,  schiavomaurizio, 6, 3, 3, neutral
607983,  aleeffe, 2, 1, 1, neutral
1167316106,  Silviiooo, 10, 8, 2, yes
296496005,  AtonXVIII, 2, 1, 1, neutral
1218796218,  Dibla86, 2, 1, 1, neutral
1071370646,  Add_Sandy, 2, 1, 1, neutral
289021157,  lucamo, 3, 1, 2, no
558842881,  FededAudino, 6, 2, 4, no
795271477901791232,  sara30052014, 6, 3, 3, neutral
408749628,  carmelodistefa1, 2, 1, 1, neutral
2765052793,  psikonerd, 14, 3, 11, no
951552866,  onedaycarme, 2, 1, 1, neutral
3251732422,  alemaritati1, 2, 1, 1, neutral
798955641012441088,  IlveroWilliam, 2, 1, 1, neutral
1480061876,  RaffaChri, 22, 16, 6, yes
3558401356,  Aldo20328433, 5, 1, 4, no
473220156,  eamarchisio, 2, 1, 1, neutral
94294891,  GinaSere, 5, 3, 2, yes
379283355,  sergiocapelli1, 2, 1, 1, neutral
803254192622145536,  Maurizi82303058, 2, 1, 1, neutral
501848693,  GabrieleGreci, 2, 1, 1, neutral
434036633,  SimoneRiccobono, 4, 2, 2, neutral
123522887,  CristianoCiolli, 2, 1, 1, neutral
243774843,  kekko1897, 3, 2, 1, yes
619299370,  pippetto72, 2, 1, 1, neutral
285796411,  DanyZull, 2, 1, 1, neutral
717935355,  antoba8, 2, 1, 1, neutral
324356604,  rosadirroandenn, 4, 2, 2, neutral
767420353,  _TommasoP, 5, 1, 4, no
856310666,  celanup, 4, 2, 2, neutral
2743778128,  FrancescoDA66, 2, 1, 1, neutral
281562636,  valemikira, 8, 4, 4, neutral
133242957,  dodao63, 3, 2, 1, yes
756533720622956544,  GenesioGenejuve, 2, 1, 1, neutral
782922217927630848,  vinoecatering, 2, 1, 1, neutral
59746019,  ivomez, 6, 5, 1, yes
1715801288,  A_C_officiel, 4, 2, 2, neutral
2339085193,  LorenzoGiorgi_, 2, 1, 1, neutral
1005966932,  delpretedavid, 6, 5, 1, yes
4836437745,  MirnaMonti, 3, 1, 2, no
125153897,  64domenico, 12, 6, 6, neutral
3362768073,  balint_maschio, 2, 1, 1, neutral
4165031189,  LorenzoSandro3, 4, 2, 2, neutral
1523357263,  TirelliEneaCesa, 2, 1, 1, neutral
431963287,  enzoflorence, 2, 1, 1, neutral
425385039,  umbertoprobo, 7, 6, 1, yes
418615937,  biaprile59, 6, 2, 4, no
1083759781,  Liuzz_a, 2, 2, 0, yes
87059776,  AndreaCampione2, 2, 2, 0, yes
916593962,  f10rux, 6, 3, 3, neutral
1096208222,  DPondini, 7, 7, 0, yes
4695906793,  agneserossi560, 4, 4, 0, yes
3667010056,  jeproma, 4, 2, 2, neutral
448056904,  laguardia_p, 5, 5, 0, yes
323272905,  henozzo, 4, 4, 0, yes
1846444333,  LavoroZero, 13, 12, 1, yes
114158160,  lukacasa, 5, 5, 0, yes
582909177,  PCirinoPomicino, 3, 1, 2, no
4834916637,  DavideZiliani80, 3, 3, 0, yes
3356708404,  Paolis995, 13, 0, 13, no
396691435,  babitabby, 17, 4, 13, no
4040505046,  donatodinovi, 4, 0, 4, no
85302943,  SBSitalian, 3, 2, 1, yes
542372059,  CarlaRo38873721, 14, 3, 11, no
422708925,  spok52, 10, 1, 9, no
703511639,  mandelli_andrea, 5, 0, 5, no
254229084,  gaiatagliabue, 3, 0, 3, no
799030343475089412,  masparri, 5, 0, 5, no
875517908,  arrigotoffolatt, 2, 0, 2, no
210847731,  linusant, 9, 0, 9, no
91960359,  htmole, 4, 2, 2, neutral
235628934,  proudGhe, 4, 0, 4, no
496967858,  OrBellaMonella, 2, 0, 2, no
1606820196,  de0_0, 2, 0, 2, no
2288684791,  AlbertoBastai, 2, 0, 2, no
734261803140669441,  SimoGBVilla, 2, 0, 2, no
398155586,  vito_dib, 2, 0, 2, no
2943709047,  GiorniDaFavola, 2, 0, 2, no
51518999,  tiennegolf, 2, 0, 2, no
760763901889871872,  MichelaMichel12, 7, 3, 4, no
802439518947254276,  alberto2487988, 3, 0, 3, no
452953533,  riccardino52, 6, 4, 2, yes
3870837869,  buodiammello, 14, 0, 14, no
3395984483,  stellaary1, 9, 4, 5, no
783982490860056577,  NoneonLamp, 2, 0, 2, no
251508201,  Matteo_Marenco, 2, 0, 2, no
96309027,  tigrealata, 2, 0, 2, no
1471885916,  isisargolex, 2, 0, 2, no
267714400,  GabrieleCorrado, 3, 0, 3, no
1898705130,  DSaponi, 2, 0, 2, no
163527039,  tomplatze, 14, 7, 7, neutral
2228571569,  vdafrittole, 9, 1, 8, no
175052857,  rickytatanka, 2, 0, 2, no
279301177,  bianchiga, 2, 0, 2, no
66651754,  ermetallo, 2, 0, 2, no
4883355514,  luca_greg_nico, 8, 0, 8, no
411769941,  tappocane, 2, 0, 2, no
30464221,  jacodeauss, 2, 0, 2, no
416582648,  beppeconte86, 2, 0, 2, no
2869334632,  silvietti737, 3, 1, 2, no
2336519569,  HobbesKalvin, 2, 0, 2, no
1332209119,  GMetitiero, 9, 2, 7, no
32152226,  Dumromae, 5, 1, 4, no
3380703819,  andreamarc94, 2, 0, 2, no
3294159100,  Berniecavalli, 6, 0, 6, no
453644661,  Pachelbel1980, 2, 0, 2, no
192939414,  matteozenatti, 6, 1, 5, no
805375471,  MauroAsara, 3, 0, 3, no
101014254,  davidebassani, 5, 2, 3, no
374592692,  redjonn, 2, 0, 2, no
2394411554,  Pmalerban, 3, 0, 3, no
802126039610785793,  odiolasinistra, 2, 0, 2, no
740649472552775681,  Irenedivvu, 2, 0, 2, no
385361791,  GiacomoRisitano, 4, 2, 2, neutral
223614136,  LeGentz_, 2, 0, 2, no
164590811,  Ste_Panta_Rei, 2, 0, 2, no
60286672,  DjNiky84, 2, 0, 2, no
724523436056428544,  nira_mm12, 4, 0, 4, no
115167975,  guidoKereze, 2, 0, 2, no
785193802352955392,  Alexgra2705, 11, 8, 3, yes
429070398,  ArmandoGiampier, 2, 0, 2, no
1867583196,  mspiccia, 9, 7, 2, yes
712741795264925696,  LeMiePassioni, 3, 0, 3, no
448911654,  FrancescoFibbi, 2, 0, 2, no
945453433,  piadonis, 5, 1, 4, no
383812478,  giunz, 2, 0, 2, no
964906940,  RafLuise, 3, 0, 3, no
4082854757,  SilviaTruini, 2, 0, 2, no
312660734,  Ezio_vim, 2, 0, 2, no
617997188,  Aurelio_Mazza, 2, 0, 2, no
102099568,  Marcellinosuper, 5, 0, 5, no
3012254517,  t_montinari, 5, 2, 3, no
458620740,  gastaldi_paolo, 4, 0, 4, no
758933464460648448,  anddam1258, 15, 0, 15, no
3230974558,  londinia37, 7, 3, 4, no
423537634,  MarcoRuzzi, 4, 0, 4, no
4905012609,  BeastLory, 2, 0, 2, no
3065583423,  luciovoreno3, 4, 0, 4, no
231750043,  VaranasiEle, 2, 0, 2, no
3700008443,  mirco_venturato, 2, 0, 2, no
1118920148,  resid_le_rose, 7, 0, 7, no
746282182038134784,  FrankBassF9Ca5, 7, 1, 6, no
1269373038,  Andrewetrusco, 5, 1, 4, no
2740699095,  GsSpada, 8, 0, 8, no
1341865640,  diacolare62, 4, 0, 4, no
4885456060,  zosima16, 6, 4, 2, yes
321949553,  maniello71, 2, 0, 2, no
2895110417,  officinacaccamo, 13, 0, 13, no
555997804,  carmenfuriosa, 5, 0, 5, no
1117323301,  gianninomerlo, 28, 5, 23, no
4033150696,  AmericoPalmieri, 2, 0, 2, no
403334506,  MassimoLazzari_, 14, 7, 7, neutral
108764403,  PietroCalabrese, 3, 1, 2, no
2272893092,  SantucciFulvio, 7, 4, 3, yes
788047861342691328,  bartologrimald1, 57, 0, 57, no
711879250572345344,  BalliniGiuliana, 6, 1, 5, no
146799199,  marianosisimbro, 2, 0, 2, no
303354087,  simopetrangeli, 1, 1, 0, yes
380351968,  PecoraroScanio, 1, 1, 0, yes
277665560,  FUniVerde, 1, 1, 0, yes
769549749833916416,  Lavoratori_Ama, 10, 2, 8, no
382024852,  anienewildernes, 1, 1, 0, yes
1115263734,  ant_mattei, 1, 1, 0, yes
4835282529,  Prof_Messina, 1, 1, 0, yes
719640403591434240,  Pizza__Italia, 1, 1, 0, yes
3846053308,  antoniodisant0, 1, 1, 0, yes
728992385833832448,  ComunitaPNALM, 1, 1, 0, yes
890802684,  EnerRinn, 13, 8, 5, yes
3296304233,  StUpGreen, 22, 11, 11, neutral
4273172801,  GEvVC, 19, 9, 10, no
822183163,  vloprino, 2, 1, 1, neutral
1482693858,  TreninoBlu, 4, 3, 1, yes
564577265,  Lele76Lele, 1, 1, 0, yes
410618802,  luca64f, 1, 1, 0, yes
85258045,  margherita1974, 13, 3, 10, no
234720176,  Simonegtt77, 5, 4, 1, yes
2374267118,  Saverio1234S, 15, 9, 6, yes
234329462,  Candeggina_, 4, 2, 2, neutral
136308372,  ciambellano1235, 6, 1, 5, no
299040343,  beyondme87, 3, 1, 2, no
470102886,  atostock1973, 2, 1, 1, neutral
63961997,  jadajin, 3, 1, 2, no
2842784237,  lisodiaz76, 2, 1, 1, neutral
216678892,  Gionspenser, 2, 1, 1, neutral
2367281287,  sancaveneta, 2, 1, 1, neutral
4120726487,  m_visona, 2, 1, 1, neutral
2509319063,  SabbadinDavide, 6, 3, 3, neutral
56819005,  distefanonova, 9, 7, 2, yes
254943968,  esperidi82, 2, 2, 0, yes
770213977553047552,  GerardoFulgion1, 15, 2, 13, no
791286819140829184,  OscarPennacchi, 8, 4, 4, neutral
373395657,  SilvanoRubino, 11, 6, 5, yes
462486093,  genti_lik, 2, 0, 2, no
752979558,  sommino, 4, 0, 4, no
256467449,  murgiar, 4, 3, 1, yes
388362333,  gio_querelato, 10, 3, 7, no
785774096613126144,  HannaPatry, 4, 1, 3, no
394957022,  robbertoni, 26, 2, 24, no
2354484061,  sigmaseisas, 1, 1, 0, yes
1118100247,  nelloufo, 11, 10, 1, yes
782574940478377984,  raffaellaluner1, 42, 41, 1, yes
774699957009997824,  merlinsilvia1, 9, 9, 0, yes
422574779,  Aronoelee, 22, 21, 1, yes
774896842211459072,  Lulla75Cat, 3, 3, 0, yes
1883765348,  laura_tesei, 8, 8, 0, yes
776884534889574404,  giosturiale, 20, 19, 1, yes
775325300334981120,  AleBelliens, 10, 9, 1, yes
774450389227823104,  SoniaNuova, 3, 3, 0, yes
773978092775870464,  FilippamariaRi1, 16, 16, 0, yes
560169622,  rosalbacrazia, 43, 41, 2, yes
1518850464,  adrianamaggior1, 12, 12, 0, yes
4133790683,  carlatrinchillo, 3, 3, 0, yes
1041519145,  cortesepinuccia, 17, 17, 0, yes
1037335069,  BrizziValentino, 5, 0, 5, no
3257070727,  TiCommento, 9, 1, 8, no
838138819,  PDLOnesto, 68, 1, 67, no
2353250347,  LRagosi, 51, 1, 50, no
2349895098,  Picchipremier, 55, 1, 54, no
435187030,  MauriziaPicci, 2, 0, 2, no
701484965272416257,  cgilbas, 2, 0, 2, no
109083682,  prandigno, 3, 0, 3, no
1675361858,  FiabVarese, 1, 1, 0, yes
618722314,  aditiya__rahman, 1, 1, 0, yes
2795303411,  ScuoleAbruzzo, 1, 1, 0, yes
718039167830257664,  Mess_Marittimo, 4, 4, 0, yes
2167782040,  CancianiRenzo, 2, 2, 0, yes
264785023,  Giannilostorto, 1, 1, 0, yes
1004322594,  FrateMatteo, 2, 2, 0, yes
2310276773,  comi_anna, 3, 3, 0, yes
716890607168434176,  usrc_it, 1, 1, 0, yes
430052444,  DiBi85, 3, 2, 1, yes
2448612458,  LeslleRockinAZ, 1, 1, 0, yes
94152299,  Rossy1284, 1, 1, 0, yes
345877889,  Tiennetti, 1, 1, 0, yes
721280877121138688,  AdgiDip, 2, 2, 0, yes
379726678,  MarioMeliado, 2, 2, 0, yes
100303468,  giorgiosantilli, 3, 3, 0, yes
240888332,  foxpap71, 3, 3, 0, yes
119005809,  ivan81bar, 1, 1, 0, yes
2523862270,  Giusepp01272858, 2, 2, 0, yes
31717022,  apreiti, 1, 1, 0, yes
937579860,  Caro_Villa_, 1, 1, 0, yes
186393484,  gazzettaReggioE, 4, 4, 0, yes
1135255465,  AndreaC1971, 1, 1, 0, yes
3981718401,  RilancioMxp, 1, 1, 0, yes
4846648917,  giusepp78881649, 1, 1, 0, yes
143443604,  bursonitaly, 1, 1, 0, yes
457942329,  VirgiMasci, 1, 1, 0, yes
1927038746,  AnciLiguria, 1, 1, 0, yes
457547376,  lauracremolini, 2, 2, 0, yes
2454976539,  silviapantw, 2, 2, 0, yes
2748503449,  desaemi, 1, 1, 0, yes
50657628,  giancalsp, 11, 2, 9, no
93606006,  gianmaz, 1, 1, 0, yes
3019874188,  acciuffi, 2, 2, 0, yes
60952648,  NeMeaSistemi, 1, 1, 0, yes
901788835,  bellino_fabio, 3, 2, 1, yes
304038044,  DanielaOddone, 4, 3, 1, yes
99520777,  Iazael, 1, 1, 0, yes
1955145548,  effeol, 3, 2, 1, yes
3064402677,  edilizia_scuole, 1, 1, 0, yes
729873024225316864,  AvvocatiDem, 2, 2, 0, yes
2982994527,  Aliceb2014Alice, 1, 1, 0, yes
17648551,  commazero, 15, 6, 9, no
165458165,  Birkmayer82, 1, 1, 0, yes
75022649,  WildItaly, 4, 4, 0, yes
545968677,  Regione_Abruzzo, 3, 3, 0, yes
468806146,  emanuelastazi, 9, 9, 0, yes
3957830837,  paoletta_62, 2, 1, 1, neutral
496343408,  gabriella_turra, 20, 8, 12, no
749188137298067456,  losbadigliomat, 2, 2, 0, yes
565500674,  A_Baldieri, 5, 5, 0, yes
2297876287,  AdrianoPalaz, 3, 2, 1, yes
733042437766144000,  Spagnacng, 2, 2, 0, yes
181888393,  Lorenzo_Merola_, 3, 2, 1, yes
51781061,  imfree81, 7, 5, 2, yes
405514210,  AlexRussello, 4, 1, 3, no
956196204,  CristianoBisio, 1, 1, 0, yes
43313918,  FabrizioTarvis, 1, 1, 0, yes
1617587352,  CastiglioneM5S, 2, 1, 1, neutral
732478040748363776,  sigonfialarete5, 10, 10, 0, yes
434783947,  kappina_, 4, 2, 2, neutral
2201692352,  FAST_Abruzzo, 2, 2, 0, yes
4141527935,  VIIBiciclettari, 1, 1, 0, yes
957611622,  roberto_mnt, 1, 1, 0, yes
790406626289262592,  aiapp_lams, 1, 1, 0, yes
1300646329,  upsideworld_, 7, 7, 0, yes
2215783693,  effebot, 3, 3, 0, yes
469394211,  nannisaviozzi, 1, 1, 0, yes
1034988296,  Berengario85, 6, 6, 0, yes
2312394189,  RTCENTRODESTRA, 2, 1, 1, neutral
742643150397804544,  lauraalese1, 1, 1, 0, yes
55683027,  santibaylor, 3, 3, 0, yes
2583970914,  AeroportoNapoli, 1, 1, 0, yes
969077816,  CristoforoPorro, 1, 1, 0, yes
47176984,  antjgone, 1, 1, 0, yes
719504576446132224,  AntonioFornasi2, 2, 2, 0, yes
80032149,  massimo_esposti, 1, 1, 0, yes
616029220,  arthurj0nkman, 1, 1, 0, yes
817440246,  quartomiglio, 2, 1, 1, neutral
1254394752,  FedericoCanullo, 3, 3, 0, yes
20008166,  Neurocrawler, 3, 0, 3, no
3007811949,  vivianacruciani, 3, 1, 2, no
209618253,  gioanah, 8, 5, 3, yes
2938357835,  lindherot, 2, 0, 2, no
151639390,  AntonioVeritas, 16, 2, 14, no
543602727,  GabrieleGucc, 2, 0, 2, no
93947421,  AndreAzzol, 4, 0, 4, no
291604982,  Holdfast77, 7, 0, 7, no
84033956,  radioeco, 3, 2, 1, yes
236139428,  ubbiubbi, 3, 1, 2, no
400600868,  Marzia_new, 2, 1, 1, neutral
730059164580519936,  SameemAkhtarSa4, 2, 1, 1, neutral
779993497445228544,  Sconti_Nascosti, 2, 1, 1, neutral
65008580,  Manusweet, 4, 1, 3, no
543703413,  Suicide_Clan, 2, 1, 1, neutral
980318629,  PeppeBille, 4, 3, 1, yes
719651965,  pietrocorbo, 5, 3, 2, yes
2249135604,  LapoCalissi, 8, 5, 3, yes
2901251668,  vincenzolagana9, 8, 6, 2, yes
592520341,  Malinc0mico, 19, 13, 6, yes
725741004876333061,  PooolFelfra, 6, 3, 3, neutral
1213623866,  CamillettiMarco, 2, 1, 1, neutral
840304898,  fabolik, 5, 1, 4, no
790596082933850113,  GLucaSKIZZOaMo1, 2, 1, 1, neutral
522272749,  PietroGiunti, 2, 1, 1, neutral
505790519,  massimovyrus, 15, 10, 5, yes
964852682,  sebastianolarus, 26, 18, 8, yes
1129269444,  a_iervolino, 26, 11, 15, no
183957850,  Vgalizia, 2, 1, 1, neutral
2269505163,  thegulliver, 3, 1, 2, no
36071881,  adivossoli, 2, 1, 1, neutral
2976062391,  nicco_costa, 2, 1, 1, neutral
799642016888012800,  m5Stesso, 7, 1, 6, no
2992982729,  ModusInRebusEst, 11, 2, 9, no
484191151,  TGuadalupi, 2, 1, 1, neutral
432584137,  Manu_Tweety, 3, 0, 3, no
1137093510,  GiacomoBeria, 3, 1, 2, no
224837196,  phonic50, 4, 2, 2, neutral
701480889084207105,  SenecaNana, 2, 0, 2, no
404022377,  oneshot971, 16, 4, 12, no
919778352,  vvncrv, 6, 2, 4, no
270896923,  lorenzoromani, 6, 0, 6, no
2361121173,  manuela_cirone, 8, 1, 7, no
561304474,  sgonfialepalle, 2, 0, 2, no
517929046,  GuidoVianello, 5, 3, 2, yes
794554811714830337,  Dalemiani, 4, 0, 4, no
1229549244,  lucaniasi, 6, 2, 4, no
908512855,  TrioloMario, 2, 0, 2, no
970504938,  dliguoro1, 8, 6, 2, yes
4144725976,  lumi_stan, 5, 2, 3, no
2342272314,  SaliconeA, 7, 5, 2, yes
242225250,  stebortuzzo, 2, 0, 2, no
213735396,  FimCatania, 2, 0, 2, no
2833897042,  marioggiglio, 4, 2, 2, neutral
2763527634,  hermitme1, 4, 2, 2, neutral
802530080639643648,  iperione_, 13, 1, 12, no
2305531562,  jusi_lee, 9, 2, 7, no
2380747454,  MKForgione, 14, 2, 12, no
1708309334,  montemilon, 27, 0, 27, no
3056847964,  carlagen2015, 13, 3, 10, no
2348272160,  menesbatto_, 12, 2, 10, no
1326344736,  Gg2008Gianni, 6, 1, 5, no
1573555616,  disfareilpd, 2, 0, 2, no
1389988651,  Gastone_derolla, 3, 0, 3, no
3385958710,  jennifer_rosati, 12, 0, 12, no
495419596,  GianAbbasc, 9, 4, 5, no
3686769617,  NessunaPerfetta, 7, 7, 0, yes
1268082668,  MarcellaMelodia, 11, 8, 3, yes
2355693375,  ElenaPascolini, 1, 1, 0, yes
53664986,  cnzpll, 1, 1, 0, yes
825321830,  ambrareda, 1, 1, 0, yes
335241668,  politicadonna, 1, 1, 0, yes
855369620,  aranciolucy, 17, 7, 10, no
471334188,  GiuseppeZuelli, 8, 3, 5, no
2992351714,  Cgil_Napoli, 2, 0, 2, no
767831797853982721,  adorno75911306, 8, 5, 3, yes
4586557397,  ufclop, 4, 3, 1, yes
2566805621,  Frassannino, 3, 1, 2, no
377405042,  SimoneBarbieri2, 2, 0, 2, no
1364231341,  AlxIxAn, 36, 0, 36, no
601016936,  gpaolo_c, 5, 0, 5, no
736441270881640448,  Virgil1309, 22, 0, 22, no
2875783329,  eingel80, 5, 0, 5, no
2762114060,  gpsegala, 2, 0, 2, no
305790839,  paolograzzano, 6, 4, 2, yes
731393402,  Gatto_Mannaro, 17, 5, 12, no
3082109127,  MOsudorg, 9, 2, 7, no
2448102733,  DiabolMark, 29, 4, 25, no
111937466,  virtusi, 5, 0, 5, no
182379277,  Skamarella77, 4, 2, 2, neutral
3252260663,  EffeEva, 4, 1, 3, no
703609955555917825,  Seamarin151, 3, 0, 3, no
470384931,  Davide67Nigro, 1, 1, 0, yes
404709140,  GiudaV, 2, 2, 0, yes
1423491181,  lorenzochiriatt, 1, 1, 0, yes
49968874,  adrianaclu, 4, 3, 1, yes
3111732579,  cpaulesu, 3, 3, 0, yes
257385815,  ParidePalumbo, 2, 2, 0, yes
60971285,  nidodeltacchino, 4, 3, 1, yes
285076894,  MicheleVann, 1, 1, 0, yes
831738350,  AntonioPondini, 4, 4, 0, yes
239411530,  CozzolinoSalvo, 2, 1, 1, neutral
188368997,  UispNazionale, 2, 1, 1, neutral
65147995,  CostHermanin, 5, 3, 2, yes
1155342385,  MacchiPiero, 4, 4, 0, yes
115701472,  La_Bigo, 1, 1, 0, yes
757002450,  leosantacrux, 2, 1, 1, neutral
1079603407,  NadinaLs, 1, 1, 0, yes
1533166392,  lucifree7, 2, 2, 0, yes
1294265473,  redlazionauta, 4, 3, 1, yes
1932047412,  opinionidisara2, 2, 2, 0, yes
92602577,  giuseppemaria, 5, 5, 0, yes
2372192396,  DiegoMozzo, 4, 4, 0, yes
905508564,  EurcaSrl, 1, 1, 0, yes
427510652,  sabbatani, 2, 2, 0, yes
82119370,  marcolambertini, 2, 2, 0, yes
1011241314,  tlotre, 2, 2, 0, yes
1487391134,  da8to, 1, 1, 0, yes
577966244,  BozzettoStefano, 2, 2, 0, yes
20515207,  davideagazzi, 3, 3, 0, yes
785367204703461376,  froggyfroggy25, 8, 2, 6, no
16777774,  paologerbaudo, 2, 2, 0, yes
1710006104,  Emiliano_Foroni, 1, 1, 0, yes
946170176,  RistoriDuccio, 8, 3, 5, no
480642937,  gle_47, 1, 1, 0, yes
402819013,  guevaraetotti, 7, 4, 3, yes
208187453,  yomo73, 1, 1, 0, yes
50587135,  FDeMichino, 3, 2, 1, yes
446490092,  BroccoloGina, 22, 11, 11, neutral
33994488,  ItalianPolitics, 9, 4, 5, no
385397958,  francescodambr3, 2, 2, 0, yes
3109897131,  MarinaBrunazzi, 13, 2, 11, no
40353863,  giovdall, 4, 2, 2, neutral
3015774443,  nove_silvia, 31, 1, 30, no
1033243188,  FacchiniAlberto, 2, 2, 0, yes
1396350326,  giorizzo62, 5, 3, 2, yes
1060233126,  TizianaZei, 3, 3, 0, yes
2886180345,  Rosella29755048, 3, 3, 0, yes
537165471,  RaffaelloMatara, 2, 2, 0, yes
948311107,  pierdalex, 1, 1, 0, yes
167341717,  De_Treias, 7, 5, 2, yes
350535235,  mattiadiletti, 3, 3, 0, yes
134193028,  aleingaria, 1, 1, 0, yes
3311089743,  getRekt889, 5, 4, 1, yes
42062113,  marcov2, 2, 2, 0, yes
628367790,  silviafranchi2, 23, 10, 13, no
206180236,  EdoardoMartino, 33, 5, 28, no
2988086885,  giovannin42, 10, 8, 2, yes
436539086,  graphos77, 1, 1, 0, yes
200890494,  tito_labo, 1, 1, 0, yes
1068681522,  CarlottaDiMarco, 21, 4, 17, no
3119599396,  Gilmonti, 1, 1, 0, yes
237398463,  Nicola_Pedrazzi, 2, 2, 0, yes
4227664641,  273_333, 58, 8, 50, no
3600543629,  RossDaminelli, 1, 1, 0, yes
150608013,  andreacreativo, 17, 2, 15, no
403293960,  giorgiobenvenut, 2, 1, 1, neutral
1288548198,  Cruscante, 1, 1, 0, yes
53915173,  MoPesce, 4, 4, 0, yes
1104906145,  joeddany, 8, 4, 4, neutral
1089272156,  estimarco, 6, 5, 1, yes
300496676,  angelicafratini, 3, 2, 1, yes
1268045520,  ennioflyano, 11, 3, 8, no
429715292,  faustalissia, 14, 9, 5, yes
2382824360,  woodenship4u, 1, 1, 0, yes
87962275,  Simonedantonio, 1, 1, 0, yes
411586879,  Pinodef, 8, 3, 5, no
1338629958,  bmvc59, 1, 1, 0, yes
512543036,  mdamico1, 1, 1, 0, yes
2257809774,  rossimone77, 7, 7, 0, yes
172669850,  darknight74it, 2, 1, 1, neutral
335174838,  andreas_1967, 1, 1, 0, yes
383284208,  DiegoCossu75, 1, 1, 0, yes
2353564274,  tittilatitti, 20, 2, 18, no
435300845,  Silvia_Moggia, 2, 1, 1, neutral
261705959,  ortyzapple, 9, 1, 8, no
1367780113,  MykiaMad, 1, 1, 0, yes
397279221,  rosanna_rosanna, 1, 1, 0, yes
2151237468,  pv21did, 9, 5, 4, yes
2575367380,  2013_BEATRICE, 2, 2, 0, yes
115618304,  stefanoballeari, 3, 1, 2, no
4921156757,  RobyDi1, 5, 2, 3, no
431966787,  frengo1987, 7, 6, 1, yes
3049067538,  HUBgiovani, 23, 2, 21, no
56803647,  Angeloleccese, 11, 7, 4, yes
2297565537,  Arturo_Parisi, 2, 2, 0, yes
2206851290,  oleandro3, 5, 4, 1, yes
462156900,  rinaldi_daniela, 10, 8, 2, yes
576106827,  AlbaGiunzioni, 9, 7, 2, yes
251094642,  kiarobsten, 38, 13, 25, no
974511188,  RMcM86, 26, 6, 20, no
1198954656,  FraZaffarano, 3, 3, 0, yes
383754117,  MarcoSilvestri9, 3, 3, 0, yes
970562868,  annaflalb, 10, 6, 4, yes
112233466,  LongoOlgaMaria, 1, 1, 0, yes
3335486015,  GGeremia58, 7, 7, 0, yes
199230149,  uburoi1, 10, 8, 2, yes
3336144413,  1a08a05d1861436, 19, 19, 0, yes
277948552,  biondifil, 1, 1, 0, yes
517201778,  fpinsicilia, 4, 4, 0, yes
329593902,  Giordano1977, 2, 2, 0, yes
4091800402,  giusnico19511, 3, 3, 0, yes
3368360345,  terzamarcia2010, 4, 2, 2, neutral
956368879,  MarcoTruffo, 5, 5, 0, yes
973832220,  glumion, 2, 1, 1, neutral
525862024,  annamariaguarda, 3, 3, 0, yes
1405314698,  aironefly, 1, 1, 0, yes
783248276875251712,  O_Contarino, 1, 1, 0, yes
484887153,  PattyBonty, 1, 1, 0, yes
2273277140,  imastandrea, 22, 16, 6, yes
193786720,  _MrsVin_, 14, 11, 3, yes
4764209895,  paolpapi, 5, 4, 1, yes
1904640829,  iaiasom, 7, 5, 2, yes
81335749,  ilbeccaccino, 7, 1, 6, no
280063261,  mervin985, 4, 2, 2, neutral
431515921,  Nipitella58, 7, 6, 1, yes
2892020627,  sport_politic, 3, 1, 2, no
535496510,  gmarigliano86, 4, 3, 1, yes
3296477548,  andreabriz, 5, 2, 3, no
470977705,  AdrianoCaorsi, 6, 2, 4, no
51424590,  LuigiBiagini, 2, 2, 0, yes
792685021354201088,  GiuMinzo, 13, 13, 0, yes
3308422191,  TuttoQuaNews, 5, 3, 2, yes
116254234,  NicolettaNiki, 3, 3, 0, yes
783558333391405056,  _MauroGilardi_, 5, 5, 0, yes
560533845,  FabrizioAnselmo, 4, 4, 0, yes
970397905,  giovannigriffi2, 3, 3, 0, yes
707424884,  giuseppe_aieta, 7, 7, 0, yes
2216107671,  gianfrancoanto7, 4, 1, 3, no
168672956,  giac77, 1, 1, 0, yes
540176252,  LudoTranquilli, 2, 2, 0, yes
780342597458034692,  firenzedicesi, 18, 18, 0, yes
390004968,  rifarelitalia, 8, 8, 0, yes
101086929,  peraltro, 1, 1, 0, yes
801183708191555585,  ditesemprediSI, 10, 8, 2, yes
417216609,  cet_77, 5, 5, 0, yes
297884272,  davcarretta, 8, 8, 0, yes
166475743,  Dedantibus, 3, 0, 3, no
20581857,  Viceitaly, 1, 0, 1, no
3200053252,  UnicronPlanetM, 53, 2, 51, no
2543699427,  Francesca_polif, 2, 1, 1, neutral
2901882595,  BarileMari, 2, 1, 1, neutral
1462993410,  311titti, 6, 2, 4, no
790250578588864512,  eleinad55, 1, 0, 1, no
2243490855,  pasquale_carta, 8, 4, 4, neutral
3065758708,  karljuliaD, 1, 0, 1, no
777876616676466689,  Deepak65633627, 1, 0, 1, no
2974879767,  mtcaruzzo, 17, 5, 12, no
350184411,  panettos, 31, 3, 28, no
574871295,  rafcirone, 6, 0, 6, no
703877219685425152,  corinnadilelio, 1, 0, 1, no
767600300,  Beailesoloio, 18, 5, 13, no
537221457,  sconsoladdolo2, 1, 0, 1, no
242399306,  micheleserafin1, 12, 0, 12, no
759449605,  Domiko8, 1, 0, 1, no
82639412,  ivaniiritano, 13, 9, 4, yes
304413441,  massimolepri, 4, 2, 2, neutral
136012345,  cholalady27, 7, 4, 3, yes
797148678372913152,  Nanni_Rillo, 4, 2, 2, neutral
486892441,  simone_mirko, 5, 2, 3, no
925782877,  SandroDini1, 6, 0, 6, no
2574023704,  MassimoBraga1, 8, 2, 6, no
929277121,  VALDAGRI5STELLE, 3, 0, 3, no
798640448558497792,  Toni43821316, 19, 0, 19, no
799907142484578304,  NadiaDiMartino7, 4, 0, 4, no
757917606707916804,  Malest2000, 14, 2, 12, no
2358353824,  bettap13, 9, 0, 9, no
1249912915,  pimonte5stelle, 9, 0, 9, no
256958384,  LuigiMuraca, 1, 0, 1, no
1411322347,  Barone5S, 5, 2, 3, no
4909204947,  SimoneSignorel3, 3, 0, 3, no
1558348513,  GiovannaChiaese, 1, 0, 1, no
1222087430,  AlessandraPannu, 3, 0, 3, no
600847079,  robibianchini, 18, 2, 16, no
4706326756,  gragnano5stelle, 6, 0, 6, no
373950389,  I_AM_IM_, 9, 1, 8, no
759511811964231684,  acissej07723372, 17, 0, 17, no
1222967826,  M5SVicoEquense, 6, 0, 6, no
793496531508793344,  claudia99234955, 6, 2, 4, no
76622281,  anto219, 6, 0, 6, no
1348975974,  Sica92Luigi, 22, 2, 20, no
2957131078,  sofonisba55, 37, 0, 37, no
2742709167,  papa5_pasquale, 15, 4, 11, no
461013719,  BobGhirhouse, 3, 0, 3, no
198683785,  Bruno_Brunelli, 4, 0, 4, no
398787729,  JackPlasters, 1, 0, 1, no
2986029209,  FerdiAysi, 1, 0, 1, no
555357391,  DiegoBenevento, 5, 0, 5, no
2676044931,  kingmile98, 1, 0, 1, no
22172093,  giacomos, 3, 1, 2, no
2421892166,  LauraS_1978, 7, 0, 7, no
2512944834,  MaTic2015, 6, 1, 5, no
2956918469,  Muscoli_info, 9, 2, 7, no
2466016514,  vittovolte, 3, 1, 2, no
270348042,  pierluigiluisi, 2, 0, 2, no
1470432672,  Mingus2011B, 2, 0, 2, no
2265311957,  EconomiaFacile, 9, 7, 2, yes
438337139,  JessicaSimonett, 3, 3, 0, yes
1135800156,  Euroscettici, 8, 7, 1, yes
2326047985,  giano23cs, 4, 3, 1, yes
1227206636,  MTibimau, 7, 5, 2, yes
701762343827537920,  GDCapitanata, 8, 5, 3, yes
1434063462,  diamiladi, 5, 4, 1, yes
430884495,  maxwell979, 3, 3, 0, yes
921649062,  smoccoli, 3, 3, 0, yes
534146296,  redaelena, 9, 7, 2, yes
1011705998,  MaxiErrante, 6, 5, 1, yes
837942602,  gloria_palazzi, 3, 3, 0, yes
931508288,  alberto_pilotto, 12, 7, 5, yes
486725466,  giuseppedainott, 4, 4, 0, yes
433416785,  zanzarazeze, 3, 3, 0, yes
873129732,  pfmurgia, 3, 2, 1, yes
2569072195,  tomtweet3, 32, 9, 23, no
909777890,  RobertoCelano, 4, 1, 3, no
1039809685,  MicheleCeoGeom, 1, 0, 1, no
347755387,  Camillanesb, 1, 0, 1, no
11418002,  ppinguinOJ, 1, 0, 1, no
392964925,  mllogiacco, 4, 3, 1, yes
308582871,  Lumen79, 1, 0, 1, no
489760837,  tefulmino, 9, 7, 2, yes
748173713787465728,  roberto72477, 4, 3, 1, yes
568550981,  gianfraschet, 1, 1, 0, yes
800684353126735873,  valeriome901, 7, 4, 3, yes
455378815,  Fontana3Lorenzo, 2, 2, 0, yes
2510540902,  giovannacarnev5, 1, 1, 0, yes
333410580,  DAVIDPARENZO, 4, 3, 1, yes
170691830,  rik1969, 2, 2, 0, yes
313771413,  lizard_king87, 3, 3, 0, yes
514160441,  paosunduk, 5, 5, 0, yes
1266792098,  peppebarbaccia, 3, 0, 3, no
830081490,  comodiceusted, 11, 3, 8, no
1354142214,  robypellegrini, 15, 5, 10, no
3070433050,  PapaPascali, 3, 1, 2, no
805405547629572096,  Marianna0054, 3, 0, 3, no
2354548375,  doc_ba, 2, 0, 2, no
2334400204,  Garnet77Luca, 2, 0, 2, no
3491171117,  paolinaLina2, 52, 1, 51, no
477844374,  kastalrogo, 2, 0, 2, no
394861796,  recymax, 24, 0, 24, no
801422494708236288,  OBacilieri, 16, 8, 8, neutral
789374017673236480,  correnteparma, 2, 0, 2, no
2187027482,  Brontolo2013, 2, 0, 2, no
395196509,  Tor72V, 2, 0, 2, no
1081906242,  CbvitoCom, 2, 0, 2, no
456081980,  mauriziorossi15, 4, 0, 4, no
8678952,  davesio, 4, 0, 4, no
4561319014,  AntonioAle5, 5, 0, 5, no
546791475,  OmnibusLa7, 6, 1, 5, no
265408261,  andreafacchini1, 13, 2, 11, no
1015870262,  red_mask9, 40, 3, 37, no
782880990259769344,  MauroMercantiMC, 4, 4, 0, yes
745334980964982785,  Massimilianosg3, 5, 3, 2, yes
2668106493,  MassimoMec, 4, 4, 0, yes
1920965048,  Hunternehmer, 7, 2, 5, no
484150543,  Alegiova1, 11, 6, 5, yes
435693275,  gianfrancosabia, 2, 0, 2, no
1456739846,  lacordacura, 5, 0, 5, no
40687613,  salvospampinato, 7, 4, 3, yes
371619032,  SimoAlex61, 4, 0, 4, no
54958908,  robydelonge182, 5, 3, 2, yes
278188295,  SalvatoreRuffo, 7, 0, 7, no
272350720,  albertopasini, 11, 7, 4, yes
315786202,  FrancescoFiorin, 3, 1, 2, no
117407713,  AnnalisaChirico, 7, 1, 6, no
312166162,  John_Doe_1001, 10, 4, 6, no
4149937405,  FrancescoC1977, 4, 0, 4, no
594906158,  erzappa, 2, 0, 2, no
53670791,  14Arcano, 3, 0, 3, no
204955368,  tuttamagia, 3, 0, 3, no
557183767,  monnalisa65, 5, 0, 5, no
2238224184,  Gaudius97, 5, 2, 3, no
2519252925,  pabapa11, 2, 0, 2, no
47641058,  rinhello, 2, 0, 2, no
1070407046,  DonaPinna, 5, 1, 4, no
286914213,  il_teo, 4, 0, 4, no
382265822,  m_selis, 9, 3, 6, no
2351401893,  elenaghezzi73, 6, 0, 6, no
957510175,  Marco_Mazzariol, 2, 0, 2, no
800374608989818880,  Audrey17051990, 4, 0, 4, no
2404302998,  Daviddino79, 11, 3, 8, no
3062692251,  Ilariatattaresu, 2, 0, 2, no
384927198,  gparagone, 4, 1, 3, no
4305700001,  RosiDelullo17, 3, 1, 2, no
1454502163,  IacobellisT, 5, 4, 1, yes
61141361,  EUROPAITALIA, 4, 2, 2, neutral
4172823213,  girossi7710, 17, 6, 11, no
120433474,  buscatier84, 8, 8, 0, yes
4119906531,  sten_lomonaco, 23, 14, 9, yes
22845706,  AlessandroRusso, 3, 3, 0, yes
346022823,  benedettalondon, 1, 1, 0, yes
476914448,  PaolaInnocenti3, 2, 2, 0, yes
2265684361,  AgostinoBianchi, 10, 1, 9, no
3044107506,  francescopres1, 1, 1, 0, yes
1159355300,  Anfiotika, 2, 1, 1, neutral
1619926346,  Miguel_Pattones, 4, 4, 0, yes
1002788786,  Sarti_Davide, 8, 8, 0, yes
254607958,  JudyMajira50, 5, 5, 0, yes
3130779556,  ChibuzoEleagud, 5, 4, 1, yes
1085685984,  primideroma1900, 1, 1, 0, yes
507650057,  MatteoBasileGE, 4, 4, 0, yes
3025472511,  anna_pia_cossu, 2, 1, 1, neutral
404759504,  AchilliMassimo, 3, 3, 0, yes
417046350,  Mic_Torres, 1, 1, 0, yes
366558043,  GalluzziPaolo, 2, 2, 0, yes
778173491921248256,  pido_kevin, 3, 3, 0, yes
544669386,  Piergiosev, 1, 1, 0, yes
315096338,  Danielegiu1980, 1, 1, 0, yes
711196541164376064,  Fabio83527447, 5, 5, 0, yes
373574384,  kaio_poiel, 2, 1, 1, neutral
1022731986,  Sissi_Massari, 2, 1, 1, neutral
1142707916,  gecangemi, 1, 1, 0, yes
3296744735,  raffarsen, 5, 2, 3, no
2961767801,  brunolopiccolo, 1, 1, 0, yes
540066448,  mbbelluco, 7, 7, 0, yes
196444688,  eluniel, 4, 2, 2, neutral
361403479,  DaustoC, 5, 2, 3, no
2266329732,  pietroswan40, 5, 4, 1, yes
593635853,  gralbertazzi, 2, 2, 0, yes
209733883,  m_ioia, 5, 4, 1, yes
1911554858,  Fottitinne, 2, 2, 0, yes
1565108870,  AngeloMaranesi, 5, 2, 3, no
805549996489711616,  la_cris82, 1, 1, 0, yes
434253661,  andreaarma, 12, 12, 0, yes
474672860,  barbotti, 1, 1, 0, yes
933043896,  boboclucianicol, 4, 1, 3, no
346498718,  Emanuelafavale, 3, 3, 0, yes
773077546766372864,  Liberi_Si, 1, 1, 0, yes
519330046,  StefanoFedele1, 22, 19, 3, yes
444971928,  fabrileoni, 1, 1, 0, yes
792792117227708416,  ragazziitalia, 2, 2, 0, yes
3523487596,  FijlkamOfficial, 1, 1, 0, yes
7121972,  AlexRenzetti, 1, 1, 0, yes
735454622509367297,  ilcittadinoroc2, 14, 14, 0, yes
1369870686,  lucaper8, 2, 1, 1, neutral
141612687,  MattTomato, 6, 1, 5, no
199316377,  patannio, 2, 1, 1, neutral
396143318,  ercondor66, 18, 18, 0, yes
2943507749,  g_grimaldi73, 23, 23, 0, yes
436239851,  EdoardoQuaquini, 1, 1, 0, yes
742402571390877696,  StefanoStacul, 3, 3, 0, yes
889444711,  Ray_pre, 21, 21, 0, yes
102672182,  robertapinotti, 13, 13, 0, yes
384192964,  MinisteroDifesa, 23, 23, 0, yes
1074597768,  DspepePepe, 1, 1, 0, yes
134440982,  GiuliaColi, 2, 2, 0, yes
398901089,  giubbo87, 8, 8, 0, yes
802683488843481088,  seothemorsamp11, 2, 2, 0, yes
523682869,  moussedisalmone, 2, 2, 0, yes
2903601496,  parliamdidroghe, 3, 3, 0, yes
2881376289,  bellid150, 4, 4, 0, yes
792782161065680896,  Chiara506213951, 4, 4, 0, yes
52671886,  ass_coscioni, 3, 3, 0, yes
3993025336,  Iskra_Aversa, 1, 1, 0, yes
585941279,  GhostRock72, 5, 1, 4, no
242741989,  MadedduM, 1, 1, 0, yes
510796801,  AntorisRispo, 1, 1, 0, yes
204299339,  AndRinal, 1, 1, 0, yes
2360794731,  AndreaBugiani, 3, 2, 1, yes
1006439738,  LianaFuser, 4, 4, 0, yes
320253490,  SaverioMarafiot, 6, 4, 2, yes
801136494471774208,  Pablo73329906, 1, 1, 0, yes
3433354012,  andreginato97, 4, 4, 0, yes
397568220,  RocchiFrancesco, 1, 1, 0, yes
403407114,  GianvitoDP, 4, 2, 2, neutral
3051404948,  Carlo_Scn, 9, 2, 7, no
418638857,  BFbieffe, 5, 0, 5, no
376313089,  carlopecoraro1, 5, 3, 2, yes
799900104123707392,  federicodescb, 14, 2, 12, no
569195786,  cmirisola, 22, 22, 0, yes
726521604042280960,  sabinaperrone7, 2, 2, 0, yes
775082261632999424,  enzapedone, 2, 2, 0, yes
149166503,  antospastore, 9, 8, 1, yes
2288632603,  ftrombet, 4, 4, 0, yes
788463119031013376,  tonia07513161, 4, 4, 0, yes
2360238173,  grecogiusi1974, 2, 2, 0, yes
790627611663863812,  Giovannaloc, 7, 7, 0, yes
791259822301806592,  mariaporri, 4, 4, 0, yes
788478068763549697,  rossanaenrica, 15, 14, 1, yes
733019117318471680,  palma_lilly, 137, 137, 0, yes
784687238974144512,  GiustoSonia, 3, 3, 0, yes
927409196,  GMagaglio, 6, 5, 1, yes
402046931,  chiappaangelo, 2, 2, 0, yes
305269020,  tobiazevi, 3, 3, 0, yes
497763567,  siciliantonio, 11, 1, 10, no
452469458,  danilo_chirico, 2, 2, 0, yes
19106485,  mzzfederico, 5, 2, 3, no
172382368,  naxdistefano, 19, 0, 19, no
2984349707,  frulrobyn, 3, 0, 3, no
104485125,  mara_carfagna, 13, 0, 13, no
145561037,  tizianacarmela, 19, 6, 13, no
1469198210,  cleliadibi, 2, 1, 1, neutral
1749764352,  BonazzolaA, 4, 1, 3, no
104768009,  brandoni_it, 4, 3, 1, yes
396019478,  barbierofranco, 4, 2, 2, neutral
554284031,  vsansalone, 2, 1, 1, neutral
2207428278,  MainiIvo4, 2, 1, 1, neutral
1053440604,  FrancescoLibe10, 2, 1, 1, neutral
602712735,  SalvScollo, 7, 1, 6, no
1067951778,  pasciutig, 6, 3, 3, neutral
2815762865,  NicolaGrolla, 3, 1, 2, no
723777820309217280,  virginrays, 8, 4, 4, neutral
2613366894,  ChaBootEZ, 2, 1, 1, neutral
557259122,  claluciani, 4, 2, 2, neutral
2473375067,  prestia_fabio, 4, 1, 3, no
909810168,  xeroxud, 4, 1, 3, no
488662317,  xxxcarpediemxxx, 6, 6, 0, yes
547932396,  luigi_garibaldi, 3, 3, 0, yes
1684298700,  AleBertolotti75, 2, 2, 0, yes
731193944764219392,  daniele17gobbi, 3, 3, 0, yes
453482376,  silvianalon, 12, 12, 0, yes
496165502,  GandalfilGrigi1, 1, 1, 0, yes
1452410072,  AlbertoMenc, 2, 1, 1, neutral
396854036,  VivianaBellini, 1, 1, 0, yes
52379526,  MarcosPalermo, 1, 1, 0, yes
1103618124,  riccardocatt, 2, 1, 1, neutral
2895843244,  BrokenwindowsRm, 6, 2, 4, no
730644364641325056,  marilea89, 2, 2, 0, yes
454194542,  Nicolabrunialti, 1, 1, 0, yes
3067558409,  StartupLazio, 1, 1, 0, yes
529265260,  amedeoformaggi, 1, 1, 0, yes
425904817,  RaffaeleNappi1, 3, 2, 1, yes
722419469902036992,  gianpd_aversa, 2, 2, 0, yes
2379204922,  LuciaBuccolo, 2, 2, 0, yes
4905762309,  PrimulaRossaLM, 11, 9, 2, yes
866853126,  infoMalpensa, 2, 1, 1, neutral
2427705645,  mcriss1961, 2, 2, 0, yes
985542859,  LACORTEGRAZIA, 7, 7, 0, yes
2828119165,  claudiapet82, 2, 2, 0, yes
792840100874944514,  F_scodefelice, 8, 7, 1, yes
791992604640604160,  NADIMAX60, 7, 7, 0, yes
785061107803287552,  real_cate2016, 8, 8, 0, yes
2494249260,  FASTConfsalsg, 2, 2, 0, yes
561482122,  VeronicaBuffone, 5, 1, 4, no
1351561135,  KikkaJolie, 20, 3, 17, no
3514615637,  gabrie_6253, 5, 0, 5, no
862592018,  ComEroe, 15, 0, 15, no
724154607254011905,  AntonioViscomi5, 18, 0, 18, no
2531056427,  A_Ciannarella, 2, 1, 1, neutral
4373742383,  iosovranista, 2, 1, 1, neutral
724653229368287232,  ItalianStyle_it, 2, 1, 1, neutral
1222977236,  Rondo_31, 2, 0, 2, no
103703823,  lucatomarelli, 4, 2, 2, neutral
492065435,  CloseToMedia, 2, 1, 1, neutral
738956376903405568,  Emanuela851015, 2, 1, 1, neutral
739476036,  NicoCanis, 11, 7, 4, yes
804638937356632064,  FeliceEvac, 4, 3, 1, yes
784072008640434176,  Claudio200564, 14, 12, 2, yes
3081135833,  accroberto, 15, 14, 1, yes
755882426530922496,  Squitter__, 4, 3, 1, yes
585588201,  antonioballor, 11, 10, 1, yes
1079394806,  Annamaddalenag, 2, 1, 1, neutral
2692384199,  Raffy72rdr, 2, 1, 1, neutral
1372207340,  DottssaRosadeMa, 10, 0, 10, no
3384474441,  EmmaPaoli_Emma, 6, 0, 6, no
44673590,  zagor70, 11, 1, 10, no
2151696938,  1AdrianoPerrone, 1, 0, 1, no
694926126351847429,  zlatickangelo, 3, 0, 3, no
2480274133,  lacasadiale, 2, 1, 1, neutral
415930351,  jkat__, 7, 4, 3, yes
1006967593,  crisblog, 2, 0, 2, no
1014884664,  acquaviva5stell, 8, 0, 8, no
796237284,  AndreaMarchell0, 25, 3, 22, no
2487043426,  AmatoLiber, 3, 0, 3, no
923055876,  stiv1865, 2, 0, 2, no
209511945,  mefishmuskela, 3, 2, 1, yes
453812693,  AntonPor, 2, 0, 2, no
1404635250,  contigiu, 8, 2, 6, no
228030987,  MeloGiunta, 2, 0, 2, no
599651301,  metalnarz, 27, 5, 22, no
3256271740,  AdrianoGanadu, 23, 12, 11, yes
38675611,  lucabernava, 1, 1, 0, yes
215589114,  settemea, 1, 1, 0, yes
188698325,  vss64, 2, 2, 0, yes
391627970,  FedeScarpato, 2, 1, 1, neutral
592647058,  FiorenzaTarenzi, 29, 23, 6, yes
3300559913,  romanogalossi1, 1, 1, 0, yes
57993753,  Ale_Grignani, 1, 1, 0, yes
226125316,  RoccoVergani, 5, 5, 0, yes
44861221,  ErikMolteni, 1, 1, 0, yes
430925661,  LuigiCostanzoIT, 3, 3, 0, yes
551949580,  SxCambiamento, 4, 4, 0, yes
4236655258,  roberta87044333, 1, 1, 0, yes
791293039,  Marilisa_DAmico, 1, 1, 0, yes
97249795,  evitabe, 11, 9, 2, yes
1213239282,  veronicascudie1, 4, 3, 1, yes
1089413082,  enzatassone48, 5, 4, 1, yes
3298343308,  Stefano32589111, 13, 8, 5, yes
2922636723,  toroforever3, 2, 1, 1, neutral
3432608494,  verter88, 2, 2, 0, yes
788276220660178944,  barbarafantini3, 3, 3, 0, yes
792814938137980928,  gajarei81, 1, 1, 0, yes
801974236315340805,  vivienvalery, 8, 4, 4, neutral
435285639,  IlPerbenista, 25, 20, 5, yes
172726520,  liboria_z, 1, 1, 0, yes
85821827,  gattoclochard, 6, 6, 0, yes
2802290616,  SalameEro, 5, 1, 4, no
599456533,  glgortani, 3, 3, 0, yes
87286001,  danytorino, 18, 2, 16, no
412415589,  iMagazineTwit, 1, 1, 0, yes
2451993944,  FDemCalabria, 2, 2, 0, yes
2251943851,  Danireport, 8, 4, 4, neutral
715686073,  FioriniEdgarda, 5, 5, 0, yes
579954898,  Udine3D, 1, 1, 0, yes
946517246,  MimmoBevacqua, 3, 3, 0, yes
3344250513,  GiovArtiFVG, 2, 2, 0, yes
501887658,  GabrieleGuerini, 2, 1, 1, neutral
236138836,  GiamBuonomo, 7, 2, 5, no
750419127655858176,  Peter_Italy, 3, 2, 1, yes
329591308,  fraqqua, 4, 2, 2, neutral
446380041,  MiyakeEau, 3, 2, 1, yes
3214676577,  heekleiner, 1, 1, 0, yes
701716640988270593,  dottor_gay, 11, 6, 5, yes
470382655,  VisionaryElvish, 3, 3, 0, yes
972872618,  contessaelvira, 16, 2, 14, no
268905980,  giannichiodi, 20, 7, 13, no
972337386,  feros3161, 19, 16, 3, yes
2808860913,  LuisaModel, 3, 3, 0, yes
459472257,  PPaolontoni, 3, 2, 1, yes
464067391,  lucamarchesi9, 3, 3, 0, yes
313399883,  giapasc, 3, 3, 0, yes
180509548,  blademoon68, 2, 2, 0, yes
3388648768,  siscaf3, 1, 1, 0, yes
490372141,  micheleaci, 2, 1, 1, neutral
376221364,  g_bellucci, 1, 1, 0, yes
4392037332,  fusonsusan1, 1, 1, 0, yes
396823374,  fo1984, 26, 2, 24, no
2200868950,  riccardobea, 4, 3, 1, yes
814889078,  LucaLelli76, 2, 2, 0, yes
918993840,  Grazp77, 2, 2, 0, yes
3294057883,  MatDonati, 1, 1, 0, yes
69001608,  mipi21, 1, 1, 0, yes
109021197,  MatteoRiz, 1, 1, 0, yes
535419702,  Truman1984, 1, 1, 0, yes
454058244,  Cheesecake_mat, 1, 1, 0, yes
86144313,  n_quadrelli, 6, 6, 0, yes
155609154,  Travapensacitu, 1, 1, 0, yes
569941954,  Lenzini81, 1, 1, 0, yes
2247492535,  andreachiabra, 4, 4, 0, yes
426660418,  LorenzoSpigoni, 1, 1, 0, yes
212995283,  pbenedettamanca, 3, 2, 1, yes
424415059,  _Mmonta, 1, 1, 0, yes
1353901538,  EmilianoPompei, 1, 1, 0, yes
2912679700,  frafraf86, 1, 1, 0, yes
400779990,  Fra_fas, 2, 2, 0, yes
94765165,  zemmu, 3, 1, 2, no
823416241,  LaGrevia, 3, 1, 2, no
529319041,  AndreaGiunchi, 1, 1, 0, yes
532365440,  MarcoBincoletto, 5, 3, 2, yes
227653924,  LRandone, 2, 2, 0, yes
453818050,  stefigiaco, 1, 1, 0, yes
378706057,  Adrian_in_it, 19, 12, 7, yes
86329726,  ari_are, 2, 2, 0, yes
2327465503,  IL_Peto, 1, 1, 0, yes
244058845,  campagnolo86, 5, 4, 1, yes
406622289,  stecca81, 2, 2, 0, yes
783414862634446848,  giandoserrao, 2, 2, 0, yes
2182571886,  mttciocci, 3, 3, 0, yes
31509217,  fabioaffinito, 1, 1, 0, yes
402864796,  cheremone, 10, 9, 1, yes
2370256891,  ilianoguglielmi, 2, 1, 1, neutral
619326952,  leftwing_it, 1, 1, 0, yes
500145535,  DArmellino, 4, 2, 2, neutral
467472024,  Pinjo1964, 8, 0, 8, no
47626792,  cgilnazionale, 2, 0, 2, no
466582888,  CgilBologna, 3, 0, 3, no
110669722,  RadioArticolo1, 3, 0, 3, no
306777099,  SFait79, 6, 5, 1, yes
40452175,  MicheledAlena, 2, 2, 0, yes
756215694455209984,  Euribor_Ghignai, 1, 1, 0, yes
1248366776,  f_bordoni, 1, 1, 0, yes
104270122,  gianpiguido, 10, 0, 10, no
372746457,  DomenicoFoti, 9, 3, 6, no
113323470,  FaustoCostantin, 3, 3, 0, yes
238641512,  GanoCat, 4, 4, 0, yes
773054104549593089,  riventheripper, 32, 7, 25, no
167429386,  matteoreale, 1, 1, 0, yes
37382519,  CanonF1, 10, 7, 3, yes
2575196077,  lgatto4, 11, 11, 0, yes
3290833539,  serpellegrino11, 2, 2, 0, yes
451048345,  VittorioLeoni, 7, 7, 0, yes
3318636784,  Marcell25197349, 4, 4, 0, yes
50794286,  fra_tizy, 1, 0, 1, no
2881244285,  pasangel1, 16, 6, 10, no
1179157244,  PietroLazzara, 21, 3, 18, no
407124229,  CarmelaAriosto, 3, 0, 3, no
4070811365,  Giuseppefar63, 4, 0, 4, no
452151464,  GianniGenziani, 8, 0, 8, no
3379698886,  carlabarani23, 4, 0, 4, no
518934318,  gessler_, 14, 2, 12, no
287334707,  EmaSigis, 18, 5, 13, no
853678268,  JessyMarchetto, 34, 3, 31, no
318446896,  MBellandi, 18, 2, 16, no
252088941,  M5SIMOLA, 2, 0, 2, no
2775753903,  CatramboneML, 2, 2, 0, yes
789130468469899264,  DariaInVersilia, 15, 4, 11, no
404736599,  mideastorels, 2, 2, 0, yes
371633792,  VivianaPremazzi, 5, 5, 0, yes
91138156,  ispionline, 7, 7, 0, yes
2846988880,  TommasoVirgili_, 1, 1, 0, yes
1120012123,  mattomay, 2, 2, 0, yes
260656713,  giu17raffa, 5, 5, 0, yes
1230204373,  UNHCR_Morelli, 2, 2, 0, yes
481152200,  vincelorubbio, 1, 1, 0, yes
4178855201,  ScalaElisabetta, 9, 5, 4, yes
4039568062,  marco4763, 20, 18, 2, yes
789441140932087808,  GabriellaZeta, 5, 4, 1, yes
702417430677753856,  TETRAGONO19731, 5, 4, 1, yes
700630516043649024,  lucia_sulas, 9, 8, 1, yes
3047287645,  SperanzaLucilla, 11, 10, 1, yes
2939751015,  Vultimodinosau, 4, 1, 3, no
185607318,  albyio, 3, 0, 3, no
414373079,  paulolden1, 11, 0, 11, no
4321424481,  antonellagabr, 3, 0, 3, no
760551532815351808,  lorandreoli, 2, 0, 2, no
773980492031004672,  leo1976na, 3, 0, 3, no
295284193,  msantarella, 4, 0, 4, no
518430422,  notavterzovalic, 1, 0, 1, no
1067773668,  ebbyit, 5, 2, 3, no
459317071,  stil64, 13, 0, 13, no
2383742853,  robimichelon, 1, 0, 1, no
835923896,  IMartire, 6, 2, 4, no
3068039679,  pmattoccia, 41, 8, 33, no
956276568,  alemurgia61, 6, 4, 2, yes
490520691,  Rubra5, 17, 12, 5, yes
104842081,  BeATrueHeart_, 1, 1, 0, yes
341045112,  GabRosana, 6, 6, 0, yes
348493456,  JLTouadi, 4, 4, 0, yes
430128171,  ingCinzia, 1, 1, 0, yes
16484564,  giugiunauta, 2, 2, 0, yes
802225040,  MastercardIT, 5, 5, 0, yes
1565935926,  StefPompili, 2, 2, 0, yes
345013921,  giovbarbera, 1, 1, 0, yes
1190127296,  _lucaromano_, 4, 4, 0, yes
1030677596,  massimonava50, 1, 1, 0, yes
2899123283,  Nortek50, 1, 1, 0, yes
562816605,  albtali, 7, 5, 2, yes
474120903,  diSomma_C, 1, 1, 0, yes
22009205,  ceranto, 15, 8, 7, yes
1017005305,  baiasilente, 2, 2, 0, yes
1128330918,  sessadany, 1, 1, 0, yes
19682207,  GianniVernetti, 4, 4, 0, yes
2305043174,  fedelebianconer, 2, 2, 0, yes
455788249,  emanueladepalo, 1, 1, 0, yes
135531774,  GIOVANNICANEPA, 1, 1, 0, yes
388572693,  laramps, 5, 5, 0, yes
783976877669122048,  Akkauntdiprova, 10, 1, 9, no
42395949,  AleSalvi12, 4, 1, 3, no
101556020,  flavioquara, 2, 0, 2, no
158017561,  akakarolina, 12, 5, 7, no
597252435,  CostanzaNOCCHI, 2, 0, 2, no
389642629,  enricomlepri, 5, 0, 5, no
4584262996,  GFranco0, 3, 1, 2, no
223575921,  elakelly, 5, 1, 4, no
2992145253,  OhCumi, 2, 0, 2, no
285077023,  CelesteRotondi, 2, 0, 2, no
417091566,  Geugnagna, 2, 0, 2, no
422480814,  LFerlaino, 2, 0, 2, no
904491504,  faustoigorcampo, 4, 0, 4, no
414127619,  giovannibat46, 2, 0, 2, no
258554422,  LoZioYuri, 6, 0, 6, no
4913717650,  asMareliber, 4, 0, 4, no
493991580,  doloresgalli, 4, 0, 4, no
53030535,  alesolinas, 2, 0, 2, no
405137914,  DaniloGallucci, 1, 1, 0, yes
53082105,  paolovincenzi, 6, 6, 0, yes
282114224,  bolognatoday, 5, 5, 0, yes
3466499235,  coalizione_bo, 4, 4, 0, yes
353898411,  moberta66, 3, 3, 0, yes
2645983188,  PiGreco1095, 2, 2, 0, yes
418798723,  ErmannoTarozzi, 3, 1, 2, no
3383981938,  michelecmassari, 7, 7, 0, yes
1406260999,  PoldoItalia, 2, 2, 0, yes
618449781,  MasPolemico, 1, 1, 0, yes
1309041114,  GPasqualucci, 2, 0, 2, no
4893303449,  MrGioppino, 2, 0, 2, no
442833297,  vit978, 2, 0, 2, no
2371576541,  davidirus79, 5, 0, 5, no
2478979036,  iivannoteii, 2, 0, 2, no
545264740,  innominato77, 6, 0, 6, no
355422495,  Salvatoremanga, 3, 1, 2, no
379112362,  MonicaSpissu, 2, 0, 2, no
3081629057,  caglie17, 3, 0, 3, no
2192358781,  trozzoantonio, 6, 3, 3, neutral
368338436,  dante4710, 9, 1, 8, no
487521897,  GNuti, 4, 0, 4, no
3559735215,  aleritamaria, 14, 0, 14, no
477096884,  pietrolecca, 8, 0, 8, no
779336944916504576,  Segnaliamoli, 32, 0, 32, no
750717566818119680,  lamiamam, 6, 0, 6, no
776823999678517249,  PrimumRerum, 2, 0, 2, no
2323497080,  RIKKIA77, 3, 1, 2, no
706086767523405824,  GaleonisV, 16, 0, 16, no
864509790,  StipendioXTutti, 2, 0, 2, no
373940749,  l22672, 2, 0, 2, no
425659307,  dadecase, 2, 0, 2, no
147551178,  alexitalian1, 2, 0, 2, no
1082553030,  davidenicolosi3, 2, 0, 2, no
613870699,  VaccariMv, 6, 0, 6, no
567185278,  BabboOrso, 2, 0, 2, no
385844069,  antonioinoki10, 2, 0, 2, no
209080471,  StePeduzzi, 4, 1, 3, no
2493829429,  nannarella60, 11, 0, 11, no
2778824457,  Va_Tutto_Bene, 15, 3, 12, no
765293676671168513,  sage2408, 2, 0, 2, no
4241291181,  piermango, 1, 1, 0, yes
494243167,  piero5320, 2, 1, 1, neutral
1026257125,  andreatuzzi78, 1, 1, 0, yes
2228376001,  DiegoGandolfini, 1, 1, 0, yes
758064531113410560,  mrbuddhacheese, 2, 2, 0, yes
2724062121,  geridepa, 1, 1, 0, yes
219005924,  carmelopalma, 9, 9, 0, yes
150196030,  Radicali, 4, 4, 0, yes
4355692264,  shaunabracco, 2, 2, 0, yes
1191356174,  AndreaSanvito, 1, 1, 0, yes
540890797,  Gneccorocca, 2, 1, 1, neutral
1887067255,  Strade_Magazine, 5, 5, 0, yes
2844329429,  EleMentiLiberal, 26, 26, 0, yes
442684129,  AvyCandeli, 1, 1, 0, yes
987465248,  AzzaLuigi, 1, 1, 0, yes
2321084820,  12345saluti, 1, 1, 0, yes
4194885053,  loreno_25, 1, 1, 0, yes
147567047,  Alessio_Ram, 6, 3, 3, neutral
483073228,  robellarda, 3, 2, 1, yes
3005370371,  tdezan21, 1, 1, 0, yes
3092255050,  cannabislegale, 1, 1, 0, yes
2267480622,  RobertoCava93, 2, 1, 1, neutral
1175736948,  crispolignano, 1, 1, 0, yes
2594365060,  openValtellina, 5, 5, 0, yes
3047938723,  quinix24, 1, 1, 0, yes
2881526861,  unar_tk, 1, 1, 0, yes
149529007,  StatEconomist, 3, 3, 0, yes
396491689,  leonardobarassi, 1, 1, 0, yes
2900976775,  CorradoMor, 1, 1, 0, yes
86434741,  Lia_italy, 5, 3, 2, yes
1416161276,  cristiandonatel, 4, 3, 1, yes
256509761,  FedericaF1990, 4, 3, 1, yes
89668286,  MarioAbbruzzese, 6, 0, 6, no
424556261,  BartolomeoPepe, 5, 3, 2, yes
854521818,  alebuccelli, 5, 0, 5, no
415820835,  GualtieroCarini, 8, 0, 8, no
386753792,  valeriodimauro, 4, 0, 4, no
2841747857,  isix82, 3, 0, 3, no
80891401,  tamy79, 4, 0, 4, no
3088659569,  giuliomancini91, 10, 1, 9, no
4875252683,  CROCE_CELTICA, 3, 0, 3, no
438676662,  MeloniGabriele, 2, 0, 2, no
794799817495085056,  PlecoDi, 2, 0, 2, no
3610537156,  XPuglia5Stelle, 19, 0, 19, no
4244790082,  massimofarina72, 6, 5, 1, yes
465428994,  andreagmelillo, 1, 0, 1, no
2417405263,  moniquepot1, 1, 0, 1, no
514243349,  m5sbari, 21, 0, 21, no
1285373419,  gcichetti3, 4, 0, 4, no
761809560,  pani_elilippa, 11, 0, 11, no
4838940477,  Aladin1099, 1, 0, 1, no
3412818976,  Puglia_M5S, 5, 0, 5, no
365932392,  85sanna, 10, 5, 5, neutral
934053559,  AlfredoGiusti3, 10, 1, 9, no
1250267900,  mazzanti_giu, 3, 0, 3, no
3033189805,  BringTheLightKP, 4, 1, 3, no
2509994134,  GuidoSchiavulli, 24, 1, 23, no
399663966,  danybaby0001, 10, 0, 10, no
2164608279,  MirkoRefatti, 43, 7, 36, no
2202015179,  vindimaso, 4, 1, 3, no
1220072246,  GNN1960, 25, 1, 24, no
233704986,  Frenk36, 6, 1, 5, no
2599371200,  pentesilea14, 2, 2, 0, yes
2760592882,  IppolitoMimi, 6, 3, 3, neutral
110647847,  ninoseminara, 1, 1, 0, yes
4895702908,  capretti_renato, 36, 25, 11, yes
1194727632,  DanyVairo, 1, 1, 0, yes
412659310,  AlvaroSeriacopi, 1, 1, 0, yes
501249777,  EliaCanino, 3, 2, 1, yes
364459650,  Parrella79, 1, 1, 0, yes
1039023414,  mmbluekite, 1, 1, 0, yes
2752094872,  spadafora_luca, 3, 1, 2, no
3510859276,  ElSumaro, 8, 6, 2, yes
1905387152,  Kermvinoo, 4, 3, 1, yes
3853195053,  daniele_pelli, 4, 0, 4, no
1898454535,  Giocoleria1, 47, 3, 44, no
1212975134,  burbero1961, 16, 2, 14, no
2200075155,  ClaudioDeglinn2, 13, 8, 5, yes
634832081,  officinainforma, 11, 3, 8, no
386811424,  marcopata19, 4, 2, 2, neutral
3552957021,  Enzo71428603, 3, 0, 3, no
1008813289,  bellafavapasqua, 3, 1, 2, no
1244200904,  giuseppe45G, 10, 0, 10, no
393352465,  franco_martino, 4, 0, 4, no
702443682126041089,  b_lore97, 8, 2, 6, no
2608508709,  carloggranara, 7, 2, 5, no
2919268179,  Angelo03557182, 3, 0, 3, no
3357276724,  ngr_angela, 3, 1, 2, no
2335353948,  saffina4, 8, 1, 7, no
614852872,  Sassi1965, 2, 0, 2, no
3047851452,  crisfilippelli, 15, 0, 15, no
3949425333,  johncotton1585, 4, 1, 3, no
182737832,  amorlupi, 5, 0, 5, no
2195935780,  tpw039, 2, 0, 2, no
2292963709,  tommaso_valleri, 5, 2, 3, no
773891042198351872,  Stefano_Striano, 2, 0, 2, no
1374984048,  forzapd, 11, 3, 8, no
742361647818395648,  Angelo77306451, 2, 0, 2, no
1076337458,  deluca_linda, 2, 0, 2, no
744856218771009536,  LuciaLeone14, 5, 1, 4, no
793461328081985536,  SalviniIltosco, 3, 0, 3, no
467568195,  Mr_siro87, 4, 0, 4, no
4186808596,  borntobecyclist, 2, 0, 2, no
799217632264200192,  DannyBull91, 2, 0, 2, no
385028903,  GianlucaFidene, 2, 0, 2, no
2964565162,  pinabiondi58, 3, 0, 3, no
413330025,  brazo66, 3, 1, 2, no
216720717,  saramo2, 2, 0, 2, no
2181642961,  zenit5458, 3, 0, 3, no
2561760034,  CinziaManunza, 7, 4, 3, yes
2364617093,  roselli80, 4, 1, 3, no
788366990956236800,  MorenoCarpaneto, 2, 0, 2, no
802149923873521664,  _LadyWinterfell, 6, 0, 6, no
3027177286,  cosv99, 3, 0, 3, no
803169294389510144,  Lupetto52807502, 8, 0, 8, no
39058202,  barbaramodesti, 2, 0, 2, no
1368025074,  emiliano978, 8, 0, 8, no
4208501391,  CC28101969, 8, 5, 3, yes
475965087,  mfrascatano, 21, 4, 17, no
2570849169,  ro_datt, 3, 0, 3, no
609894475,  ChiaIod, 3, 0, 3, no
410942100,  maxmor2, 2, 0, 2, no
55250984,  miky512, 4, 1, 3, no
58201131,  kopulos, 9, 1, 8, no
1336547604,  Jay_Kappa, 2, 0, 2, no
4611169457,  Dasansei, 4, 1, 3, no
2572257123,  vittiveronese68, 2, 0, 2, no
1547443927,  Davide_Thor, 3, 0, 3, no
415811043,  giusydetta, 4, 2, 2, neutral
409518536,  FrancescaCose, 10, 0, 10, no
1311177253,  filrug, 2, 0, 2, no
2889612136,  _d_a_n_i_e_l_e_, 49, 4, 45, no
805461075458146304,  68tifosonapoli, 5, 0, 5, no
222442719,  ggamberonci, 12, 3, 9, no
796005053534498818,  Carusoluigi5, 5, 0, 5, no
339874904,  Ilenya68, 4, 1, 3, no
279542176,  Instinctkube, 2, 0, 2, no
3068049551,  TEsposito95, 8, 0, 8, no
370169443,  BergamoEmanuele, 4, 0, 4, no
327003115,  AntonioMandolfo, 3, 1, 2, no
737298834385166340,  Renato01384155, 2, 0, 2, no
238909327,  francescoparava, 2, 0, 2, no
474303874,  rihannasbboobs, 14, 3, 11, no
95385414,  policoalf, 4, 1, 3, no
1284039450,  energymanu, 2, 0, 2, no
3128584955,  adolisa, 2, 0, 2, no
1525243567,  anna_blrd, 4, 1, 3, no
963073442,  c_appendino, 11, 2, 9, no
1539421987,  estrojos, 55, 10, 45, no
1092172458,  baraldop, 4, 0, 4, no
538462625,  elio_sileno, 18, 18, 0, yes
263702718,  catera_roma, 4, 4, 0, yes
1376904187,  e_dujany, 2, 2, 0, yes
613258756,  pfp2016, 4, 3, 1, yes
753989676030128128,  FrancoA71227072, 4, 3, 1, yes
465631373,  lidialoffredo, 48, 3, 45, no
345460028,  BaldiniEnrica, 4, 4, 0, yes
22083,  catepol, 7, 7, 0, yes
499260273,  GiovanniRienzo, 7, 7, 0, yes
2610342792,  Gioblogger86, 4, 2, 2, neutral
799568243186921472,  Nichiviki, 4, 4, 0, yes
518403199,  luna30128391, 5, 4, 1, yes
697879690309214208,  prof_artis, 31, 31, 0, yes
2363914417,  PDCalabria, 23, 23, 0, yes
2160639991,  PDCastellammare, 3, 3, 0, yes
2501199751,  UmbogyVella, 5, 2, 3, no
3007835170,  GhinottoFab, 5, 0, 5, no
948730916,  mteresaGHorta, 2, 0, 2, no
1007270076,  LorenzoPalesti1, 6, 0, 6, no
3527260401,  rinosiconolfi1, 225, 0, 225, no
791724313552547849,  Dravil97, 2, 0, 2, no
118740741,  angelobellusci, 2, 0, 2, no
767423908404457472,  MicheleBrunell6, 2, 0, 2, no
438518215,  monicarizzini1, 2, 0, 2, no
706606079774486532,  drifer8, 2, 0, 2, no
3419697862,  emrico_balella, 2, 0, 2, no
2173760019,  gabryfabiano, 4, 1, 3, no
630459182,  67Malaguti, 15, 2, 13, no
309533058,  zizigong, 5, 0, 5, no
452960309,  farina_domenico, 2, 0, 2, no
245378986,  cupidovj, 28, 0, 28, no
281097296,  GalleriaDAMarte, 3, 0, 3, no
242776975,  tore75, 2, 0, 2, no
793048979948929024,  SilviaVivarell1, 2, 0, 2, no
543690939,  MarcoAretino, 3, 0, 3, no
757257628263276544,  vittorinho60, 4, 0, 4, no
2735509463,  ri_cara, 2, 0, 2, no
1855609550,  mila1035, 2, 0, 2, no
541752926,  PaoloGiangrasso, 2, 0, 2, no
96327375,  Tizianamanca, 2, 0, 2, no
45522065,  italiandream48, 5, 2, 3, no
703348631261282304,  caiazzostefy, 2, 0, 2, no
428032196,  igiulz, 2, 0, 2, no
783407476330889216,  isdri96, 2, 0, 2, no
787255535947091968,  SirianaFinotti, 2, 0, 2, no
567633436,  ileggend, 2, 0, 2, no
513598801,  sylilla, 2, 0, 2, no
767616854,  adelmocastagnet, 7, 0, 7, no
150046203,  titotore, 6, 4, 2, yes
794498319808663556,  franksinopol, 2, 0, 2, no
2331733877,  Michel79086762, 5, 0, 5, no
568393612,  claudiababu, 3, 1, 2, no
1044954534,  checcofiori, 2, 0, 2, no
773029583583076352,  EPiccolo48, 6, 0, 6, no
409332025,  SavonaAccursio, 12, 1, 11, no
1013093844,  alemaste73, 2, 0, 2, no
143235905,  frafec, 2, 0, 2, no
952558944,  elche67, 10, 0, 10, no
764448838434390016,  simone_attilia, 2, 0, 2, no
2304228233,  LisaLacanfora, 2, 0, 2, no
50598789,  mariomosca, 2, 0, 2, no
482042101,  emura1976, 3, 1, 2, no
405854311,  annaangelini1, 2, 0, 2, no
2942440745,  to_elia, 4, 0, 4, no
3179223957,  Mic_a_e_la, 24, 0, 24, no
2890463488,  Mrck86, 2, 0, 2, no
4083826618,  Ora1234567, 2, 0, 2, no
19110013,  bulini, 3, 0, 3, no
603441494,  GuerriereAmedeo, 2, 0, 2, no
599608633,  RiccardoCioni2, 2, 0, 2, no
1702730929,  980Luca, 3, 1, 2, no
1479417662,  SPEVENTIMANAGEM, 2, 0, 2, no
3902631803,  erpvet58, 2, 0, 2, no
552242754,  sirottatwitt, 2, 0, 2, no
3652269263,  NinoCarlao, 31, 10, 21, no
1622970242,  adrimarcotulli, 45, 2, 43, no
831854412,  Orsobianco68, 8, 0, 8, no
558534010,  monicapipitone, 11, 0, 11, no
799774009072226308,  MaxPODz, 2, 0, 2, no
2375711402,  Walter5Stars, 5, 0, 5, no
574765497,  VanessaCarrozza, 10, 0, 10, no
515561206,  twicolombotter, 3, 1, 2, no
789058472860082176,  mikjred, 3, 0, 3, no
1194815508,  Livio_Sicily, 6, 1, 5, no
499080594,  scerbanton, 2, 0, 2, no
4892570230,  ft093962, 3, 1, 2, no
2824712309,  kpuoma, 12, 0, 12, no
4877257138,  laeli67, 3, 0, 3, no
802795895767134208,  Michel34945515, 4, 0, 4, no
3094380329,  mimmo_2015, 2, 0, 2, no
4046146715,  fabionicolet, 2, 0, 2, no
1555265359,  liarossi15, 2, 0, 2, no
4416614361,  AliquidLucis, 4, 0, 4, no
2367591444,  nannipalex, 4, 0, 4, no
459180701,  Matthew_T_Kent, 2, 0, 2, no
1699274312,  GMiglioranzi, 2, 0, 2, no
700244333,  GiacomoNesci, 2, 0, 2, no
3299950450,  riply_biz, 4, 0, 4, no
194515238,  susarda, 2, 0, 2, no
1008939038,  alecerio, 2, 0, 2, no
586804044,  TizianoTorielli, 15, 2, 13, no
2312465170,  LucaLucas0777, 2, 0, 2, no
2306567981,  SserCarlo81, 2, 0, 2, no
194196738,  GrazyBell, 7, 0, 7, no
742180351821418496,  AlexFiori121, 2, 0, 2, no
459464288,  sabrylomb, 3, 0, 3, no
1257745957,  billobillo2, 5, 1, 4, no
975582895,  patbenvenuti, 2, 0, 2, no
4251078683,  IL_DUCA_MOCCI, 4, 1, 3, no
3131346994,  DiegoAn0n, 4, 0, 4, no
1869414950,  milljfiori, 18, 0, 18, no
261542509,  vittoriobarile, 22, 0, 22, no
3384471478,  Victor24852, 3, 0, 3, no
2933177745,  YariDolo, 2, 0, 2, no
2739348212,  costajoe40, 3, 0, 3, no
355545085,  andreazannoni2, 8, 0, 8, no
3027987772,  bdecbec75d784b2, 9, 0, 9, no
804674615528292352,  NicFranc3, 3, 0, 3, no
1324659536,  AleMonster97, 2, 0, 2, no
2694520743,  matkava96, 3, 0, 3, no
712275596001288192,  LorenzFKT, 2, 0, 2, no
943120548,  RosannaMagnani1, 7, 0, 7, no
3261477083,  ciullgius, 4, 0, 4, no
96666156,  millarockstar, 7, 1, 6, no
849387156,  luca190771, 15, 1, 14, no
1157854118,  nocitovirginia, 3, 1, 2, no
634737656,  renoZed, 3, 0, 3, no
1036938613,  SofiaMa07413947, 28, 1, 27, no
2832119268,  vlista65, 2, 0, 2, no
292164334,  MarinaTerribile, 2, 0, 2, no
507724462,  Shabbar84, 5, 2, 3, no
269212676,  ninoaccardo, 2, 0, 2, no
617532607,  Paolowab, 2, 0, 2, no
719102022591639552,  emmygrams2, 2, 0, 2, no
88051558,  gigifuiano, 4, 0, 4, no
499152966,  RolandoCerullo, 2, 0, 2, no
1246988113,  ernesto_quaglia, 2, 0, 2, no
348374702,  ilcastelli, 2, 0, 2, no
3105772210,  StefaniaGandos1, 2, 0, 2, no
197424739,  NickCrive, 10, 0, 10, no
814747711,  Pietro3591, 65, 25, 40, no
560598348,  annaannetta82, 4, 2, 2, neutral
723845674043858944,  CristinaNegrin3, 2, 0, 2, no
1099195932,  montitemagna, 2, 0, 2, no
1036168604,  MastronardiGino, 2, 0, 2, no
2362418930,  andreafari_, 20, 0, 20, no
1303512036,  MarioUrsumando, 3, 0, 3, no
727844588459835393,  giorgiomari16, 3, 1, 2, no
1208685920,  OGGIMAESTRALE, 4, 0, 4, no
479832408,  SantinaMastrone, 13, 8, 5, yes
536451917,  adryfog, 6, 1, 5, no
3102687059,  aragorn2966, 2, 0, 2, no
792614406135873537,  Loredan60699004, 11, 0, 11, no
702152442239180800,  deme_19, 2, 0, 2, no
748253339469643777,  Carla89092568, 4, 1, 3, no
597518498,  Irenerusso60, 2, 0, 2, no
733722041585655808,  ealges56, 7, 0, 7, no
2261638041,  MessuaShandar, 9, 0, 9, no
795950031916376065,  arzachena5star, 6, 0, 6, no
3065317450,  aldillasyarli, 2, 0, 2, no
2744571067,  MCavallerin, 2, 0, 2, no
1001956213,  piebor, 5, 2, 3, no
101280803,  stascrivendo, 2, 0, 2, no
510360682,  konzenDj, 15, 0, 15, no
615152166,  gisondo, 5, 1, 4, no
776144101850943488,  mangiaracina77, 3, 1, 2, no
772179889877295104,  Mikeledanzilli, 3, 0, 3, no
415784288,  FrancyU2, 2, 0, 2, no
2731843617,  milesi_mirko, 2, 0, 2, no
47493493,  yuzaman, 2, 0, 2, no
1215629552,  94Catalano, 2, 0, 2, no
803130723246940160,  morenashanti, 2, 0, 2, no
1531397095,  luciadelloiacov, 15, 2, 13, no
4115046268,  barbarademarco9, 2, 0, 2, no
1057961011,  LucBorzelli, 2, 0, 2, no
4252762821,  PrimoPrimero, 5, 0, 5, no
1017498192,  paolodannunzio2, 2, 0, 2, no
437747012,  gabrieppe, 3, 0, 3, no
501153654,  SergioBraga55, 3, 0, 3, no
124162915,  IJCSLYMJ77, 5, 0, 5, no
1933284714,  Freegolor, 19, 4, 15, no
1858478731,  sacchaw0, 2, 0, 2, no
222914046,  HanzoHattori23, 2, 0, 2, no
3342653327,  AndreaGemignanj, 13, 0, 13, no
520291889,  macisimi, 20, 1, 19, no
1074741745,  fabal_, 2, 0, 2, no
804991669972176896,  Nello13011952, 6, 0, 6, no
2192692641,  cima_luisa, 6, 0, 6, no
2317495928,  CLagoM5S, 21, 0, 21, no
2874154983,  FrancescoLau83, 6, 0, 6, no
357464260,  Paolo__Ferrara, 23, 0, 23, no
939620869,  ManuelaLarena, 13, 6, 7, no
783315138497642496,  sannio46, 3, 0, 3, no
435003460,  FedericoErminia, 2, 0, 2, no
2169813478,  bazzani64, 3, 0, 3, no
453959464,  marcovic79, 24, 1, 23, no
3300230453,  Ninalabarbera, 19, 6, 13, no
2530314205,  M5S_Europa, 22, 1, 21, no
2327584543,  manolouser, 7, 0, 7, no
407817358,  sparowM, 8, 0, 8, no
761997788662169605,  ILpiddinoRocco, 15, 3, 12, no
1650664062,  ritaenello, 2, 0, 2, no
219712189,  zeldarenata, 4, 0, 4, no
1186844724,  mariogiuseppem1, 2, 0, 2, no
706826094,  FaustoBartolini, 2, 0, 2, no
2846746942,  bertoldino00, 7, 0, 7, no
356143808,  Ederesque, 9, 5, 4, yes
2148602272,  Sonia96952657, 4, 2, 2, neutral
2354230935,  nicola39901992_, 2, 0, 2, no
784829018457636864,  Trpvnt95Vito, 2, 0, 2, no
940945716,  SandroPaderi, 2, 0, 2, no
786135013729402880,  pep_zap, 21, 5, 16, no
457819169,  teoz1993, 2, 0, 2, no
248669477,  Lucagibbe, 2, 0, 2, no
793522021263179776,  Filippo87081261, 3, 0, 3, no
58990105,  TeresaDonato, 3, 0, 3, no
1281404929,  ubongarzoni, 2, 0, 2, no
413060957,  GianpietroG, 9, 1, 8, no
793749599899058176,  sarah_14285, 2, 0, 2, no
980577650,  netdany75, 3, 0, 3, no
574433501,  ElkoGaetano, 3, 0, 3, no
398290240,  otisblue58, 10, 4, 6, no
1058019872,  morenograssi, 4, 0, 4, no
3987990022,  Michele97067287, 2, 0, 2, no
804694899136270337,  guido_chiovato, 2, 0, 2, no
2745818051,  adrianaobreja1, 2, 0, 2, no
454009387,  Smellymelly84, 13, 2, 11, no
542146146,  nino_aiello, 11, 1, 10, no
381076830,  serafinosalerno, 2, 0, 2, no
796393148066988032,  cla_delgobbo, 2, 0, 2, no
1044233354,  MarcoVantin, 3, 0, 3, no
1947918198,  ASignoroni, 2, 0, 2, no
2358597147,  LeandroPetrotta, 2, 0, 2, no
781793383052374017,  MauroPelliccia8, 8, 1, 7, no
212500329,  noveturbo, 2, 0, 2, no
870137624,  Monia__95, 2, 0, 2, no
319634872,  lorenzolippolis, 4, 0, 4, no
3175658951,  misteryo60, 3, 0, 3, no
86455803,  Solarthought, 4, 0, 4, no
305854390,  GianlucaRonca, 2, 0, 2, no
2153292263,  CameddaJacopo, 2, 0, 2, no
2478145269,  CaroSandracaro, 2, 0, 2, no
15408344,  tatomix, 12, 0, 12, no
735414206,  orni_vedo, 2, 0, 2, no
758752401474121729,  giakkagiakka, 2, 0, 2, no
3397648523,  Niccol79827807, 32, 0, 32, no
4861365023,  luca_fezzi, 6, 0, 6, no
410894122,  paolomelzi, 6, 1, 5, no
235877809,  mauriziopica, 1, 0, 1, no
3347471813,  _Marco_81, 1, 0, 1, no
137278976,  antonio_vinci, 1, 0, 1, no
4901364209,  The_collector22, 5, 0, 5, no
141925961,  giusmicc, 5, 3, 2, yes
228189307,  ZipBlu, 3, 1, 2, no
2153319320,  antoss00, 2, 0, 2, no
523200808,  AntoninoMartin1, 6, 0, 6, no
83865444,  gnaojones, 8, 0, 8, no
3006219351,  67Gentile, 1, 0, 1, no
416272206,  duiliogennari, 1, 0, 1, no
601855480,  cata_gianni, 4, 0, 4, no
401358649,  FrancodeMasi1, 13, 7, 6, yes
22120232,  Bombonati, 3, 2, 1, yes
801181588365209601,  C_Crocco04, 8, 6, 2, yes
33897141,  mirkocavion, 5, 1, 4, no
2313567032,  bondinisergio, 2, 0, 2, no
184936094,  rkmontanari, 3, 1, 2, no
4256624122,  teomine68, 1, 0, 1, no
128859858,  Hatch2676, 6, 1, 5, no
803943194,  petrogalli67, 1, 0, 1, no
267313733,  PFB969, 2, 0, 2, no
96370832,  lucagrazzini, 1, 0, 1, no
917041897,  MassimoBertoni3, 8, 1, 7, no
1565122411,  robertamercorio, 1, 0, 1, no
406884836,  spadanuda, 1, 0, 1, no
2930397267,  a13b44a597fb434, 1, 0, 1, no
906745448,  antossina5, 1, 0, 1, no
1264022826,  MarioComet, 2, 1, 1, neutral
3036233567,  ZadarOfficial, 5, 0, 5, no
886485402,  claudiaimpressi, 1, 0, 1, no
468467131,  pennettablu, 1, 0, 1, no
525836240,  AlessandroDevi, 1, 0, 1, no
888385988,  nardinicarlotta, 3, 0, 3, no
472989062,  GiovanniPezzano, 10, 6, 4, yes
888353958,  lucacarli0, 2, 0, 2, no
2413125525,  socialmatte, 2, 0, 2, no
375285024,  Jorida1977, 1, 0, 1, no
599147815,  f_bertelli, 4, 2, 2, neutral
374447222,  reterurale, 4, 1, 3, no
3438806667,  walsabatini, 1, 0, 1, no
411005470,  g_esentato, 1, 0, 1, no
4157934987,  db56Pa, 1, 0, 1, no
2721197602,  teocentonze100, 2, 0, 2, no
323446144,  Francesco_Vozza, 2, 0, 2, no
594802106,  rosaida63, 8, 6, 2, yes
790846446908112896,  PDescrementi, 3, 2, 1, yes
801071186461474817,  GiannyVinyle, 3, 3, 0, yes
3064631746,  AnSantorum, 5, 2, 3, no
2776380137,  LiaLisi2, 13, 13, 0, yes
1008728029,  gdmpadula, 9, 9, 0, yes
919871334,  xavierhue007, 5, 2, 3, no
896179669,  alfonso_alaimo, 4, 3, 1, yes
706809412221009920,  danyennyo, 2, 2, 0, yes
3018112323,  393dea75f66f48d, 2, 2, 0, yes
165025387,  tennisboy77, 1, 1, 0, yes
2872414576,  AvvLucaDeRosa, 6, 4, 2, yes
3004768510,  578valeria, 3, 3, 0, yes
392008215,  MormilePietro, 4, 3, 1, yes
2364393968,  ilmerlaccio, 3, 3, 0, yes
581787698,  AndreaZirilli, 2, 2, 0, yes
2392084666,  luchi50135, 14, 6, 8, no
4871860863,  apprescindere8, 3, 2, 1, yes
4003846217,  anthonyilbiond1, 2, 2, 0, yes
239143892,  nenciafi, 13, 3, 10, no
1868295402,  fdegasperi, 6, 0, 6, no
1230551046,  pasquino2000, 22, 17, 5, yes
494475884,  GotorMiguel, 13, 3, 10, no
187452064,  rodolfobellini0, 13, 4, 9, no
406907103,  LBesi, 2, 0, 2, no
1068896102,  marletta2003, 8, 3, 5, no
22605126,  fabiofr, 13, 7, 6, yes
3247838446,  giovaUg, 5, 1, 4, no
2306444410,  freecookies_, 9, 1, 8, no
2685569658,  nino_bonaiuto, 8, 5, 3, yes
411046193,  whasshappenss, 3, 0, 3, no
1613475049,  ycnarF1988, 10, 1, 9, no
520560735,  seremart, 9, 3, 6, no
1681073648,  gianpaolag18, 15, 2, 13, no
2217996483,  esonotre, 18, 14, 4, yes
753218253598625792,  Giancar37600182, 5, 0, 5, no
2938546498,  mario__lavezzi, 3, 0, 3, no
730929960773386240,  MunvicMovimento, 1, 1, 0, yes
770594211758534656,  marcogherardi64, 1, 1, 0, yes
707698306303062016,  CerminaraG, 3, 3, 0, yes
462764304,  StefanoMenenti, 11, 2, 9, no
786494468190941184,  alberto_frag, 1, 1, 0, yes
2567300479,  franco56it, 1, 1, 0, yes
462938464,  marinluca1, 8, 5, 3, yes
143393223,  ignaziocorrao, 6, 2, 4, no
1167196104,  FILIPPOSTANGARO, 1, 1, 0, yes
249620286,  Earthfriend88, 1, 0, 1, no
2372863064,  Alba35582229, 5, 0, 5, no
282240212,  GennaAndrea, 2, 0, 2, no
319782293,  NicolettaOmezzo, 20, 0, 20, no
1063345483,  Agenzia_Funebre, 3, 1, 2, no
2527443220,  tottoi70, 1, 0, 1, no
3035292231,  stefanocoli47, 3, 0, 3, no
637057911,  nitrochris72, 12, 6, 6, neutral
2369091619,  Antoniocricm, 1, 0, 1, no
2314008111,  stefanorossi825, 5, 2, 3, no
407194493,  damorantonio, 43, 6, 37, no
847495968,  andreatornago, 1, 0, 1, no
139464051,  GrandePas, 1, 0, 1, no
3304582408,  michelepace324, 1, 0, 1, no
1384478448,  ElisabettaDAle1, 12, 0, 12, no
1734072200,  MaraTurini, 3, 0, 3, no
730429888977641472,  EnricoBiccarin3, 1, 0, 1, no
1580269218,  LeuciLuigi, 2, 0, 2, no
312615662,  garat_o_meter, 2, 0, 2, no
1455581167,  lberto67, 3, 0, 3, no
460355867,  marco67mm, 1, 0, 1, no
707318418677092353,  VincentMA, 2, 0, 2, no
2394796134,  FIMezzocammino, 2, 0, 2, no
1062998066,  RossiEmilioS, 1, 0, 1, no
2286663444,  seboleanza, 1, 0, 1, no
139086039,  Vane_ace, 2, 0, 2, no
1026122636,  NicoloGiraldi, 1, 0, 1, no
1224152383,  fantaliz, 8, 3, 5, no
2447717504,  masdepasca2, 10, 0, 10, no
474239930,  LMantovani28, 2, 1, 1, neutral
551339829,  EliGaravaglia, 1, 0, 1, no
2763305468,  alessand_mella, 5, 0, 5, no
565750845,  Antony_Mammino, 3, 0, 3, no
2896170585,  enricoperte, 1, 0, 1, no
703327398859816960,  RisoStolto, 2, 0, 2, no
1966564285,  ravischumber, 4, 0, 4, no
1040471648,  annalisabaroni, 2, 0, 2, no
595613960,  FrancoSalis, 4, 1, 3, no
131238747,  stefanopolastri, 13, 0, 13, no
715421276563701760,  123schiodati, 1, 0, 1, no
1343953026,  Valemont20, 2, 0, 2, no
45803546,  GiorgioDelfino, 1, 0, 1, no
1526069822,  voce_riccardo, 1, 0, 1, no
54168213,  angelofrighetto, 1, 0, 1, no
764034561814716417,  karlokarli9, 3, 0, 3, no
1655636611,  LaGabbiaTw, 15, 5, 10, no
157950019,  luigi_ci, 7, 3, 4, no
269799316,  monicandsugar, 1, 0, 1, no
802320974,  pisani_anna, 14, 5, 9, no
1179455066,  ppppyellow, 4, 0, 4, no
709467172,  ulfton, 4, 0, 4, no
232503766,  DanieleBassini, 1, 0, 1, no
1062966253,  lveronese65, 7, 1, 6, no
1453854996,  salfium, 1, 0, 1, no
606602735,  mara_venezia, 2, 0, 2, no
370206198,  andrearamos1971, 6, 0, 6, no
777852967504506880,  danipoppo, 1, 0, 1, no
567086543,  LiveandletLie, 8, 0, 8, no
795393269559656449,  Shady_Sequy, 1, 0, 1, no
1385284172,  mat77farina, 1, 0, 1, no
174643719,  Ariel2575, 2, 1, 1, neutral
514794207,  mgiuscaffagnini, 4, 1, 3, no
1369902319,  astronomhy, 2, 0, 2, no
789181592564404224,  MinaMurray75, 7, 0, 7, no
864186162,  LuigiPiccirilo, 13, 1, 12, no
318882223,  LucianoBec, 18, 0, 18, no
1638278257,  dellorco85, 35, 0, 35, no
529656077,  xilax65, 1, 0, 1, no
491353254,  DonZauker1, 6, 1, 5, no
354808947,  LidiaBeduschi, 4, 2, 2, neutral
791043991714299904,  Isabell93255846, 1, 0, 1, no
2754731478,  MpPatrizia, 19, 1, 18, no
1885749720,  DinoPadovano, 4, 0, 4, no
496982040,  AngeloBozzoni, 3, 0, 3, no
799175088423706624,  Mad_Sound83, 5, 0, 5, no
22203964,  giannisibilla, 2, 2, 0, yes
12944132,  loffio, 3, 3, 0, yes
19759212,  tanagi, 1, 1, 0, yes
286328359,  marteblog, 2, 1, 1, neutral
4784052443,  aportatadiansia, 2, 2, 0, yes
767743626105479168,  GhostLoved, 1, 1, 0, yes
21454307,  Netflixhelps, 2, 2, 0, yes
55333479,  dueditanelcuore, 2, 2, 0, yes
69568272,  ele_cel, 1, 1, 0, yes
13227312,  Brendon983, 1, 1, 0, yes
8672382,  edweena, 2, 2, 0, yes
781557313492705281,  camihawke, 1, 1, 0, yes
1004205446,  Marjyz, 1, 1, 0, yes
274635641,  RipperReview, 1, 1, 0, yes
802293054296256512,  aleksufniarz, 1, 1, 0, yes
43888619,  vanooger, 1, 1, 0, yes
42663404,  muumma, 3, 2, 1, yes
16402819,  andreadelogu, 1, 1, 0, yes
140551640,  Antonsesfemmina, 1, 1, 0, yes
1055808912,  SerenaBatti89, 1, 1, 0, yes
247864904,  asce83, 5, 3, 2, yes
291779474,  ange_leena, 3, 3, 0, yes
263596296,  CateFerrara, 1, 1, 0, yes
11444162,  Jadran, 3, 3, 0, yes
124236216,  silviettalomo, 1, 1, 0, yes
187874363,  habit_, 2, 2, 0, yes
4613866276,  beatriceschv, 2, 2, 0, yes
65014859,  dario_head, 1, 1, 0, yes
1117268040,  La_Salvi_, 1, 1, 0, yes
1003731954,  silbisilbi, 2, 2, 0, yes
32363073,  raffaellamoroso, 2, 2, 0, yes
6820052,  Dania, 3, 3, 0, yes
7451612,  emilime, 1, 1, 0, yes
8407812,  ilnorge, 1, 1, 0, yes
784146474,  martinoexpress, 2, 2, 0, yes
16127199,  elena_giffoni, 1, 1, 0, yes
8109872,  _Adele_, 1, 1, 0, yes
712157642,  alex_liccardo, 1, 1, 0, yes
48706030,  Pottina, 1, 1, 0, yes
68983766,  ErgoSylar, 1, 1, 0, yes
229092881,  lagonzi, 1, 1, 0, yes
134900781,  bmilena, 1, 1, 0, yes
9680302,  manuelblu, 1, 1, 0, yes
399008641,  RosariaDeCaro, 1, 1, 0, yes
15820857,  krom999, 1, 1, 0, yes
197812078,  franclavolpe, 1, 1, 0, yes
5986092,  doninside, 4, 4, 0, yes
227666368,  conoscounposto, 1, 1, 0, yes
432684974,  PaolaGuttadauro, 1, 1, 0, yes
245297146,  Coccimari, 1, 1, 0, yes
284660047,  aledionigi75, 1, 1, 0, yes
104300736,  ___thisKID, 1, 1, 0, yes
15467126,  blaptos, 1, 1, 0, yes
1157650220,  AntonellaMossa1, 1, 1, 0, yes
11330432,  stellavale, 1, 1, 0, yes
421992276,  brusinho5, 2, 2, 0, yes
26995584,  marchioman, 1, 1, 0, yes
504980671,  lazy_ahi, 3, 2, 1, yes
43542804,  vespertime, 1, 1, 0, yes
295145758,  robba_m, 1, 1, 0, yes
711918096169172992,  T1LDIEL, 1, 1, 0, yes
259255330,  Moirarchia, 1, 1, 0, yes
405476051,  amoresquallore, 1, 1, 0, yes
50591106,  lucafaenzi, 1, 1, 0, yes
155611478,  giuliopasserini, 1, 1, 0, yes
303647994,  lamartamilanese, 1, 1, 0, yes
216003080,  eli78todo, 1, 1, 0, yes
332220681,  la_cinzietta, 1, 1, 0, yes
20694485,  CitizenOCydonia, 4, 3, 1, yes
423582298,  francesco_frenk, 2, 2, 0, yes
1028630946,  ricgazza, 1, 1, 0, yes
221075783,  iscarlets, 1, 1, 0, yes
2884655078,  Gin_Miriam, 1, 1, 0, yes
361211235,  ValentinaKermit, 3, 3, 0, yes
99579155,  GianniGrandi, 3, 3, 0, yes
286905390,  EmiIians, 3, 2, 1, yes
75892050,  FRAnkgile, 4, 3, 1, yes
7830782,  RobGrassilli, 4, 4, 0, yes
171057477,  Lauravienna, 1, 1, 0, yes
573831937,  itraMaL, 1, 1, 0, yes
803192010,  claudia__fiume, 1, 1, 0, yes
2426215915,  piccolaRae_, 1, 1, 0, yes
356421356,  azzumel, 2, 2, 0, yes
350404007,  riparliamone, 2, 2, 0, yes
129482901,  vmaggio, 5, 2, 3, no
425685576,  manuelaminzi, 2, 2, 0, yes
2262416157,  GranchiTatiana, 17, 14, 3, yes
278029012,  Gresberten, 1, 1, 0, yes
786467616894451712,  aboutcarolb, 1, 1, 0, yes
436152269,  MartaLaFranca1, 1, 1, 0, yes
3618560777,  stayfreestayart, 2, 2, 0, yes
787992135236775937,  IesuAnna, 4, 3, 1, yes
716217206753902592,  Daniele6566, 10, 10, 0, yes
4888820951,  LMinconeti, 4, 4, 0, yes
51878989,  simoreve, 2, 2, 0, yes
724912138658152449,  OlgaMarrazzo, 1, 1, 0, yes
434839840,  lauracesaretti1, 28, 8, 20, no
42295123,  matteomichelini, 1, 1, 0, yes
2873683379,  MarcoMari17, 5, 5, 0, yes
2813029598,  rcelestino2, 10, 10, 0, yes
200879760,  Lorollo, 6, 4, 2, yes
30516985,  pozlu0, 1, 1, 0, yes
2367661536,  steffan3065, 12, 2, 10, no
800811829173751809,  mardepieri, 1, 1, 0, yes
470412998,  andrea_scipio, 2, 1, 1, neutral
451430534,  MarcoPignatti, 1, 1, 0, yes
429001617,  gabrielefermi, 3, 3, 0, yes
1675513404,  GinoPietro, 3, 3, 0, yes
3003930130,  fabribus2, 3, 3, 0, yes
1551619392,  francescorodati, 7, 7, 0, yes
2481166569,  MarioP_CT62, 2, 2, 0, yes
1183254864,  PietroPecchioni, 3, 3, 0, yes
597686082,  giucalvelli, 2, 2, 0, yes
748873325515042816,  ThinkLiveLove1, 1, 1, 0, yes
43993712,  federicoriboldi, 1, 1, 0, yes
1109221303,  GiuseppePanzar1, 1, 1, 0, yes
1566395436,  vzns_, 12, 12, 0, yes
3949073254,  Ambra03461759, 11, 3, 8, no
312772509,  fpasto, 7, 4, 3, yes
785150345135677445,  Simontemplar67, 1, 1, 0, yes
379280129,  Fabioleman, 7, 7, 0, yes
469717295,  paolinojper, 13, 6, 7, no
1178340480,  andrejpapowsky, 6, 5, 1, yes
332894847,  CarloStagnaro, 7, 5, 2, yes
1639608654,  LorenRossignoli, 3, 2, 1, yes
431438801,  dmarguccio, 11, 6, 5, yes
18406278,  flavagno, 2, 2, 0, yes
2707254209,  MarazitiMassimo, 5, 2, 3, no
483160810,  lucafidanza89, 5, 5, 0, yes
1538696953,  ariannaviani81, 4, 3, 1, yes
424336334,  IlmioManifesto, 4, 4, 0, yes
800335452079173636,  nataliacafolla1, 5, 5, 0, yes
573970612,  gilbertovendram, 1, 1, 0, yes
4905617759,  cfg_777, 5, 4, 1, yes
2776262486,  Bonfras, 3, 3, 0, yes
2173132780,  DmassariMassari, 1, 1, 0, yes
1399683188,  Andrysapienz, 5, 5, 0, yes
1388900256,  CuneoTweet, 1, 1, 0, yes
1070288839,  Lucone71, 9, 2, 7, no
479942012,  FlaminiMarina, 1, 1, 0, yes
2800392316,  matirubis, 5, 5, 0, yes
430934901,  GioStalteri, 2, 2, 0, yes
2575324037,  klikka69, 4, 4, 0, yes
424391490,  PatriziaFerri1, 6, 6, 0, yes
1645840459,  IeriVeronica, 1, 1, 0, yes
783244525728915456,  instantaneparis, 1, 0, 1, no
727483794467463169,  alvaroretorico1, 1, 0, 1, no
752520131553660928,  lisasciltian1, 1, 0, 1, no
770271033119178752,  annalisabuscem1, 1, 0, 1, no
803269234209988608,  bennyschrai, 1, 0, 1, no
785096776122507264,  ErwanKermagoret, 1, 0, 1, no
757926274522288129,  LogicAttenuante, 1, 0, 1, no
355724715,  silviastaerman, 1, 0, 1, no
434857982,  ciemmeelle, 4, 3, 1, yes
476028957,  lellaconfa, 6, 4, 2, yes
335547677,  macastal, 6, 1, 5, no
621848107,  rubinorossob, 8, 6, 2, yes
741379824,  adrianamusella, 1, 1, 0, yes
1176112362,  IsaGarosi, 9, 9, 0, yes
1063553574,  ALBINIA12, 1, 1, 0, yes
469396491,  dario_borriello, 4, 4, 0, yes
426702527,  castelluzzo444, 1, 1, 0, yes
2260295838,  toscanamedianew, 13, 13, 0, yes
2165518905,  DanieleConfetti, 7, 6, 1, yes
4590614848,  super_mattone, 5, 5, 0, yes
781790534553702400,  regionetoscana, 1, 1, 0, yes
1454233897,  LucillaMiss, 13, 12, 1, yes
412941225,  AlbanoLoredana, 8, 8, 0, yes
542617564,  EnricoSantarel1, 2, 2, 0, yes
44335065,  ComunicareDigit, 5, 5, 0, yes
58133191,  drmohanthomas, 1, 1, 0, yes
410752364,  GianfrancoSimo1, 10, 10, 0, yes
154572149,  giovannibonelli, 3, 3, 0, yes
539713843,  roccavarano, 1, 1, 0, yes
2257038246,  saraligutti, 6, 6, 0, yes
925794343,  FilippoGreco_, 2, 1, 1, neutral
926031224,  EugenioGiani, 3, 3, 0, yes
877917956,  EMencattini, 1, 1, 0, yes
1248044209,  nomicrochips, 11, 2, 9, no
432926462,  mobi44, 6, 3, 3, neutral
369428302,  massimovitturi, 1, 1, 0, yes
418762191,  ManuelMangano, 3, 3, 0, yes
2296214830,  ccpensi, 3, 0, 3, no
815415421,  MartaFerrucci, 1, 1, 0, yes
2733882387,  michelecicerch1, 1, 1, 0, yes
709125176122851328,  DvAGvTNt7EhgXBF, 1, 1, 0, yes
1041871652,  DonatoSantarsie, 4, 4, 0, yes
2434464491,  lscuvera, 2, 2, 0, yes
315818222,  Francesco_Puc, 1, 1, 0, yes
3390782038,  nicolan460, 1, 1, 0, yes
419498039,  DonikaHoxha, 4, 4, 0, yes
3129540850,  MediaVoxpop, 1, 1, 0, yes
3262232680,  NewIThinking, 1, 1, 0, yes
245685864,  Sottwitt, 3, 3, 0, yes
977177822,  MicheleIanmich, 2, 2, 0, yes
416340182,  RosarioPorzio1, 6, 6, 0, yes
4866219627,  dwb_nrd, 2, 2, 0, yes
2240116653,  consoli77, 1, 1, 0, yes
81604711,  massagregory, 1, 1, 0, yes
341179497,  AdEvsaDe, 2, 2, 0, yes
488663330,  GIANGOLINILEX, 5, 5, 0, yes
139849030,  anthonybella94, 1, 1, 0, yes
1421109373,  DALOCARLO, 4, 3, 1, yes
703351666595258368,  CricriToso, 1, 1, 0, yes
4860773571,  TRUTH_USA_2016, 1, 1, 0, yes
134364906,  sebastian27474, 1, 1, 0, yes
3024819412,  jyongsmv, 1, 1, 0, yes
155560291,  AlbaOlague, 5, 5, 0, yes
2396793506,  DottorWatson, 26, 16, 10, yes
2271558209,  MarcCorradi, 1, 1, 0, yes
2166600421,  sandra_furfaro, 2, 2, 0, yes
270992675,  JOSECRUZPRZLPZ, 1, 1, 0, yes
1057882938,  SimplePlan1619, 1, 1, 0, yes
722313522437300224,  810b7210540e4df, 2, 2, 0, yes
968158926,  ValentucciTucci, 2, 2, 0, yes
1262249239,  serge_arno, 1, 1, 0, yes
586680141,  gianluigimorot1, 2, 2, 0, yes
701064343,  GabrieleCasagni, 10, 10, 0, yes
551904422,  lucamaestri7, 3, 3, 0, yes
799327881252007936,  BukFeis, 1, 1, 0, yes
2476405765,  manilu59, 1, 1, 0, yes
2714500212,  sarabattaglia_7, 29, 29, 0, yes
141361812,  capetingio, 1, 1, 0, yes
2494823137,  C_mike94, 3, 3, 0, yes
1317874705,  55_Babi, 9, 5, 4, yes
297060762,  federicig, 12, 11, 1, yes
986111888,  luigimerolle, 8, 6, 2, yes
96361290,  sventur, 2, 2, 0, yes
21852199,  Steinhage, 1, 1, 0, yes
582038138,  grazia_chimenti, 1, 1, 0, yes
631458447,  AntonelloRago, 3, 2, 1, yes
804733905685413888,  p_salvador39, 1, 1, 0, yes
3134594627,  baffomilanes, 1, 1, 0, yes
3307547255,  ilgeneegoista, 2, 2, 0, yes
2852952899,  santserg77, 5, 5, 0, yes
3049277276,  GiovanniGiomar, 2, 2, 0, yes
279423986,  michelepan, 2, 2, 0, yes
41210459,  CaryMetz, 1, 1, 0, yes
779959771642331136,  evatortellina, 8, 8, 0, yes
3293586330,  alessia_dibiase, 1, 1, 0, yes
90636117,  Alcavi, 5, 5, 0, yes
1705643862,  maxleo1964, 3, 3, 0, yes
2526747198,  TibRignano, 2, 2, 0, yes
2194791385,  adrianomasiero, 1, 1, 0, yes
14340947,  jaikappa, 12, 8, 4, yes
788806147914465280,  MarinaSella4, 1, 1, 0, yes
718472766811455488,  patrizia_sada, 3, 3, 0, yes
2426934491,  maubondirventa1, 1, 1, 0, yes
799565079465312256,  Chiaretta994, 1, 1, 0, yes
799004893658959875,  Angelic21522756, 1, 1, 0, yes
2889945755,  matteo_calcagno, 1, 1, 0, yes
2364856331,  mouradbennoui, 1, 1, 0, yes
805024214021509120,  carlamarzano57, 1, 1, 0, yes
1308682861,  nikdeg78, 1, 1, 0, yes
557466835,  federiconani, 1, 1, 0, yes
135617909,  gdelgiovine, 4, 3, 1, yes
3489267617,  simoneborri61, 2, 2, 0, yes
1638861805,  beatrz_a, 10, 10, 0, yes
1045009034,  MareosLuciano, 2, 2, 0, yes
193646774,  Marco_Savino, 1, 1, 0, yes
1230033247,  OrnellaCastell3, 1, 1, 0, yes
2176737567,  LapponiP, 2, 2, 0, yes
595836650,  EnricaCarosella, 29, 29, 0, yes
127064486,  Liv_ing_, 1, 1, 0, yes
2932798964,  111b49034c9f450, 2, 2, 0, yes
410195814,  UbriacoACM, 2, 2, 0, yes
725721553741205504,  enricomantovano, 1, 1, 0, yes
6829722,  lorenzoruzzene, 1, 1, 0, yes
120734575,  MichelePivetti, 3, 3, 0, yes
4627513637,  honeybutterflyy, 1, 1, 0, yes
391311521,  luca_cicinelli, 1, 1, 0, yes
4286270548,  Elentarnew, 1, 1, 0, yes
3435973289,  artvmoon, 1, 1, 0, yes
804332055014371328,  ComignaniAlice, 13, 13, 0, yes
4009714228,  DarioLauretta3, 1, 1, 0, yes
755206795,  publasvegas, 4, 4, 0, yes
78697576,  seilmeglio, 8, 6, 2, yes
3404321067,  BSALVADORI71, 1, 1, 0, yes
2986927603,  THEGCAPUTO, 1, 1, 0, yes
795187955430264832,  marrobruno56, 6, 6, 0, yes
831362528,  killianboc, 4, 4, 0, yes
126125535,  FGPizzolante, 1, 1, 0, yes
748630167120138240,  aliyahgdr, 4, 4, 0, yes
2281238201,  BuonannoDamiano, 3, 3, 0, yes
793015261112696832,  TristeGetsemani, 5, 4, 1, yes
446424619,  fcarlocioca, 4, 4, 0, yes
578337906,  aledivozzo, 1, 1, 0, yes
464593709,  stefanochiarin1, 1, 1, 0, yes
1239113316,  DavideCN12, 1, 1, 0, yes
267763795,  giotsc, 2, 2, 0, yes
4768044183,  pucella_adriano, 2, 2, 0, yes
1082264935,  mauro_morabito, 2, 2, 0, yes
790153268269879305,  thefrasan, 1, 1, 0, yes
68668560,  NadiaCarta, 2, 2, 0, yes
124272170,  eleonorapanzeri, 1, 1, 0, yes
4133127375,  FBergamini3, 1, 1, 0, yes
22494577,  Costalink, 1, 1, 0, yes
758750662104522752,  MariaEvors, 2, 2, 0, yes
46712564,  eugeekpat, 2, 2, 0, yes
401879153,  gio_bow, 1, 1, 0, yes
2250726350,  gmperancin, 3, 3, 0, yes
172041634,  picpocpuc, 1, 1, 0, yes
484765823,  FraRomanin, 2, 2, 0, yes
2288338998,  Comm4Peace, 2, 2, 0, yes
784510322,  lillyfal69, 3, 2, 1, yes
292158589,  MDilonardo, 6, 6, 0, yes
1691046102,  KactCatos, 2, 2, 0, yes
17774275,  PsichiatriaITA, 1, 1, 0, yes
3198037594,  laurarom8, 4, 4, 0, yes
3020578613,  lagrullaia, 13, 10, 3, yes
802567189018660864,  palmorabito, 1, 1, 0, yes
3075395735,  fpinca15, 26, 25, 1, yes
2163574791,  IdrizSelaj, 1, 1, 0, yes
750349544127365120,  Max22232896, 2, 2, 0, yes
18721974,  dinoserpe, 1, 1, 0, yes
3310616615,  BelcariGiulio, 2, 2, 0, yes
772698236444352512,  tiziana47260981, 1, 1, 0, yes
424357996,  dessspistada, 2, 2, 0, yes
699694791878168576,  m_lampro, 4, 4, 0, yes
1356468979,  angida118, 5, 2, 3, no
250854940,  GiancarloCitrea, 1, 1, 0, yes
1117535029,  StefanoFalone, 5, 4, 1, yes
2364819052,  dikabernard, 14, 14, 0, yes
260387396,  volterraio, 1, 1, 0, yes
714125984,  Frox_11, 1, 1, 0, yes
1534920248,  ManuelFurla, 2, 2, 0, yes
292556611,  dariofini, 3, 3, 0, yes
794598299424739328,  Martidimarco1, 11, 11, 0, yes
3149531853,  emily_vez, 3, 3, 0, yes
412168233,  boccalon1, 16, 12, 4, yes
214475387,  c_briguglio, 19, 19, 0, yes
432950146,  peppinomaisto, 8, 5, 3, yes
437791905,  1441em, 9, 9, 0, yes
542691406,  sarabiagiotti, 2, 2, 0, yes
800608883525881856,  beafraschetti, 2, 2, 0, yes
966475711,  AlbertFiorino, 7, 7, 0, yes
4193378369,  MilelloPaolo, 1, 1, 0, yes
802559661878738945,  ortina52, 1, 1, 0, yes
786578626523308032,  mario_viapiana, 1, 1, 0, yes
780501372416425984,  antolombard63, 1, 1, 0, yes
2748470032,  Violablonde74g1, 3, 3, 0, yes
551199262,  DanielaChi91, 2, 2, 0, yes
422058212,  LauraPerci, 1, 1, 0, yes
3040802637,  TiSabba, 1, 1, 0, yes
3981639861,  GiorgioFaraon00, 3, 3, 0, yes
2901317194,  irenelasagna, 9, 9, 0, yes
757301557616607232,  nicholas_paoli, 1, 1, 0, yes
1063626588,  CiroCarriero, 4, 2, 2, neutral
160584970,  SassiLive, 6, 3, 3, neutral
505613405,  RobertoMatta56, 2, 2, 0, yes
590358735,  SilviaFregolent, 6, 6, 0, yes
1184584854,  fab_ferrara, 1, 1, 0, yes
415046131,  SylvieGuari, 5, 5, 0, yes
1348914024,  Gerdac1971, 2, 2, 0, yes
139512031,  Horus76, 6, 5, 1, yes
793237098660827136,  RitaTola4, 1, 1, 0, yes
802411959652151296,  Giuseppe_fox1, 1, 1, 0, yes
4889757933,  antomonello73, 3, 3, 0, yes
38873697,  lampoblu1978, 7, 4, 3, yes
3965043981,  ScajolaM, 1, 1, 0, yes
519619381,  arturodelisi, 16, 4, 12, no
1450758229,  Eustacchiofranc, 1, 1, 0, yes
799317054880944132,  carmendidero, 1, 1, 0, yes
81412056,  capassomario, 5, 4, 1, yes
78412028,  robby_ro, 3, 3, 0, yes
875930238,  Pfpirruccio, 1, 1, 0, yes
327471759,  FaustoDeMaria, 4, 4, 0, yes
2227758951,  CongiuElisa, 2, 2, 0, yes
1360385989,  antoniobaesso, 2, 2, 0, yes
366025992,  FBonafaccia, 3, 3, 0, yes
7414282,  mlupoi, 21, 17, 4, yes
339528511,  AleTrigila, 2, 2, 0, yes
288366021,  ZiaMickyVS, 1, 1, 0, yes
2573483704,  Federica73Marin, 2, 2, 0, yes
2656924408,  mirkotreme, 2, 2, 0, yes
23280841,  paciuko, 15, 12, 3, yes
444115638,  carloebasta, 4, 2, 2, neutral
431928052,  perliniandrea, 3, 3, 0, yes
2212544767,  alessandromai14, 6, 4, 2, yes
473166234,  AlexGiampa, 25, 25, 0, yes
92229462,  janeiro41, 1, 1, 0, yes
782188114454405120,  ferriangelo1, 2, 2, 0, yes
2322811565,  RagiDella, 1, 1, 0, yes
2252440769,  ScCalabrese, 1, 1, 0, yes
1230888704,  amali64, 3, 3, 0, yes
2152381152,  mariaruggieri8, 29, 27, 2, yes
1179770209,  mauriziogarbu, 2, 2, 0, yes
521645027,  BaldiGianni, 2, 2, 0, yes
355747715,  MARIACASALDI, 1, 1, 0, yes
539724967,  SAUROAPOLLONI, 6, 6, 0, yes
1558477968,  FGregorio77, 3, 3, 0, yes
414331511,  roccoqz, 5, 5, 0, yes
2482825875,  sabrinagrelli, 3, 3, 0, yes
290527870,  vaFanGoogle, 2, 1, 1, neutral
533346277,  AndreTelchi, 4, 4, 0, yes
2962475685,  _LuigiLeonardi, 44, 39, 5, yes
1877956903,  gr_roca, 3, 3, 0, yes
3347530847,  3424b69980a7415, 4, 4, 0, yes
3201907600,  alian_maria, 6, 6, 0, yes
1146083755,  PgCarrescia, 3, 3, 0, yes
336155154,  TonioAbcde, 1, 1, 0, yes
16732211,  DTenenbaum, 1, 1, 0, yes
312204696,  IlariaGuidi, 1, 1, 0, yes
1926643158,  daniela61778885, 11, 5, 6, no
435700257,  cris_rigo, 2, 2, 0, yes
2180853339,  giuseppecicile, 25, 25, 0, yes
73595849,  giuseppeoliva09, 26, 26, 0, yes
1044539172,  pierl86, 6, 3, 3, neutral
69340006,  visionnairasoc, 4, 3, 1, yes
741220758643441664,  elemimich, 4, 3, 1, yes
353888721,  Dan_Maze, 2, 2, 0, yes
4735754218,  egidiopesa1, 6, 6, 0, yes
2222816851,  SCViterbo, 66, 41, 25, yes
433636980,  eccapecca, 7, 4, 3, yes
2871244143,  fradiv72, 3, 3, 0, yes
357154328,  federicorocchit, 2, 1, 1, neutral
1438958683,  ScuolaDelCane, 1, 1, 0, yes
546239230,  CaroleMagoha, 2, 1, 1, neutral
36612294,  angeloargento, 7, 7, 0, yes
603637951,  GiovDemRoma, 1, 1, 0, yes
1128185149,  AgataElle, 1, 1, 0, yes
2186217137,  MorroniBruno, 11, 11, 0, yes
539026441,  ZenusZeno, 2, 2, 0, yes
66930325,  Andreadiluccio, 1, 1, 0, yes
1377266593,  g_bianchi59, 4, 1, 3, no
330330577,  kundolidernatur, 10, 7, 3, yes
2573821529,  valeriasemerar4, 2, 2, 0, yes
99532524,  Jabadabado0, 1, 1, 0, yes
185760677,  m4arc0, 11, 7, 4, yes
2263606787,  ferruccio1953, 6, 6, 0, yes
757189171148681216,  Angela28726337, 1, 1, 0, yes
573000953,  AnnaFag8, 1, 1, 0, yes
3295658451,  _DJM__, 16, 4, 12, no
3017185311,  6b0d356d53eb4d5, 2, 2, 0, yes
2305318506,  gigante, 1, 1, 0, yes
3414835636,  Franny_FI, 2, 2, 0, yes
1375171728,  daventurino, 1, 1, 0, yes
787451704954482688,  Real_puccio, 1, 1, 0, yes
4851241510,  amaliamariapepe, 1, 1, 0, yes
2365538973,  simotraviata, 5, 5, 0, yes
215145317,  new_flame, 1, 1, 0, yes
730730989891268609,  MontiRosalia, 1, 1, 0, yes
30579071,  stefanocolonna, 2, 2, 0, yes
801986598699233280,  Stefano66443912, 2, 2, 0, yes
704911394,  IOLANDAESPOSIT4, 5, 3, 2, yes
2534619576,  MarinkovicVera, 1, 1, 0, yes
489421781,  DavideSilvestr6, 21, 14, 7, yes
4765490783,  matteo5104, 4, 1, 3, no
2337512081,  _smicera, 2, 2, 0, yes
406947394,  FabioVincent14, 10, 9, 1, yes
801490262275092480,  Gianfra46421919, 3, 3, 0, yes
2265984404,  d_p_antonio, 2, 2, 0, yes
461219174,  renatabriano, 5, 5, 0, yes
4861532578,  ferdicurini5, 6, 6, 0, yes
922995847,  alelorenzini29, 1, 1, 0, yes
118063867,  genhai, 1, 1, 0, yes
535762202,  AleXiAzzurro, 1, 1, 0, yes
777128701700046848,  cazeaux_delia, 2, 2, 0, yes
452723164,  bimba_pigra, 4, 3, 1, yes
781082983205859332,  FraDelcuratolo, 1, 1, 0, yes
1116753012,  Marcocau70, 3, 3, 0, yes
435059596,  TommasoPugliese, 1, 1, 0, yes
1146115483,  salvato94885960, 6, 6, 0, yes
434857590,  m_dael, 4, 4, 0, yes
1337081946,  InfantEnzo, 2, 2, 0, yes
490367299,  GOccorsio, 16, 3, 13, no
1542761893,  corradopari, 5, 3, 2, yes
532666601,  GiuseppeLatorra, 1, 1, 0, yes
2360508155,  enzo23019767, 4, 4, 0, yes
75136920,  UnPalmo, 1, 1, 0, yes
54864678,  ChinellatoPhoto, 1, 1, 0, yes
4914013611,  minervazena16, 14, 14, 0, yes
3363046271,  armidago68, 3, 3, 0, yes
686543,  davidcasalini, 1, 1, 0, yes
474823972,  LaCusma, 1, 1, 0, yes
282025038,  LingottoFiere, 2, 2, 0, yes
2361407142,  Giacomo63923738, 1, 1, 0, yes
432903283,  colosimo82, 5, 5, 0, yes
118339229,  michele_maschio, 1, 1, 0, yes
786273506849853440,  marcello221142, 6, 3, 3, neutral
521766551,  _TiffanyAmber13, 1, 1, 0, yes
1647824629,  gnagnolohc, 1, 1, 0, yes
489510463,  GiuseppeMammoli, 1, 1, 0, yes
593572152,  AndreaSerino1, 4, 4, 0, yes
2469776817,  simobona75, 6, 2, 4, no
101218055,  cezar073, 17, 5, 12, no
109078503,  a_arminante, 5, 3, 2, yes
3676455017,  mrmarfly, 1, 1, 0, yes
3411450412,  LetMeSitOnThorn, 1, 1, 0, yes
146822630,  reilachii, 1, 1, 0, yes
506112919,  BaniValter, 1, 1, 0, yes
305523994,  pieromagnani, 6, 5, 1, yes
2347675929,  montinaromanuel, 6, 6, 0, yes
255143121,  BabayagaGlam, 5, 5, 0, yes
570663412,  FerraresiPV, 1, 1, 0, yes
4218590117,  linuss_com, 2, 2, 0, yes
792982394601078784,  GiorgioCuri, 1, 1, 0, yes
732661771836755968,  Bet69Rossi, 3, 1, 2, no
203995583,  rokkina71, 4, 4, 0, yes
1066272294,  ricky_tedeschi, 1, 1, 0, yes
437035123,  wolvessoccer01, 2, 2, 0, yes
22610875,  zaccas, 2, 1, 1, neutral
103068418,  Tenhund, 3, 2, 1, yes
4876533515,  ozkanalix, 8, 7, 1, yes
2262396887,  rob_rciriminna, 3, 3, 0, yes
851786490,  FraAngelone, 9, 8, 1, yes
472689582,  Leonetti_Bg, 2, 2, 0, yes
258800738,  marcodige, 22, 19, 3, yes
754014404275044356,  81f200b0c1d0416, 1, 1, 0, yes
4873124837,  numero_uno_one, 1, 1, 0, yes
2495776155,  UFoggia, 1, 1, 0, yes
120531227,  messico76, 5, 4, 1, yes
21293399,  giampierogallo, 6, 6, 0, yes
3835026681,  DinoBastianelli, 1, 1, 0, yes
3123958103,  e46152c00c874e2, 1, 1, 0, yes
541150443,  vivereaChioggia, 1, 1, 0, yes
998073350,  DenisRamoino, 1, 1, 0, yes
944447748,  BaninDiego, 1, 1, 0, yes
510499913,  GiacomoSanavio, 2, 2, 0, yes
586562476,  liamangieri, 2, 2, 0, yes
40948942,  claudiocolby, 1, 1, 0, yes
1065907650,  elgrinfio, 4, 4, 0, yes
2978019477,  e8784b71da2148b, 19, 13, 6, yes
91348491,  PiemonteInforma, 5, 3, 2, yes
3295153623,  tonyfrizzi, 3, 3, 0, yes
428931337,  fdicos10, 16, 16, 0, yes
554521013,  J80Michael, 1, 1, 0, yes
2355144468,  IncardonaTonio, 3, 3, 0, yes
204796616,  chirgen, 2, 2, 0, yes
1564408128,  Paolomul93, 2, 2, 0, yes
526327701,  cpetruccioli, 10, 6, 4, yes
808338949,  sxm_m, 1, 1, 0, yes
53877977,  ftonello, 1, 1, 0, yes
769154598795939841,  dinamo_enzo, 1, 1, 0, yes
3434830510,  Mimmo079Mimmo, 1, 1, 0, yes
730525013711925248,  Mondotestaingiu, 1, 1, 0, yes
2946586799,  carpentiere70, 2, 1, 1, neutral
502239221,  vinochepassione, 2, 1, 1, neutral
548221028,  saracino58, 3, 3, 0, yes
2907264681,  NettunoEnore, 7, 7, 0, yes
320183573,  MirtelliDavide, 1, 1, 0, yes
1223069394,  GIULIANA7G, 3, 3, 0, yes
553765708,  m_bertoli, 2, 2, 0, yes
746603431620644864,  diegoclmb, 1, 1, 0, yes
481495667,  giovanniciafard, 1, 1, 0, yes
29161948,  Surveyor1973, 5, 5, 0, yes
213030845,  LucaAstigiano, 1, 1, 0, yes
498883267,  WalterBaffi, 3, 3, 0, yes
1425809204,  giuliodecre, 5, 5, 0, yes
2974864583,  GGlarocca9931, 1, 1, 0, yes
758168423167819776,  Cristia24373511, 1, 1, 0, yes
54861430,  aliasvaughn, 1, 1, 0, yes
802282147465875456,  cristiano_biggi, 3, 3, 0, yes
3055754503,  APaolo78, 4, 4, 0, yes
1329293731,  ClarusaRosa, 2, 1, 1, neutral
428085622,  sandrocioni, 3, 3, 0, yes
790303007602839552,  bastaunsi_eur, 1, 1, 0, yes
1327117352,  ElMaria40346201, 1, 1, 0, yes
46715834,  albertopandolfo, 4, 4, 0, yes
3301451717,  emicalamita, 1, 1, 0, yes
361748780,  RoccisanoF, 6, 6, 0, yes
4308453381,  MassimoQuarta4, 2, 2, 0, yes
2277937200,  raffaelebarki, 15, 11, 4, yes
1055585250,  carmen_liguori, 4, 4, 0, yes
1122659574,  colazzo_andrea, 7, 7, 0, yes
757213488,  paolafriargiu, 1, 1, 0, yes
801139946555867137,  appleblog33, 1, 1, 0, yes
320663980,  Astrolasagna, 2, 2, 0, yes
789144305264910336,  LemuroidAndroid, 5, 4, 1, yes
13899542,  blugalu, 3, 1, 2, no
151205711,  vittoriocirillo, 4, 3, 1, yes
2755819828,  hcsrl3, 1, 1, 0, yes
406569640,  colamartino77, 2, 1, 1, neutral
2515635548,  GramazioLia, 1, 1, 0, yes
36047644,  MarilenaMunaro, 33, 33, 0, yes
472883767,  briga17, 1, 1, 0, yes
87159665,  adigio, 1, 1, 0, yes
538360052,  ALRandazzo, 1, 1, 0, yes
371123495,  DavGabriele, 6, 4, 2, yes
802325710538993664,  gianfrancosdog3, 1, 1, 0, yes
571710585,  GiulioSchenone, 3, 3, 0, yes
2333850771,  Ciccio_Fimiani, 1, 1, 0, yes
144902509,  fabuloso978, 3, 2, 1, yes
346128938,  ryder9000, 4, 3, 1, yes
1901258058,  75Ginny, 13, 13, 0, yes
1140926593,  EmanuelaSpadaro, 6, 6, 0, yes
1851668641,  melioravit, 1, 1, 0, yes
2712498692,  Oliverio_MarioG, 5, 5, 0, yes
942104587,  Alemartict, 1, 1, 0, yes
3025473960,  Lau84G, 1, 1, 0, yes
1723968264,  dantravelaround, 1, 1, 0, yes
431818692,  CCicchirillo, 1, 1, 0, yes
243097501,  Giacominog88, 8, 8, 0, yes
151652866,  marcorighez, 2, 2, 0, yes
452303982,  colonnello1979, 2, 2, 0, yes
798253751274500100,  GrathiasMas, 1, 1, 0, yes
1291536336,  LailaManzardo, 2, 1, 1, neutral
574013991,  FraDublin, 1, 1, 0, yes
221774529,  alf_crisci, 3, 1, 2, no
829566312,  CrisDottavio, 3, 3, 0, yes
466379768,  VeronicaMonimo, 1, 1, 0, yes
2824748381,  mariucciapatru1, 1, 1, 0, yes
401492216,  Tizicapo, 1, 1, 0, yes
8379692,  Andrea_Fanchin, 1, 1, 0, yes
800128513151881216,  gessica12se, 1, 1, 0, yes
399045162,  andremme, 1, 1, 0, yes
1279962288,  LuigiSpagnolli, 1, 1, 0, yes
562736946,  annibalemusa, 2, 2, 0, yes
2935951648,  OnurSarau, 1, 1, 0, yes
288990649,  Edeniti, 1, 1, 0, yes
173239993,  ChromeNun, 3, 2, 1, yes
16087705,  YouReporter, 5, 3, 2, yes
2905965225,  VillaHeinzvil, 3, 3, 0, yes
3716883675,  isp_bassettoni, 6, 5, 1, yes
722176992867708929,  chopsderfvadim, 1, 1, 0, yes
283006215,  macbroccoli, 1, 1, 0, yes
3046671413,  pieroalfonso73, 5, 4, 1, yes
364738656,  albertomambro, 1, 1, 0, yes
1281018260,  matteo_dec, 5, 5, 0, yes
781584426186735616,  epiazza73, 1, 1, 0, yes
155695954,  icebergfinanza, 1, 1, 0, yes
272406559,  telemacopardo, 3, 3, 0, yes
140057440,  fabbrj, 11, 11, 0, yes
2427495967,  claudio78381441, 1, 1, 0, yes
426178907,  pasqu85, 6, 2, 4, no
823518710,  stefaniaguizzo, 1, 1, 0, yes
2370915699,  GrazianiAngela, 2, 2, 0, yes
707930497171771393,  Erbion_, 1, 1, 0, yes
2451684146,  FederfarmaCA, 2, 2, 0, yes
18472449,  iw0rby, 2, 2, 0, yes
733282660127236100,  rakso1234, 7, 6, 1, yes
1068916382,  nico71_, 2, 2, 0, yes
27083314,  AnnaLauraWelsh, 4, 4, 0, yes
550370900,  HeelGianz, 3, 3, 0, yes
772749836596707329,  massimi22880727, 1, 1, 0, yes
781798958440079360,  lapinella_, 6, 6, 0, yes
605776483,  mauxsky76, 2, 2, 0, yes
3042119529,  LinoGianfranco, 11, 8, 3, yes
552302316,  iodissento, 3, 2, 1, yes
1272067212,  ettobuscema, 1, 1, 0, yes
757720086,  LorisCalanni, 2, 2, 0, yes
1319088739,  Mariachiaraagu, 1, 1, 0, yes
2637001376,  residentiCM, 1, 1, 0, yes
100463796,  ergys888, 1, 1, 0, yes
253658866,  Mapinietz, 2, 2, 0, yes
736296343476523012,  Mario97848, 1, 1, 0, yes
2944763793,  LouAsSunshine, 7, 7, 0, yes
296836306,  Paola_Marocchi, 5, 5, 0, yes
96297956,  vartuli_luigi, 1, 1, 0, yes
786217307622240256,  ElisaViapiana, 2, 2, 0, yes
4818891382,  GiuseppeAl3, 1, 1, 0, yes
509994762,  DaRould, 1, 1, 0, yes
2454968384,  sanchici, 1, 1, 0, yes
2603427143,  danielameneghe3, 1, 1, 0, yes
4297575155,  MatLolli, 1, 1, 0, yes
796632658575060992,  F_antaman, 3, 3, 0, yes
134046168,  salvoandrea, 2, 2, 0, yes
541748806,  PetrilliAngelo, 1, 1, 0, yes
760572539278090241,  LeonardoGarzia, 1, 1, 0, yes
452869670,  AldoPimpolari, 3, 3, 0, yes
123231777,  ExTimUpperClass, 7, 6, 1, yes
214068060,  Marx_ist, 1, 1, 0, yes
411731864,  mauro_vaiani, 2, 2, 0, yes
767996964118097920,  RiccardoOrsi, 6, 6, 0, yes
1442364708,  VSavux, 1, 1, 0, yes
2714518903,  GregorHeavans, 1, 1, 0, yes
501166750,  babypapaianni, 1, 1, 0, yes
2322754363,  Annaleclipse, 4, 4, 0, yes
3150869255,  ZangiMauro, 1, 1, 0, yes
745949503,  FabioFerra82, 1, 1, 0, yes
156935606,  ilbaffochecorre, 1, 1, 0, yes
790208423958876160,  MirkoTiAmo00, 1, 1, 0, yes
262698479,  mtarozzi78, 1, 1, 0, yes
1360366502,  Chicco91949, 1, 1, 0, yes
2795653154,  dagiora, 2, 2, 0, yes
254192133,  alessandro_67, 1, 1, 0, yes
710915223721525248,  Nicol40520023, 1, 1, 0, yes
39140772,  palur74, 2, 2, 0, yes
339814113,  ClaudiaCristini, 2, 2, 0, yes
1563515574,  croma90D, 3, 3, 0, yes
4736806277,  FabioDiFede1981, 1, 1, 0, yes
425280400,  AntonyB1, 2, 2, 0, yes
560413688,  AUREMA2, 1, 1, 0, yes
2503804834,  Serena71St, 1, 1, 0, yes
94421751,  ToniGiugliano, 2, 2, 0, yes
2415498244,  SamueleTedesco, 4, 4, 0, yes
4493808615,  annamarialiscio, 13, 12, 1, yes
4031918452,  ValeriaLipani, 1, 1, 0, yes
161795148,  robertoanesi, 6, 6, 0, yes
425193883,  rRexee, 3, 3, 0, yes
4768175920,  walterdagal, 3, 1, 2, no
1139875363,  FedeNobilio, 7, 4, 3, yes
1849639560,  Avelenese, 3, 3, 0, yes
794309169197305857,  fabriziacasam10, 2, 1, 1, neutral
101180862,  mark_nm, 1, 1, 0, yes
450982008,  angymanganiello, 1, 1, 0, yes
2147605620,  LeleMerisi, 1, 1, 0, yes
566530063,  EttoreRavizza, 1, 1, 0, yes
407316124,  EnricoSiviero, 3, 3, 0, yes
385042626,  AnnaLaChimia, 1, 1, 0, yes
447896469,  Luca_Mussati, 8, 6, 2, yes
2917164790,  GertaLecini00, 1, 1, 0, yes
2460165950,  euridicesophia, 1, 1, 0, yes
466679177,  breves2012, 4, 4, 0, yes
2189679107,  davide_sutera, 9, 6, 3, yes
970598372,  mimmocontartese, 1, 1, 0, yes
822710310,  PompeoPomponio, 2, 2, 0, yes
427319519,  amichelotti001, 1, 1, 0, yes
48384215,  Emi75, 3, 3, 0, yes
730819447427112960,  tMhl7jUkTLonsGz, 1, 1, 0, yes
799920407797256192,  AMAMARCO1, 1, 1, 0, yes
452084520,  Gabrinew, 1, 1, 0, yes
802812608898363392,  DanieleSandrin2, 1, 1, 0, yes
764136133286629377,  lennygaudino, 2, 1, 1, neutral
896233980,  gcasarel, 9, 8, 1, yes
1056228325,  GiovanniCaglio, 9, 8, 1, yes
4485038235,  MonicaMelis8, 1, 1, 0, yes
195427895,  ISOLACHENONCE60, 1, 1, 0, yes
293504218,  robertocuillo, 7, 4, 3, yes
703575563,  alepaini96, 4, 4, 0, yes
126502749,  morellik777, 1, 1, 0, yes
2919170415,  biro947, 8, 8, 0, yes
75085022,  FrancoValdez, 1, 1, 0, yes
122910706,  lavidae, 2, 2, 0, yes
455632539,  TommasoCorradi, 2, 2, 0, yes
916240801,  Tux1970Marcello, 1, 1, 0, yes
453114491,  PGianfreda, 2, 2, 0, yes
1103627640,  IonutRi, 1, 1, 0, yes
198224286,  timwoerner, 2, 2, 0, yes
3236323753,  CarlaFazzini, 1, 1, 0, yes
718898052128489472,  fiorancini, 3, 3, 0, yes
2776595983,  giuseppepiscio7, 1, 1, 0, yes
306671692,  AlvaroBaroni, 1, 1, 0, yes
31216192,  Tegliucci, 2, 2, 0, yes
805173835456741376,  loris90859229, 1, 1, 0, yes
1286675653,  wazegrLazanzara, 1, 1, 0, yes
914779435,  NicolettaMarch3, 6, 5, 1, yes
736290813962014720,  alesspalmerini, 2, 2, 0, yes
589855405,  BKirovxx, 2, 2, 0, yes
506388786,  Ferracci_Michi, 1, 1, 0, yes
426812144,  franzecchini, 1, 1, 0, yes
755920470,  RedAndBlack00, 1, 1, 0, yes
904586378,  MarinielloMauro, 1, 1, 0, yes
516281490,  gianlucalav, 7, 7, 0, yes
173992633,  mickeykookee, 4, 4, 0, yes
1069062834,  Leonardotwitt73, 1, 1, 0, yes
211117366,  peresalo68, 3, 2, 1, yes
179096387,  pantagruel2014, 10, 7, 3, yes
2985710727,  villanidonatel1, 1, 1, 0, yes
2226802248,  SquilibrataS, 1, 1, 0, yes
2166843416,  MauroParentini, 4, 2, 2, neutral
722440741,  orogiampaolo, 4, 4, 0, yes
1863123950,  MariaLuisaPutti, 1, 1, 0, yes
461127452,  bruciaferro59, 4, 4, 0, yes
2754292189,  pacca571, 1, 1, 0, yes
777180754610626561,  ZOOMTUMBTUMB, 1, 1, 0, yes
256213996,  AngeloCivico, 5, 5, 0, yes
2896503063,  49Enrico, 1, 1, 0, yes
1017336150,  GianmarcoDeme, 3, 3, 0, yes
41090013,  bkex, 3, 3, 0, yes
1680114756,  enzodaversa95, 18, 18, 0, yes
377992089,  stefanoientile, 2, 2, 0, yes
527752168,  direlaviolenza, 8, 8, 0, yes
1244867058,  au680, 3, 3, 0, yes
801713086176563200,  micspin72, 1, 1, 0, yes
3198731351,  AntbrgAntonio, 5, 5, 0, yes
380449282,  GiovannaMancino, 2, 2, 0, yes
171942005,  MicheleNapoli73, 1, 1, 0, yes
3868874836,  _Esploratore_, 3, 3, 0, yes
805090280789733377,  sofialoi04, 1, 1, 0, yes
17061821,  emmanuelnavon, 2, 2, 0, yes
2410113435,  LunatiMarco, 3, 3, 0, yes
1446753674,  antonioparisi06, 3, 3, 0, yes
1696603856,  giuseppedivendr, 1, 1, 0, yes
727904226773487616,  pratochedicesi, 1, 1, 0, yes
61996974,  pierumberto, 3, 3, 0, yes
1349452861,  costi7476, 3, 3, 0, yes
789887372653723652,  falcoprimo66, 4, 4, 0, yes
2175297476,  Andrea_PHV, 3, 3, 0, yes
805179553090072576,  JackdelPolemica, 1, 1, 0, yes
777653605,  rocriale, 13, 12, 1, yes
451571805,  DISYDenis, 2, 2, 0, yes
1066887492,  Alessia_elle, 1, 1, 0, yes
1474690615,  PoggianiMarco, 1, 1, 0, yes
877531850,  rossanarocco3, 1, 1, 0, yes
1439358858,  effesenzaspazi, 2, 2, 0, yes
93667122,  franzal68, 1, 1, 0, yes
302810045,  AdelValledeToro, 1, 1, 0, yes
789090311729545216,  Lorenzo42816040, 1, 1, 0, yes
159050482,  Elle__22, 1, 1, 0, yes
2568747103,  fperrone_, 1, 1, 0, yes
471139502,  LirPaola, 2, 1, 1, neutral
2450751947,  alemeimp, 1, 1, 0, yes
3363915879,  FaithCompassion, 6, 6, 0, yes
4859438769,  __steta__, 9, 8, 1, yes
3930897094,  alfamask1, 1, 1, 0, yes
3295891146,  ValentinaBerbo, 1, 1, 0, yes
3195990347,  JekoAngelo, 1, 1, 0, yes
1582850112,  my1970450310, 2, 2, 0, yes
468817704,  sabluty, 2, 2, 0, yes
448088280,  MandrilloBionic, 1, 1, 0, yes
2368223791,  PcPdAR, 1, 1, 0, yes
2288735035,  mrs_styles_00, 5, 5, 0, yes
2222854710,  C_Barbaza, 1, 1, 0, yes
2844842889,  MauraViani, 5, 5, 0, yes
2982334853,  LavolpeCo, 2, 2, 0, yes
785449306396450817,  Antonio28124, 1, 1, 0, yes
2386527144,  JOSEGAL45629666, 6, 6, 0, yes
357659237,  mennozz81, 2, 2, 0, yes
781941488,  dariobellante, 2, 2, 0, yes
62325493,  Antonietta80, 3, 2, 1, yes
2276189400,  RLevanoMartin, 1, 1, 0, yes
432382919,  MichaelPalumbo2, 5, 5, 0, yes
801363913380073472,  BrogiGiuseppe, 2, 2, 0, yes
557108101,  GermanoGiulio, 3, 2, 1, yes
2889417815,  BiancaMangano, 1, 1, 0, yes
1119055321,  pvilvecchio, 1, 1, 0, yes
2663697436,  itsloulover, 2, 2, 0, yes
774168139550433280,  Ale_Real1, 1, 1, 0, yes
791706486972026885,  Antonio95160833, 1, 1, 0, yes
746324746254561280,  Frances02119109, 4, 4, 0, yes
2856545477,  LydiePaule, 2, 2, 0, yes
747898341246238720,  enzapaola51, 1, 1, 0, yes
3747508455,  Arianninannaira, 1, 1, 0, yes
715636339346157569,  CasaMazzolini, 1, 1, 0, yes
2280964682,  FabioCasalucci, 1, 1, 0, yes
3216773356,  marcoinnocent19, 1, 1, 0, yes
769629854,  pietroivanovic, 2, 2, 0, yes
430090090,  mrcddv, 5, 5, 0, yes
1188832464,  Fede_Campa1, 3, 3, 0, yes
3028738804,  LMulinetti, 2, 1, 1, neutral
407627101,  STEFANOFUSI1, 1, 1, 0, yes
4708148267,  partyfood2, 2, 2, 0, yes
718895818305048576,  CorrMaupa, 5, 2, 3, no
4860349336,  Vivi35299838, 1, 1, 0, yes
595306303,  CriSStraits, 9, 8, 1, yes
731451681855143936,  LucaBollani, 2, 2, 0, yes
428521248,  megmalp, 2, 2, 0, yes
783323312814493697,  FernandoUriati, 1, 1, 0, yes
2492981371,  edibastianelli, 2, 2, 0, yes
430765955,  SafaHaouam, 3, 3, 0, yes
4747943075,  PariselliFelice, 1, 1, 0, yes
632130796,  Pvnkouis, 1, 1, 0, yes
793559300962676737,  MaraDavi2, 1, 1, 0, yes
326680574,  SimonePepe1981, 3, 2, 1, yes
470450722,  giodempa, 2, 2, 0, yes
539079537,  dianellamaroni, 3, 3, 0, yes
510249769,  roccadicave, 3, 3, 0, yes
592246362,  GiulioNovari, 3, 3, 0, yes
914392435,  GulySporting, 1, 1, 0, yes
771091767697534977,  Riccardotosto89, 1, 1, 0, yes
490449494,  misterious62, 1, 1, 0, yes
4818871595,  GiulioConte79, 4, 4, 0, yes
1080849440,  9magghie2, 2, 2, 0, yes
487433518,  MariaPiaGovi, 5, 5, 0, yes
2875143741,  danilogpoggio, 1, 1, 0, yes
1277799804,  Angelitastefan1, 3, 3, 0, yes
303969702,  carmelocaggia, 1, 1, 0, yes
853629632,  Dranem128, 1, 1, 0, yes
747892943353188352,  ri4ily, 1, 1, 0, yes
110888613,  m_delbianco, 1, 1, 0, yes
171860363,  ShirleyKVChan, 1, 1, 0, yes
423006463,  Panorama24H, 2, 2, 0, yes
422542943,  Elena_hermanita, 1, 1, 0, yes
2539747033,  Mafalda_Mitica, 2, 1, 1, neutral
2569193581,  El7assa9, 2, 2, 0, yes
778859035122601984,  sylbolid, 4, 1, 3, no
1299826472,  dellimutidomy, 1, 1, 0, yes
2746134749,  LouDibrio, 1, 1, 0, yes
3393788759,  mikanonsounds, 1, 1, 0, yes
3328846707,  51337668d9e343f, 1, 1, 0, yes
47983965,  IlaANDila, 1, 1, 0, yes
801821718537007104,  JustaJaneite, 3, 3, 0, yes
361754257,  MarcoOleoni, 2, 2, 0, yes
762969223937269760,  roberto24265, 2, 2, 0, yes
2209414790,  francasen, 4, 4, 0, yes
805116382560002048,  GabrieleMilane2, 1, 1, 0, yes
700469676846018560,  maxdatenerife, 1, 1, 0, yes
95490309,  Dagghii, 4, 4, 0, yes
1710955382,  SottoLaMole, 15, 12, 3, yes
1017974048,  GabrielePetrone, 9, 9, 0, yes
342332426,  DjDragon88, 6, 4, 2, yes
1678402296,  J1975Marco, 1, 1, 0, yes
712239784052330496,  fracz77, 1, 1, 0, yes
362485257,  MasRossett, 3, 3, 0, yes
1085676949,  LordCamPoT, 8, 7, 1, yes
3077658094,  sr2805, 3, 3, 0, yes
1387260044,  LaVocediNewYork, 5, 5, 0, yes
1037954268,  eattoli, 4, 2, 2, neutral
4502167881,  magnone_rosa, 2, 2, 0, yes
871183387,  BatuecasOficial, 3, 3, 0, yes
702867603258253312,  diamantigisella, 1, 1, 0, yes
517687282,  Aroppolino, 1, 1, 0, yes
957412262,  Valeria31_10, 4, 4, 0, yes
1898433764,  sasekloves, 1, 1, 0, yes
554504621,  CarmineFab96, 26, 24, 2, yes
548474855,  CIannuzziello, 4, 4, 0, yes
2521301199,  LuviCeri, 3, 3, 0, yes
1385514882,  Gianlucavirzi, 6, 6, 0, yes
2704832459,  pasc4474, 1, 1, 0, yes
124710922,  nadiaeffe, 6, 5, 1, yes
1409747527,  53_Vince, 3, 3, 0, yes
2353220905,  FrancoiseRomano, 1, 1, 0, yes
586679431,  GianGor, 1, 1, 0, yes
1168532738,  GiovanniGumiero, 1, 1, 0, yes
2973117363,  ziofester082, 3, 3, 0, yes
802070166901231616,  Maximus34028327, 1, 1, 0, yes
4193928556,  nsel_name, 3, 3, 0, yes
597605833,  Madda1111982, 1, 1, 0, yes
2473872080,  lauria949, 1, 1, 0, yes
4501774163,  francescomon92, 1, 1, 0, yes
562081610,  DaniTerrinoni, 1, 1, 0, yes
2757197728,  ottavianoagusto, 1, 1, 0, yes
266778712,  andypappa, 1, 1, 0, yes
3281239550,  robydyb, 1, 1, 0, yes
1883029429,  LDrezza, 2, 2, 0, yes
2810009016,  pet1713, 17, 17, 0, yes
2499272229,  NardulliDaniele, 3, 3, 0, yes
957474895,  Claudenzio, 1, 1, 0, yes
1960736604,  irenerossi41, 8, 6, 2, yes
767209128,  faber_71, 2, 2, 0, yes
1341552145,  lucarobinsonco, 1, 1, 0, yes
458270464,  NicholasDeidda, 1, 1, 0, yes
411723959,  Ronnie_Laureana, 1, 1, 0, yes
3647477113,  sabrinaperugia1, 2, 2, 0, yes
195316316,  carneade99, 7, 7, 0, yes
436727036,  locard123, 5, 5, 0, yes
2557627068,  MezzadridItalia, 6, 2, 4, no
631361738,  andreafranchi77, 1, 1, 0, yes
423804948,  _H0lden, 3, 3, 0, yes
3383095330,  alfaprivativa, 3, 2, 1, yes
2507631967,  SaverioBerte, 1, 1, 0, yes
2230023476,  r4ff4ele1980, 1, 1, 0, yes
396928527,  flavio_bxl, 1, 1, 0, yes
135806832,  lesferedeldrago, 3, 1, 2, no
927726264,  FedezDiane, 1, 1, 0, yes
772477797210161152,  tonydaria69, 2, 2, 0, yes
74422212,  ugosorr, 1, 1, 0, yes
801080699017170944,  La_Stefy6, 1, 1, 0, yes
116803999,  raffaele_trano, 3, 1, 2, no
754297913522659328,  KeenaMamba, 1, 1, 0, yes
1186407192,  medigliagiovani, 8, 5, 3, yes
503303760,  secondobarbero, 1, 1, 0, yes
796464365050494976,  biko6655, 1, 1, 0, yes
157357753,  Luiginewton, 1, 1, 0, yes
596739356,  c2jfk, 7, 7, 0, yes
3057407321,  DimundoEmanuele, 1, 1, 0, yes
371231813,  playboy199189, 2, 2, 0, yes
458738784,  denisdigiorgi, 5, 5, 0, yes
717713995,  machetilamenti, 5, 3, 2, yes
1329384000,  NewsAbruzzo, 5, 3, 2, yes
2222041907,  FrankMininno, 2, 2, 0, yes
2276043234,  giovmur, 2, 2, 0, yes
3311610921,  LMule89, 1, 1, 0, yes
1895201935,  preds67, 1, 1, 0, yes
1063251018,  alberocane, 1, 1, 0, yes
3127900121,  burgmas, 3, 3, 0, yes
958331552,  makadatoxaxvias, 1, 1, 0, yes
24632965,  adeadcrab, 1, 1, 0, yes
396467245,  ClaudiaGiunti, 10, 10, 0, yes
371825725,  giulianomanzi, 7, 7, 0, yes
1583613260,  MartyO13, 7, 7, 0, yes
2603107446,  PinnaDennis, 1, 1, 0, yes
602217677,  MichelaDiBiase1, 1, 1, 0, yes
3131644312,  TecnoconfEU, 1, 1, 0, yes
773161233033924609,  Ezio412285591, 1, 1, 0, yes
390526122,  MarcucciMassimo, 5, 5, 0, yes
268793564,  InEsplorazione, 7, 6, 1, yes
1040512933,  bisigno81, 4, 4, 0, yes
802598027265540096,  Franco37582700, 1, 1, 0, yes
576216226,  michiplus89, 1, 1, 0, yes
4754020667,  de940981a8ad458, 1, 1, 0, yes
1109906076,  MauryFabiani, 2, 2, 0, yes
485741768,  Stefano_Gugliot, 2, 2, 0, yes
553859404,  saverionapoli76, 3, 2, 1, yes
993283524,  emonti87, 1, 1, 0, yes
1192578464,  eliomenna57, 7, 4, 3, yes
2786310392,  The_Last_Gasp, 4, 1, 3, no
3369127809,  IreneBrin2015, 7, 3, 4, no
1058606282,  RosellaCalzola, 1, 1, 0, yes
92734271,  webgraffiti_it, 1, 1, 0, yes
2847080404,  lithece, 1, 1, 0, yes
1066309460,  torreborraco, 2, 1, 1, neutral
319271486,  AlessioPecoraro, 6, 6, 0, yes
390568786,  gvv1965, 1, 1, 0, yes
743565574555504641,  francescospuma_, 3, 1, 2, no
2518725797,  alexdalex5, 5, 3, 2, yes
988451100,  finapo, 1, 1, 0, yes
2820527567,  gpcosti, 5, 3, 2, yes
1330069440,  ItCalabrese, 4, 4, 0, yes
761228645008609281,  gianfra26938850, 11, 11, 0, yes
595878183,  danbertsamp, 53, 23, 30, no
595627313,  AngelaFrigo, 1, 1, 0, yes
55283902,  GiacomoMancini, 1, 1, 0, yes
423610783,  JacopoMendie, 2, 2, 0, yes
2511259762,  adriana_bonini, 3, 3, 0, yes
1166058295,  nlamieri, 3, 3, 0, yes
722122786936856576,  simyjeming, 1, 1, 0, yes
715979798275821568,  romeoscorze, 5, 5, 0, yes
853516549,  entropia7612, 2, 2, 0, yes
22188018,  yo22gi, 2, 2, 0, yes
2459351590,  CarloMonteporzi, 8, 8, 0, yes
186369811,  gialni1968, 1, 1, 0, yes
361270492,  1964chiara, 1, 1, 0, yes
246668793,  LEYPOLITICA, 1, 1, 0, yes
178659273,  gianlucasberna, 3, 3, 0, yes
2295579267,  ariannasb74, 1, 1, 0, yes
2306619133,  lovelydays_, 2, 2, 0, yes
30656303,  fragaz, 1, 1, 0, yes
702011921160134656,  emmadellapietra, 1, 1, 0, yes
746960805288099842,  Liliana94375134, 20, 17, 3, yes
805108710435684354,  LoreVoce, 1, 1, 0, yes
86311986,  SilvaNadalLlera, 3, 3, 0, yes
778206337171873792,  pirimesin, 4, 4, 0, yes
579701946,  PMicarelli, 4, 3, 1, yes
2493423698,  euro_coma, 6, 3, 3, neutral
400344549,  taigaJPark, 1, 1, 0, yes
720687098592956416,  GiulioMenegol75, 1, 1, 0, yes
765908695054155777,  vale_cr95t, 5, 3, 2, yes
64789750,  marcoavvo, 5, 1, 4, no
3290368415,  AmicucciClaudia, 4, 2, 2, neutral
793808702323191808,  brucherisab, 2, 2, 0, yes
469403750,  grizia3, 2, 2, 0, yes
511534517,  sorriso1971, 4, 3, 1, yes
803974869415292929,  AmiciDiAdesso, 8, 8, 0, yes
4874924663,  federica_dbs, 3, 3, 0, yes
4894920933,  daft08923026, 2, 2, 0, yes
2600620115,  GiulioPollina, 1, 1, 0, yes
1154119261,  barabeke, 5, 5, 0, yes
969945894,  ChiaraRicchetti, 13, 13, 0, yes
55704769,  immigrationflow, 1, 1, 0, yes
387002787,  umbgrassi, 1, 1, 0, yes
780806706066395136,  TamaraFiorot, 4, 3, 1, yes
495448614,  martino_andre, 2, 2, 0, yes
3304540408,  Elena_Rovereto, 3, 3, 0, yes
1061111934,  m_bevere, 2, 2, 0, yes
1916472936,  ScompaTek, 1, 1, 0, yes
380849323,  LuanaFerrar, 1, 1, 0, yes
786481498660626432,  benedetto_lopre, 14, 13, 1, yes
999571362,  SabinaMoscatell, 3, 3, 0, yes
148777893,  donadventures, 1, 1, 0, yes
3076855880,  SaSaulruss, 2, 2, 0, yes
375745210,  DomenicoFiore92, 7, 7, 0, yes
482288004,  Scagnetti_, 1, 1, 0, yes
203434097,  pmondia, 2, 2, 0, yes
781833692096372736,  durante_c, 3, 3, 0, yes
454365633,  scenarieconomic, 1, 1, 0, yes
2236140732,  e_fantoni, 1, 1, 0, yes
115309076,  l14366, 2, 2, 0, yes
735062260847136769,  puffo84, 7, 7, 0, yes
366698775,  Wasimj96, 2, 2, 0, yes
1313991374,  Oscar_Maggioli, 3, 3, 0, yes
703872863665782784,  sianigiovanni16, 1, 1, 0, yes
899524722,  resta_filippo, 1, 1, 0, yes
122033909,  crifusa, 1, 1, 0, yes
2892298719,  luciabruno113, 14, 4, 10, no
3972317955,  _fraash_, 8, 7, 1, yes
805085216306040832,  Elisabe45420555, 1, 1, 0, yes
557074159,  ImmaIavarazzo, 14, 1, 13, no
2770527339,  manfruito, 4, 3, 1, yes
272992559,  xavierberujon, 2, 2, 0, yes
408068270,  kkvignarca, 14, 9, 5, yes
123921424,  RoryMacMahon, 3, 3, 0, yes
842336256,  PeppeV25, 1, 1, 0, yes
214160814,  adivince, 2, 2, 0, yes
2762614546,  luca75cocco, 1, 1, 0, yes
2219331032,  ivanopolit, 6, 6, 0, yes
356182393,  s3rcp02, 4, 4, 0, yes
784166239,  efte1987, 2, 2, 0, yes
791171156489408512,  Tigro99371447, 4, 1, 3, no
1408543448,  SimoneCosimi, 3, 3, 0, yes
1162650138,  MStramandinoli, 1, 1, 0, yes
122718347,  nunziocdg, 1, 1, 0, yes
4216847229,  IlDlOC4NE, 1, 1, 0, yes
803338438070169600,  Giusepp47458019, 1, 1, 0, yes
753960561386352641,  under36mbd, 6, 6, 0, yes
748447839215321088,  PepiArmando, 2, 2, 0, yes
701167259813879808,  BartoloniAmedea, 6, 6, 0, yes
796057348435542020,  TonyUncas, 3, 3, 0, yes
1369176474,  GUIDOdipp, 2, 2, 0, yes
462393889,  masaniellosan, 1, 1, 0, yes
1205164044,  Natxo_Saenz, 1, 1, 0, yes
373887841,  kisskissnapoli, 24, 16, 8, yes
3946464974,  kosukekunishi, 1, 1, 0, yes
1372167474,  Antonio78g, 13, 8, 5, yes
563892736,  BinItalia, 1, 1, 0, yes
375170652,  Stefy_1987, 5, 4, 1, yes
795243203104538624,  BrunettiTania, 3, 3, 0, yes
366761086,  darkside671, 3, 3, 0, yes
1528704474,  chloebboobs, 4, 4, 0, yes
481311669,  DLogrie, 5, 5, 0, yes
2382563042,  Mario_Basciani, 2, 2, 0, yes
2509416930,  DedagroGrosso, 1, 1, 0, yes
160134649,  mitico_alex, 6, 3, 3, neutral
99913258,  MarcoMirabile, 1, 1, 0, yes
2828463887,  pbbnev, 3, 3, 0, yes
3031188244,  erolo66, 24, 22, 2, yes
828366277,  LozSeaman, 5, 5, 0, yes
918347246,  stefanoesposi19, 1, 1, 0, yes
211918972,  nunziopara, 1, 1, 0, yes
105422399,  francivale, 3, 2, 1, yes
962955534,  Deborahpiac, 7, 5, 2, yes
3171369615,  tnicola86, 1, 1, 0, yes
712981333224595456,  faithwiski, 2, 2, 0, yes
200093749,  Frenky_Loso, 2, 2, 0, yes
2949319450,  li_note_neo, 3, 3, 0, yes
396874129,  francescopepici, 5, 5, 0, yes
999487596,  conteblaze, 1, 1, 0, yes
371451913,  Annathelion, 17, 16, 1, yes
802855006307319808,  Sonia070607, 1, 1, 0, yes
921713318,  claudia_mastro, 2, 2, 0, yes
315206594,  Paolo_Foschi, 2, 1, 1, neutral
182767371,  adriscm, 11, 6, 5, yes
791746557515272192,  vindav59, 5, 5, 0, yes
378635004,  IvanBartolomeo, 1, 1, 0, yes
525364699,  GiuseppedeloDe, 3, 2, 1, yes
468304135,  LemmaAndrea, 8, 8, 0, yes
269321658,  lamaketu, 1, 1, 0, yes
391957545,  fabriziosilvest, 1, 1, 0, yes
2964444107,  Guido59845442, 2, 2, 0, yes
1470458840,  DtDonatella, 4, 4, 0, yes
780806706066395136,  TestaDiCalcio1, 4, 4, 0, yes
803646164105039872,  MarcoNatalizi, 1, 1, 0, yes
798434518025781248,  McDonaldTrumpe, 1, 1, 0, yes
3074786519,  seren_verre, 8, 8, 0, yes
3309238635,  MentinaEnrico, 1, 1, 0, yes
705835156054134785,  carmine581, 7, 7, 0, yes
1065983292,  dangelo1050, 1, 1, 0, yes
799728105896214529,  Tinopa1, 2, 2, 0, yes
7950242,  sergioragone, 5, 4, 1, yes
3629872875,  jan_schroeder56, 1, 1, 0, yes
751670545041788928,  brigittinaa, 2, 2, 0, yes
1731196412,  elisalatino, 1, 1, 0, yes
797753885364486144,  Enrico94987430, 5, 5, 0, yes
758022631773863936,  Monkey201082, 2, 2, 0, yes
39079629,  pantheramed, 1, 1, 0, yes
801353728175509505,  AlejandroScie26, 3, 3, 0, yes
398586508,  benedettocucine, 1, 1, 0, yes
420454893,  IreneGuarrella, 3, 3, 0, yes
241544501,  paolardavid, 1, 1, 0, yes
755882445367566336,  PatriziaRenzi3, 9, 7, 2, yes
1377048103,  skywalker_1968, 1, 1, 0, yes
3402520873,  purada0412, 2, 2, 0, yes
2316632732,  _Acqua_Cheta, 1, 1, 0, yes
60266856,  GiacomoMaria, 2, 2, 0, yes
955966339,  paolozapp, 10, 8, 2, yes
492443919,  Nespega, 1, 1, 0, yes
360663852,  28952, 1, 1, 0, yes
490598325,  EmanueleTSavoia, 2, 1, 1, neutral
755147154759512064,  Nico62386572, 1, 1, 0, yes
2948943329,  AlfonsoParisa, 8, 8, 0, yes
3121299317,  salvacaldarone, 11, 11, 0, yes
51827092,  estakhriam, 2, 2, 0, yes
391342139,  vincentorsini, 1, 1, 0, yes
526832298,  mariacarpanini, 2, 2, 0, yes
884261850,  mhantonini, 1, 1, 0, yes
462843097,  MartinaPignate1, 2, 2, 0, yes
2365252169,  BoccardoFabio, 9, 9, 0, yes
711317541084381184,  rognetta1952, 1, 1, 0, yes
2948667406,  5747695b8d3147e, 2, 2, 0, yes
330469712,  ECiangherotti, 1, 1, 0, yes
483057595,  WebGinMovimento, 3, 1, 2, no
4856775351,  riccard35883667, 7, 6, 1, yes
4165127721,  SilviaZanetti98, 1, 1, 0, yes
715782891586908160,  renziVattene, 11, 11, 0, yes
735435149882601473,  Valter_Matola, 1, 1, 0, yes
507717518,  stelviogentile, 1, 1, 0, yes
596841827,  GiuliaGyhugyhu, 2, 2, 0, yes
3001239377,  michebrune1, 16, 13, 3, yes
736166324028768256,  esmecarlino, 13, 11, 2, yes
736880955374325761,  davidelungus, 12, 10, 2, yes
3124283242,  happyanto64, 2, 2, 0, yes
486876996,  openetwork_it, 10, 8, 2, yes
2226692812,  Guerrag61G, 1, 1, 0, yes
1332043525,  s_brac, 1, 1, 0, yes
113185359,  eleofabbroni, 5, 5, 0, yes
131961987,  minocarriero, 2, 2, 0, yes
824715074,  ferdinandodim, 8, 8, 0, yes
4061034316,  Raffytrieste, 4, 4, 0, yes
559499000,  GiuseppeSulfaro, 2, 2, 0, yes
226221652,  MarcoD82, 6, 6, 0, yes
775421050054139906,  soggiggi, 11, 10, 1, yes
226618187,  alepinto910280, 1, 1, 0, yes
1262566346,  valeria_ci, 16, 2, 14, no
85171931,  GnuFabio, 9, 8, 1, yes
387329231,  kr73pa, 6, 6, 0, yes
704371812407316481,  Tommaso_Didimo, 3, 3, 0, yes
2895710387,  Mickberna93, 6, 6, 0, yes
3543817995,  onofrio1976, 1, 1, 0, yes
620728311,  saparsonic, 1, 1, 0, yes
4098439161,  Les_fleurs2mal, 6, 5, 1, yes
15255207,  ninoesposito69, 6, 4, 2, yes
975716743,  Sandybaylor2, 3, 3, 0, yes
803605838049013760,  marina69132268, 1, 1, 0, yes
802626063662772224,  Niki1908Niki, 1, 1, 0, yes
799733071721406468,  potius1, 4, 4, 0, yes
4262741963,  geroterrito, 1, 1, 0, yes
713184048,  zanzarina14, 1, 1, 0, yes
719180243240677376,  JacopoParente02, 1, 1, 0, yes
2904990087,  marepotter, 3, 3, 0, yes
253631664,  capitanun, 2, 1, 1, neutral
488423574,  NSigaro, 7, 6, 1, yes
177942819,  Letiziamls, 2, 2, 0, yes
378621183,  BestPaolo, 3, 3, 0, yes
501934382,  MarcoTaichi, 1, 1, 0, yes
1376818658,  ARRIGOLANDI, 8, 7, 1, yes
753935465712087040,  Galluc1995, 1, 1, 0, yes
710245497194323969,  luca_genicco, 10, 10, 0, yes
824889726,  Bruss1163, 1, 1, 0, yes
1085803328,  NiccolAko, 2, 2, 0, yes
1039175150,  g_curti, 2, 2, 0, yes
735765372293382144,  SIMilanoNavigli, 1, 1, 0, yes
3074596101,  romidelg, 1, 1, 0, yes
2489608477,  Roby2014SS, 3, 3, 0, yes
67283912,  massimobrugnone, 8, 7, 1, yes
2367055176,  AlexColavitti, 2, 1, 1, neutral
831251114,  MaurizioSmorti, 2, 2, 0, yes
418802563,  RobyVava, 1, 1, 0, yes
928159321,  giovanniartillo, 1, 1, 0, yes
718336279260307457,  Lavex61, 12, 12, 0, yes
4783184315,  Bragadin16, 1, 1, 0, yes
47327484,  juanpapel, 1, 1, 0, yes
260313178,  marcodesteph, 1, 1, 0, yes
3482470821,  lokoloko711, 7, 3, 4, no
779422751002099712,  mauro5base, 1, 1, 0, yes
196601786,  dottorbona, 1, 1, 0, yes
408246656,  massimoscaleia, 9, 4, 5, no
423349502,  alespata488, 4, 3, 1, yes
96551123,  sigardi, 5, 5, 0, yes
406869976,  PaoloGentiloni, 5, 5, 0, yes
4038670067,  RosaTulle6, 6, 6, 0, yes
2825034274,  gep40, 1, 1, 0, yes
1065238962,  nazzabellesi, 1, 1, 0, yes
2301029686,  lucianavventura, 1, 1, 0, yes
3631168101,  pomelena67, 1, 1, 0, yes
734197338596618240,  zarabirsha, 1, 1, 0, yes
914256042,  FedeCicchinelli, 1, 1, 0, yes
746759531045195780,  comunegioialive, 1, 1, 0, yes
362522804,  turchettienrico, 1, 1, 0, yes
791198107568578560,  ef1b91c263ca4c8, 1, 1, 0, yes
290576899,  imlaar, 1, 1, 0, yes
581783951,  ToniniFranco, 1, 1, 0, yes
14840618,  benmalaussene, 1, 1, 0, yes
596507825,  caps_banfi, 2, 2, 0, yes
2960465626,  191_331, 3, 3, 0, yes
749963389,  Annamariacarmen, 11, 11, 0, yes
2377247953,  fonzi1975, 1, 1, 0, yes
393550837,  sigtacchino, 1, 1, 0, yes
142669688,  xPREY74x, 4, 4, 0, yes
356735555,  FilippoLagana, 1, 1, 0, yes
4436949681,  oxilnovo, 2, 2, 0, yes
2626859321,  givers9, 1, 1, 0, yes
449562276,  FilosaMarco, 1, 1, 0, yes
198945230,  Mattia_Fadda, 3, 3, 0, yes
776154541289070596,  BastaUnSiTs, 3, 3, 0, yes
1037498256,  ZIVO99, 1, 1, 0, yes
2745302313,  AngelaFusaroli, 2, 2, 0, yes
242482632,  milglc, 1, 1, 0, yes
62071167,  mattiamattia, 6, 4, 2, yes
2363967955,  plinscky, 1, 1, 0, yes
783570205108604928,  cornermikeitaly, 1, 1, 0, yes
484158845,  davidealgebris, 4, 4, 0, yes
4902555711,  pgreco125, 1, 1, 0, yes
2924455714,  mrosaria1974, 10, 7, 3, yes
1262508870,  iBavato, 1, 1, 0, yes
4866958593,  dinatale_cinzia, 21, 19, 2, yes
3114706373,  AzraAzraalic, 2, 2, 0, yes
96368645,  Massicum, 1, 1, 0, yes
447382738,  paoneantonio, 3, 3, 0, yes
801793584026554369,  Roberto86182054, 1, 1, 0, yes
419861596,  MrStupendo78, 1, 1, 0, yes
264858209,  robertasocci, 1, 1, 0, yes
2724131603,  MBonMaurizio, 5, 5, 0, yes
755865615836020736,  davforthefuture, 6, 6, 0, yes
1154237778,  Gnp74, 8, 8, 0, yes
116743111,  dgiorgio73, 5, 4, 1, yes
494147560,  mauroperuzzo1, 1, 1, 0, yes
1947278862,  Elessar2412, 10, 10, 0, yes
768715835183693824,  SandraChiaraF, 2, 1, 1, neutral
700423516794056704,  HadzovicMuharem, 2, 2, 0, yes
2340699060,  SalvaCastiglia, 2, 2, 0, yes
4054328842,  vittorioPagnoz1, 6, 5, 1, yes
783414598082916352,  ccrispino861, 1, 1, 0, yes
4217818427,  simontaxxi, 1, 1, 0, yes
788075385267314688,  JhonLoyyle, 1, 1, 0, yes
713149162209017856,  LdrLucky75, 1, 1, 0, yes
471971193,  75Davide, 9, 8, 1, yes
803269530147553280,  Ciro15061982, 4, 4, 0, yes
939663067,  home_marco, 4, 4, 0, yes
8119512,  facciapiatta, 4, 4, 0, yes
2344039777,  leosant87, 8, 5, 3, yes
2780350163,  BackAngelo, 10, 10, 0, yes
802835587837415428,  LaSfigaTiSegue, 2, 2, 0, yes
861058987,  mycroft_79, 1, 1, 0, yes
485903140,  Girl_FormulaOne, 4, 4, 0, yes
944616122,  taglialatela7, 1, 1, 0, yes
354349202,  PasqualeMarongi, 10, 10, 0, yes
1006044900,  RCodini, 7, 7, 0, yes
3088789403,  bruto015, 5, 5, 0, yes
3293750699,  andrearivelli1, 2, 2, 0, yes
81099715,  gianbubi, 1, 1, 0, yes
779066811941781504,  MarcoRm81, 2, 2, 0, yes
603770814,  romano_giova, 3, 3, 0, yes
2400484641,  silviavalente_, 1, 1, 0, yes
1150375867,  sambo_matt, 1, 1, 0, yes
4867636829,  me_desaparecido, 1, 1, 0, yes
3155712406,  Fraanto2, 1, 1, 0, yes
597780846,  GiulioVelletri, 1, 1, 0, yes
1630775174,  davborto, 1, 1, 0, yes
805860684173086720,  Daniela29122016, 2, 2, 0, yes
454920726,  monic_chiara, 1, 1, 0, yes
54496528,  vittoriozincone, 2, 2, 0, yes
526758106,  DAVEPAZZAGLIA, 1, 1, 0, yes
2845526283,  antoniobucci281, 2, 2, 0, yes
770009519254536192,  marko_cann, 1, 1, 0, yes
525479700,  nplfnc, 1, 1, 0, yes
805869011946926081,  elena_bentini, 2, 2, 0, yes
434272476,  DirkMarienfeld, 4, 3, 1, yes
200310833,  rivoluzione76, 1, 1, 0, yes
2263294183,  jbtissot, 2, 2, 0, yes
782163778817363968,  giubi7, 3, 2, 1, yes
2222178930,  Onuitalia, 1, 1, 0, yes
951216578,  gabanan1, 3, 3, 0, yes
4182092081,  Mic81_2013, 3, 3, 0, yes
795358524809367554,  CiroInGiro, 2, 1, 1, neutral
804232472477233152,  michele33735283, 2, 2, 0, yes
981989335,  enpao55, 2, 2, 0, yes
1119691334,  PiDav1969, 1, 1, 0, yes
3006601383,  milly782009, 6, 6, 0, yes
1065153530,  Mastiff48, 3, 3, 0, yes
450621858,  CorradoConfa, 1, 1, 0, yes
3413519735,  justaphotobj, 5, 5, 0, yes
2336290420,  matibooks, 2, 2, 0, yes
2434070997,  gx_gio, 1, 1, 0, yes
256198020,  francina007, 1, 1, 0, yes
1552489903,  giampiserafini, 1, 1, 0, yes
766983575707144192,  draconiforsx, 2, 2, 0, yes
180004814,  matiaspiazza, 7, 7, 0, yes
1074397933,  adrianofila, 1, 1, 0, yes
2393209665,  LucaLucastefy, 2, 1, 1, neutral
805796955767107584,  zambelettig, 1, 1, 0, yes
805880374798807040,  ia_paolo, 6, 6, 0, yes
47978197,  peuca, 1, 1, 0, yes
833545501,  steidro, 2, 2, 0, yes
4235917456,  claudiabestia2, 2, 2, 0, yes
880401740,  pasqualemazzei3, 1, 1, 0, yes
2811550769,  Giovann_Ramundo, 1, 1, 0, yes
805919161679548422,  Giulian68118293, 1, 1, 0, yes
23196966,  C_mat, 3, 3, 0, yes
1265157986,  MichaelOnTwitt, 1, 1, 0, yes
47449932,  SilviaRigacci, 3, 3, 0, yes
69250714,  Davideeee, 2, 2, 0, yes
3085347732,  MinaLonigro, 1, 1, 0, yes
923671178,  adami_antonio, 52, 51, 1, yes
1080657504,  carminecapoccia, 2, 2, 0, yes
771936129591414784,  Laquaglia1, 1, 1, 0, yes
2506823304,  PoggialiAlessio, 2, 2, 0, yes
496439143,  lugargano, 2, 2, 0, yes
2172574355,  simonemargarese, 1, 1, 0, yes
827585288,  lumacapop, 5, 4, 1, yes
3294876563,  mondini_ca, 2, 2, 0, yes
778337514524409857,  Luca19738043, 1, 1, 0, yes
147938415,  giovanni_sali, 1, 1, 0, yes
3096953386,  iole_ioleperr, 1, 1, 0, yes
3303241126,  ef97d3e33fca439, 3, 1, 2, no
3423683705,  cuorechevive, 2, 2, 0, yes
170044601,  claudiovittori, 1, 1, 0, yes
2252812821,  FranciOggino, 4, 4, 0, yes
3063043545,  CriticalMassR, 6, 3, 3, neutral
4853498398,  Boss_Caino, 1, 1, 0, yes
2723099309,  GiovRss, 4, 4, 0, yes
233999812,  mariogreco91, 3, 3, 0, yes
3806452282,  aproserp, 1, 1, 0, yes
1563068839,  Alberto_SdC, 2, 2, 0, yes
98875589,  silviade_marchi, 3, 3, 0, yes
759380139713163264,  Alishams1000, 2, 2, 0, yes
60409480,  EnricoSerotti, 2, 2, 0, yes
805173019706617856,  foolangel85, 1, 1, 0, yes
2352321186,  283mari, 4, 4, 0, yes
22804777,  SuperStefman, 1, 1, 0, yes
365664894,  miticofabio98, 8, 8, 0, yes
800971386,  mattiaricci8, 2, 2, 0, yes
480670025,  puffoodioso, 1, 1, 0, yes
2452415854,  VincenzoFederi8, 2, 2, 0, yes
461019019,  giusyoni, 15, 13, 2, yes
795757734,  Vale_Juve95, 1, 1, 0, yes
2585137203,  lenci_francesco, 2, 2, 0, yes
1065118284,  vulcanosturlini, 9, 9, 0, yes
498191944,  neri_valeria, 3, 1, 2, no
452382482,  fcaras_fc, 4, 3, 1, yes
2509164609,  SergiorossiGit, 2, 2, 0, yes
1052389141,  1983SB, 1, 1, 0, yes
804677642922446848,  alexfiloni, 1, 1, 0, yes
579407462,  Girardmarcelle, 1, 1, 0, yes
3361173604,  lorenasecco, 3, 3, 0, yes
2346399766,  lucaval71, 3, 3, 0, yes
2742810029,  dorettafiore, 1, 1, 0, yes
2315513468,  ferrarirossa97, 3, 3, 0, yes
946268443,  GigiPrestanicol, 1, 1, 0, yes
805838947100360704,  GiovannaScanu83, 1, 1, 0, yes
510548559,  Raffaele_78, 2, 2, 0, yes
1045968192,  robertosharan, 1, 1, 0, yes
845951149,  LReggi, 1, 1, 0, yes
1224784388,  StefanoZagnoni, 1, 1, 0, yes
66298874,  peppedimiccoli, 9, 3, 6, no
1239929210,  mixo1965, 2, 2, 0, yes
2990670934,  marmilrose71, 1, 1, 0, yes
768940585243799552,  Alessan34845919, 1, 1, 0, yes
371192549,  Tweet_Pub, 1, 1, 0, yes
4899280048,  massimo17564, 4, 4, 0, yes
1220779908,  alexperotti74, 1, 1, 0, yes
15630381,  anamorfo, 1, 1, 0, yes
2355749232,  EsciDalBlogBepp, 3, 3, 0, yes
2986474576,  maglione5stelle, 1, 1, 0, yes
805818122104086532,  onorinadevito95, 1, 1, 0, yes
2166627741,  BenedettoRupe, 2, 2, 0, yes
2758210086,  Gasco66Gasco, 1, 1, 0, yes
478995914,  beppemg60, 4, 1, 3, no
2626156881,  MartaRamat, 4, 4, 0, yes
796774926166491136,  emanuelaqua61, 4, 4, 0, yes
2194637036,  MazzoccoMike, 1, 1, 0, yes
4218351261,  lucapelle72, 1, 1, 0, yes
2166635091,  Nicol_B_, 1, 1, 0, yes
206804813,  Antosimbula, 2, 2, 0, yes
613746177,  KevinMaurizi, 2, 2, 0, yes
726583206,  franlazzin, 2, 2, 0, yes
337334877,  Scheber1960, 5, 5, 0, yes
43322330,  FashionPurist, 1, 1, 0, yes
4738687402,  flavia_solina, 1, 1, 0, yes
1884220010,  SoniaVincenzi, 2, 2, 0, yes
16182995,  cosmic53, 4, 1, 3, no
125272120,  giudip, 1, 1, 0, yes
933124879,  petrone_angela, 1, 1, 0, yes
543379040,  simobatt70, 2, 2, 0, yes
805879348968439809,  gio1057, 1, 1, 0, yes
179966511,  ALFONS86, 1, 1, 0, yes
2737293437,  GhizzinardiLuca, 1, 1, 0, yes
517389774,  Max_Puccio, 7, 3, 4, no
478620288,  1mamy1, 2, 2, 0, yes
2946408573,  forzayuve98, 6, 6, 0, yes
2334987709,  francesco_pen, 2, 2, 0, yes
2380751802,  smontanaro1, 2, 2, 0, yes
397437514,  cinziasalimbene, 1, 1, 0, yes
497765702,  rubinia2, 1, 1, 0, yes
410034826,  PaoloBonaiti, 2, 2, 0, yes
20172466,  italia4stelli, 1, 1, 0, yes
2182263817,  LAM1552, 1, 1, 0, yes
3200304341,  iladerossi, 1, 1, 0, yes
615303191,  anghpel, 4, 1, 3, no
588975097,  mariannamadia, 2, 2, 0, yes
400480143,  ddalbroi, 5, 4, 1, yes
1956171698,  carmelomiceliPD, 5, 5, 0, yes
506449892,  biffignandi, 2, 2, 0, yes
428108756,  RitaRoncone, 3, 3, 0, yes
2163669030,  cbettinelli76, 1, 1, 0, yes
1560674570,  SGianfri, 2, 2, 0, yes
805814550079668228,  EleonoraC63, 2, 2, 0, yes
1461667334,  extrasmall_, 1, 1, 0, yes
206202531,  Criladaisy, 1, 1, 0, yes
1860543804,  ileana1954, 1, 1, 0, yes
365622822,  Tagliola85, 5, 4, 1, yes
146065455,  Beppe1977, 1, 1, 0, yes
409335640,  Blitz_chi, 1, 1, 0, yes
3125803247,  JCSPAKO, 5, 3, 2, yes
602961831,  vincenzareale1, 1, 1, 0, yes
476224626,  Gianciarla, 11, 8, 3, yes
798803459201855489,  elenabonato31, 1, 1, 0, yes
4927258641,  paolastella13, 1, 1, 0, yes
988879908,  s_giacomet, 1, 1, 0, yes
2280807893,  GiorgiaGuiggi, 4, 4, 0, yes
3012543173,  AlbyCoso, 3, 3, 0, yes
403066516,  CiroGrande, 2, 2, 0, yes
4258813169,  cabritaloca15, 1, 1, 0, yes
108648019,  dbchiara, 2, 2, 0, yes
1158208939,  peppec2008, 1, 1, 0, yes
3246716987,  PietroLozar, 1, 1, 0, yes
790228543557005312,  DanieleFrizzar4, 1, 1, 0, yes
1318996693,  domenica_nicol, 3, 3, 0, yes
440775164,  AlbinotMaloku, 1, 1, 0, yes
377469691,  Faby_Mare, 6, 6, 0, yes
3089989211,  manusimoncini1, 4, 4, 0, yes
2372509834,  elipaletta, 1, 1, 0, yes
477824206,  seriuled, 1, 1, 0, yes
2392065983,  maurizio_pozzi, 2, 2, 0, yes
2415687292,  FrettaGabriella, 2, 2, 0, yes
2389476284,  cristiano280870, 2, 2, 0, yes
289807592,  paolofierli, 2, 2, 0, yes
3075234466,  filidonna54, 1, 1, 0, yes
1862710801,  gordinic1, 4, 2, 2, neutral
1105706282,  fm1611, 1, 1, 0, yes
345532190,  AngeTra, 9, 7, 2, yes
195008649,  timisboredaf, 3, 3, 0, yes
396873985,  marchinovogogna, 3, 2, 1, yes
741657488597110784,  CharlieLucky8, 5, 5, 0, yes
252521566,  quadrogreg, 1, 1, 0, yes
400396749,  DarioErmini1, 2, 1, 1, neutral
805829905397252096,  CaputoTommaso2, 2, 2, 0, yes
566164108,  MarcoSarde94, 2, 2, 0, yes
2435365823,  569a6167a1fa49b, 1, 1, 0, yes
482114630,  graziaaffatato, 2, 2, 0, yes
231884158,  rolantoti, 1, 1, 0, yes
773186778035519488,  paolopozzi77, 1, 1, 0, yes
603916241,  MaurizioMaubriz, 2, 2, 0, yes
1484402124,  luci_stefano, 1, 1, 0, yes
756771079981522944,  DanielaDodo2016, 3, 1, 2, no
2755564521,  lettera2116, 1, 1, 0, yes
1071552558,  brucaliffo10, 1, 1, 0, yes
1359219932,  freccia42, 4, 4, 0, yes
736878312,  lserranoconde, 2, 2, 0, yes
567341959,  AlfredodiPadova, 1, 1, 0, yes
1876618392,  lauretta7369, 4, 2, 2, neutral
1085940314,  dinoferrauto, 1, 1, 0, yes
393636301,  patrik8cesc, 1, 1, 0, yes
2357757948,  FabioVena1971, 1, 1, 0, yes
398744062,  paolothegame, 2, 2, 0, yes
812735148,  pdtalenti, 2, 2, 0, yes
519359559,  AdrianaSalvi, 3, 2, 1, yes
806055172694806528,  pasqualepap1, 3, 3, 0, yes
421399609,  fersalvetti, 1, 1, 0, yes
804403354793340928,  InPiazzetta, 1, 1, 0, yes
472237736,  PietroSpedale, 2, 2, 0, yes
2874133337,  giosalo32, 2, 2, 0, yes
2357646337,  GuadaVarese, 1, 1, 0, yes
749954289989189632,  pieroromano81, 1, 1, 0, yes
806102087314575360,  Guglielmocalam1, 3, 3, 0, yes
806105832819658752,  Franz2470, 1, 1, 0, yes
1282843482,  SereniChiara, 2, 1, 1, neutral
1900248146,  RBombonato, 1, 1, 0, yes
568123118,  predator185071, 16, 16, 0, yes
556156225,  _Alma95, 1, 1, 0, yes
549344896,  timangio, 3, 2, 1, yes
619744018,  MassimoCosta11, 1, 1, 0, yes
354549311,  bulloli, 2, 2, 0, yes
3116015123,  rckdngrs, 1, 1, 0, yes
449868263,  elisa_casa, 1, 1, 0, yes
805882760690827265,  Pietrovet1987, 1, 1, 0, yes
2865977735,  mgaidone, 31, 27, 4, yes
1451023909,  MaurizioRicca1, 2, 2, 0, yes
261457119,  princicocco, 2, 2, 0, yes
414903464,  FPinarelli, 1, 1, 0, yes
4854936225,  _romabella_, 1, 1, 0, yes
3309391685,  pr129438, 7, 7, 0, yes
372732095,  CrissiTango, 2, 2, 0, yes
2358682797,  angyboy76f, 1, 1, 0, yes
2974006916,  ariannadue, 1, 1, 0, yes
912437736,  agolabella, 1, 1, 0, yes
2175541839,  LucriIlVolo99, 1, 1, 0, yes
1035974762,  Geodanilo73, 3, 2, 1, yes
345284647,  calipso_f, 1, 1, 0, yes
801738577545719808,  CeciliaPetru94, 2, 2, 0, yes
2601624727,  allegramentesem, 1, 1, 0, yes
721931076088827904,  FranciMrl, 2, 2, 0, yes
2753477415,  fmed__, 2, 2, 0, yes
799310020903137281,  luteleg, 1, 1, 0, yes
3438166155,  Gianfryfs, 2, 2, 0, yes
3373673675,  SilviaFalanga1, 4, 4, 0, yes
16032768,  ukos, 1, 1, 0, yes
989321461,  MaurizioMei1, 6, 3, 3, neutral
1441562438,  NicholasVita990, 1, 1, 0, yes
2611798281,  GaHagrid, 2, 2, 0, yes
133417160,  viaggifidel, 1, 1, 0, yes
1885987513,  Trapassi17, 3, 3, 0, yes
394304488,  MartianLouise, 1, 1, 0, yes
2418452590,  Official_MICRO, 1, 1, 0, yes
804692403923910657,  Paola51382901, 2, 2, 0, yes
4703457437,  d4a1991b9c4a479, 5, 4, 1, yes
1254636811,  pakyaut, 1, 1, 0, yes
2593842138,  Sepsa90, 1, 1, 0, yes
3544295843,  iessi_gabriele, 1, 1, 0, yes
1218826147,  flaviodeluca19, 4, 3, 1, yes
496200636,  Lucia_Boh, 1, 1, 0, yes
4048414942,  Luigi92994033, 2, 1, 1, neutral
733697810751729664,  Marti_Scolari, 2, 2, 0, yes
952372789,  RivGian, 1, 1, 0, yes
586075861,  aarc83, 1, 1, 0, yes
396566809,  lillamargo, 1, 1, 0, yes
383401806,  FBlaso, 1, 1, 0, yes
1065319921,  V_Panzera, 2, 2, 0, yes
141552396,  MarcoVannucci, 7, 7, 0, yes
1063570993,  corrytri, 1, 1, 0, yes
192353315,  niccolofalomi, 5, 5, 0, yes
1093070466,  buccinicl, 1, 1, 0, yes
731108440144248832,  Med83852063, 5, 5, 0, yes
1960527751,  FortunatoDeni, 1, 1, 0, yes
132133028,  antoniodballaro, 1, 1, 0, yes
351727087,  NNic169N, 1, 1, 0, yes
2267393306,  ignaciozanettin, 1, 1, 0, yes
2212449568,  F7DE_7_, 2, 2, 0, yes
3842545463,  vincenzo1081, 2, 1, 1, neutral
862910370,  elBosetti, 2, 2, 0, yes
3038537723,  Rizzi1980, 1, 1, 0, yes
135259165,  inFocusDC, 1, 1, 0, yes
2855767750,  lcana69, 1, 1, 0, yes
2302079794,  RazvanMarian458, 1, 1, 0, yes
198089759,  TwittingThom, 1, 1, 0, yes
4256665371,  pinomasterboy, 4, 4, 0, yes
775529738,  agus83_andrea, 1, 1, 0, yes
2294122020,  stemegaiven, 3, 2, 1, yes
2921940052,  giulivirdis, 5, 5, 0, yes
28533668,  fransyk, 2, 2, 0, yes
599850928,  simonesto, 1, 1, 0, yes
806025325582880768,  Beppe48568213, 1, 1, 0, yes
1127964432,  ribicm, 1, 1, 0, yes
352331515,  FrangipaneGiorg, 1, 1, 0, yes
1931510983,  valletta_elena, 3, 3, 0, yes
2270497896,  giafosch, 1, 1, 0, yes
2301175841,  neve_anna, 5, 5, 0, yes
4256871616,  GloriaLolli52, 1, 1, 0, yes
573752958,  rob3m0, 3, 3, 0, yes
636587517,  sssuperbabbo, 2, 2, 0, yes
2842002796,  giara57, 1, 1, 0, yes
3010886349,  EmilioMuccio, 1, 1, 0, yes
6066832,  inertia_rules, 1, 1, 0, yes
1072385041,  gjoez, 1, 1, 0, yes
2220323296,  bonuramartina, 2, 2, 0, yes
53046364,  GianFreee, 2, 1, 1, neutral
2444119618,  VurchioLuca, 1, 1, 0, yes
1010945840,  CBises, 4, 4, 0, yes
1928314573,  m5s_polverigi, 1, 1, 0, yes
988596602,  emanuelaroccati, 2, 2, 0, yes
831716515,  EnricoTrieste1, 1, 1, 0, yes
60867626,  ByteHitchhiker, 1, 1, 0, yes
228460354,  sereluca, 1, 1, 0, yes
795157914789052416,  Eu_Capo, 2, 2, 0, yes
760503124545138688,  Nikkyp82, 3, 3, 0, yes
2917225906,  Rosy09627668, 1, 1, 0, yes
2346474790,  lucio_luccosmo, 1, 1, 0, yes
3294369287,  MarIntroini, 5, 5, 0, yes
2359495127,  Sara20834931, 1, 1, 0, yes
466338008,  AttilioPiglia, 1, 1, 0, yes
1296504841,  ApPravato, 1, 1, 0, yes
2740757854,  Pasc93, 3, 3, 0, yes
3025765624,  save_seui, 1, 1, 0, yes
269974355,  borrecaste, 1, 1, 0, yes
803949681722228737,  eri_fier86, 2, 2, 0, yes
916487064,  duespillo, 3, 2, 1, yes
2358370745,  SamiCarobbio, 2, 2, 0, yes
4052676983,  Caterina61262, 3, 3, 0, yes
2983889771,  JBBlutarsky, 1, 1, 0, yes
1275350982,  GraziaLuci, 5, 5, 0, yes
598528444,  MarikaPatuelli, 3, 3, 0, yes
379706102,  lapo43, 3, 3, 0, yes
1026457428,  HakulinenMaria, 7, 6, 1, yes
1102931556,  andrea_garrone, 2, 2, 0, yes
336999671,  Giandonato1, 1, 1, 0, yes
2494222351,  SIMONET83026306, 2, 2, 0, yes
107969632,  BENEDETTA132, 1, 1, 0, yes
223175550,  ugopisano, 1, 1, 0, yes
1480526342,  ziopapes, 2, 2, 0, yes
718132284,  _namelessmich_, 1, 1, 0, yes
770259488502845440,  dbuenosal, 3, 3, 0, yes
1278542719,  robizanco, 1, 1, 0, yes
244188027,  diwa1300, 1, 1, 0, yes
711189629316239361,  bettyventuri67, 1, 1, 0, yes
2696504742,  poz63, 3, 3, 0, yes
960542310,  AlbeRossetti, 5, 4, 1, yes
512304421,  luciasweet11, 1, 1, 0, yes
745251786378838016,  ronzio96, 4, 4, 0, yes
4923954136,  algarlaschelli1, 4, 4, 0, yes
805820200998371328,  salernogos1961, 1, 1, 0, yes
560964986,  EnzoPapier1, 1, 1, 0, yes
396739976,  EVendramini, 3, 3, 0, yes
2725056976,  antondebe, 8, 8, 0, yes
768652987677933568,  ServiceMachser, 1, 1, 0, yes
903668870,  GhiaStefano, 1, 1, 0, yes
163026460,  stefanopit78, 2, 2, 0, yes
728933115322900481,  antocit68, 2, 2, 0, yes
805830147970629633,  nicolapapapicc, 1, 1, 0, yes
472327553,  SusannaBallerio, 2, 2, 0, yes
2187301480,  melarara1, 5, 5, 0, yes
2364866266,  giovanna_cau, 1, 1, 0, yes
218663068,  giuseppesollami, 3, 3, 0, yes
1977292003,  hackersid65, 1, 1, 0, yes
1157830542,  ale_segatto, 1, 1, 0, yes
1647683820,  marcella_bovero, 1, 1, 0, yes
2973132557,  flaviacarpitel, 1, 1, 0, yes
593462506,  TatianaRomanini, 1, 1, 0, yes
4289338888,  CassisiGianni, 1, 1, 0, yes
1418424246,  ElioPacilli, 3, 3, 0, yes
2361441598,  Pani53Pani, 2, 2, 0, yes
3290277827,  AdryAntoniucci, 2, 2, 0, yes
794253910085140491,  nicolas_brcrd, 2, 2, 0, yes
2365515958,  lellarivy, 2, 2, 0, yes
23046635,  ildaguanno, 2, 2, 0, yes
2677180819,  barbarosa69, 1, 1, 0, yes
397169325,  giuseppe_nocera, 1, 1, 0, yes
720307466576248832,  lcoianizeu, 4, 3, 1, yes
4047008831,  _Kr4zy_, 1, 1, 0, yes
1109787068,  LucaSforziniArt, 1, 1, 0, yes
4046161715,  CarloRivers87, 2, 2, 0, yes
118436472,  MargheritaBosca, 1, 1, 0, yes
566600058,  gabryago, 1, 1, 0, yes
410041048,  A_Musil, 4, 4, 0, yes
2250757714,  ClaudiaLeali, 1, 1, 0, yes
3248079646,  RaffaeleMeroll1, 1, 1, 0, yes
2338611488,  ConstantinusXI, 1, 1, 0, yes
171022666,  Varchi85, 1, 1, 0, yes
2364379428,  capobiancoart, 1, 1, 0, yes
416701098,  _miriam_AT_fan, 3, 3, 0, yes
2462541359,  RobertoGalassi3, 4, 4, 0, yes
802770632,  ValeriaStefan17, 2, 2, 0, yes
14183430,  albertomotta, 2, 2, 0, yes
1055724014,  garfilacrepus, 1, 1, 0, yes
540743461,  m_chiaar, 1, 1, 0, yes
636062345,  Luca_Episcopo, 2, 2, 0, yes
2680027245,  StefanoSalaroli, 14, 12, 2, yes
3949404681,  stemerziballini, 1, 1, 0, yes
745623258,  nikiebri, 1, 1, 0, yes
452779546,  UmbertoMancino, 1, 1, 0, yes
2243192349,  tijeroam, 2, 2, 0, yes
525314813,  eloise_41, 1, 1, 0, yes
429390726,  miainter222, 1, 1, 0, yes
3940192775,  DannyStradiotto, 1, 1, 0, yes
469538008,  FraDeRu, 1, 1, 0, yes
805912838195777536,  dequalunquibus, 2, 2, 0, yes
443794900,  MassimoTallari1, 1, 1, 0, yes
453507812,  Tagliobasso, 1, 1, 0, yes
3299061533,  AnnaMaffi75, 1, 1, 0, yes
2338081003,  persianwolf1, 3, 3, 0, yes
1425825901,  fuoriportaweb, 1, 1, 0, yes
889249333,  albertosca68, 1, 1, 0, yes
783035081116049409,  salvatoredavola, 4, 1, 3, no
197369064,  igor_cappello, 1, 1, 0, yes
3231724695,  ff2207a14a7a457, 1, 1, 0, yes
127861545,  clairespanish, 2, 2, 0, yes
712356892945866758,  knwes85, 1, 1, 0, yes
589396414,  astancolle, 2, 2, 0, yes
48345770,  GiuseppeCortese, 2, 2, 0, yes
45217308,  smauz007, 6, 5, 1, yes
1106896303,  SergioFallucca, 4, 3, 1, yes
3413087163,  NNanella, 1, 1, 0, yes
337158527,  tvrgfl49, 2, 1, 1, neutral
524632668,  EmaGibilaro, 3, 3, 0, yes
104940172,  aiJFor, 2, 2, 0, yes
496737943,  emivitola, 1, 1, 0, yes
805531788332466176,  MercedesDiretto, 2, 2, 0, yes
405594332,  KatRinakor, 3, 3, 0, yes
744169435955625984,  EConsolati55, 7, 6, 1, yes
2529344180,  StaffoliC, 5, 4, 1, yes
45662302,  arnocast, 2, 2, 0, yes
558390919,  costantini1891, 1, 1, 0, yes
948799580,  robriksrl, 1, 1, 0, yes
806123647719112706,  AndreaMasula, 1, 1, 0, yes
131236751,  PupiParis, 5, 2, 3, no
1369230955,  Martis_Mars_, 7, 5, 2, yes
946462916,  CosimoRenna1, 1, 1, 0, yes
3657726321,  vedonudo, 3, 3, 0, yes
1011639912,  ninoconforto, 1, 1, 0, yes
501122906,  Asso_di_Quadri, 3, 2, 1, yes
22628958,  sirenadellopera, 1, 1, 0, yes
791346102977069057,  CICCIUZZU511, 2, 2, 0, yes
480531574,  __clizia, 1, 1, 0, yes
620546533,  herrlichmann, 1, 1, 0, yes
553368112,  simrad79, 3, 2, 1, yes
268365318,  PDGrosseto, 2, 2, 0, yes
320612641,  russo_aldo, 1, 1, 0, yes
433392707,  vanandrix79, 1, 1, 0, yes
751364672,  CookMcBacon, 6, 6, 0, yes
2758708829,  dariorossi2809, 1, 1, 0, yes
3400166723,  fabio021071, 1, 1, 0, yes
393310803,  pierluigi_me, 3, 3, 0, yes
127140587,  diegocammiller, 1, 1, 0, yes
3081011259,  raffaeledemelas, 1, 1, 0, yes
3014216859,  MLombardi1962, 1, 1, 0, yes
2628383675,  Pierlippolis, 1, 1, 0, yes
2801618074,  apmorabito_anna, 1, 1, 0, yes
928120466,  antonio37372998, 1, 1, 0, yes
805742689190875136,  antonio55006914, 1, 1, 0, yes
405093185,  sabatinom2011, 1, 1, 0, yes
16363651,  letiziajaccheri, 1, 1, 0, yes
805781422795620354,  Roby114425, 1, 1, 0, yes
285091698,  liles68, 1, 1, 0, yes
99992756,  wolverix78, 1, 1, 0, yes
805562324824289281,  DavidTorelli72, 1, 1, 0, yes
516539671,  RosellaSchiro, 1, 1, 0, yes
71001402,  spiderv, 1, 1, 0, yes
838016479,  88Boy2004, 1, 1, 0, yes
3173266109,  FresiaTigre, 1, 1, 0, yes
318934586,  lolllo72, 1, 1, 0, yes
4686169034,  zangelinajolie1, 4, 4, 0, yes
198434105,  IGGIUSTI, 1, 1, 0, yes
529582171,  LorenzoGuzzoni, 1, 1, 0, yes
2511911640,  LRossari, 1, 1, 0, yes
3338421766,  rosannacola, 5, 5, 0, yes
453720551,  lisadagliocchib, 3, 3, 0, yes
2160805950,  chiarantinucci, 1, 1, 0, yes
1483228362,  rickycerro, 2, 2, 0, yes
4860406042,  ac731c24c328446, 1, 1, 0, yes
2190405630,  marmir85, 1, 1, 0, yes
932023963,  PaoloCuccia, 1, 1, 0, yes
2206490493,  emmeastore, 1, 1, 0, yes
130826021,  MAURA72, 7, 5, 2, yes
2942526931,  DOttaviRosanna, 1, 1, 0, yes
1710348528,  luc798, 4, 4, 0, yes
98839812,  emagiardina, 2, 2, 0, yes
392600721,  eddyvespafo, 1, 1, 0, yes
2192714352,  virico58, 2, 2, 0, yes
795565851265159168,  vviola14, 5, 2, 3, no
43282628,  marco_meschieri, 3, 3, 0, yes
2263822269,  FranzGardella, 1, 1, 0, yes
434957693,  salerno_lucia, 2, 2, 0, yes
342930272,  sherlcockholmes, 5, 5, 0, yes
78730534,  S17S, 1, 1, 0, yes
628388101,  desirauhl, 3, 3, 0, yes
948121993,  bobon64, 1, 1, 0, yes
2358238396,  Deb_beba, 2, 2, 0, yes
3428649292,  Monica89307566, 1, 1, 0, yes
1423888142,  HyunMoon_, 1, 1, 0, yes
499653980,  ermescardy, 2, 2, 0, yes
2753616771,  GessyFo, 1, 1, 0, yes
110512600,  Albertopesce94, 1, 1, 0, yes
90760446,  SilviaGi_, 2, 2, 0, yes
2889946193,  newsitalialive, 2, 2, 0, yes
2207339461,  Cir8x, 1, 1, 0, yes
1812202452,  Gatta_Vale, 1, 1, 0, yes
805875940442177537,  Andrea190670, 2, 2, 0, yes
4414214297,  Giamp15, 1, 1, 0, yes
30304111,  d0minius, 1, 1, 0, yes
3428693765,  ere_ernesto, 2, 2, 0, yes
396426637,  P3droFavale, 1, 1, 0, yes
152965422,  liberti97, 1, 1, 0, yes
79781325,  SteffiMaf, 3, 3, 0, yes
805875189443530752,  Nico722326, 4, 4, 0, yes
338003489,  AnnalisaDemuro, 3, 3, 0, yes
307233953,  PippoFilippo, 7, 6, 1, yes
799713470782414849,  gabriellaciri, 1, 1, 0, yes
2663677899,  MeriCukali, 1, 1, 0, yes
1389017366,  cocca1952, 1, 1, 0, yes
383094338,  barragato, 1, 1, 0, yes
1252824816,  auglig, 1, 1, 0, yes
325170333,  Mark_Parenti, 3, 3, 0, yes
612592648,  guidorvitale, 1, 1, 0, yes
1127738533,  DeanGiovanni, 1, 1, 0, yes
805821738948894720,  Alessan10387874, 1, 1, 0, yes
402637348,  Immaaallocca, 2, 2, 0, yes
942319154,  peter302022, 2, 2, 0, yes
3081348035,  cronitaliana, 5, 5, 0, yes
2867962101,  gigisava99, 1, 1, 0, yes
805837253692059648,  francisconicla1, 1, 1, 0, yes
991446290,  dariodf70, 1, 1, 0, yes
388839409,  Air_Wizard, 1, 1, 0, yes
200743464,  Nimrod38, 5, 5, 0, yes
2361343700,  colonnasmp, 1, 1, 0, yes
2308565144,  gmangatia, 1, 1, 0, yes
1849298862,  sergio_troise, 11, 11, 0, yes
2877945867,  Lorelladiceno, 2, 1, 1, neutral
2380750730,  dinobellussi, 1, 1, 0, yes
805557175930286080,  Ele_Caparello87, 1, 1, 0, yes
2227503239,  CaturanoSavio, 1, 1, 0, yes
984095078,  raffafer_65, 1, 1, 0, yes
620296965,  XSocialMediaLab, 1, 1, 0, yes
289932581,  mailla1955, 2, 2, 0, yes
17211295,  Piero_Strada, 4, 3, 1, yes
713471756238000128,  bragacristina2, 1, 1, 0, yes
86544451,  paolaberardi, 3, 3, 0, yes
1690264164,  Itasta100, 2, 2, 0, yes
806080612809527296,  antoniodenigri5, 1, 1, 0, yes
150631104,  luciosway, 1, 1, 0, yes
2987541862,  clementinca1, 1, 1, 0, yes
803569989676662784,  Caty60763947, 4, 4, 0, yes
1052426527,  mrcprtpn, 1, 1, 0, yes
793159612736430080,  carlofrizzi1, 1, 1, 0, yes
800514080,  GiuseppeM8, 2, 2, 0, yes
298486860,  filippocannioto, 5, 4, 1, yes
799293821515399168,  vincenzocardeni, 1, 1, 0, yes
498345547,  RSarpone, 4, 2, 2, neutral
600042534,  nurse_rosy, 6, 6, 0, yes
713807893875843072,  BaroffioCarla, 3, 3, 0, yes
160838142,  lupettorosso76, 1, 1, 0, yes
1601839914,  AngelBiccari, 3, 3, 0, yes
1163402599,  angelo_lionetti, 3, 3, 0, yes
2148569547,  rosanna_tedesco, 4, 4, 0, yes
510597929,  schillacisilvio, 4, 4, 0, yes
476847259,  manto300875, 1, 1, 0, yes
379338454,  jacopospacagna, 2, 2, 0, yes
715284283749974016,  GiulioSiamoNoi, 5, 5, 0, yes
1940364450,  AlikBeats, 1, 1, 0, yes
2734420354,  StoppaAntonio, 2, 2, 0, yes
153723618,  Andreaciv, 1, 1, 0, yes
443366090,  olivia_rossetti, 1, 1, 0, yes
1923498710,  GagginiLara, 1, 1, 0, yes
104551647,  POOHLOVER66, 2, 2, 0, yes
954009594,  lucaleandrin, 2, 2, 0, yes
4544396435,  e_c_o_c, 5, 1, 4, no
105184158,  filippomarsella, 4, 3, 1, yes
234815796,  nikonot, 3, 3, 0, yes
1620434077,  melitia_, 13, 13, 0, yes
2716420332,  giulioderrico94, 7, 6, 1, yes
2822852759,  luci_chia, 6, 6, 0, yes
291763976,  sciltian, 7, 2, 5, no
2408921980,  enonmollaremai, 3, 3, 0, yes
796336318087364608,  saccavinogiuli1, 2, 2, 0, yes
513708863,  SalvatoreMauro3, 1, 1, 0, yes
2322889134,  MarchesaVonS, 4, 4, 0, yes
3240905590,  69377083f84444d, 2, 2, 0, yes
798606296027189252,  Fabio60469852, 1, 1, 0, yes
2902705120,  g1a1b1r1y1, 3, 3, 0, yes
802444898762981376,  DavideRandisi, 1, 1, 0, yes
847892292,  marcomr75, 9, 9, 0, yes
324951114,  Fra_cegra84, 3, 3, 0, yes
963106586,  biccarese, 1, 1, 0, yes
1894735952,  ChiaraLimpida, 1, 1, 0, yes
753299006659371008,  to1cross, 1, 1, 0, yes
440099769,  viorica_grecu, 2, 2, 0, yes
12275882,  paperogha, 2, 2, 0, yes
34652704,  Zufiria, 5, 4, 1, yes
87677127,  MarX_77, 3, 1, 2, no
2439810651,  349a581eabb4403, 2, 2, 0, yes
1227754856,  andreaf7777, 4, 2, 2, neutral
1071927644,  barbararizzi68, 1, 1, 0, yes
431603447,  artigianindipen, 8, 8, 0, yes
1460038452,  Doc_luca, 1, 1, 0, yes
294563959,  fabioamato3, 1, 1, 0, yes
3412167435,  massimorigo16, 1, 1, 0, yes
750375628994711552,  auropaolini, 1, 1, 0, yes
3544963937,  LanfossiM, 2, 2, 0, yes
4895233605,  angiespro, 1, 1, 0, yes
3612812669,  pietrobrz, 1, 1, 0, yes
801512564366647296,  LucaArcangeloM, 2, 2, 0, yes
1226026806,  RinoPappacena, 1, 1, 0, yes
2283531689,  birbadiunbirba, 1, 1, 0, yes
422995676,  albertomtx, 3, 2, 1, yes
3207812481,  clarinaldini, 1, 1, 0, yes
3084810567,  Dodo_17098, 2, 2, 0, yes
112410952,  claudiomiglia, 1, 1, 0, yes
785552040244154368,  Angela62518086, 2, 2, 0, yes
252316883,  toma171254, 6, 6, 0, yes
833057377,  marioalbanese1, 1, 1, 0, yes
802970820561793024,  simone_balestri, 1, 1, 0, yes
477838959,  NicolaTuvo, 1, 1, 0, yes
136960523,  ChiccaAsRoma, 4, 3, 1, yes
2407663642,  MariinRima, 3, 3, 0, yes
3402336711,  Annabenvenuti5, 10, 10, 0, yes
748866523675197441,  Guido12719209, 6, 6, 0, yes
408329555,  PatryMarras, 2, 2, 0, yes
1164320118,  UngattoperTutti, 1, 1, 0, yes
396216950,  franci10maggio, 1, 1, 0, yes
569820566,  Is1977Roberto, 2, 2, 0, yes
319885436,  CristianIsmelli, 1, 1, 0, yes
42478291,  luifam, 8, 7, 1, yes
855213282,  onderadio1, 3, 2, 1, yes
428601367,  Andredpi, 7, 2, 5, no
2806094501,  mariafatima1967, 6, 6, 0, yes
2626236131,  clioscopetani, 4, 4, 0, yes
1621368146,  dinamoandrej, 15, 6, 9, no
862598437,  GianniPiazzolla, 2, 2, 0, yes
130491225,  pietroroberto, 3, 2, 1, yes
798296107600191496,  SilviettaGB, 3, 3, 0, yes
83241797,  sasacannao, 1, 1, 0, yes
1033180843,  Nemesio1945, 5, 5, 0, yes
818068309,  isymi87, 1, 1, 0, yes
114477009,  claudio010678, 1, 1, 0, yes
619162465,  Antinea2001, 4, 3, 1, yes
497131561,  rossi_va, 1, 1, 0, yes
904616450,  larossa_gilda, 1, 1, 0, yes
516483255,  Paola64Paola, 3, 2, 1, yes
759714475696021504,  sarettarm82, 4, 4, 0, yes
773507831890845696,  giaccoangelo, 6, 6, 0, yes
747013354116489217,  rosannapignate2, 1, 1, 0, yes
539343953,  GiovanniMarras4, 1, 1, 0, yes
247155813,  rachlefyhelvide, 4, 3, 1, yes
464064917,  AleLolli72, 2, 2, 0, yes
1480178468,  LaVenittelli, 3, 3, 0, yes
613624250,  CoiettePappas, 1, 1, 0, yes
893488326,  TammaNicola, 4, 2, 2, neutral
564935726,  cangiano77, 3, 3, 0, yes
803643203270414336,  marioangelo1963, 1, 1, 0, yes
453373634,  byby1972, 1, 1, 0, yes
444979812,  GabrieleM93, 3, 3, 0, yes
2928117832,  Gianna23193640, 1, 1, 0, yes
371714243,  giorgiopasotti, 1, 1, 0, yes
3304767448,  macoxygene, 6, 6, 0, yes
3027161610,  Dante30Gc, 2, 2, 0, yes
454925098,  thomaspiccio, 1, 1, 0, yes
377410041,  FrancescoArbato, 3, 3, 0, yes
815373541,  lorenzocontab, 2, 1, 1, neutral
264718231,  renatoserao, 2, 2, 0, yes
384176532,  GiovannaGio85, 4, 4, 0, yes
796802534367170560,  Vane91674549, 4, 4, 0, yes
528771969,  MarcoPetrangeli, 1, 1, 0, yes
240118613,  luis0tta, 6, 5, 1, yes
198907056,  Anto_Nicoli, 2, 1, 1, neutral
128471504,  pisani41, 5, 5, 0, yes
3293324296,  BahistasClaudio, 2, 1, 1, neutral
760749655554744320,  SilvioSrd, 3, 3, 0, yes
708832844995555328,  creanza_sandra, 2, 1, 1, neutral
399428387,  degal73, 2, 2, 0, yes
705852604807581696,  picamenantonio, 2, 2, 0, yes
2423095641,  malvo_v, 6, 6, 0, yes
705801203687530496,  GIOVANN44703236, 1, 1, 0, yes
1241030965,  giacomomilillo, 1, 1, 0, yes
593709833,  MMorgando, 1, 1, 0, yes
409518132,  Alessio_1973, 2, 1, 1, neutral
125097961,  AmirAissaoui7, 13, 13, 0, yes
244911038,  NICOVENDOME55, 4, 2, 2, neutral
803962713307222020,  Garby8021, 1, 1, 0, yes
2919610629,  Adrianomarzo76, 1, 1, 0, yes
3399065008,  fernandohz55, 10, 4, 6, no
3912089235,  MassimoCicale, 12, 11, 1, yes
506344878,  danicutro, 1, 1, 0, yes
2360369831,  giuliano_signo, 1, 1, 0, yes
102388755,  decarola, 1, 1, 0, yes
444612914,  DanieleColonna, 8, 3, 5, no
2525599681,  bagnacouda, 6, 6, 0, yes
410040461,  biblos65, 8, 2, 6, no
1632398988,  dariofranco61, 2, 2, 0, yes
3066574037,  e66ae6f721d946f, 1, 1, 0, yes
351843456,  mauro_odk, 11, 9, 2, yes
4719189449,  xTommy1995, 2, 2, 0, yes
3883790117,  venetocattolico, 1, 1, 0, yes
784111878918332416,  RiggallGio, 1, 1, 0, yes
342352609,  riccardoliso, 3, 3, 0, yes
284657297,  lostrappo, 7, 5, 2, yes
1347003716,  agneseadele, 2, 2, 0, yes
2449278295,  avv_Calabria, 1, 1, 0, yes
55862897,  alex_orlowski, 1, 1, 0, yes
382863674,  vettosil, 2, 2, 0, yes
795327852870778880,  servino_angela, 5, 4, 1, yes
498090294,  BBWIN1, 1, 1, 0, yes
111799776,  calaris, 4, 3, 1, yes
800747658893660160,  DCaraglia, 5, 5, 0, yes
1039871592,  jurimarini, 6, 6, 0, yes
459219814,  LaBruzzy, 11, 7, 4, yes
14443284,  francescosacco, 1, 1, 0, yes
1472638976,  ImmaEvan, 7, 3, 4, no
2566632783,  giudibari, 2, 2, 0, yes
2371645673,  gabbriG, 2, 2, 0, yes
425686235,  NFratoianni, 8, 5, 3, yes
2769827087,  allovato3, 6, 6, 0, yes
2417781063,  manculuditu, 1, 1, 0, yes
2277568157,  Dalpha42, 4, 1, 3, no
374573871,  culodibrendon, 1, 1, 0, yes
394848411,  antoniolc55, 3, 3, 0, yes
2934936809,  BigattiFabio, 1, 1, 0, yes
475763891,  PcaputoCaputo, 3, 3, 0, yes
803775139968155648,  mykil44, 1, 1, 0, yes
2544433441,  MicheleAntoni12, 9, 9, 0, yes
453925278,  lynatweet, 1, 1, 0, yes
3410368912,  marioemarinella, 1, 1, 0, yes
1678602583,  doshancos, 1, 1, 0, yes
2475530527,  carlomazza5, 3, 3, 0, yes
795352135022051329,  cresheeda_98, 4, 4, 0, yes
388130010,  Enzogiorgio, 1, 1, 0, yes
442193839,  Lasher9, 7, 6, 1, yes
1734254454,  fedefarne1, 8, 6, 2, yes
3929040797,  mitacaterina, 1, 1, 0, yes
337555221,  48Gianna, 12, 12, 0, yes
1528759902,  Alburen, 14, 3, 11, no
789485254646038529,  faustocampis, 1, 1, 0, yes
805226096,  ViolaMorrone, 1, 1, 0, yes
3217797526,  ivanpoly74, 1, 1, 0, yes
398617489,  Fabio_Larosa_, 1, 1, 0, yes
4103471667,  ComunediCaluso, 5, 5, 0, yes
390819984,  Ale_DiLuzio, 5, 5, 0, yes
759021203247861760,  Mikcavaliere, 8, 8, 0, yes
380342179,  senso41, 3, 3, 0, yes
540025056,  scarplin, 2, 2, 0, yes
187950589,  bravalindait, 1, 1, 0, yes
483006753,  silviagrazzini, 11, 11, 0, yes
60749694,  Marco_Pazzaglia, 2, 2, 0, yes
4805595143,  iandolosilves, 4, 3, 1, yes
497714059,  bassarelli, 8, 8, 0, yes
2298294082,  romano_ciluzzi, 9, 4, 5, no
1748057000,  nmkweb, 2, 2, 0, yes
1183989451,  AndreaSoggiu1, 1, 1, 0, yes
3020280513,  dav_silvia, 1, 1, 0, yes
772776726002892800,  simo_bore, 1, 1, 0, yes
733660083326980100,  cardinardo, 1, 1, 0, yes
49319956,  davideprandi, 3, 2, 1, yes
2365649391,  NestolaGiorgio, 2, 2, 0, yes
2801528655,  bobdvc, 4, 4, 0, yes
773958025535229954,  sebyilmadator, 1, 1, 0, yes
989386320,  GMorardo, 1, 1, 0, yes
305141558,  VicendoneAndrea, 1, 1, 0, yes
396708377,  AdranoRossoNera, 2, 2, 0, yes
450585386,  luisabosco, 9, 3, 6, no
1131626191,  krush70, 1, 1, 0, yes
69554901,  rmc_official, 3, 3, 0, yes
370726988,  RmcNewsOfficial, 3, 3, 0, yes
311721221,  stephykamzy, 2, 2, 0, yes
135787456,  HaidiGarulli, 1, 1, 0, yes
3096657562,  BureiM, 1, 1, 0, yes
824533860,  JANPY_A, 7, 7, 0, yes
2276872121,  NadiaBedeschi, 1, 1, 0, yes
1182788720,  LAbbondanti, 3, 3, 0, yes
2949652168,  postiglioneang1, 4, 4, 0, yes
388206997,  ledaefrati, 1, 1, 0, yes
779036371608625153,  CapodoglioT, 2, 1, 1, neutral
3295357029,  joe_ital, 1, 1, 0, yes
718834510994006016,  aldo_carano, 1, 1, 0, yes
991153194,  AndPea, 2, 2, 0, yes
1252166347,  sammydago, 2, 2, 0, yes
2161809406,  juribettollini, 2, 2, 0, yes
2192645934,  AndreaConforti4, 1, 1, 0, yes
313218226,  MattiaMorbidoni, 8, 8, 0, yes
803074974,  r_pangrazi, 2, 2, 0, yes
719657108,  IsabellaOrfano, 1, 1, 0, yes
699650300089671680,  gianfrancop3, 4, 4, 0, yes
4012398209,  Simonet08667044, 1, 1, 0, yes
2902935382,  gmaneri1, 1, 1, 0, yes
516416030,  enrico_mondani, 8, 8, 0, yes
798875537565425666,  ferrentivincent, 1, 1, 0, yes
72382660,  ellebione, 1, 1, 0, yes
10280002,  claudioc, 3, 3, 0, yes
805567184244273152,  Ilenia19172297, 2, 2, 0, yes
60899235,  Marioperna, 5, 3, 2, yes
931488728,  JELENAVASILJE11, 5, 5, 0, yes
66315515,  gbarbacetto, 3, 3, 0, yes
78239997,  Beacher72, 1, 1, 0, yes
704010538842353664,  antoniosavio23, 7, 7, 0, yes
1368738852,  gabrieldenotari, 4, 4, 0, yes
471306404,  DaniloCiacelli, 1, 1, 0, yes
319126344,  AlessandroCecc1, 1, 1, 0, yes
2275421105,  LiaLromegialli, 1, 1, 0, yes
2198334809,  FerdyromRomano, 3, 3, 0, yes
2214106671,  carlo_peretti, 1, 1, 0, yes
805884719363661824,  giuseppe1680, 1, 1, 0, yes
1046104886,  francescamazzo, 5, 5, 0, yes
77340775,  wincris, 2, 2, 0, yes
428587953,  GensGiulia, 3, 2, 1, yes
802911788522151937,  irene_cocuzzi, 1, 1, 0, yes
805835064533811201,  caponi_giuseppe, 1, 1, 0, yes
262533672,  mdr1961, 1, 1, 0, yes
199817339,  enrico_do, 3, 3, 0, yes
2905323508,  averonese40, 1, 1, 0, yes
53924827,  Monkerland, 1, 1, 0, yes
3090442818,  chipswilliams1, 3, 3, 0, yes
3421721278,  giusibat, 1, 1, 0, yes
776860851164905472,  rotondogiancar1, 3, 3, 0, yes
3387707392,  vingol72, 1, 1, 0, yes
331811499,  giovannimarino1, 1, 1, 0, yes
186205091,  alvisedozza, 1, 1, 0, yes
1258944283,  silvianasi1, 2, 2, 0, yes
801854985524940801,  andreasettembr4, 1, 1, 0, yes
1665383634,  laradecunzo, 1, 1, 0, yes
3230152199,  elenagiugno61, 1, 1, 0, yes
2195890046,  ZanchiCristina, 1, 1, 0, yes
4897996695,  Rosanna44500587, 1, 1, 0, yes
526263626,  lilliilcanarino, 1, 1, 0, yes
133714175,  crisdz, 1, 1, 0, yes
763752205916770304,  mareazzurro16, 1, 1, 0, yes
150609011,  barkes1, 1, 1, 0, yes
84792336,  kriskinnan, 7, 4, 3, yes
1172952613,  Liciomacelloni, 1, 1, 0, yes
461985300,  moky_86, 1, 1, 0, yes
257559109,  ildocente, 1, 1, 0, yes
724327744780275717,  Cristin14767352, 1, 1, 0, yes
270826547,  montinen, 1, 1, 0, yes
407839063,  pfrascarelli, 1, 1, 0, yes
269334754,  alepagliantini, 1, 1, 0, yes
3646512615,  sabm1972, 1, 1, 0, yes
2610591821,  GGerardh, 16, 15, 1, yes
2848657641,  patriziatweet1, 1, 1, 0, yes
1448793222,  MarrettaS, 1, 1, 0, yes
4895506510,  mori_venanzio, 8, 8, 0, yes
174160371,  geoxmas, 1, 1, 0, yes
529644480,  TulipanoNero64, 2, 2, 0, yes
3412690750,  js_avvamericano, 3, 1, 2, no
290552355,  ImmaRomano, 1, 1, 0, yes
596833964,  darkzam89, 7, 2, 5, no
341051033,  BarbaraSterni, 2, 2, 0, yes
188916091,  Lorenzo_Genesis, 2, 2, 0, yes
3360860553,  dea_magister, 1, 1, 0, yes
779205582855213056,  Aurora07476480, 1, 1, 0, yes
916583503,  Mussmauer, 1, 1, 0, yes
3288969585,  marcof53, 4, 3, 1, yes
255944111,  barbacar, 1, 1, 0, yes
809346588,  RamanaMaharsi, 1, 1, 0, yes
1037982133,  danilobigi, 3, 1, 2, no
1069184802,  gb99999, 1, 1, 0, yes
3152410919,  Valerio_Lorenz, 2, 2, 0, yes
433472919,  Fenicesofia, 2, 2, 0, yes
343954859,  AuRory_, 1, 1, 0, yes
2326027237,  eh7_enri, 1, 1, 0, yes
494143463,  SaraSacchelli, 1, 1, 0, yes
2884682246,  alessandrabis1, 1, 1, 0, yes
2883472987,  peverieri80, 1, 1, 0, yes
503347544,  judartemide, 1, 1, 0, yes
2375550580,  riccettia1, 3, 3, 0, yes
1454932543,  RicresciItalia, 1, 1, 0, yes
805904541392715776,  AntoPeruffo, 1, 1, 0, yes
2758151231,  mariarosachi9, 4, 4, 0, yes
136700403,  antombazzo83, 2, 2, 0, yes
846194792,  p_licciardello, 1, 1, 0, yes
4872314811,  IFuligni, 1, 1, 0, yes
361886821,  rioser82, 1, 1, 0, yes
2459210002,  DiBruny, 1, 1, 0, yes
2889161313,  simoruvio, 1, 1, 0, yes
555408466,  vecchiocorvo, 9, 6, 3, yes
3288138993,  Frances29555004, 1, 1, 0, yes
68984712,  gorillablues, 1, 1, 0, yes
45146744,  exupper, 1, 1, 0, yes
1066895088,  mauro_arcangeli, 1, 1, 0, yes
805888396254150656,  Daniele6186, 1, 1, 0, yes
471211037,  SavelliSerena, 5, 5, 0, yes
1071718562,  beat_oven, 1, 1, 0, yes
463727974,  ANTONELLASPAGGI, 4, 4, 0, yes
266855450,  kekkobk, 6, 3, 3, neutral
440716047,  _tizianoslaugh, 2, 2, 0, yes
1596313639,  StMilandri, 1, 1, 0, yes
805794882069626881,  GalatiFloriana, 1, 1, 0, yes
348651203,  grechste, 1, 1, 0, yes
482200058,  7maMAS, 2, 2, 0, yes
838020062,  matteozuccon2, 1, 1, 0, yes
340972113,  LorenzoMiglior1, 29, 7, 22, no
2743636095,  OliMary1, 2, 2, 0, yes
4612696762,  spike_1973, 1, 1, 0, yes
805443539660394496,  mariaH2_0, 2, 2, 0, yes
86802454,  antgioia, 1, 1, 0, yes
4186407081,  chiara_ferro96, 2, 2, 0, yes
399711193,  lindacampani, 2, 2, 0, yes
371683080,  beeblu, 1, 1, 0, yes
16096774,  mamminad2, 1, 1, 0, yes
3126299189,  mettiumeconaghi, 1, 1, 0, yes
2917308922,  timetotime17, 1, 1, 0, yes
400207220,  pluto_74, 2, 2, 0, yes
500945141,  lmaraf, 1, 1, 0, yes
455076329,  UmbertodellaMar, 4, 4, 0, yes
2934362277,  IgnariLuciana, 1, 1, 0, yes
785132822000525312,  robflayer, 2, 2, 0, yes
899598481,  GiacintoFesta, 1, 1, 0, yes
72169143,  LauPerezCisnero, 1, 1, 0, yes
769692757,  AB875JV, 1, 1, 0, yes
1166757204,  GiorgiaRedaelli, 1, 1, 0, yes
860086070,  mrcrsu, 1, 1, 0, yes
796437696545718272,  _Giusss, 1, 1, 0, yes
813223982,  Giostegua, 1, 1, 0, yes
564069706,  NPRKelly, 1, 1, 0, yes
786952826211762177,  LiutMilena, 2, 2, 0, yes
568298608,  Stecaligola, 8, 2, 6, no
4063354959,  CocoCalzature, 1, 1, 0, yes
906010800,  CavallariGiulio, 2, 2, 0, yes
284107815,  cavallino0119, 1, 1, 0, yes
3031279703,  MaxgamMg, 1, 1, 0, yes
122030995,  CTodde, 5, 3, 2, yes
406636399,  LucaRicciardi94, 1, 1, 0, yes
2941129223,  Serghejthebest, 1, 1, 0, yes
90302266,  enriprof, 1, 1, 0, yes
503538437,  doffinid, 3, 3, 0, yes
4473209477,  teogaregnani, 1, 1, 0, yes
76461353,  vincenzolamanna, 2, 2, 0, yes
524741361,  B500Laura, 1, 1, 0, yes
132090376,  nicolemattew, 1, 1, 0, yes
3060193917,  Iosonoindignato, 6, 5, 1, yes
2368565725,  giannitala, 2, 2, 0, yes
723600471445897216,  cristina_nera, 1, 1, 0, yes
83900772,  vcardell, 1, 1, 0, yes
3007150403,  paoloragni1964, 2, 1, 1, neutral
4189424542,  lacodadelgatto, 1, 1, 0, yes
1097963750,  luigi_faiola, 2, 2, 0, yes
540296438,  GianniMantovi, 2, 2, 0, yes
2154881111,  AnnamariaLamura, 1, 1, 0, yes
243819751,  viviana_cozi, 2, 2, 0, yes
479410027,  letyfio, 1, 1, 0, yes
2768929786,  matteucci1965, 4, 4, 0, yes
742097369160908800,  ffone03, 1, 1, 0, yes
2952724245,  DarioSorre, 2, 2, 0, yes
1006949785,  gvignatg, 6, 1, 5, no
384914074,  FraFortinguerra, 2, 1, 1, neutral
446079805,  marco_calabro96, 1, 1, 0, yes
403405684,  LSpallino, 1, 1, 0, yes
384552588,  ilfidolopez, 4, 4, 0, yes
1082575249,  nicoleffes, 4, 4, 0, yes
1347748350,  nluchenti, 1, 1, 0, yes
4237807073,  maria_rocco16, 1, 1, 0, yes
2467159653,  lilnefertitties, 3, 2, 1, yes
2817821826,  giugimaio, 1, 1, 0, yes
1283354216,  enricoantignati, 3, 3, 0, yes
585113241,  CJN68, 1, 1, 0, yes
1305307284,  GiacoFore, 1, 1, 0, yes
802804101675384832,  BuzzoniFederico, 2, 2, 0, yes
531169902,  patriziachi, 1, 1, 0, yes
570844631,  SDelprato, 4, 4, 0, yes
487332189,  NuccioRic, 1, 1, 0, yes
3406074509,  gas_franco, 1, 1, 0, yes
326207248,  ettore22, 1, 1, 0, yes
1068700052,  GioRico5, 1, 1, 0, yes
184945190,  alecheru, 1, 1, 0, yes
444055310,  BZanna3, 1, 1, 0, yes
1288267278,  Giulia_DiG, 2, 2, 0, yes
464787657,  NoraGheri, 5, 3, 2, yes
264225627,  cris_s82, 1, 1, 0, yes
434864209,  NirvanaSamsara1, 5, 5, 0, yes
341184767,  tarikatid, 1, 1, 0, yes
776130429657186304,  OhmyOhmiya, 2, 2, 0, yes
805893058344714244,  RazziNando, 1, 1, 0, yes
838693075,  1395Hui, 10, 10, 0, yes
477764834,  RobertaZicari, 4, 4, 0, yes
346665712,  petersan883, 1, 1, 0, yes
805891190725996544,  Gioviper89, 1, 1, 0, yes
805560082083807232,  Mariaolmina, 4, 4, 0, yes
529380279,  pantera47001170, 2, 2, 0, yes
490591636,  mmidara, 1, 1, 0, yes
2759758145,  PosellaRoberto, 1, 1, 0, yes
1007527526,  giorgioruini, 1, 1, 0, yes
1069222621,  antoassogna, 1, 1, 0, yes
352899212,  Simo_Dal, 1, 1, 0, yes
2411949635,  blanco_michele, 9, 9, 0, yes
2999303645,  attac_italia, 1, 1, 0, yes
822095473,  LachegarL, 1, 1, 0, yes
444225252,  colvieux, 11, 2, 9, no
244134584,  elidina, 2, 2, 0, yes
2231198935,  angeliniguido1, 1, 1, 0, yes
793742589291790336,  xpradaornada, 3, 3, 0, yes
805664789343207424,  ritaspano48, 1, 1, 0, yes
82313419,  mahorchiche, 1, 1, 0, yes
801790275085598720,  MarcoSkipper2, 2, 2, 0, yes
231134468,  angelascarparo, 3, 3, 0, yes
2225190669,  TerryCisternino, 1, 1, 0, yes
427769644,  dieffe79, 2, 1, 1, neutral
759739273557843970,  Niccolot19, 1, 1, 0, yes
142589904,  mariofusco, 4, 4, 0, yes
789939794088456192,  Gia102, 2, 2, 0, yes
2580018522,  MirkoSR13, 1, 1, 0, yes
37653224,  kantauri, 2, 2, 0, yes
289820796,  kubotina, 1, 1, 0, yes
1690312585,  AlleRegg, 1, 1, 0, yes
527942368,  tiziana_oli, 5, 5, 0, yes
782185118152724480,  andreaz_2, 2, 2, 0, yes
82653459,  andreavicini, 1, 1, 0, yes
2226258544,  peppino_99, 1, 1, 0, yes
806042313143308289,  bbr25451, 1, 1, 0, yes
213205186,  frelimpio, 1, 1, 0, yes
2320558507,  serfiren, 2, 2, 0, yes
451562803,  laura__kateg, 1, 1, 0, yes
85844947,  vincithibaut, 2, 2, 0, yes
759091779375357952,  adele_rachele, 1, 1, 0, yes
3844243173,  Debby_Sprint, 6, 2, 4, no
806045948514340864,  MonicaStuyck, 1, 1, 0, yes
2969955742,  barbolini_b, 2, 2, 0, yes
774966094381613056,  Hawkippo, 1, 1, 0, yes
555001150,  marielladidi, 5, 4, 1, yes
1083310260,  michelangelotim, 2, 2, 0, yes
805830993017966593,  marilisa67, 2, 2, 0, yes
4587092963,  carbpie, 1, 1, 0, yes
2954778166,  FerrariFedagima, 1, 1, 0, yes
2263839233,  gporioli, 1, 1, 0, yes
89170651,  achille01, 2, 2, 0, yes
1972685804,  graziaianna, 2, 2, 0, yes
768885077069721600,  AngeloRalf66, 1, 1, 0, yes
1062302311,  RenascRenas, 2, 2, 0, yes
2618367742,  karmyo76, 1, 1, 0, yes
764543982521163777,  thedoo688, 1, 1, 0, yes
717816769,  Mela09_, 2, 2, 0, yes
2763500612,  luigidenigris, 3, 3, 0, yes
805850161457074180,  bonato_mauro, 1, 1, 0, yes
716402697327534080,  donatellaformi2, 1, 1, 0, yes
785068214430666752,  Krik2014, 2, 2, 0, yes
3097020185,  igorrossi81, 1, 1, 0, yes
1405110319,  NittiLuigi, 4, 4, 0, yes
799315558202220549,  elvisidame81, 2, 2, 0, yes
708733910377754625,  AcquariusN, 1, 1, 0, yes
705306192,  laMad0nna, 4, 2, 2, neutral
805850533181452288,  ladygodivaNA, 1, 1, 0, yes
2849567727,  CapMiky, 2, 2, 0, yes
107647855,  Thrasher86, 3, 3, 0, yes
906516434,  stefano_ceci, 1, 1, 0, yes
2783799928,  corra_davide, 3, 3, 0, yes
709371767,  XTOMMYAYY, 3, 2, 1, yes
3319345127,  gianluigi721, 1, 1, 0, yes
2361700232,  anto_e_erika, 3, 3, 0, yes
225957971,  joylutes, 2, 2, 0, yes
339596400,  annalisacarelli, 1, 1, 0, yes
455495174,  rpicchio, 1, 1, 0, yes
2769796480,  dimenza_g, 1, 1, 0, yes
4845527260,  BegginMarco, 1, 1, 0, yes
1191218358,  ElenaDC83, 1, 1, 0, yes
1080795937,  stefaniapezzopa, 20, 19, 1, yes
4186442691,  marinaott64, 1, 1, 0, yes
775798541679603712,  MarcoBarrera_, 3, 2, 1, yes
2299301118,  luigi_npl, 5, 5, 0, yes
77323487,  big_fly, 1, 1, 0, yes
586157904,  cirapinup, 2, 1, 1, neutral
31683399,  partedesopra, 1, 1, 0, yes
700115915,  asiachr, 1, 1, 0, yes
2391215367,  paolabergonzoni, 3, 3, 0, yes
2217883176,  PierreMonquet, 1, 1, 0, yes
1686177894,  Emmachampagne95, 2, 2, 0, yes
3899894777,  DEV4Ethic, 1, 1, 0, yes
805461886393270272,  roccogold_, 4, 4, 0, yes
255182357,  ValeMercanti, 8, 8, 0, yes
4236713747,  silvigiannett, 2, 2, 0, yes
1869080820,  Balestrisandra, 2, 2, 0, yes
430086357,  LiboDamiani, 1, 1, 0, yes
1270334324,  GabriLattari, 4, 4, 0, yes
585183645,  fseviareggio, 1, 1, 0, yes
520657885,  robby671, 8, 8, 0, yes
526899714,  lilipi3, 2, 2, 0, yes
794638263122358273,  Jacobstaywithm3, 3, 3, 0, yes
3007543721,  stefanom68, 3, 3, 0, yes
307960634,  nataliprodan, 8, 4, 4, neutral
802234083321479168,  adelelaura61, 1, 1, 0, yes
805748785892749312,  alfredino19, 1, 1, 0, yes
505054747,  nottedafavola, 4, 4, 0, yes
406139759,  aalina3, 3, 3, 0, yes
569789848,  CiappaGiuseppe, 3, 3, 0, yes
92226315,  AntonioVChanal, 1, 1, 0, yes
1423465328,  Leo_Dilengite, 1, 1, 0, yes
815934367,  emanu_mori, 7, 7, 0, yes
1063787468,  annazampa, 2, 2, 0, yes
746811384063737856,  Yennypm_81, 2, 2, 0, yes
256469568,  Rhinobear61, 4, 2, 2, neutral
291676545,  LucaGuarnaccia, 2, 2, 0, yes
3191120104,  OrizzBrasil, 2, 2, 0, yes
2410649945,  ChiaraBonacossa, 3, 3, 0, yes
3295946196,  MarchAntonella, 1, 1, 0, yes
413778440,  AvvFulvia, 5, 5, 0, yes
393525107,  HectorMackendy, 3, 3, 0, yes
475114249,  DanielePangallo, 1, 1, 0, yes
1112625564,  ChiapperinM, 1, 1, 0, yes
480547364,  SBACCHIONE, 2, 2, 0, yes
1354347576,  GiusPoliti, 1, 1, 0, yes
2238771392,  carlo040759, 2, 2, 0, yes
487026533,  EmkaraEmanuele, 2, 2, 0, yes
518744738,  mar_tinvb, 1, 1, 0, yes
609883387,  AleRanaldi, 2, 2, 0, yes
4871917449,  azraalicsaraje1, 5, 5, 0, yes
1024778318,  VendraminA, 3, 1, 2, no
812632291,  NicolaCorvi, 1, 1, 0, yes
1119721009,  elvecc, 1, 1, 0, yes
854645743,  NtsRaia, 1, 1, 0, yes
752238593742168064,  elia52414616, 2, 2, 0, yes
55505952,  GiorgioMariano, 1, 1, 0, yes
163269007,  morris_vincent, 1, 1, 0, yes
719484791545032704,  Giusepp15875444, 2, 2, 0, yes
4404028463,  federici_maria, 2, 2, 0, yes
99985577,  valebagnoli, 2, 2, 0, yes
382592657,  GiovanniCarullo, 1, 1, 0, yes
2219900067,  BBoccasso, 6, 6, 0, yes
774230772542734336,  dilvo_sfriso, 1, 1, 0, yes
785506067002318848,  cherylleebeach, 10, 10, 0, yes
2385207516,  Gliulia38398714, 1, 1, 0, yes
4242038183,  Belinaisreal, 5, 4, 1, yes
3018425415,  BilaEoE, 1, 1, 0, yes
498309280,  Recs_97, 1, 1, 0, yes
440216684,  AlexSaccomanno, 1, 1, 0, yes
494185643,  BarbaraCerbioni, 1, 1, 0, yes
759133067500019712,  VignoliPiero, 2, 2, 0, yes
2945515365,  lele7126, 4, 4, 0, yes
554580329,  agomarcellino, 2, 2, 0, yes
299337099,  GennaroCarbone, 3, 3, 0, yes
4858358895,  Gabri641, 2, 2, 0, yes
3234011152,  dustin_one, 2, 2, 0, yes
593522933,  marinamogarelli, 2, 1, 1, neutral
752071123,  Peppocoancora, 2, 2, 0, yes
2807108027,  marin_ts, 1, 1, 0, yes
63449721,  lauradebe, 1, 1, 0, yes
1389280814,  pibi65, 1, 1, 0, yes
2174142141,  francescocipr13, 3, 3, 0, yes
972319562,  claudio_benassi, 2, 2, 0, yes
770710734573596672,  giava61, 4, 4, 0, yes
1007178920,  wecan1all, 2, 2, 0, yes
515214332,  GuerinoEsposito, 1, 1, 0, yes
462914512,  colpadiprodi, 4, 2, 2, neutral
146811114,  losfastidios, 5, 3, 2, yes
328506360,  maurofodaroni, 1, 1, 0, yes
3066044427,  attacchina, 2, 2, 0, yes
4873475835,  LupopaoloPaolo, 1, 1, 0, yes
2776699463,  corradomartina1, 2, 2, 0, yes
3121892753,  santarsierodom, 4, 2, 2, neutral
22900344,  biforme_, 6, 6, 0, yes
487436113,  SuperPolacco, 1, 1, 0, yes
3423959554,  AntonellaDeca11, 1, 1, 0, yes
3348196937,  Verganma2, 2, 2, 0, yes
176146930,  AntoStorny, 1, 1, 0, yes
129552719,  ocram_b, 1, 1, 0, yes
1040758267,  LuZingarelli, 2, 2, 0, yes
626935478,  eric_loreto, 3, 3, 0, yes
806115947312517120,  Caterina_A_89, 9, 8, 1, yes
767679162584854528,  misterZY, 6, 4, 2, yes
1003771064,  MBelpasso, 1, 1, 0, yes
218093343,  Alessandro_S_, 3, 1, 2, no
783995969067245568,  anderskort, 1, 1, 0, yes
830931973,  PaoloBiginelli, 4, 4, 0, yes
500998925,  SebaBiro, 3, 3, 0, yes
164266350,  caprozz, 5, 5, 0, yes
1389551054,  LinaCuthbertson, 1, 1, 0, yes
805790603485319168,  lollo_69, 4, 4, 0, yes
1225238562,  dimartino_peppe, 1, 1, 0, yes
555506562,  restamg, 3, 3, 0, yes
513356505,  Fuerteventura72, 1, 1, 0, yes
3067910507,  DavidVaragnolo, 2, 2, 0, yes
423229205,  NadiaKarbo, 3, 3, 0, yes
2153400366,  universedrop_mc, 1, 1, 0, yes
969019987,  pliniofabiani, 1, 1, 0, yes
3346427355,  Giogiudici54, 2, 2, 0, yes
418861332,  IaiaSgaglione, 3, 3, 0, yes
747313372807389185,  SalvoFaviana, 1, 1, 0, yes
142593220,  stalineruben, 10, 6, 4, yes
506352999,  ElenErre, 1, 1, 0, yes
383690993,  stolenrauhl, 4, 4, 0, yes
984748670,  IlariaPooh, 1, 1, 0, yes
2929910584,  studiobergantin, 1, 1, 0, yes
2602284788,  babette283, 1, 1, 0, yes
477680189,  AlfPisicchio, 1, 1, 0, yes
1084054124,  domtom789, 2, 2, 0, yes
204256316,  ONINOT73, 1, 1, 0, yes
1278534128,  munasmir, 1, 1, 0, yes
805826300426457088,  Matteo_Pregno, 3, 3, 0, yes
716808332,  LucianoLukeM, 1, 1, 0, yes
707136160116690944,  MarcelliRoby, 4, 2, 2, neutral
81897527,  grazianodipaola, 1, 1, 0, yes
933089870,  viola1864, 1, 1, 0, yes
722122879,  26valeria26, 3, 3, 0, yes
806030742933438465,  Alice72795606, 1, 1, 0, yes
2964821193,  mgiulia26, 1, 1, 0, yes
1078976664,  therealROSH, 1, 1, 0, yes
726716655594815488,  Mauro42452113, 1, 1, 0, yes
710305947,  Abctvz, 1, 1, 0, yes
149823875,  DenLombardo, 10, 10, 0, yes
45061598,  KeithBarnesLife, 1, 1, 0, yes
330597137,  SilvanoBottero, 3, 3, 0, yes
573006396,  MariaLumici, 1, 1, 0, yes
452183386,  danielaranon, 3, 3, 0, yes
426966347,  StefanoPugno, 3, 3, 0, yes
805883319963582464,  ericaleorato, 1, 1, 0, yes
2882514598,  AloisiaMC, 1, 1, 0, yes
2224880222,  EnricaColombina, 6, 4, 2, yes
2819898863,  franzese79, 1, 1, 0, yes
4201307896,  franczanca, 2, 2, 0, yes
1131555204,  Antonio260181, 1, 1, 0, yes
1286690875,  AngeloBolletta, 3, 3, 0, yes
805729999726739456,  ivana88184517, 2, 2, 0, yes
137337075,  Piersoft, 4, 3, 1, yes
120879351,  pdtsheri, 1, 1, 0, yes
45391969,  Pajaa93, 5, 3, 2, yes
3567486975,  Rominalamina1, 3, 3, 0, yes
53027129,  albybv, 1, 1, 0, yes
877958954,  catalano1958, 4, 4, 0, yes
220689840,  Mary83cost, 1, 1, 0, yes
356754698,  adimuccio55, 1, 1, 0, yes
805855379485691904,  Raffael54745958, 4, 4, 0, yes
529480892,  luigipalesandro, 1, 1, 0, yes
714117426057777153,  _Phoenix_007, 2, 2, 0, yes
2380867248,  LeovigLeonardo, 1, 1, 0, yes
1668127376,  g70460167, 2, 2, 0, yes
1708213249,  PinaCimino, 1, 1, 0, yes
517453341,  felgregor, 1, 1, 0, yes
392933135,  Mena_Celestino, 3, 3, 0, yes
135441917,  mariabeatrice77, 1, 1, 0, yes
143004001,  PatriziaPV, 2, 2, 0, yes
810483710,  lidiapa76, 1, 1, 0, yes
189131385,  nooracarey, 2, 2, 0, yes
437840031,  laverod, 1, 1, 0, yes
1032639654,  piccoloale81, 1, 1, 0, yes
121778278,  Martcus71, 1, 1, 0, yes
1294913706,  gabriveleno, 4, 4, 0, yes
524828130,  LucaCanevari, 1, 1, 0, yes
1205448452,  PatriziaNovell4, 1, 1, 0, yes
3226013529,  marimusic87, 2, 2, 0, yes
79963123,  martinacarletti, 4, 4, 0, yes
2838517743,  gaetano050, 1, 1, 0, yes
1587766124,  SCarpiceci, 2, 1, 1, neutral
545797190,  MatteoBastasin, 1, 1, 0, yes
1062535159,  franco_sagone, 1, 1, 0, yes
716526944897142784,  antoniosinisca2, 1, 1, 0, yes
722522191645052928,  sorco90, 1, 1, 0, yes
1128261450,  Matteo_Comi, 2, 2, 0, yes
2883813258,  lindavitale11, 3, 1, 2, no
48958624,  danigamberini, 3, 3, 0, yes
2973874516,  GianolaAg, 3, 3, 0, yes
547635512,  Pau_e_Pauino, 6, 2, 4, no
3352192281,  Pit_Rock86, 2, 2, 0, yes
449269452,  Ale_Venuto, 3, 3, 0, yes
51419201,  andreasoban, 1, 1, 0, yes
3096110321,  airtura, 1, 1, 0, yes
392589825,  pccpla, 7, 7, 0, yes
1470478922,  ENovelli60, 3, 3, 0, yes
1057813165,  RaffaeleRosa68, 1, 1, 0, yes
866119824,  Kantu2012, 1, 1, 0, yes
2541132644,  francocarafa, 1, 1, 0, yes
3001197518,  silviapaoloross, 2, 2, 0, yes
3384666371,  GurieriAnita, 1, 1, 0, yes
2440573178,  rosafragomeni, 3, 3, 0, yes
1273224013,  AleContigiani, 1, 1, 0, yes
381373938,  FrancescoCanali, 1, 1, 0, yes
1475357329,  EmanuelePimpini, 4, 4, 0, yes
2163566358,  rt_bew, 1, 1, 0, yes
259939028,  codapussi, 1, 1, 0, yes
4472578401,  bonominiloreda2, 1, 1, 0, yes
1890784644,  ValerioMequio, 1, 1, 0, yes
511735099,  luisellapier, 5, 5, 0, yes
2326629605,  djbartigno, 4, 4, 0, yes
3840758295,  lelesoulx, 3, 1, 2, no
1477403678,  RamK90, 1, 1, 0, yes
4758052456,  57Franchino, 19, 19, 0, yes
2209032833,  Louissassy_, 1, 1, 0, yes
2611778665,  CAvondet, 6, 5, 1, yes
1331672088,  ROBERTOMARTINA4, 4, 3, 1, yes
935328864,  GDallOlmo, 1, 1, 0, yes
2174295987,  ACortopass, 1, 1, 0, yes
2951408861,  SpagnoliAngelo, 2, 2, 0, yes
2725178549,  michelev1senior, 2, 2, 0, yes
1644541332,  STriglione, 1, 1, 0, yes
2319424591,  marialuisalanz2, 1, 1, 0, yes
4362010276,  grazzi_aime, 3, 3, 0, yes
805857262568935425,  georgiabellin74, 1, 1, 0, yes
917157296,  GVEVENTI, 2, 2, 0, yes
71597214,  Safeeyar, 2, 2, 0, yes
1013577343,  francopolidori, 1, 1, 0, yes
2296154927,  StefanoFederi10, 1, 1, 0, yes
840287467,  enricalandolfi, 1, 1, 0, yes
2712196248,  moltitudo, 3, 3, 0, yes
805388432713334785,  joecalzino, 1, 1, 0, yes
1366555484,  BiagiomF, 4, 2, 2, neutral
2591546700,  PatriziaQuinte1, 1, 1, 0, yes
999268855,  matteferrari, 1, 1, 0, yes
3044943313,  mantovanto, 1, 1, 0, yes
380456374,  Gerardo_Santoro, 3, 3, 0, yes
130874801,  FlavioBoffi1988, 1, 1, 0, yes
2493014217,  1danyda, 1, 1, 0, yes
3043427426,  Letteria3, 1, 1, 0, yes
968523174,  Cipridis, 7, 6, 1, yes
128355143,  folleragione, 4, 1, 3, no
743471279093780480,  idiakez87, 1, 1, 0, yes
2635338317,  Zaccmarco, 2, 1, 1, neutral
1911946633,  Sportflash24, 2, 2, 0, yes
1179291769,  Frances51496971, 1, 1, 0, yes
2279531083,  Valeri58Valeri, 1, 1, 0, yes
535260789,  SimoneZarri, 1, 1, 0, yes
2172679465,  DENIS65625852, 1, 1, 0, yes
3053298783,  CordeschiGuido, 2, 2, 0, yes
241479189,  hisiao, 1, 1, 0, yes
1159837046,  AttilioCaruso1, 7, 7, 0, yes
415893187,  fdellapelle, 1, 1, 0, yes
324321423,  bartorunner, 1, 1, 0, yes
3107403695,  NVernaglione, 2, 1, 1, neutral
1063280564,  anna_goi, 2, 2, 0, yes
50694968,  sabribree, 2, 2, 0, yes
3028306714,  PsiSenato, 3, 3, 0, yes
2294595158,  Pierpiffe, 1, 1, 0, yes
1322878460,  elisettii, 4, 4, 0, yes
379088060,  GIUSEPPEPEDULLA, 1, 1, 0, yes
2560248859,  SirioTini, 3, 3, 0, yes
102579838,  GianlucaCovelli, 1, 1, 0, yes
422006595,  CellaLuigi, 1, 1, 0, yes
586849536,  m_foscaro, 2, 2, 0, yes
1705453885,  Giusyz18, 2, 2, 0, yes
2565485987,  sabrina_ruggeri, 2, 2, 0, yes
1066207429,  frapolis83, 8, 4, 4, neutral
445699557,  vitale_paolo, 4, 1, 3, no
782316521750142976,  GiancaGuccione, 7, 7, 0, yes
1038257455,  DurigonDario, 1, 1, 0, yes
3010333444,  gianni_970, 2, 2, 0, yes
1274855371,  MoriconiLucia, 2, 2, 0, yes
2341007582,  resile2778, 4, 4, 0, yes
371118925,  CFolla, 3, 2, 1, yes
392796065,  antonioventu, 1, 1, 0, yes
2945763772,  cogiusti, 2, 1, 1, neutral
2909263949,  Roby1815, 2, 2, 0, yes
453871514,  rosariocava1, 8, 8, 0, yes
2955187899,  robbix67, 1, 1, 0, yes
540128217,  giganetto, 3, 2, 1, yes
1105906524,  Pasquino4Mauri, 1, 1, 0, yes
472069637,  LaganGiovanni, 1, 1, 0, yes
790456224697442304,  albe_gala90, 1, 1, 0, yes
93662380,  roro1001, 1, 1, 0, yes
189110064,  caroletta71, 9, 5, 4, yes
4588008687,  RIPORTO, 20, 1, 19, no
2365016519,  Alessan23661433, 1, 1, 0, yes
719410555069603840,  official_ambra_, 1, 1, 0, yes
805791194462691329,  WPAOLA_RH, 16, 7, 9, no
340833340,  lollodercole, 1, 1, 0, yes
403316330,  bladeone54, 2, 2, 0, yes
4189356688,  fed_biagi, 1, 1, 0, yes
1266598608,  gfdinicola, 1, 1, 0, yes
3151471672,  fuviovalentini, 1, 1, 0, yes
488671317,  umberto558, 2, 2, 0, yes
3059513296,  xBradfordGirl, 2, 2, 0, yes
1079586907,  MaleoneLeone, 1, 1, 0, yes
1065602838,  montesanomarco, 1, 1, 0, yes
195786572,  RicOlivier, 1, 1, 0, yes
2768846523,  francescod52, 1, 1, 0, yes
2951457375,  DiegoDlonardi, 1, 1, 0, yes
755426982,  gaia_dovichi, 1, 1, 0, yes
575236900,  matteofarina77, 1, 1, 0, yes
610088678,  salvo_laperna, 2, 2, 0, yes
2996059456,  andrearinone, 2, 2, 0, yes
536337042,  Beretta93A, 1, 1, 0, yes
2247712893,  Renyomagician, 8, 7, 1, yes
991494079,  gibellen, 1, 1, 0, yes
291755729,  peppeiaco84, 1, 1, 0, yes
1253010624,  Fr_Pilenga, 2, 2, 0, yes
382159660,  AnnaKalisa, 2, 2, 0, yes
1491369212,  variedeventual, 1, 1, 0, yes
361815158,  Skifar, 1, 1, 0, yes
430185608,  O_Resasco, 1, 1, 0, yes
590966023,  aasiciliano, 2, 2, 0, yes
495806630,  pdcorreggio, 5, 5, 0, yes
558585374,  SilviaDragone, 1, 1, 0, yes
1002312463,  LaDea3, 2, 2, 0, yes
2836232935,  leonlaiming, 1, 1, 0, yes
2740067747,  franco_oceano, 6, 4, 2, yes
265613558,  simonetrinetti, 1, 1, 0, yes
2896413441,  vinciant, 1, 1, 0, yes
1127690666,  fsalmaz, 1, 1, 0, yes
3199470706,  Jonny_all_85, 2, 1, 1, neutral
282509630,  varazzzz, 1, 1, 0, yes
1343834791,  officialmaz, 1, 1, 0, yes
3196158269,  MarcoGuglielma1, 3, 3, 0, yes
521625330,  eziogava, 6, 6, 0, yes
805803485019176961,  nicolardi_marco, 1, 1, 0, yes
3025038089,  primavera681, 1, 1, 0, yes
2608151325,  vinciguerra_3, 3, 3, 0, yes
1695453240,  gianluca_tanda, 1, 1, 0, yes
3370553369,  presdaliani, 2, 2, 0, yes
1283034565,  Barki0, 2, 1, 1, neutral
634601369,  DeborahChiodoni, 2, 2, 0, yes
3144005519,  piergianni93, 1, 1, 0, yes
4501094794,  Paolo51863470, 4, 4, 0, yes
755510942394359808,  MikaelsonSophie, 1, 1, 0, yes
172775167,  ch_rouillon, 3, 3, 0, yes
1071323504,  PaoloAnglesio, 1, 1, 0, yes
3128830823,  SilvGatto, 1, 1, 0, yes
52073623,  sbauri, 1, 1, 0, yes
421768124,  ben_benjy, 1, 1, 0, yes
1128793332,  idieforcalum, 1, 1, 0, yes
617911302,  carnevale1986, 1, 1, 0, yes
49787793,  loriosan, 3, 3, 0, yes
776300610740219904,  jopozzolini, 3, 3, 0, yes
847370024,  DavideDalMaso2, 2, 2, 0, yes
431026896,  silviarossi23, 1, 1, 0, yes
804413111612612608,  luciano9121967, 4, 3, 1, yes
485926036,  PaolaNicora, 2, 2, 0, yes
171018891,  FranButera, 1, 1, 0, yes
2856925336,  wesel_barbara, 1, 1, 0, yes
1481011574,  StefanoZanella5, 3, 3, 0, yes
33513756,  fedebell, 1, 1, 0, yes
793123877387927552,  IlSudCheDiceSi, 3, 3, 0, yes
1580814079,  gomezandedwards, 2, 2, 0, yes
792695516404539392,  leonmucc, 1, 1, 0, yes
3402412755,  mcdallicardillo, 56, 6, 50, no
2727428469,  MarcoDolc, 1, 1, 0, yes
510110763,  NicolettaVischi, 1, 1, 0, yes
102688383,  P4olino, 5, 4, 1, yes
798996934744674304,  marceloscotton, 1, 1, 0, yes
359429583,  dmf1961, 1, 1, 0, yes
2396599558,  PistilloPp, 4, 4, 0, yes
2332230789,  AlessandraGua16, 2, 2, 0, yes
3378313167,  zioGio9, 1, 1, 0, yes
399952992,  gchiare, 1, 1, 0, yes
2205921921,  GianlucaBuonoc1, 1, 1, 0, yes
719607820325412864,  RbellesiRoberta, 1, 1, 0, yes
1356832394,  MargheritaMacca, 1, 1, 0, yes
459201110,  alessio_moretti, 4, 4, 0, yes
342897643,  manumorente, 2, 2, 0, yes
233325566,  alicelafenice, 3, 3, 0, yes
3016558263,  marcolanfranch5, 1, 1, 0, yes
3166156053,  MikeZapMG, 18, 6, 12, no
591675607,  PieroPuccinelli, 1, 1, 0, yes
472128673,  sognocalifornia, 2, 1, 1, neutral
482784627,  taesu61, 1, 1, 0, yes
184379260,  massitaly, 1, 1, 0, yes
45618022,  paologmaria, 1, 1, 0, yes
763405961205800961,  enzo97457178, 23, 3, 20, no
522570216,  ORLANDOCIACCI, 1, 1, 0, yes
3123358953,  NunzioIngiusto, 2, 2, 0, yes
795288405605253120,  Rosyfluo, 2, 2, 0, yes
974204280,  VenturiLuciano, 2, 2, 0, yes
367611357,  IgAzara, 2, 2, 0, yes
134573413,  artnibis, 1, 1, 0, yes
792789788143325184,  andrea23grm, 2, 2, 0, yes
189229826,  Brown_1948, 5, 5, 0, yes
4910362701,  live_inmusic, 5, 3, 2, yes
412405706,  nic_calabro, 1, 1, 0, yes
405692785,  PVenuti, 1, 1, 0, yes
421981932,  PaoloMiria, 1, 1, 0, yes
204691397,  armin_83, 2, 2, 0, yes
502971430,  CaprariAntonio, 3, 3, 0, yes
2351551950,  lpaolisso, 2, 2, 0, yes
733368091,  PalermoBarbara, 2, 2, 0, yes
1484402004,  LBG67, 1, 1, 0, yes
481909513,  GrammrNazi, 1, 1, 0, yes
2412144013,  penalizzato, 1, 1, 0, yes
769560748905394177,  funbrushvangog, 1, 1, 0, yes
411723377,  EzioCasagranda, 7, 6, 1, yes
34676096,  gcardu, 1, 1, 0, yes
23460272,  xmaux, 20, 14, 6, yes
2421073909,  MartinSelmayr, 1, 1, 0, yes
382016132,  viso_pg, 1, 1, 0, yes
411449568,  VirgiPalmieri, 2, 2, 0, yes
46348655,  domenicobnd, 1, 1, 0, yes
908164304,  burnigia, 1, 1, 0, yes
1653832284,  SimoRedelBlu, 5, 5, 0, yes
848845550,  renzoblasetti, 2, 2, 0, yes
471906211,  OsMirco, 1, 1, 0, yes
1366663460,  GPagliacci, 1, 1, 0, yes
2207784991,  edesmaz, 1, 1, 0, yes
1057907772,  AntonioDiSavino, 1, 1, 0, yes
126024866,  cereninna, 1, 1, 0, yes
805865914512142336,  monicuccia_1997, 1, 1, 0, yes
905788567,  daLEaFI, 2, 2, 0, yes
403656460,  robertogia69, 1, 1, 0, yes
47590022,  MaxSestini, 2, 2, 0, yes
536638082,  barbaracoron, 6, 6, 0, yes
1317107058,  chiaramortari1, 3, 1, 2, no
749611364,  scarpaufficiale, 8, 8, 0, yes
3503527823,  franconico2010, 1, 1, 0, yes
1339887457,  Gorecka2, 1, 1, 0, yes
2396672482,  Viperissima_, 1, 1, 0, yes
434482607,  mpiase, 1, 1, 0, yes
518255877,  ltallarigo, 3, 3, 0, yes
783604924588388352,  michelespina61, 1, 1, 0, yes
796473968375070720,  Ida39437663, 2, 2, 0, yes
2156491525,  eleonor85062757, 1, 1, 0, yes
308388645,  PaolaPaolicchi, 1, 1, 0, yes
1595355949,  FaustoAntenucci, 1, 1, 0, yes
805532640208179201,  dimonacomassimo, 1, 1, 0, yes
71556401,  charlinelobato, 2, 2, 0, yes
1454765706,  opinabile, 1, 1, 0, yes
470008762,  Ceccatelli_Gian, 6, 3, 3, neutral
67984345,  Spiderjin, 1, 1, 0, yes
150230336,  nvittadini, 1, 1, 0, yes
2322949688,  2750anna, 1, 1, 0, yes
428401541,  RiotGrrls1, 1, 1, 0, yes
3257084375,  _LonelyMoon_, 1, 1, 0, yes
1605327894,  dannynpaul1, 2, 2, 0, yes
1419033457,  lellaxy, 1, 1, 0, yes
791393283821961220,  MariPast74, 1, 1, 0, yes
465073359,  Felicecortese, 1, 1, 0, yes
464691892,  ca_ste, 7, 3, 4, no
21803228,  CorinziaMonfort, 3, 3, 0, yes
2301762114,  FRANKWHITE1954, 1, 1, 0, yes
1710874273,  MiloConcas, 1, 1, 0, yes
238288111,  beck62mb, 2, 2, 0, yes
3014070485,  DenTheJam, 1, 1, 0, yes
798283117408690176,  01vinber, 2, 2, 0, yes
2243043647,  MarraBeppe, 4, 4, 0, yes
4429938495,  953f0d33789c4d5, 1, 1, 0, yes
1066796996,  CortesiLorena, 7, 3, 4, no
49020455,  chritara81, 1, 1, 0, yes
1006967851,  vittoriogiovan2, 1, 1, 0, yes
778106431,  doro_tella, 2, 2, 0, yes
492275437,  MaurizioPanzir1, 2, 2, 0, yes
238611868,  GoldenBigBoy, 2, 2, 0, yes
453370322,  alessandro1282, 1, 1, 0, yes
231139494,  Spartano1969, 1, 1, 0, yes
2176059259,  Misfitlidia, 1, 1, 0, yes
484778446,  landolfistefano, 1, 1, 0, yes
3050467693,  ILYnashgrlerr, 1, 1, 0, yes
2854956753,  zaccaria_simone, 1, 1, 0, yes
376311271,  MarioRiva2, 1, 1, 0, yes
2433831238,  pipol161, 1, 1, 0, yes
18403411,  rondia, 2, 2, 0, yes
782542371259052033,  trasparencynews, 2, 2, 0, yes
2491075088,  AntonioAvalente, 1, 1, 0, yes
209791643,  fiammato, 2, 2, 0, yes
474297979,  IreneGiordano1, 6, 6, 0, yes
88479652,  floraghebali, 1, 1, 0, yes
585434485,  MasieriSilvana, 2, 2, 0, yes
806126132055699456,  GRAZIA81472695, 1, 1, 0, yes
773529220790222848,  Martinalovesgov, 1, 1, 0, yes
1260070700,  LoryfalcoF, 2, 1, 1, neutral
805022642268999682,  selmagjeci, 1, 1, 0, yes
2819364346,  LauraFuoriTema, 1, 1, 0, yes
1639144656,  chuchinita03, 1, 1, 0, yes
1108992859,  CriLupo98, 1, 1, 0, yes
4351612168,  vagab_onda, 1, 1, 0, yes
474671737,  fabalaloc69, 1, 1, 0, yes
3956224822,  lucia4012, 1, 1, 0, yes
801101308900048896,  Cantastorie8, 5, 5, 0, yes
292988864,  Santi_Bruno, 3, 3, 0, yes
2800763806,  pietro_fortugno, 2, 2, 0, yes
779318437365571584,  PCarbonatto, 1, 1, 0, yes
2837181195,  MircoPeverieri, 1, 1, 0, yes
439207654,  mrgggit, 1, 1, 0, yes
463727606,  BenedettiL, 1, 1, 0, yes
455691912,  FlavioUndanno, 1, 1, 0, yes
29440781,  Giatesta, 1, 1, 0, yes
2785484088,  Sa_deSantis, 1, 1, 0, yes
84447967,  frPanfilo, 4, 3, 1, yes
438129669,  F_Pesce, 1, 1, 0, yes
454122828,  FedericoPoppi1, 1, 1, 0, yes
116219778,  LUCRIGONI, 3, 3, 0, yes
3843148408,  valenti48341014, 13, 13, 0, yes
1358975850,  Annix40, 1, 1, 0, yes
2924944360,  l92899745, 5, 5, 0, yes
902677940,  71Lochiatto, 1, 1, 0, yes
2531558597,  angelo_196865, 3, 3, 0, yes
2937534765,  Patrizio68420, 3, 3, 0, yes
245708571,  ggallett, 1, 1, 0, yes
2615266953,  dsturabotti, 1, 1, 0, yes
599368592,  LucaPigozzi, 1, 1, 0, yes
39788776,  Savio59, 4, 4, 0, yes
378489692,  Architetti77, 2, 2, 0, yes
31429348,  gabrisandrelli, 1, 1, 0, yes
434062606,  mbonizzoli, 1, 1, 0, yes
18613760,  alexfuse, 1, 1, 0, yes
2974297485,  BiancottiMaikol, 1, 1, 0, yes
556620797,  ManuelTundis, 5, 2, 3, no
446406820,  vincemanz, 1, 1, 0, yes
2170643185,  2lost_souls, 3, 3, 0, yes
378265547,  g185963, 2, 2, 0, yes
792646000074715137,  danilomei, 1, 1, 0, yes
390712724,  barbarellamarra, 1, 1, 0, yes
2312389900,  achimaltese, 1, 1, 0, yes
2256578555,  cesare_72, 1, 1, 0, yes
3159646263,  rockevy85, 1, 1, 0, yes
448374270,  cicciodeca, 1, 1, 0, yes
419107727,  PEETER1956, 1, 1, 0, yes
399903133,  massyumberti, 2, 2, 0, yes
4081241908,  SimoStefanuto, 6, 6, 0, yes
707223648986337280,  atrejurm12, 9, 9, 0, yes
2917451476,  elen3288, 9, 9, 0, yes
494427022,  GiacoGhilardi, 1, 1, 0, yes
2873949399,  Moretta56, 1, 1, 0, yes
97921008,  IlCafaro, 1, 1, 0, yes
1084247610,  G_DAquino, 3, 3, 0, yes
802559855202537473,  davide_3004, 1, 1, 0, yes
1900770631,  Etzi2891, 10, 10, 0, yes
803417486163058689,  cristinosabate1, 2, 2, 0, yes
497230381,  109lore, 4, 3, 1, yes
727151756065542144,  LandoniMirko, 1, 1, 0, yes
999004099,  nicomassaro81, 3, 2, 1, yes
2941003353,  sempre4444, 4, 4, 0, yes
432484243,  PompeoStefano, 1, 1, 0, yes
846324013,  RrRosci, 1, 1, 0, yes
376688279,  salvoguzzi, 9, 8, 1, yes
2808346126,  melarosag, 9, 1, 8, no
296244924,  Massifrasca, 5, 4, 1, yes
2330865256,  BuffaAnna, 7, 6, 1, yes
56949284,  fabtrentin, 1, 1, 0, yes
490446577,  sabpant, 1, 1, 0, yes
52107851,  lelebin8, 1, 1, 0, yes
120734182,  turbocagio, 1, 1, 0, yes
1009031245,  Costantant, 2, 2, 0, yes
2484661227,  BiscioneA, 23, 23, 0, yes
1160871912,  marcocrotti4, 1, 1, 0, yes
1040153521,  AlessioLelleni, 2, 2, 0, yes
1145650134,  MarcoCivolani, 12, 5, 7, no
773490325776134145,  ChristianPaone4, 4, 4, 0, yes
4163358137,  BelzebuRosso, 1, 1, 0, yes
275637632,  marcoiaquone, 6, 5, 1, yes
14227296,  claudiovelardi, 5, 5, 0, yes
385885795,  GabrieleGorett1, 1, 1, 0, yes
151041421,  tetoelbano, 1, 1, 0, yes
575500709,  AndreaVanzo85, 4, 2, 2, neutral
2519452785,  EziaLucrezia, 1, 1, 0, yes
704411356355817472,  CpChiarapratesi, 1, 1, 0, yes
525633415,  Leooooooooooo86, 1, 1, 0, yes
2614724955,  renydem, 7, 6, 1, yes
806071265073176576,  oantobella, 5, 5, 0, yes
1433457426,  KeesPopinga66, 1, 1, 0, yes
2636664434,  zaccaria_g, 5, 4, 1, yes
1201912662,  unPoPulista, 3, 2, 1, yes
475050195,  guagio61, 1, 1, 0, yes
2481962054,  Euro_comunica, 1, 1, 0, yes
2232029869,  RossiGabrio, 7, 1, 6, no
4425345994,  romeapt4u1, 1, 1, 0, yes
704664767143809025,  merimazzoni, 1, 1, 0, yes
1911513092,  SalvMolettieri, 1, 1, 0, yes
806094440297336832,  domefontanella, 2, 2, 0, yes
33212890,  ElisaDospina, 1, 1, 0, yes
238316666,  ChiaraBLG, 1, 1, 0, yes
783221700825640960,  kaosby1, 1, 1, 0, yes
507063069,  ciuka9fosdondo, 1, 1, 0, yes
724646324772155392,  fabiocast74, 3, 3, 0, yes
734650628480372736,  BubblesClubOFCL, 1, 1, 0, yes
2969995391,  raffavono, 1, 1, 0, yes
805818278232936448,  Roberto210966, 1, 1, 0, yes
1066769840,  lucape0402, 2, 2, 0, yes
45808968,  TAQB, 7, 5, 2, yes
560188538,  MicheleDiMasi, 2, 2, 0, yes
408355738,  iceredevilman, 3, 2, 1, yes
410979325,  RosaZammitto, 1, 1, 0, yes
634720492,  pepitoFalco, 10, 6, 4, yes
3312775517,  fred20104, 1, 1, 0, yes
760861694470025216,  BoffelliMaria, 1, 1, 0, yes
1292287172,  giampaoli1984, 1, 1, 0, yes
1851000380,  FedPDlecco, 1, 1, 0, yes
2803100914,  fragallina, 1, 1, 0, yes
411405263,  pl_tracanzan, 4, 4, 0, yes
733004266948956160,  alessgua, 2, 2, 0, yes
388966522,  enzotonelli1, 1, 1, 0, yes
2773203804,  FuschinoF, 1, 1, 0, yes
3247895993,  marcodieugenio1, 1, 1, 0, yes
1241767526,  giancaldieri, 3, 3, 0, yes
384236782,  AntoZangaro, 6, 5, 1, yes
317213797,  MassimiCorrias, 3, 3, 0, yes
804207200860250112,  amolapacesempre, 1, 1, 0, yes
2396546035,  uggefausto, 2, 1, 1, neutral
2343331660,  luisa13371193, 9, 9, 0, yes
2214655011,  AlessandraVatta, 2, 2, 0, yes
546725114,  mmichelaf, 7, 7, 0, yes
495367712,  Skyller1988, 2, 2, 0, yes
802605933398491138,  noureen45, 3, 3, 0, yes
2225808167,  CeraLorenzo, 1, 1, 0, yes
202770907,  franci_bibi, 1, 1, 0, yes
728679799129001984,  vargoldberg, 1, 1, 0, yes
310327131,  Luis_Piselli, 4, 4, 0, yes
313008482,  SabatiniLuca, 3, 3, 0, yes
2325894237,  tella2910, 1, 1, 0, yes
835516741,  paam1972, 1, 1, 0, yes
444569994,  CBellemo, 1, 1, 0, yes
798971882217283584,  kappaerre72, 1, 1, 0, yes
1546744730,  fabri_viti, 1, 1, 0, yes
25483483,  angelicaMdalgas, 1, 1, 0, yes
485538699,  securety76, 1, 1, 0, yes
226098932,  xriusenoticies, 1, 1, 0, yes
794654060,  nanconinco, 2, 2, 0, yes
477871930,  IsaQuerci, 3, 3, 0, yes
1043297900,  PaoloPozzani, 1, 1, 0, yes
830927029,  f_bizzotto, 2, 2, 0, yes
2580374513,  Raybanman1981, 1, 1, 0, yes
702053047040679936,  matteo_ermini, 1, 1, 0, yes
2722108090,  cinzias1971, 1, 1, 0, yes
531682148,  EmanueleLuthor, 1, 1, 0, yes
758232296067592192,  paolo_calderaro, 1, 1, 0, yes
2205713551,  CMinzoni, 1, 1, 0, yes
313179172,  benoitbernard, 1, 1, 0, yes
970815374,  LorenaCosatto, 1, 1, 0, yes
2472284909,  albertomasci1, 1, 1, 0, yes
2250640854,  ottorizzontale, 2, 2, 0, yes
434481487,  leonardorotondi, 1, 1, 0, yes
51798964,  marcokaf, 2, 2, 0, yes
2465017751,  Benedetta_Alba, 8, 8, 0, yes
607027604,  AlessandroCrim1, 1, 1, 0, yes
14442736,  baro69, 2, 2, 0, yes
717291432382431232,  themisfitsclass, 3, 3, 0, yes
786652238353752064,  MMohtafid, 9, 9, 0, yes
3069657982,  FranceBarba80, 13, 10, 3, yes
1883542382,  fabiolongo1973, 1, 1, 0, yes
154322105,  masqliddo, 17, 15, 2, yes
799195846659239936,  UlyanaBobr, 1, 1, 0, yes
593759199,  Iron_Iceman, 5, 2, 3, no
346729893,  angelanovek, 1, 1, 0, yes
76700929,  Maurizio_F, 1, 1, 0, yes
1377305138,  Agapeblu, 13, 8, 5, yes
3218572971,  francescorrano, 1, 1, 0, yes
556863232,  s_licia, 2, 2, 0, yes
354948716,  YESWECANCLUB, 1, 1, 0, yes
805721784599330817,  RobertaBenede, 1, 1, 0, yes
801338992197246977,  InessaI5, 1, 1, 0, yes
2347123756,  giampi_dassi, 1, 1, 0, yes
4799008163,  enricolivucci, 1, 1, 0, yes
3126056373,  thoropi, 1, 1, 0, yes
1694843306,  BPlacano, 1, 1, 0, yes
478991044,  Mastro_AlFa, 1, 1, 0, yes
315092963,  MigliettaM, 1, 1, 0, yes
473082058,  branca_sara, 3, 3, 0, yes
3413458521,  lodasabi, 1, 1, 0, yes
1673197860,  para3010, 1, 1, 0, yes
128570838,  gioser06, 1, 1, 0, yes
1029021866,  Maxim33028900, 2, 2, 0, yes
397422154,  FrancescoMalag1, 1, 1, 0, yes
3353758954,  fanta9news, 4, 4, 0, yes
96213866,  marcovsr, 2, 2, 0, yes
4913455468,  elismagi, 4, 4, 0, yes
4747354996,  RohmanBmh, 4, 4, 0, yes
805808171336036353,  mirellaleotta28, 2, 2, 0, yes
3006138545,  IsaOdelanti, 2, 1, 1, neutral
778319737080143872,  anitamagiar, 1, 1, 0, yes
97414744,  CrisProvenzano, 1, 1, 0, yes
805802118883983360,  MABELL61, 1, 1, 0, yes
456502728,  pagipo42, 1, 1, 0, yes
434124212,  Lo_Lorenza, 1, 1, 0, yes
4212734487,  FascioDeeJay, 1, 1, 0, yes
1471642706,  Joy_Cricket, 10, 7, 3, yes
2512255369,  Gnostico4Paolo, 1, 1, 0, yes
789182381706006528,  dmtgra, 4, 2, 2, neutral
3075297994,  GiangiMeteokid, 1, 1, 0, yes
443607674,  MaxGiacomini, 1, 1, 0, yes
494988043,  Lello19953605, 2, 2, 0, yes
702989185930678275,  To_Monica_, 6, 6, 0, yes
1062957535,  MarilaGennaro, 3, 3, 0, yes
767785908556992512,  campise_samuele, 1, 1, 0, yes
1448518916,  PaoliniElena, 1, 1, 0, yes
100975203,  jaypiscopo, 1, 1, 0, yes
879844903,  AndreaBen155, 2, 2, 0, yes
316535562,  pinodig, 6, 3, 3, neutral
479483455,  GiovanniMorgia, 1, 1, 0, yes
585263805,  StefanoDeMaron, 6, 6, 0, yes
1934151967,  valentistrada, 3, 1, 2, no
700952025605996544,  frLorenzoFelice, 1, 1, 0, yes
906751698,  SteP_1974, 4, 3, 1, yes
1370106768,  MassimoTurci2, 20, 19, 1, yes
5922292,  baotzebao, 2, 2, 0, yes
446526975,  BertiPadano, 2, 2, 0, yes
554733792,  gur_issam, 2, 2, 0, yes
419380079,  mauverna, 1, 1, 0, yes
400050070,  fabiosonni, 1, 1, 0, yes
482181994,  nicolasballario, 3, 3, 0, yes
778182187208368129,  sgalbi28, 1, 1, 0, yes
93165663,  toti977, 1, 1, 0, yes
175124410,  simonesolimeo, 1, 1, 0, yes
358119628,  sabrisiv, 7, 5, 2, yes
1490789586,  mgasbarrino, 1, 1, 0, yes
390353740,  carminelamoglie, 3, 2, 1, yes
932939593,  mauromastrovito, 1, 1, 0, yes
3393834946,  silvio89679538, 1, 1, 0, yes
424933391,  LAURAGuercilena, 1, 1, 0, yes
490529960,  unaAgnes, 1, 1, 0, yes
2518059282,  silviasem1962, 4, 4, 0, yes
807130800,  giusecabras, 1, 1, 0, yes
4398121643,  TagarelliDome, 1, 1, 0, yes
555528953,  cristin60068396, 3, 3, 0, yes
488738551,  marcelloromanel, 1, 1, 0, yes
993673842,  okrimassamac, 1, 1, 0, yes
741232713345142784,  giusepp90404326, 7, 7, 0, yes
370063521,  EricMedvetTs, 1, 1, 0, yes
251754579,  bagnidi, 1, 1, 0, yes
610968391,  mauriziopedre, 4, 3, 1, yes
3468716363,  carlo81341194, 4, 4, 0, yes
193822844,  RoxLuxemburg, 2, 2, 0, yes
740802550472028160,  Gianluc16883886, 1, 1, 0, yes
369384908,  SimoneSecci1, 10, 8, 2, yes
409322647,  stebrunelli, 1, 1, 0, yes
2327068754,  melfiantonio, 1, 1, 0, yes
791292703812227072,  giuseppemontaq6, 2, 2, 0, yes
2294048120,  DanyofFlorence, 2, 1, 1, neutral
52305444,  albertobit, 5, 5, 0, yes
56449615,  egogildo, 4, 4, 0, yes
460233960,  paolabertolini2, 3, 3, 0, yes
2998377094,  B56Fb, 4, 4, 0, yes
788509551716859904,  drago96g, 1, 1, 0, yes
796340446221963264,  ManuelaPuglisi4, 12, 12, 0, yes
706561823605202944,  StritFud, 3, 3, 0, yes
2266647094,  annerd1, 1, 1, 0, yes
529402617,  MorelliM92, 3, 3, 0, yes
1337343271,  SaraBaCC, 1, 1, 0, yes
245051615,  SkinPatrizio, 2, 2, 0, yes
803886566301175808,  RottinSimonetta, 1, 1, 0, yes
461248674,  SERGIOVANNI1, 13, 13, 0, yes
776855405637038080,  Zeronegativo73, 4, 4, 0, yes
874235131,  Icaroriginal, 1, 1, 0, yes
711877336396865536,  ManziPaola, 2, 2, 0, yes
27623719,  gianlucamansi, 1, 1, 0, yes
375682938,  a_alessandrino, 1, 1, 0, yes
570894672,  BarbaraGazzoli, 1, 1, 0, yes
2906873477,  1984Chiara, 1, 1, 0, yes
482882415,  AlessiaDammicco, 1, 1, 0, yes
147332550,  ContehMMd, 3, 2, 1, yes
4756502391,  Kai5erLXXXVII, 5, 3, 2, yes
3363562053,  BiobioCreativo, 2, 2, 0, yes
230824333,  MoonFilmsChile, 2, 2, 0, yes
703046171703562240,  sacco84070, 3, 3, 0, yes
392937274,  miro100462, 1, 1, 0, yes
626350749,  proietti_mauro, 1, 1, 0, yes
70410969,  fabriziocataldi, 1, 1, 0, yes
2761214580,  steadystateCSTR, 1, 1, 0, yes
1689149268,  redigdecampos, 1, 1, 0, yes
358175615,  passidilupo, 1, 1, 0, yes
1093904449,  Lilyth85, 4, 4, 0, yes
806136788934885380,  alida1960, 2, 1, 1, neutral
2725060048,  vanni_stefano, 1, 1, 0, yes
1349481115,  FirstScoutfoot, 1, 1, 0, yes
101907520,  Elena_di_Troika, 1, 1, 0, yes
2943930394,  marinobiagio91, 1, 1, 0, yes
593791954,  Cristina241289, 3, 3, 0, yes
453161714,  olgagargiulo, 2, 2, 0, yes
1310229355,  MaggisanoNicco, 1, 1, 0, yes
152436929,  manuelamesco, 1, 1, 0, yes
2890717774,  RossanoCampani, 1, 1, 0, yes
159590871,  ubaldi1, 2, 2, 0, yes
730100716250005504,  GianlucaMal, 2, 2, 0, yes
1933244276,  ck_daripa, 3, 3, 0, yes
798890670,  C_Coolidge, 1, 1, 0, yes
760547032625020929,  flaviocaporizzo, 4, 4, 0, yes
378171852,  francescofaiel1, 2, 1, 1, neutral
514469819,  SoniaParti, 2, 2, 0, yes
1229535578,  luanasquilloni, 1, 1, 0, yes
1002663290,  hedilamnna, 1, 1, 0, yes
810449076,  Calpe19, 1, 1, 0, yes
462848185,  fra418, 1, 1, 0, yes
1260232232,  AgostinoCemmino, 1, 1, 0, yes
2371925091,  manulagrassa, 3, 3, 0, yes
2983489509,  cronacatweets, 4, 3, 1, yes
795656034182434817,  ilfalabrach, 1, 1, 0, yes
1452545070,  LasioLasio, 10, 10, 0, yes
1052805500,  lucio00512548, 2, 2, 0, yes
498936070,  robertop550, 6, 6, 0, yes
46059944,  belledejour_uk, 1, 1, 0, yes
1339067298,  Andranikat, 4, 1, 3, no
170761931,  Ori_aler, 1, 1, 0, yes
1382331840,  deltaforce1961, 1, 1, 0, yes
2291365104,  PaolaBaudinos, 3, 3, 0, yes
1466852564,  48onitram, 1, 1, 0, yes
3436934397,  monicadidomeni, 5, 2, 3, no
3218369247,  IleniaOrifici, 1, 1, 0, yes
1050775609,  vitobiancorosso, 1, 1, 0, yes
3228121683,  giulia_russo2, 12, 9, 3, yes
406162759,  AGuaglione, 1, 1, 0, yes
2298140245,  alessia_bussoni, 2, 1, 1, neutral
1283710128,  Infinity_Efp, 3, 3, 0, yes
1381291388,  amato_annarita, 2, 2, 0, yes
4252240941,  michela07690258, 1, 1, 0, yes
4216718548,  alessiopiras12, 2, 2, 0, yes
592905275,  PGambetti, 1, 1, 0, yes
326900625,  clarinsolia, 2, 2, 0, yes
794509368276488192,  Cianfagna25Zar, 1, 1, 0, yes
150006038,  simotony81, 1, 1, 0, yes
1125528018,  mberbellini, 1, 1, 0, yes
2420422117,  renatocian, 1, 1, 0, yes
129714853,  guerrieri_ales, 1, 1, 0, yes
952103144,  DocLippi, 1, 1, 0, yes
1069090044,  nonnaAnita, 2, 1, 1, neutral
2438762476,  il_Bec, 6, 6, 0, yes
2714959299,  antonellabart19, 3, 3, 0, yes
789867137682837504,  emanuela_muraca, 1, 1, 0, yes
427227030,  LORENZOLIGATO1, 2, 2, 0, yes
463329378,  pietromilazzo1, 1, 1, 0, yes
290958486,  luisra_gava, 1, 1, 0, yes
114723978,  twitalessio, 2, 2, 0, yes
794504474932998145,  LaviBianchi3, 1, 1, 0, yes
15818764,  g4n, 1, 1, 0, yes
79502644,  stream65, 4, 3, 1, yes
527938655,  nicolaosti, 2, 2, 0, yes
887115744,  PioDag, 4, 2, 2, neutral
2723227713,  gianni57dicost1, 1, 1, 0, yes
409359462,  squimanu, 1, 1, 0, yes
789589519,  bettape, 9, 2, 7, no
376646968,  antares546, 2, 2, 0, yes
13236482,  licciardi, 3, 3, 0, yes
4052195476,  umbertinos, 2, 2, 0, yes
75883181,  specchionero, 6, 4, 2, yes
2469782729,  bacol84, 1, 1, 0, yes
2966359733,  SaraNY07, 5, 5, 0, yes
702233893143977985,  SofiaDelMonaco1, 5, 5, 0, yes
754719889,  savbart, 3, 2, 1, yes
204757221,  FabioVagaggini, 1, 1, 0, yes
803691260548616192,  gildacaffe, 3, 3, 0, yes
222473908,  francisalve, 1, 1, 0, yes
2214623072,  loryyzo, 6, 6, 0, yes
858795774,  federicagiulia8, 4, 4, 0, yes
2722018162,  AngiealbiV, 1, 1, 0, yes
3175188171,  bombolalli, 1, 1, 0, yes
4011396449,  giuliatouch, 3, 3, 0, yes
2231803733,  unabeata, 2, 2, 0, yes
466368047,  GilardiFederico, 2, 2, 0, yes
418258649,  angiestone7, 1, 1, 0, yes
1439633221,  TataRosiePosie, 2, 2, 0, yes
616142012,  lucavarello, 6, 6, 0, yes
133949650,  msgarbossars, 3, 3, 0, yes
187302424,  MatteoColla, 1, 1, 0, yes
369702714,  Anmagiuffreda, 3, 1, 2, no
4689866900,  crstn82, 1, 1, 0, yes
877801596,  giampyFdl, 7, 5, 2, yes
2495725759,  fulviocervellon, 4, 4, 0, yes
504745994,  raffaelemedugno, 3, 3, 0, yes
1155089563,  cecco34, 1, 1, 0, yes
932204797,  AlfScavone, 1, 1, 0, yes
113769603,  beppeTwT, 2, 1, 1, neutral
404836757,  EGardini, 13, 5, 8, no
120418975,  fbardelle, 1, 1, 0, yes
50295560,  marcomartorelli, 6, 6, 0, yes
3425790568,  giannimadda1, 2, 2, 0, yes
23447708,  laFabri, 1, 1, 0, yes
337174304,  Billone55, 1, 1, 0, yes
2205596798,  salvolotauro, 6, 6, 0, yes
353675651,  venturilaura, 1, 1, 0, yes
4928044852,  DragoniDelio, 1, 1, 0, yes
2504694411,  giuseppevalvo30, 1, 1, 0, yes
105586707,  enzogargano, 1, 1, 0, yes
2980667012,  Reedfilter, 1, 1, 0, yes
3397795421,  camaria75807666, 1, 1, 0, yes
368241794,  GirolamoNavarra, 3, 2, 1, yes
1241828868,  damore_nunzia, 2, 2, 0, yes
84134511,  sabrinaottavian, 2, 2, 0, yes
59869460,  valeal, 3, 3, 0, yes
390366181,  kiralyneSissi, 3, 3, 0, yes
59428226,  robfero, 1, 1, 0, yes
426022196,  DanieleBellone, 2, 2, 0, yes
2525053388,  BoccuzziAntonio, 1, 1, 0, yes
1633220767,  CDinice, 2, 2, 0, yes
1856950873,  mirkodefalco1, 1, 1, 0, yes
2466003974,  fiorecrocegmail, 1, 1, 0, yes
2275847500,  maxyingr, 1, 1, 0, yes
95528446,  EnricoBattist, 2, 1, 1, neutral
2492518320,  picci60, 6, 6, 0, yes
1230752582,  f_palmese, 1, 1, 0, yes
105911621,  fersanabria_25, 2, 2, 0, yes
3343157452,  Genc57720229, 1, 1, 0, yes
1274346252,  anichini781, 11, 11, 0, yes
4203955936,  Antonunna, 4, 1, 3, no
144116076,  Vakerobetta, 2, 2, 0, yes
164213527,  kovacic96, 5, 5, 0, yes
2592816870,  MarkoFerluga, 1, 1, 0, yes
2737524651,  PirettiSilvia, 1, 1, 0, yes
44882270,  lindapieragnoli, 2, 2, 0, yes
3075080867,  orammariell1963, 2, 2, 0, yes
68381149,  gzileni, 1, 1, 0, yes
789126114417446912,  saromal3, 1, 1, 0, yes
299161391,  Ambro_Kyo, 3, 3, 0, yes
24709513,  francescapitta, 1, 1, 0, yes
803715094148509696,  fraesammi, 1, 1, 0, yes
1200806024,  MarcoAriatta, 2, 2, 0, yes
542491211,  mariavitalicata, 1, 1, 0, yes
795817923529084928,  damnjoshx, 2, 2, 0, yes
553684583,  pasquale_foti, 6, 6, 0, yes
590756317,  Tommy_The_Wild, 1, 1, 0, yes
538152625,  dianzbd7, 2, 2, 0, yes
596594145,  federicabarghin, 1, 1, 0, yes
846973561,  mammaori, 15, 13, 2, yes
783584786711535616,  Nicolet46764281, 1, 1, 0, yes
258434862,  gaetanto, 1, 1, 0, yes
51800098,  lfpace, 1, 1, 0, yes
2203569688,  elemirsm68, 3, 3, 0, yes
234851087,  PIGIO63, 1, 1, 0, yes
595267886,  AnpiBrescia, 41, 17, 24, no
803869420271628288,  mauroneri58, 1, 1, 0, yes
1113794648,  GiuPay, 1, 1, 0, yes
370682166,  denni66, 2, 1, 1, neutral
39728743,  alessmess, 1, 1, 0, yes
500189677,  santamaria_tw, 4, 4, 0, yes
3929305397,  caver63, 3, 2, 1, yes
554238433,  MirkoMelella, 1, 1, 0, yes
696075129042944000,  pstriziapalmie1, 2, 2, 0, yes
4179150196,  2015Sabry456, 1, 1, 0, yes
876037140,  ClownBombastik, 4, 4, 0, yes
40750418,  marilinac, 2, 1, 1, neutral
702398027340881920,  Amesis1, 3, 3, 0, yes
3862328859,  Adriano34478115, 1, 1, 0, yes
1066012568,  ScanaviniAndrea, 2, 2, 0, yes
90258050,  alexmaiux, 1, 1, 0, yes
1976018636,  zoesun83, 1, 1, 0, yes
725828917,  Anna_Scavuzzo, 3, 3, 0, yes
793497098809475072,  Gerardo92956827, 1, 1, 0, yes
803909156595974144,  angelofederic, 3, 3, 0, yes
757415958,  salvatorecausa1, 1, 1, 0, yes
293643903,  FagusFranco, 3, 2, 1, yes
5440232,  drpbrock, 1, 1, 0, yes
802503264080199680,  Joe03525337, 2, 2, 0, yes
2208056206,  anna888ster, 1, 1, 0, yes
407982210,  AntFuniciello, 2, 1, 1, neutral
406561518,  AC_Ramella, 6, 6, 0, yes
463262805,  destebanica, 2, 2, 0, yes
370813681,  mic_celentano, 1, 1, 0, yes
1552716493,  fabsalt, 1, 1, 0, yes
517717792,  LillyLilly79, 14, 6, 8, no
769784946361794560,  StefanoGioli, 3, 3, 0, yes
442450584,  vinierm, 1, 1, 0, yes
2876814849,  tubinonero2, 1, 1, 0, yes
1011131605,  CiodoCuglas, 2, 2, 0, yes
222759682,  cuochincasa, 1, 1, 0, yes
2148840191,  valerioberghi, 1, 1, 0, yes
502110406,  marco_savi, 3, 3, 0, yes
581734747,  ClaudiaCarciofi, 1, 1, 0, yes
382125014,  zainseimio, 2, 2, 0, yes
4413429676,  FPDaigl, 3, 3, 0, yes
378661982,  maxadler67, 2, 2, 0, yes
423570528,  AnnaNobile1, 1, 1, 0, yes
424054593,  giovannialagna, 1, 1, 0, yes
558528970,  beloivino, 1, 1, 0, yes
1598964204,  robbysgp84, 2, 2, 0, yes
2804818011,  GiulioMirella, 1, 1, 0, yes
849978120,  CocoAntonello, 1, 1, 0, yes
1497920052,  LucaGialdini, 1, 1, 0, yes
2343161827,  angelolbasile, 3, 3, 0, yes
2211105639,  addario_mariago, 1, 1, 0, yes
725421324240343040,  Maiorano69, 3, 3, 0, yes
758773301330272256,  andrea10jfc, 1, 1, 0, yes
2653904513,  GermanaPerrotta, 1, 1, 0, yes
390100028,  kbsite, 1, 1, 0, yes
477742702,  RosiZuccaro, 1, 1, 0, yes
615539623,  Barzaglier, 20, 6, 14, no
54864774,  andreaganduglia, 1, 1, 0, yes
141717132,  carlopoggi, 1, 1, 0, yes
350950543,  michelemogavero, 1, 1, 0, yes
1259767039,  VINCENT1NY, 1, 1, 0, yes
344954159,  AndreZelota, 8, 8, 0, yes
443926629,  EL_PAGA1973, 6, 6, 0, yes
2340568543,  EMANUEL93378867, 1, 1, 0, yes
432622559,  valentinomic, 2, 2, 0, yes
803167744074153984,  Michelucci63, 1, 1, 0, yes
48145270,  TonyLP84, 7, 5, 2, yes
2954612650,  leonimariarosa2, 4, 4, 0, yes
2288845078,  ClaudioNighty, 8, 5, 3, yes
721285765095899136,  AngeCavallo, 1, 1, 0, yes
913132429,  babygold66, 1, 1, 0, yes
444150892,  ViCyuX, 1, 1, 0, yes
238178900,  vincenzo_ingros, 2, 2, 0, yes
581977737,  ferraramariagra, 1, 1, 0, yes
404214104,  PietroTrentini, 1, 1, 0, yes
1566687548,  GingerBo1, 1, 1, 0, yes
396922663,  AttiMorro10, 2, 2, 0, yes
775336111681961984,  BettaBelardi, 2, 2, 0, yes
1014798714,  francovezza, 1, 1, 0, yes
96538236,  manuelmazzuola, 3, 3, 0, yes
803285854089347072,  Michele251259, 1, 1, 0, yes
2974902359,  mimmomagnotti, 2, 2, 0, yes
752176306738044928,  Jacopo19773950, 2, 2, 0, yes
986617478,  andre23091988, 1, 1, 0, yes
746314809503809536,  Maurizio1704, 6, 6, 0, yes
709634135288111105,  unfair_coffee, 9, 7, 2, yes
2420965975,  ciociocioeero, 3, 3, 0, yes
309304789,  ponchomao, 1, 1, 0, yes
753179775032786944,  acgalluzzo, 1, 1, 0, yes
2356967878,  FarnetaniFranco, 3, 3, 0, yes
2785128160,  EmidiArnaldo, 3, 2, 1, yes
732561151,  namelessclara, 10, 8, 2, yes
3309427367,  PaivarintaSusa, 1, 1, 0, yes
361395779,  andreasani80, 3, 3, 0, yes
2760440145,  AngeloCaso3, 1, 1, 0, yes
332681880,  Nemo_cri, 2, 1, 1, neutral
4250417572,  Andrea51202864, 9, 9, 0, yes
2711789036,  giorgio_salve, 1, 1, 0, yes
3119815961,  gabrieleguglie, 1, 1, 0, yes
1543638229,  ISIDOROMARTIN1, 1, 1, 0, yes
1621416823,  maurogrottole, 2, 1, 1, neutral
1117687165,  pedersoli65, 1, 1, 0, yes
3107935427,  cagliaritanosa1, 1, 1, 0, yes
799698834318360576,  tiziRMA, 2, 2, 0, yes
164813609,  Mitofied, 2, 2, 0, yes
255288864,  Ermal17, 1, 1, 0, yes
755110968078823428,  KatoPro8, 7, 7, 0, yes
799323094544424960,  Marsimo16, 2, 1, 1, neutral
2301173789,  gallo_damiano, 1, 1, 0, yes
1249113176,  avenuemistake, 1, 1, 0, yes
2721604847,  EaArlotta, 5, 5, 0, yes
262278118,  GabriellaRoma, 2, 1, 1, neutral
4735246341,  nonenone1963, 4, 4, 0, yes
1071445854,  CheRobaDaMatti_, 1, 1, 0, yes
522377562,  antonella_frida, 1, 1, 0, yes
927462229,  juanjoalic, 2, 2, 0, yes
427697452,  dbchantal, 1, 1, 0, yes
479330315,  MaxMirri, 3, 2, 1, yes
317681267,  maspero71, 1, 1, 0, yes
346117908,  AlexAlyzts, 4, 4, 0, yes
297905311,  sinabozzano, 1, 1, 0, yes
247284957,  Vale41pgh, 1, 1, 0, yes
188482319,  TheRub14, 1, 1, 0, yes
3801782362,  RobiGarba, 1, 1, 0, yes
594459735,  lauratigi, 1, 1, 0, yes
2798012040,  alegriabetorres, 1, 1, 0, yes
3392553737,  jghost99, 2, 2, 0, yes
2746141946,  r_soncin, 1, 1, 0, yes
871503662,  liberocris, 1, 1, 0, yes
425755775,  EMILIORANIERI, 1, 1, 0, yes
790459201717997568,  marcozarrilli, 3, 3, 0, yes
1006550790,  NuccioDR, 3, 3, 0, yes
548583885,  IannucciDiletta, 5, 5, 0, yes
2591663627,  CacyFerri, 1, 1, 0, yes
371967111,  _jlawshug_, 1, 1, 0, yes
3324893553,  g_parrini, 1, 1, 0, yes
395232662,  Kellarios, 1, 1, 0, yes
720527698737696768,  smijavapicurta, 2, 2, 0, yes
32758692,  Be_Italian_, 8, 6, 2, yes
365321803,  marchidomenico, 2, 2, 0, yes
837371060,  ArtoNatkynmaki, 1, 1, 0, yes
1039890864,  AntoniniManuel, 1, 1, 0, yes
730402699175469057,  RobertoSbergamo, 1, 1, 0, yes
1379962796,  mrmnft, 3, 3, 0, yes
836324732,  filippo_vanni, 4, 4, 0, yes
3077787573,  giuseppedid4_di, 1, 1, 0, yes
1159858148,  Cla_Martino, 2, 2, 0, yes
2367194942,  Jacobisthewayyy, 1, 1, 0, yes
124834731,  chiarisss, 1, 1, 0, yes
987656269,  StefanoCalo00, 2, 2, 0, yes
3719573476,  filipporubbo, 3, 3, 0, yes
972698431,  AleMenego77, 1, 1, 0, yes
2218162740,  cainano7, 1, 1, 0, yes
484648514,  capricorne_o, 8, 4, 4, neutral
782564953244987392,  81317bc45bd04a5, 3, 3, 0, yes
769417581241466880,  acconsento, 1, 1, 0, yes
130580971,  giovannigentili, 2, 2, 0, yes
451563463,  achillecilea, 1, 1, 0, yes
1055858269,  maurosabellico, 1, 1, 0, yes
711843915293396992,  anto482000, 2, 1, 1, neutral
805828159216242688,  Tiziano19661, 1, 1, 0, yes
631875191,  Kitran1Salis, 3, 3, 0, yes
1031418979,  Ri_Vanda, 1, 1, 0, yes
269990331,  ReginaKiky, 1, 1, 0, yes
435735578,  AleCarpita, 1, 1, 0, yes
711453640104546304,  angelb3382, 2, 2, 0, yes
1089922537,  Cice534, 3, 3, 0, yes
311585744,  GiulianoMaria, 3, 3, 0, yes
1663147279,  argentera64, 1, 1, 0, yes
2612022706,  DanieleRedondi, 1, 1, 0, yes
2354713851,  DecaminadaW, 1, 1, 0, yes
174988441,  dellicarpinig, 1, 1, 0, yes
1068164431,  ClaudiaCattane0, 2, 2, 0, yes
400330224,  vinlab81, 2, 1, 1, neutral
990726625,  Mattia_Santucci, 1, 1, 0, yes
429040843,  Martyfreespirit, 1, 1, 0, yes
95873530,  IndivigliaSere, 2, 2, 0, yes
1281282217,  atramfra, 2, 2, 0, yes
1024691870,  AdiLuminari, 1, 1, 0, yes
2348446194,  Giusy8385, 1, 1, 0, yes
840402643,  mariellassanti, 2, 1, 1, neutral
3373788165,  BurcusFlorica, 1, 1, 0, yes
2828279840,  AlbiAgo93, 2, 1, 1, neutral
170813905,  _fabio_m_87_, 1, 1, 0, yes
408103322,  _aid_85_, 4, 2, 2, neutral
525164630,  Elisa_Buratto, 1, 1, 0, yes
991297952,  carloperego70, 1, 1, 0, yes
455653827,  giov_ace, 5, 5, 0, yes
805899673101889536,  Oli130470, 1, 1, 0, yes
287171675,  fulgenspa, 4, 4, 0, yes
714339177,  alessiosabelli, 2, 2, 0, yes
150761176,  omusco, 1, 1, 0, yes
1244647422,  ElianaCostantin, 1, 1, 0, yes
793027413114585088,  Scattolinmauri1, 1, 1, 0, yes
439470264,  nicolagelsomino, 1, 1, 0, yes
1080503144,  alfins1992, 1, 1, 0, yes
2417919919,  MancioRuggiero, 1, 1, 0, yes
2594083175,  Ferrettiandrea5, 1, 1, 0, yes
2370495549,  246c034fc877443, 2, 2, 0, yes
1364492293,  Massimo7222m, 1, 1, 0, yes
522780512,  DottRiccardi, 7, 5, 2, yes
1187171011,  maruals16, 3, 3, 0, yes
80453215,  giopiccolo, 1, 1, 0, yes
794573631661674496,  claudiaamazzaa, 1, 1, 0, yes
741906175009169408,  Michal_Zablocki, 1, 1, 0, yes
450010911,  simo_vin, 6, 4, 2, yes
805668727245205504,  harleyblack88, 2, 2, 0, yes
1216444724,  christianmereu8, 3, 3, 0, yes
63722830,  scaraurbino, 2, 2, 0, yes
396165183,  giuserk, 1, 1, 0, yes
724551118731223040,  bendur4, 1, 1, 0, yes
723502779273195520,  Ale77780795136, 1, 1, 0, yes
807368744,  AlessiaCr7, 2, 2, 0, yes
2750016569,  n_mariagrazia, 1, 1, 0, yes
2445078025,  slevinkelevra27, 2, 2, 0, yes
31814068,  amonni, 1, 1, 0, yes
573692565,  BalivieraMorgan, 1, 1, 0, yes
710511455511191553,  comunitega, 1, 1, 0, yes
805893644393807872,  pacogelsom84, 1, 1, 0, yes
728498953512226816,  marvi_65, 1, 1, 0, yes
1398109956,  giannimu_pi, 1, 1, 0, yes
116437098,  Andreabont, 1, 1, 0, yes
987344071,  PaoloTardonato, 1, 1, 0, yes
725337622512541700,  DaniloGiannell1, 1, 1, 0, yes
3124736901,  jacopocoghe, 11, 4, 7, no
2731882690,  danieleangelo10, 1, 1, 0, yes
486937527,  gmzama, 4, 4, 0, yes
747720903585304577,  pierinoscarpa, 4, 4, 0, yes
738434718287450112,  valereali22, 1, 1, 0, yes
522645856,  DarioCiccarell1, 2, 2, 0, yes
1406174118,  CTrabello, 1, 1, 0, yes
369762590,  FantinRoberto, 4, 2, 2, neutral
392096209,  GiulioGiumelli, 3, 3, 0, yes
705377374632845312,  giulianamezzab1, 1, 1, 0, yes
328491544,  AnnaCazzato, 2, 2, 0, yes
1106363018,  BigDen88, 3, 3, 0, yes
4730040141,  Gnomo_armato, 3, 1, 2, no
4764739937,  agata_46, 1, 1, 0, yes
194582452,  tommofaa, 1, 1, 0, yes
2245653349,  fabiop2056, 1, 1, 0, yes
852570362,  GioPaini23, 2, 2, 0, yes
805886942646824960,  baroni_rossella, 1, 1, 0, yes
2882547052,  Antonio92805983, 2, 2, 0, yes
533293266,  danielafaccini1, 1, 1, 0, yes
3104441007,  paola_destefano, 4, 3, 1, yes
1301015124,  cmarangoni45, 1, 1, 0, yes
2612119279,  MaxDecris, 1, 1, 0, yes
422447952,  Loryferrantino, 1, 1, 0, yes
805770657917206529,  liccardomaria5, 4, 4, 0, yes
426883834,  PepeBarbara, 1, 1, 0, yes
805877341578792960,  McCalevi, 1, 1, 0, yes
742439264634429441,  graziantonio, 1, 1, 0, yes
712572506155196417,  Adriana6820, 1, 1, 0, yes
2211275061,  MetexVerri, 1, 1, 0, yes
2185943618,  SimonaFerrigno, 2, 2, 0, yes
157264821,  vitt58, 1, 1, 0, yes
2576835918,  annaTeocrito, 1, 1, 0, yes
787988590492053505,  picchi_maria, 2, 1, 1, neutral
452184440,  SciaccaLeandro, 1, 1, 0, yes
605434193,  rosichechile, 1, 1, 0, yes
805901560630956033,  sylvia_ilaria19, 1, 1, 0, yes
802432542,  AL0890, 1, 1, 0, yes
487414429,  ciccilluzzo66, 1, 1, 0, yes
2496986089,  gennyiris, 1, 1, 0, yes
196240250,  PREVIDANZ, 1, 1, 0, yes
435319385,  DanielCardella, 1, 1, 0, yes
1074099775,  gio_decesare, 1, 1, 0, yes
801181281073635329,  Marina98569474, 4, 4, 0, yes
1610413645,  elipilotto, 1, 1, 0, yes
1219845163,  sapirro, 1, 1, 0, yes
715905436617080834,  mondo_grande, 1, 1, 0, yes
459595085,  RossellaAlice, 1, 1, 0, yes
361209360,  CapozziAngelo, 3, 3, 0, yes
487913540,  SamanthaDomo1, 2, 2, 0, yes
1285556504,  AltayAtli, 1, 1, 0, yes
2465797847,  luraffa15, 1, 1, 0, yes
374525464,  onizuka_74, 1, 1, 0, yes
1370627900,  GianpaOcchi, 2, 1, 1, neutral
564910192,  robytab1975, 2, 2, 0, yes
776126572680122368,  SusyColdani, 1, 1, 0, yes
1360394078,  polenghi_laura, 1, 1, 0, yes
144094119,  eligia60, 5, 5, 0, yes
562807602,  annamariadiste2, 1, 1, 0, yes
512047393,  GiacomoM21, 1, 1, 0, yes
953435533,  pat2878, 2, 2, 0, yes
1274432312,  AlexriccoRicco, 2, 2, 0, yes
475264432,  lucagentile82, 2, 2, 0, yes
805536902619267072,  paolo_bongio, 1, 1, 0, yes
291951525,  smirandaberrios, 2, 2, 0, yes
805870261543325698,  AndreaSignori61, 2, 2, 0, yes
3492743956,  gabriga, 1, 1, 0, yes
778981281774366720,  Antonella_Zon, 1, 1, 0, yes
724647029234905091,  augustogargiul2, 2, 1, 1, neutral
2543001328,  prcdjo, 1, 1, 0, yes
768575366936100864,  347_3901834, 1, 1, 0, yes
2364041090,  _Ste_Reo_, 2, 2, 0, yes
831530906,  supermucc, 1, 1, 0, yes
771317289706749952,  Frapaosa, 1, 1, 0, yes
87179410,  bikan78, 1, 1, 0, yes
42735462,  alexduca22, 1, 1, 0, yes
258153630,  Von_TrOto, 1, 1, 0, yes
243387192,  emanuelesanti, 1, 1, 0, yes
107451227,  Whizzkiddyy, 1, 1, 0, yes
847547569,  Pino462Volo, 1, 1, 0, yes
1497948943,  BernoccoSergio, 2, 2, 0, yes
410784013,  BarbaraEsposit, 2, 1, 1, neutral
805907581231366145,  Nicolabenucci1, 1, 1, 0, yes
1068635341,  adsebam, 1, 1, 0, yes
1407243602,  LetiziaGallacci, 2, 2, 0, yes
2604012643,  urbancenterbs, 1, 1, 0, yes
1020730568,  sorge_sorge6, 1, 1, 0, yes
57367213,  TeikDet, 4, 2, 2, neutral
4188938500,  claudiateani62, 3, 3, 0, yes
1219740385,  elena_pivato, 1, 1, 0, yes
141980528,  allwaswell_, 1, 1, 0, yes
3907063761,  xcguido, 1, 1, 0, yes
976734018,  GaetaninoMolino, 1, 1, 0, yes
390428793,  mojopin82, 2, 2, 0, yes
1453522026,  acdicerbo, 8, 6, 2, yes
600472039,  chnindia, 2, 2, 0, yes
385110492,  MicheleAzzoni, 1, 1, 0, yes
283640603,  _peaceloveteen, 2, 2, 0, yes
2890667314,  ABiffignandi, 1, 1, 0, yes
2609560783,  normanrusin, 1, 1, 0, yes
963961790,  Francesco_Ruggi, 1, 1, 0, yes
2225019673,  rita_maurizi, 1, 1, 0, yes
473060936,  Bolla1970, 1, 1, 0, yes
2201247817,  vitodomenico2, 1, 1, 0, yes
2345296493,  CPanfido, 1, 1, 0, yes
105053026,  trishadria, 2, 2, 0, yes
525311447,  catesimonetta, 1, 1, 0, yes
381568548,  cedrix69, 1, 1, 0, yes
760014773853556736,  JackBurtonn2000, 1, 1, 0, yes
805790150504615936,  MarziaCagnato, 1, 1, 0, yes
1086792000,  belellazanni, 1, 1, 0, yes
528917055,  toscano_sergio, 3, 1, 2, no
1445925811,  Mike63Ho, 2, 2, 0, yes
4319003842,  caterinabruno84, 1, 1, 0, yes
703301775504363524,  angelodabramo2, 2, 2, 0, yes
191869260,  JoBusnelli, 1, 1, 0, yes
177157796,  dolcestella22, 1, 1, 0, yes
804813426,  Alisnontarsis, 1, 1, 0, yes
111650382,  asia58, 1, 1, 0, yes
65311995,  hispaunique, 3, 1, 2, no
744479400524136449,  wolfgang6012, 1, 1, 0, yes
532438449,  luigipriore, 2, 2, 0, yes
1219416210,  mariaflissia, 1, 1, 0, yes
95106953,  paolopaterno, 16, 7, 9, no
240566257,  diturigio, 2, 2, 0, yes
1066629925,  ToncapAntonio, 1, 1, 0, yes
1188804643,  GBesostri, 4, 3, 1, yes
218141718,  bakiatilal, 1, 1, 0, yes
358199427,  UrbaniGilda, 1, 1, 0, yes
553556334,  66oznerol, 3, 1, 2, no
94162446,  claudiugeo, 1, 1, 0, yes
107443647,  alexsibilia, 2, 2, 0, yes
2148663592,  alfieriseverin7, 1, 1, 0, yes
133032441,  andrea_ispanico, 3, 1, 2, no
61474009,  VimerKaizen, 6, 3, 3, neutral
1971972030,  barreca56, 2, 2, 0, yes
2350692007,  Francicampomori, 1, 1, 0, yes
298739862,  BarbyPatty, 1, 1, 0, yes
4610932577,  ilucian2, 5, 3, 2, yes
399246036,  RSInews, 1, 1, 0, yes
444700148,  antoniofiorese, 1, 1, 0, yes
1703205367,  PietroBjorn, 4, 4, 0, yes
2990249578,  Steskrilli28, 1, 1, 0, yes
806046063643725824,  PatriziaFilard, 1, 1, 0, yes
539098109,  lucia_pal, 17, 13, 4, yes
498212917,  raffaele391, 1, 1, 0, yes
4260050973,  lungasina, 2, 2, 0, yes
4038857799,  Vincentr2s, 6, 6, 0, yes
371215185,  sergiob74, 1, 1, 0, yes
412500669,  marcoputano, 3, 3, 0, yes
3124374833,  raultassoni, 1, 1, 0, yes
2183402061,  CConservati, 5, 5, 0, yes
805850605793214464,  SyrmaNetwork, 1, 1, 0, yes
2806017956,  IlaMaSai, 1, 1, 0, yes
189793682,  lucaroncolini, 1, 1, 0, yes
4892960189,  EntitaAstratta, 1, 1, 0, yes
3036224586,  ColandreaRosa, 1, 1, 0, yes
2563476906,  gentediferro66, 1, 1, 0, yes
1638584010,  ma_vittoalbi, 2, 2, 0, yes
407752145,  liviocinque, 1, 1, 0, yes
332185091,  Theodossiou_Lui, 1, 1, 0, yes
377970245,  eemme93, 1, 1, 0, yes
908801413,  madana_e, 1, 1, 0, yes
1274942012,  pandozzirita, 1, 1, 0, yes
2870866894,  blackmesa_ita, 1, 1, 0, yes
493060591,  VeroGrey, 3, 3, 0, yes
2176193576,  luca__pani, 1, 1, 0, yes
2340274544,  AndrePiazzo, 1, 1, 0, yes
1057682683,  acord1410, 3, 1, 2, no
2380633702,  MaroneBenedetta, 1, 1, 0, yes
2436934572,  martapiras8, 3, 3, 0, yes
3676549834,  IzzoEdo, 13, 13, 0, yes
805945482036051968,  cabrio1998, 1, 1, 0, yes
4654021697,  EliaPruzzo, 1, 1, 0, yes
857728867,  Inchiostronline, 1, 1, 0, yes
1148940668,  vale_ferdy, 1, 1, 0, yes
3184354421,  giusy13573, 7, 4, 3, yes
711605443701903360,  tizianopag, 3, 3, 0, yes
760183997381173249,  giuliana_hemmo, 3, 3, 0, yes
52509655,  clabel67, 2, 1, 1, neutral
3026099110,  fameht, 4, 4, 0, yes
3662923950,  GiusiDiStefano5, 1, 1, 0, yes
242885155,  TommyTrei, 3, 3, 0, yes
558985377,  letiziabellemo, 1, 1, 0, yes
775383800251645952,  bea_bisogni, 2, 2, 0, yes
264327185,  domemartin, 1, 1, 0, yes
1539390186,  RiccardoSpini, 1, 1, 0, yes
2308000276,  Rob_Bonanno, 2, 2, 0, yes
570304957,  GiuliaPergher, 1, 1, 0, yes
722398285,  Jacopoeva, 1, 1, 0, yes
2599642884,  venerapadua, 3, 2, 1, yes
255792264,  CateDeSilvestro, 1, 1, 0, yes
1205354846,  CPettiti, 1, 1, 0, yes
950122428,  mondant95, 1, 1, 0, yes
2679521044,  66lume, 1, 1, 0, yes
1057161192,  costancisl, 2, 2, 0, yes
3256311822,  hika_ri070, 2, 2, 0, yes
1462482566,  GmailVio, 3, 2, 1, yes
1198472317,  ZahariaMonica, 1, 1, 0, yes
1071811099,  LuxBisceglia, 2, 2, 0, yes
2412885015,  CapannoloMarisa, 1, 1, 0, yes
1225157396,  PantaniPantani, 1, 1, 0, yes
805801962314797060,  maseirodobrasil, 1, 1, 0, yes
1224121074,  Lucyo__R, 2, 2, 0, yes
384427964,  emacoltelli, 1, 1, 0, yes
1276838551,  RobertoSerra73, 1, 1, 0, yes
3134914471,  giovannafragala, 1, 1, 0, yes
2942105237,  loredana5264, 1, 1, 0, yes
115024071,  SIS024, 1, 1, 0, yes
1885976930,  signoradeifiltr, 1, 1, 0, yes
2921043755,  CoxPerseo012, 7, 1, 6, no
232968747,  morandisilvia, 2, 2, 0, yes
734020351072567296,  DPulci, 1, 1, 0, yes
562399185,  iorizzoantonio, 3, 3, 0, yes
804302503277891584,  Annachiarasosio, 1, 1, 0, yes
418286420,  dalla077, 1, 1, 0, yes
805895911348072448,  GaiaLucillaGall, 1, 1, 0, yes
2388403762,  matialedda, 3, 3, 0, yes
497010137,  Mariannatao, 1, 1, 0, yes
761252940,  78teacher78, 1, 1, 0, yes
2366279700,  GattopardoTweet, 2, 2, 0, yes
746439475681759232,  Isabell73659924, 1, 1, 0, yes
3052778868,  IamBrlaCurry, 1, 1, 0, yes
571812056,  BarbaraAngi1, 1, 1, 0, yes
316493557,  paolacecconi, 7, 7, 0, yes
2429386930,  maxremolo, 4, 4, 0, yes
348387638,  AbadArchitetti, 1, 1, 0, yes
197575905,  LuciaGuerrasio, 1, 1, 0, yes
3773920703,  eugeniocaldo52, 3, 1, 2, no
2560002155,  cammaratarob, 1, 1, 0, yes
1337693348,  GianlucaCutrona, 1, 1, 0, yes
805749735256690688,  giorgio1414555, 3, 3, 0, yes
74728621,  potina83, 2, 2, 0, yes
2212503497,  AleblaAleblasi, 2, 2, 0, yes
2159647721,  ManoniManu, 2, 2, 0, yes
1173363540,  gilaguardia, 5, 5, 0, yes
111961091,  giuli673, 1, 1, 0, yes
1485089334,  MikaIsti185, 2, 2, 0, yes
270121337,  romanocugini, 2, 2, 0, yes
1324197673,  armapan_it, 3, 3, 0, yes
158418589,  DaviScalvi, 2, 2, 0, yes
805592012099584001,  Sara14179089, 2, 2, 0, yes
2238237993,  surrevnder, 2, 2, 0, yes
805816298173296645,  cristiana0773, 1, 1, 0, yes
702540775444385792,  TeobaldoDragna, 2, 1, 1, neutral
2937240045,  DonaAdonan, 1, 1, 0, yes
1536731845,  ermigen65, 1, 1, 0, yes
4776112373,  psantomassimo, 2, 2, 0, yes
2434225281,  dodoscot, 3, 3, 0, yes
831144326,  aldocavi, 4, 4, 0, yes
805814984261468160,  blaesius1967, 1, 1, 0, yes
1278074342,  carbone_gio, 1, 1, 0, yes
805737774447988736,  mrpiquel, 4, 2, 2, neutral
1697422272,  slaylorswjft13, 1, 1, 0, yes
3036972749,  fedeberry19, 3, 3, 0, yes
751729823979102208,  ffranck08, 5, 5, 0, yes
2565800577,  BeAnIkon, 1, 1, 0, yes
4833517913,  fleinaudi, 1, 1, 0, yes
1189850346,  Gonzalomiao, 2, 2, 0, yes
184073963,  paolopagnani, 1, 1, 0, yes
383147499,  antreb70, 1, 1, 0, yes
283736186,  giuppoQ, 1, 1, 0, yes
1006876178,  MonicaMarianel1, 1, 1, 0, yes
2262356182,  NardiniLuciano, 5, 4, 1, yes
331292864,  DiegoPierotti90, 3, 3, 0, yes
350766347,  ElenaRodighiero, 1, 1, 0, yes
2753606067,  annastabez, 1, 1, 0, yes
711323552054697985,  GViglietti1, 4, 1, 3, no
738805650344542208,  flaviamauro1, 9, 5, 4, yes
1728932216,  edavid57edavid, 2, 2, 0, yes
481344798,  DavideDW2, 1, 1, 0, yes
782463866,  GraBon81, 3, 3, 0, yes
16501369,  1976david, 6, 5, 1, yes
490364129,  Chris3890, 1, 1, 0, yes
130270574,  graziafirenze, 2, 2, 0, yes
734043903070994433,  pamela75it, 2, 2, 0, yes
2160920051,  simoico, 1, 1, 0, yes
3424274885,  aaanna_rana, 1, 1, 0, yes
12612202,  Stantonundersun, 1, 1, 0, yes
135939871,  taorcar, 2, 2, 0, yes
712933454577549313,  rossellaricco, 2, 2, 0, yes
483809978,  giorgiansa, 12, 7, 5, yes
2526966019,  Olgafanotti1697, 1, 1, 0, yes
1248202345,  ffabbri52, 2, 2, 0, yes
770866242194399232,  90e799372df1425, 1, 1, 0, yes
119921111,  marilisacoll, 1, 1, 0, yes
599129644,  MengoniLov, 1, 1, 0, yes
2282687898,  PersonalShipper, 1, 1, 0, yes
472176643,  LuongoDaniele, 1, 1, 0, yes
4697711293,  Nessunolaura, 2, 2, 0, yes
64041947,  gigiocamicio, 5, 5, 0, yes
1947835710,  swonsae, 3, 1, 2, no
386687136,  ceciliatencone, 2, 2, 0, yes
986583032,  MatteoCapuano3, 3, 3, 0, yes
361389822,  MarcoZeppa, 2, 2, 0, yes
780464402,  xsandrasheart, 3, 3, 0, yes
805888803407884288,  carmen_morg, 1, 1, 0, yes
2912475195,  stefaniaorselli, 2, 2, 0, yes
433750466,  alekso7, 1, 1, 0, yes
381088822,  JustPaolaC, 10, 8, 2, yes
512387705,  GioiaLagalla, 1, 1, 0, yes
73768522,  VittSmaldone, 1, 1, 0, yes
1264709348,  stenog2, 1, 1, 0, yes
700411790669299712,  agivikdi, 1, 1, 0, yes
1039994628,  GmaiRattalino, 1, 1, 0, yes
188708174,  Snake90Inter, 12, 12, 0, yes
586821355,  EnzoRavanelli, 1, 1, 0, yes
618443092,  thomaslebeux, 1, 1, 0, yes
211454659,  gianlucaboerio, 1, 1, 0, yes
2356887630,  Sofia6610, 1, 1, 0, yes
2826424217,  CoppolaGemma, 1, 1, 0, yes
157946397,  AllStarsLA, 5, 3, 2, yes
712174637283741696,  klin1964, 1, 1, 0, yes
986536724,  clemederosa, 1, 1, 0, yes
24040619,  DoctorMounir, 2, 2, 0, yes
417202643,  francyelia29, 1, 1, 0, yes
3095435091,  fferreri76, 1, 1, 0, yes
1042817496,  G_Tanzi, 1, 1, 0, yes
1213116002,  scideru, 1, 1, 0, yes
627236979,  Giuseppe_Lino, 1, 1, 0, yes
1013211769,  egonstocca, 2, 2, 0, yes
1039313287,  Fausto62855343, 1, 1, 0, yes
164009400,  enstatel, 1, 1, 0, yes
408760297,  Feversinger, 15, 6, 9, no
379265008,  maricageno, 2, 2, 0, yes
3394444413,  _ilaria71_, 1, 1, 0, yes
3297589470,  bergonzini65, 1, 1, 0, yes
1975547893,  HPellizzari, 1, 1, 0, yes
3310899273,  MeAndry7mo, 1, 1, 0, yes
245437223,  scuoco, 6, 4, 2, yes
478025833,  MauroBattocchi, 1, 1, 0, yes
3381470813,  imbalsamto, 3, 1, 2, no
244688082,  teoporrini, 2, 2, 0, yes
485894899,  giorcesa, 1, 1, 0, yes
367404041,  champagnefeds, 1, 1, 0, yes
1533213979,  laumik2, 8, 3, 5, no
802947459987214336,  lucabersa, 2, 2, 0, yes
717069146861776896,  Saby98268953, 3, 3, 0, yes
3438440643,  admess78, 1, 1, 0, yes
777089880417501184,  EllaNonna, 9, 9, 0, yes
3295039204,  bolzoni41, 5, 4, 1, yes
16770004,  guido1946, 5, 5, 0, yes
3238910007,  samuelegerra, 2, 2, 0, yes
2435411612,  macciuk, 1, 1, 0, yes
2972771547,  ric_gris, 1, 1, 0, yes
49621992,  OkyDoki, 1, 1, 0, yes
3044822301,  ThomasBurns02, 1, 1, 0, yes
2330894345,  CavestroDaniel, 3, 3, 0, yes
58020070,  emmedibi, 9, 8, 1, yes
507361899,  PietroPicchione, 2, 2, 0, yes
329654685,  SPettirossi, 1, 1, 0, yes
2970042478,  GaetanoRu, 1, 1, 0, yes
475583491,  Anna__Traverso, 2, 2, 0, yes
249885528,  Lelemusso, 2, 2, 0, yes
732287754483142657,  italiachedicesi, 9, 8, 1, yes
6667662,  FedeCantore, 3, 3, 0, yes
109306788,  alex21daly, 1, 1, 0, yes
4888682921,  Vera3318, 3, 3, 0, yes
296922136,  pitehr36, 1, 1, 0, yes
593435707,  PietroAngelo66, 2, 1, 1, neutral
797882257470062592,  giusepp62650091, 2, 2, 0, yes
284320032,  jhmm61, 1, 1, 0, yes
803384371055067138,  DanieleFeder, 10, 10, 0, yes
2173103482,  FBellafiore, 3, 1, 2, no
1550260160,  ugobatta, 2, 1, 1, neutral
466374664,  erreesse3, 2, 2, 0, yes
792003256788611072,  Amy_Gdala75, 2, 2, 0, yes
325998469,  elisfor, 1, 1, 0, yes
2283373956,  menta7878, 4, 3, 1, yes
257003372,  GUERRIEROSS, 1, 1, 0, yes
160339069,  markgonzales34, 6, 6, 0, yes
3026858723,  rakyfirinu, 2, 2, 0, yes
2333450384,  GianlucaLupo1, 9, 8, 1, yes
968032663,  Saladino_M, 1, 1, 0, yes
2483939889,  CarlosFalchluza, 1, 1, 0, yes
3127942570,  enrico_pippo, 1, 1, 0, yes
1653604406,  tdm1955it, 2, 2, 0, yes
517723738,  Donakunnn, 1, 1, 0, yes
803660257033646080,  Ernesto_Lesto, 2, 1, 1, neutral
833299458,  vinzivona, 2, 2, 0, yes
3899236816,  tani_milena, 2, 2, 0, yes
823564208,  JohnnyIdiot, 1, 1, 0, yes
3792736767,  AurelienVie, 3, 3, 0, yes
606592795,  KALOSPIETRO, 1, 1, 0, yes
3036587481,  mbianchi462, 17, 17, 0, yes
795235929472516096,  VGrazie, 2, 2, 0, yes
794118522901299202,  paolo93183246, 2, 2, 0, yes
558089202,  bordonaroluca68, 3, 3, 0, yes
224574652,  twitkekko, 1, 1, 0, yes
322697437,  gelatil, 1, 1, 0, yes
2330738430,  lazzaro_valerio, 1, 1, 0, yes
3102691408,  AleBert59, 3, 3, 0, yes
421433392,  AveBicci, 13, 12, 1, yes
791257257413578752,  little_teeny, 1, 1, 0, yes
573579130,  pierchiodo, 2, 1, 1, neutral
2700071212,  evapascal15, 10, 9, 1, yes
2863798143,  famularim, 3, 1, 2, no
387022949,  solodax, 1, 1, 0, yes
75395790,  aleandrorossini, 2, 2, 0, yes
796796368266391552,  AndreaCantoni8, 5, 4, 1, yes
940908996,  CostanzaRdO, 9, 7, 2, yes
193739510,  raffaelevitali, 11, 11, 0, yes
438281116,  claudiognoni, 1, 1, 0, yes
2951313046,  cathillustrator, 1, 1, 0, yes
1127685474,  DdlDaniela2, 1, 1, 0, yes
2584361935,  valter76_, 2, 1, 1, neutral
1011412032,  Orizzonte58, 1, 1, 0, yes
2765428826,  Bart7Bm, 4, 4, 0, yes
640073,  melamorsicata, 1, 1, 0, yes
2574452613,  calvi_lorenzo, 14, 1, 13, no
2510576799,  64Lovisetto, 11, 11, 0, yes
3007780061,  vincenzomele95, 2, 2, 0, yes
326146021,  DarioChinnici, 2, 2, 0, yes
820389576,  mariapaolelli, 2, 2, 0, yes
635566811,  maurosironi77, 1, 1, 0, yes
2310684649,  00Zucchi, 3, 1, 2, no
301468494,  DavideBills, 2, 1, 1, neutral
1050595495,  Crismero69, 1, 1, 0, yes
2886982929,  farastella21, 12, 12, 0, yes
371820912,  ClaudioVetica, 2, 2, 0, yes
2819161970,  EJTweetHouse, 1, 1, 0, yes
377199894,  bennyscud, 12, 5, 7, no
2627796677,  giusan68, 1, 1, 0, yes
441651345,  UGLNazionale, 154, 4, 150, no
553591290,  BaranEmelie, 4, 4, 0, yes
491176354,  MasulliAntonio, 2, 1, 1, neutral
2751984429,  donatella_lo, 1, 1, 0, yes
2236048704,  markaffa78, 2, 2, 0, yes
2990250646,  QuiNewsFirenze, 6, 4, 2, yes
2690997729,  CloFede, 1, 1, 0, yes
244021846,  MattiaZuninoSv, 4, 4, 0, yes
985133178,  f_flores78, 12, 6, 6, neutral
35697270,  DANY_ELLE1982, 8, 8, 0, yes
546315372,  Corradino66, 1, 1, 0, yes
803741173210902528,  mariast39721096, 1, 1, 0, yes
714968789,  gaspaAndrea84, 5, 2, 3, no
492675576,  ADenatalle, 1, 1, 0, yes
216361540,  LiaQuartapelle, 2, 2, 0, yes
45120224,  comAttiva, 7, 6, 1, yes
3184426408,  ObamoliniB, 13, 13, 0, yes
775314188596051968,  opellone, 1, 1, 0, yes
795615393431846912,  fraccabrino, 2, 2, 0, yes
772162945186955265,  Leonard36794901, 2, 2, 0, yes
2182841745,  adriano_pessina, 3, 3, 0, yes
3360344733,  roccocerina, 1, 1, 0, yes
2428567557,  mauropitton, 2, 2, 0, yes
2179898026,  leolovesu2, 2, 2, 0, yes
257058124,  gustavochiaia, 1, 1, 0, yes
2996647597,  nacho_oliva, 2, 2, 0, yes
730598124,  MarcoCivCiviero, 2, 2, 0, yes
2447546260,  tony63it, 1, 1, 0, yes
3039844868,  71Maxneri, 8, 7, 1, yes
2962789199,  RobyArcidiacono, 1, 1, 0, yes
2761757177,  gia_gmcasadio1, 2, 2, 0, yes
789176953194491906,  StellaS09002291, 1, 1, 0, yes
2361232380,  angeloluigigi, 3, 3, 0, yes
575586304,  photocaptionist, 1, 1, 0, yes
1957607898,  torepira, 5, 2, 3, no
3397183961,  LuigiGiglio6, 3, 3, 0, yes
3002208143,  danielefesta265, 3, 3, 0, yes
765612750580035584,  manuelmendozah7, 1, 1, 0, yes
2480640006,  imariasanova, 1, 1, 0, yes
3074524055,  marina_fabris, 1, 1, 0, yes
2355421763,  ScarabocchioM, 1, 1, 0, yes
798053129048756224,  coruccicarlo2, 3, 1, 2, no
787888638,  giotina74, 10, 2, 8, no
1246491950,  lorenzoandreat1, 1, 1, 0, yes
594879721,  OnAntonioGuidi, 3, 2, 1, yes
481475713,  KentAllard23, 6, 6, 0, yes
636882327,  TvRocca, 2, 1, 1, neutral
754667416492318720,  MirianoGolfari1, 2, 2, 0, yes
2343279570,  bartolo91062907, 2, 1, 1, neutral
3837178823,  manuela_repetti, 1, 1, 0, yes
394850579,  steilcapo, 14, 3, 11, no
1482312986,  UmbertoCrimaldi, 1, 1, 0, yes
732569695,  Da89Na, 5, 5, 0, yes
489756977,  MicheleTripodi, 2, 2, 0, yes
787074648324333568,  DaniloCroci, 2, 1, 1, neutral
50265202,  claudiocaputo, 1, 1, 0, yes
2814619524,  fildered, 1, 1, 0, yes
2973189238,  paolo_demartin, 1, 1, 0, yes
499910613,  UGOACANFORA, 6, 1, 5, no
2510733091,  annarosagallo, 1, 1, 0, yes
236044812,  fpmule, 2, 2, 0, yes
406876120,  skorpionet, 1, 1, 0, yes
1274578022,  easiertosay, 1, 1, 0, yes
4908255899,  CoordNazTFA, 1, 1, 0, yes
566533860,  Sbirulin0, 1, 1, 0, yes
473410891,  FrancoGemoli, 2, 2, 0, yes
796218960211480579,  marioOakland, 1, 1, 0, yes
427449888,  gualtino, 1, 1, 0, yes
376812864,  DelDottoSindaco, 1, 1, 0, yes
754795288100044800,  giusepp1803, 5, 5, 0, yes
380275805,  BrunettiRiccard, 10, 9, 1, yes
763416023458582528,  lorenza_pasetto, 3, 3, 0, yes
2181076939,  LucaToma1994, 1, 1, 0, yes
779967912526376960,  LuigiMariaVairo, 4, 2, 2, neutral
246435678,  chiccaolivieri, 1, 1, 0, yes
781030438357897216,  hashtagstrunz, 1, 1, 0, yes
8722682,  matteocascinari, 1, 1, 0, yes
595224319,  NicolettaGruppu, 1, 1, 0, yes
2749088045,  gabbianelligia1, 2, 2, 0, yes
804399149517041664,  BeppeNassa1, 1, 1, 0, yes
3307074435,  italiadigital, 1, 1, 0, yes
2199345186,  verlaine64, 1, 1, 0, yes
382662736,  MauroLogoluso, 4, 2, 2, neutral
3074874802,  Stefo_254, 1, 1, 0, yes
144238477,  leontovar, 4, 4, 0, yes
515589181,  PaoloStern, 6, 5, 1, yes
2361702682,  giuseppe_max, 1, 1, 0, yes
1374076440,  checcosedda, 4, 3, 1, yes
787733172146540544,  ANDREAA79200647, 1, 1, 0, yes
326340678,  ClaOfficial_, 4, 4, 0, yes
2534686371,  fuiano_pa, 5, 5, 0, yes
2578471809,  ramini_fabio, 1, 1, 0, yes
593577410,  esseds72, 1, 1, 0, yes
1704580074,  Giu_Terlingo89, 4, 4, 0, yes
444931728,  ALEALEFARINA, 1, 1, 0, yes
1304968112,  BbbNunziol, 5, 3, 2, yes
326926222,  NicAcanfora, 2, 2, 0, yes
516453177,  claudiasonni, 2, 2, 0, yes
510307226,  Samu17_98, 3, 3, 0, yes
2183042574,  96gattoGatto, 8, 7, 1, yes
410303607,  GCannoletta, 2, 2, 0, yes
361898272,  runningeleven, 2, 2, 0, yes
2821370567,  nicodelavi, 2, 2, 0, yes
248339825,  NickGarrone, 1, 1, 0, yes
4894897763,  Alessandro_Ill, 1, 1, 0, yes
51107058,  francesco_spini, 1, 1, 0, yes
723754024797872128,  Nthestationband, 1, 1, 0, yes
3834311536,  CiroKalabrie, 1, 1, 0, yes
597370837,  alfonso_bo, 2, 2, 0, yes
479614754,  IlBomma, 1, 1, 0, yes
1127973074,  furiavecio, 1, 1, 0, yes
1010702017,  Andyfex, 1, 1, 0, yes
2992828757,  farinapeppe1, 4, 2, 2, neutral
431603239,  ArnaldoPiace, 6, 5, 1, yes
338026601,  MaurizioCardone, 1, 1, 0, yes
2393696916,  CarlaPara1, 2, 2, 0, yes
569206780,  chanos9, 1, 1, 0, yes
416398905,  Edoniki, 1, 1, 0, yes
456928505,  higays_, 5, 5, 0, yes
1373751762,  elisatomat, 1, 1, 0, yes
321968756,  G_Innamorati, 1, 1, 0, yes
2544433278,  elledi78, 1, 1, 0, yes
2169931168,  dav_insa3, 3, 3, 0, yes
452112808,  lveltro, 1, 1, 0, yes
527624443,  ilpatriota75, 6, 3, 3, neutral
481479393,  Viaggiare_87, 1, 1, 0, yes
72257237,  frankdi63, 5, 1, 4, no
2149309513,  constancewillli, 1, 1, 0, yes
1889561377,  Frankiesquare69, 1, 1, 0, yes
746092736898547713,  BastaUnSiFormia, 3, 3, 0, yes
2997639443,  bea7shon, 3, 1, 2, no
83224596,  gabrcip, 9, 3, 6, no
1286465791,  borga_lor, 4, 3, 1, yes
349642471,  GiuseppeScat, 2, 2, 0, yes
1048895396,  chicco966, 3, 3, 0, yes
1364981654,  giusepp30016367, 8, 1, 7, no
324934640,  antonioventura7, 1, 1, 0, yes
963938472,  Palazzo_Chigi, 10, 10, 0, yes
803587400937209856,  15Giuseppe1985, 3, 3, 0, yes
973839372,  acuksa, 1, 1, 0, yes
831827472,  NicKiappa, 8, 5, 3, yes
2967510047,  dentepaola3, 3, 3, 0, yes
912350342,  waltergrosso1, 1, 1, 0, yes
520241462,  fischiofresco, 1, 1, 0, yes
200440164,  giovanniluca69, 6, 6, 0, yes
2313378680,  AndreaFer0223, 3, 2, 1, yes
266017620,  aokikuchan, 1, 1, 0, yes
799106819478188032,  renatovolonta7, 1, 1, 0, yes
803658363812872192,  AmoreMi71900653, 3, 3, 0, yes
627829911,  Fcstbl, 4, 2, 2, neutral
1030368018,  sergio_murari, 2, 2, 0, yes
447155122,  pietro_polito, 1, 1, 0, yes
1334666292,  RenzIsis, 9, 4, 5, no
14128105,  mikelabatt, 1, 1, 0, yes
1929781434,  oreip78, 1, 1, 0, yes
1852811395,  Leo_burns85, 5, 5, 0, yes
745689833331359745,  MonzaperilSi, 8, 8, 0, yes
929469324,  mark_martinelli, 1, 1, 0, yes
2453337396,  Antonio27046782, 2, 2, 0, yes
740302141676523520,  Luc_Giannotti, 7, 1, 6, no
551962283,  LoPasquali, 1, 1, 0, yes
3979935923,  bartolean, 3, 3, 0, yes
785445474291638272,  antoniopireddu1, 3, 3, 0, yes
2960680120,  Pasqualebisi, 1, 1, 0, yes
3852803728,  flo55302417, 2, 2, 0, yes
701822386925076480,  IreneididiMarzo, 1, 1, 0, yes
1004615576,  GiuseppeBigica, 1, 1, 0, yes
799524531182403588,  Alessiaorsa96, 4, 4, 0, yes
2183162509,  Pagliarulo72, 1, 1, 0, yes
1595987317,  fabjo66, 5, 5, 0, yes
593910587,  sonounagatta, 3, 3, 0, yes
2515674801,  robyd39, 1, 1, 0, yes
803929257206497285,  LucatoFlavio, 1, 1, 0, yes
3673542329,  jackdaniel969, 1, 1, 0, yes
718526010308829184,  paoloelgriso, 2, 1, 1, neutral
266125600,  bart651838, 1, 1, 0, yes
2973337469,  ppatty1262, 10, 8, 2, yes
736806615609937920,  paolomandato66, 1, 1, 0, yes
223617019,  davideboso, 1, 1, 0, yes
310699995,  AntoninoCast, 3, 3, 0, yes
443198044,  TNannicini, 3, 3, 0, yes
837898884,  rogerbag23, 2, 2, 0, yes
739484673974370305,  AnnaritaDiSena, 3, 3, 0, yes
2457603903,  GABRY_FERRARI, 2, 1, 1, neutral
47733738,  praox, 1, 1, 0, yes
706901139749519360,  robiriccio1, 3, 3, 0, yes
410595635,  nightman72, 3, 3, 0, yes
784018784101212160,  bastaunsi2016, 5, 5, 0, yes
418762910,  gianvitodapri, 12, 2, 10, no
227714691,  silviaminaldi, 1, 1, 0, yes
1405657195,  igriv49, 2, 2, 0, yes
246267839,  MaxFerrari1967, 1, 1, 0, yes
486663050,  Nemo71G, 5, 5, 0, yes
16193352,  kingmax, 1, 1, 0, yes
408501396,  MartaScattoni, 2, 1, 1, neutral
407224828,  SylvieOuioui, 1, 1, 0, yes
795562880104038400,  twittgas, 2, 2, 0, yes
435791551,  emmeiacono, 3, 3, 0, yes
2471692167,  55Pierno, 7, 2, 5, no
315177388,  stefp77, 1, 1, 0, yes
2184297581,  PaesaniSimona, 1, 1, 0, yes
3060208776,  BelinciBruno, 3, 3, 0, yes
488345791,  RuggeroBaudino, 1, 1, 0, yes
2250913801,  claudiodjprof, 2, 2, 0, yes
3981993394,  Angelopasc1, 3, 3, 0, yes
185547132,  AdrianaAmodio, 7, 7, 0, yes
450522942,  cosmopin, 3, 3, 0, yes
776102005873995776,  federico6122, 3, 3, 0, yes
768211076957822977,  Romeddy10, 1, 1, 0, yes
428318288,  akrachm, 1, 1, 0, yes
1697604230,  antocaneps, 1, 1, 0, yes
4722648082,  pdnotaresco, 1, 1, 0, yes
290973691,  vitogeom, 1, 1, 0, yes
1039976624,  LunelliMatteo, 1, 1, 0, yes
788082979335704577,  Nicoloruju, 4, 2, 2, neutral
510821883,  DonatoRamunno, 3, 3, 0, yes
489451158,  saveriolapadula, 1, 1, 0, yes
82295380,  emiliotoma, 1, 1, 0, yes
517330794,  MarvasiT, 3, 1, 2, no
436957303,  refereedoc, 1, 1, 0, yes
329898404,  lucaddeu, 1, 1, 0, yes
755384531935432704,  driftcaccia, 1, 1, 0, yes
1274972942,  augustoercolino, 10, 10, 0, yes
771813207853916161,  Fare_Firenze, 7, 6, 1, yes
778273782,  carmelacherie, 2, 1, 1, neutral
2546652284,  MscSilvio, 7, 4, 3, yes
553793872,  MatteoCiofi, 1, 1, 0, yes
88477744,  sarahperf, 2, 2, 0, yes
176433140,  shake313, 4, 4, 0, yes
777223484057477120,  uomosenzacuore, 5, 4, 1, yes
147907396,  francrosati, 3, 2, 1, yes
2901449159,  capricornooo, 2, 2, 0, yes
387357851,  Christian__78, 1, 1, 0, yes
47656671,  Peppezero, 1, 1, 0, yes
2566948102,  19girasole, 1, 1, 0, yes
2170707725,  villastefano_73, 1, 1, 0, yes
2985912037,  AgilyaBi, 2, 2, 0, yes
365850500,  comecincinnato, 1, 1, 0, yes
2741860486,  MarcoLycan23, 1, 1, 0, yes
840083857,  ppatricas, 6, 6, 0, yes
1583104512,  kranko59, 1, 1, 0, yes
2604440050,  rivagrande, 4, 4, 0, yes
3433848027,  massimomariaf, 1, 1, 0, yes
925401258,  alicemilitello0, 1, 1, 0, yes
706899092732059648,  9cc884414e3a417, 1, 1, 0, yes
3019940981,  2015Zacchy, 1, 1, 0, yes
277407762,  MatteoMati, 3, 3, 0, yes
4185060496,  DinoInterdonato, 1, 1, 0, yes
404388230,  doctor_tommi, 1, 1, 0, yes
735817583279149057,  riccardocortesi, 3, 3, 0, yes
573974227,  KarerseeMdr, 1, 1, 0, yes
363129737,  iales91, 2, 2, 0, yes
1003617564,  aronica_carmelo, 1, 1, 0, yes
2479357085,  MeanGreenGoid, 1, 1, 0, yes
3052113163,  elenitagavllan, 1, 1, 0, yes
2449274378,  StoverMuslc, 1, 1, 0, yes
3052099532,  southstarfllm, 1, 1, 0, yes
38499791,  jesusLOVErde, 2, 2, 0, yes
3065717673,  MsBchlk, 1, 1, 0, yes
2437339851,  __sunxissed, 1, 1, 0, yes
2612089371,  AleMangiac, 1, 1, 0, yes
479289781,  catmassimo, 5, 2, 3, no
418524241,  ZALASC, 1, 1, 0, yes
712974222,  doctor_pols, 1, 1, 0, yes
82426793,  thoyles, 2, 2, 0, yes
483747090,  plrachele, 1, 1, 0, yes
597504671,  pazzoxdafne, 1, 1, 0, yes
108717695,  LaZoida, 3, 3, 0, yes
945403489,  carlonet1, 1, 1, 0, yes
2874702022,  GGl1960, 1, 1, 0, yes
800652388419833856,  SilvioGiuliani3, 3, 3, 0, yes
1006483980,  sacchi66, 5, 3, 2, yes
802151840808837120,  lazzaretto85, 3, 3, 0, yes
236842366,  alicasadei, 2, 1, 1, neutral
4612811716,  davidecerretani, 6, 6, 0, yes
805144405179035648,  BonanniDaniele, 1, 1, 0, yes
630946120,  OnioSile, 1, 1, 0, yes
426060124,  Zuccheroso, 4, 3, 1, yes
2283375104,  Nonnadinano, 3, 3, 0, yes
805753405805301760,  chiaraiosue, 1, 1, 0, yes
397382712,  ilTia88, 1, 1, 0, yes
937681849,  studiopalmieri, 1, 1, 0, yes
310390743,  DanieleScozzari, 1, 1, 0, yes
3001665089,  franceschinimas, 20, 19, 1, yes
593923185,  GiovanniSlgg, 3, 3, 0, yes
20475975,  alestanga, 1, 1, 0, yes
3133541547,  CostGiannelli, 7, 4, 3, yes
796001849295966209,  carmedonnafugat, 4, 3, 1, yes
2808899800,  elio_psq, 3, 2, 1, yes
2190708864,  leonetina1, 3, 3, 0, yes
2536638116,  agrecorrado, 2, 2, 0, yes
460933477,  SalvatoreBiazzo, 1, 1, 0, yes
453113450,  amas_71, 1, 1, 0, yes
2656551650,  Lucemaresole, 3, 3, 0, yes
230173940,  jjoncour, 1, 1, 0, yes
1718385926,  omeromadda, 1, 1, 0, yes
2457927541,  DigitaliansEU, 1, 1, 0, yes
918894384,  youssefsdiri, 1, 1, 0, yes
44852492,  pantesimo, 1, 1, 0, yes
2198044864,  bea_vice, 2, 2, 0, yes
1307717450,  PuricMarghe, 3, 2, 1, yes
1002405570,  shogunpg98, 1, 1, 0, yes
2202114582,  luigidevito90, 1, 1, 0, yes
111321383,  Gordifuture, 2, 2, 0, yes
106204756,  alfredoferrante, 2, 2, 0, yes
503199826,  giacintociminel, 64, 1, 63, no
526877744,  enribriganti, 2, 2, 0, yes
805814518160957440,  RolleRicfisio65, 1, 1, 0, yes
978817627,  LuigiRapisarda3, 1, 1, 0, yes
156925343,  Marqog, 1, 1, 0, yes
18354673,  gianka_nastari, 1, 1, 0, yes
426758735,  LallyMorello, 2, 2, 0, yes
1412875290,  SorellaT, 1, 1, 0, yes
99170407,  a_digio, 2, 2, 0, yes
802096787288899584,  CH_Camacho07, 2, 2, 0, yes
841930033,  APomante, 7, 6, 1, yes
2971268932,  oronzofiorino55, 1, 1, 0, yes
422767246,  manu82el, 1, 1, 0, yes
1699901659,  RonconiAntonio, 1, 1, 0, yes
3363916803,  fbianchi2010, 1, 1, 0, yes
2745821569,  antonio55111, 1, 1, 0, yes
1020655322,  SandroMarinacci, 2, 2, 0, yes
452904156,  RTatemae, 2, 1, 1, neutral
2216289180,  MicheleAnesi, 2, 2, 0, yes
229038096,  aldocamm, 1, 1, 0, yes
435162360,  edocesarini, 1, 1, 0, yes
2897193045,  barbylenzi, 2, 2, 0, yes
396801852,  xmisterxagbx, 1, 1, 0, yes
3612827537,  AlfredoFoti1, 2, 2, 0, yes
4641977776,  burlonmarco5, 1, 1, 0, yes
85068775,  simorenz, 1, 1, 0, yes
275652121,  gioluc70, 1, 1, 0, yes
1573522722,  MiniGioCar, 1, 1, 0, yes
269873618,  fervicom, 2, 2, 0, yes
113360317,  leon90ify, 1, 1, 0, yes
1102059277,  milenapirola61, 3, 3, 0, yes
308606319,  zambo57, 1, 1, 0, yes
536638401,  gustavdattero, 1, 1, 0, yes
1355199234,  CardemarcDe, 2, 2, 0, yes
567975777,  BertoldoMichele, 1, 1, 0, yes
128349574,  marcorapino, 1, 1, 0, yes
4744865728,  romanofausta, 1, 1, 0, yes
1664406763,  Omennomen67_, 2, 2, 0, yes
1349937715,  Fla_Antonelli, 1, 1, 0, yes
805820475611942912,  mariaga77098685, 1, 1, 0, yes
4766746725,  serenafratus90, 1, 1, 0, yes
3885094696,  Patrizi08650395, 1, 1, 0, yes
501951935,  _blackduchess_, 3, 3, 0, yes
697849743972691969,  chiccolina69, 1, 1, 0, yes
805711441277972480,  giusepp40861575, 1, 1, 0, yes
781602919833538560,  TizianoCiccone, 1, 1, 0, yes
4783282515,  Valeria_naginy, 2, 2, 0, yes
792796232469114882,  ivoavagliano, 1, 1, 0, yes
405453634,  BGasperini, 2, 2, 0, yes
1063037172,  onir25, 1, 1, 0, yes
178406581,  mathieualbugues, 1, 1, 0, yes
747077316837261312,  GioseGios, 1, 1, 0, yes
2512774616,  Lorena54063223, 3, 3, 0, yes
437408259,  domenicocaprini, 4, 4, 0, yes
2379301870,  PonteMarisa, 1, 1, 0, yes
192350417,  litomax1970, 1, 1, 0, yes
1627502124,  LexFirenze4ever, 1, 1, 0, yes
96191476,  Eugenio03, 1, 1, 0, yes
335320911,  pistyy, 1, 1, 0, yes
778284942820249600,  LucaSan42153583, 1, 1, 0, yes
713372677151596544,  drpietro3, 3, 2, 1, yes
2926532355,  ciccheduburgu, 1, 1, 0, yes
438556443,  FabrizioDiNapol, 1, 1, 0, yes
1042546080,  esposito_kekko, 1, 1, 0, yes
2978834169,  giuseppe_m76, 2, 2, 0, yes
785741413078208512,  francescosm96, 2, 2, 0, yes
1379809824,  wjtharry, 1, 1, 0, yes
1426149824,  Sim_Salvioni29, 1, 1, 0, yes
290147254,  annaroxc, 2, 2, 0, yes
531181741,  manuel110hs, 1, 1, 0, yes
572478832,  giuse1908, 2, 2, 0, yes
4891532183,  silviabsc98, 1, 1, 0, yes
378246517,  LuigiFreda, 1, 1, 0, yes
706749882514731008,  luesp1672, 8, 6, 2, yes
137642246,  MassimoMallegni, 5, 3, 2, yes
418541142,  HDmenti, 3, 3, 0, yes
128179643,  corradofinardi, 1, 1, 0, yes
2469878238,  anastasia_p_55, 1, 1, 0, yes
629514678,  braccicarlo, 1, 1, 0, yes
747092955966627840,  ndiagasarr75, 1, 1, 0, yes
416525926,  Elisacagossi, 2, 2, 0, yes
398819061,  fcalabro80, 1, 1, 0, yes
398254651,  GiacomoGrossi31, 1, 1, 0, yes
625324811,  mibapp, 1, 1, 0, yes
515666862,  beppemarconcini, 1, 1, 0, yes
1707148159,  NiinaMerikoski, 1, 1, 0, yes
235308086,  graziabea, 3, 3, 0, yes
801423589484412928,  nannetti_andrea, 2, 2, 0, yes
1723092912,  angelacopernico, 1, 1, 0, yes
2739768281,  RTaietta, 2, 2, 0, yes
2823596068,  RussanoLuca, 1, 1, 0, yes
2196018501,  PLuigi28, 1, 1, 0, yes
428450570,  giancaGG, 1, 1, 0, yes
124012324,  giorgiopagnotta, 1, 1, 0, yes
426542439,  kathicampari, 1, 1, 0, yes
1965515684,  GoffCar, 1, 1, 0, yes
796438611956793347,  ornella_manzi, 2, 2, 0, yes
1035336710,  maurivez, 2, 2, 0, yes
827788441,  depaolo2, 3, 1, 2, no
220829978,  riccardoconi, 1, 1, 0, yes
226112148,  AttilioVanzo, 1, 1, 0, yes
4010980623,  chiaret05514807, 3, 3, 0, yes
805891733510823937,  domenicoacampo, 1, 1, 0, yes
599240215,  AlessandroDeCia, 1, 1, 0, yes
1154991632,  FlorianeNicolo, 1, 1, 0, yes
805895289127182338,  GiuGiu1975, 2, 2, 0, yes
584548614,  NannyFasitta, 1, 1, 0, yes
3407684944,  TacitoClaudia, 1, 1, 0, yes
495816057,  fraianpantarei, 2, 2, 0, yes
2902753786,  miagiorgi73, 3, 3, 0, yes
2389505121,  ClimLuca, 2, 2, 0, yes
3341203948,  81c36f8c76c2480, 1, 1, 0, yes
367662756,  MonclSimone, 1, 1, 0, yes
1100645634,  chiccoida, 2, 2, 0, yes
746432998854135808,  PeppinoBranca, 1, 1, 0, yes
2935248599,  Pietro_dambro, 1, 1, 0, yes
1093269157,  MattiaFacch, 1, 1, 0, yes
1439480814,  vivodistilinski, 5, 5, 0, yes
31115134,  m3du5a, 1, 1, 0, yes
4202703562,  orgoglioacucu, 1, 1, 0, yes
101858538,  stella2205, 4, 4, 0, yes
3381769522,  laura90yy, 1, 1, 0, yes
1726662828,  Acibudrio, 6, 5, 1, yes
805882663731077120,  babxxx1_babxx, 1, 1, 0, yes
51508401,  mandrazze, 1, 1, 0, yes
1040203231,  anto1701, 2, 2, 0, yes
442862527,  vindfdf, 1, 1, 0, yes
784991612,  MiniAlessio, 1, 1, 0, yes
756256852359413760,  spampinato69, 2, 2, 0, yes
339918824,  davidedania, 1, 1, 0, yes
585916083,  ValeriaGassani, 1, 1, 0, yes
3145034733,  Marco50M, 2, 2, 0, yes
805883283875758081,  MorenaG64, 1, 1, 0, yes
359900851,  EliaAuriemma, 2, 2, 0, yes
1275597386,  okkyrubati74, 1, 1, 0, yes
1049902064,  samgrosso, 1, 1, 0, yes
1066323547,  paver60, 2, 2, 0, yes
2397641423,  Medicinafiscale, 1, 1, 0, yes
84535718,  shobaty, 2, 1, 1, neutral
2901403913,  dardozzi, 1, 1, 0, yes
712318478200479744,  ComeglioMassimo, 3, 3, 0, yes
983355416,  Raffaele_Pasqua, 1, 1, 0, yes
718039456,  giadagiupy, 1, 1, 0, yes
1902969146,  santeper, 2, 2, 0, yes
1238681874,  GioStivv, 1, 1, 0, yes
1667242129,  GiuseppeCanto84, 5, 4, 1, yes
827716970,  bellomo69, 25, 11, 14, no
2255369284,  CrisafiMi, 2, 2, 0, yes
2288581537,  paolocastiglio7, 1, 1, 0, yes
2325410041,  pasquale2969, 1, 1, 0, yes
805843643777118208,  Nello88636924, 1, 1, 0, yes
2532842886,  genaiel1, 2, 1, 1, neutral
2318016385,  PipebombTeller, 2, 2, 0, yes
587658246,  TaniaTellini, 2, 2, 0, yes
21336055,  claudio_andrea, 2, 2, 0, yes
851236429,  mapo1962, 1, 1, 0, yes
47941653,  LucaCere, 1, 1, 0, yes
784525968,  autocostruttore, 2, 2, 0, yes
87481871,  gianpy1983, 1, 1, 0, yes
67260041,  pfranchini1973, 1, 1, 0, yes
599824605,  giuseppeaufiero, 1, 1, 0, yes
1100761093,  speciale_paolo, 4, 3, 1, yes
717488257,  GSasanelli, 2, 2, 0, yes
2435099377,  babola2009, 3, 2, 1, yes
1474357141,  Bruno2Franco, 1, 1, 0, yes
2513647388,  salvo93077375, 2, 2, 0, yes
3226194633,  AlbertoGalimb, 2, 2, 0, yes
1278879775,  buffadimitri, 2, 2, 0, yes
385122061,  cguglielminotti, 1, 1, 0, yes
263363638,  argonmr, 1, 1, 0, yes
26231258,  alby_moon, 1, 1, 0, yes
805883621710106625,  GSantospagnuolo, 1, 1, 0, yes
2185222224,  amleto75, 1, 1, 0, yes
988975550,  RosaliaLaPorta1, 1, 1, 0, yes
2231676521,  alpo1958, 5, 5, 0, yes
1022539381,  totinot, 2, 2, 0, yes
717447220530909186,  antoniopappada1, 3, 3, 0, yes
805886825999040512,  AlessandroInve4, 1, 1, 0, yes
1050499069,  castelli1960, 1, 1, 0, yes
815921760,  Giupanet, 2, 2, 0, yes
596568218,  puccisss, 1, 1, 0, yes
2336640031,  Yalda_so, 1, 1, 0, yes
77304299,  insiemeadonzel, 2, 2, 0, yes
392389271,  GuendaEsposito, 2, 2, 0, yes
421984356,  UrsulaKraus, 1, 1, 0, yes
1008563402,  AveroAt, 1, 1, 0, yes
2788880355,  2c0d13105a11478, 3, 3, 0, yes
408653009,  FelixTIJM, 1, 1, 0, yes
1029436543,  AndreCodegaReal, 2, 2, 0, yes
96323506,  martinogiusepp, 1, 1, 0, yes
719476323194925057,  BozzaFabio, 1, 1, 0, yes
756506773092204544,  amedeo550, 1, 1, 0, yes
416415709,  MaurizioPas, 1, 1, 0, yes
439113705,  mapid83, 2, 2, 0, yes
513191986,  BettySoncini, 1, 1, 0, yes
3791765834,  chiera_rosa, 1, 1, 0, yes
986310061,  DraganAndjel, 1, 1, 0, yes
4244390745,  Laura97983113, 1, 1, 0, yes
373287402,  DanieleKeshk, 6, 2, 4, no
805544224573820928,  Clara52633080, 1, 1, 0, yes
2396692571,  MarsilyC, 1, 1, 0, yes
625974573,  villaltajacob, 1, 1, 0, yes
4113142048,  Giorgia_Trotto, 1, 1, 0, yes
1267385588,  NicolettaFattor, 1, 1, 0, yes
303741424,  Kaudillo77, 1, 1, 0, yes
164687938,  Fedescony, 10, 3, 7, no
2205133985,  marynizzi, 1, 1, 0, yes
805842473260118016,  Mariate67609897, 1, 1, 0, yes
297288464,  vincentdthe, 1, 1, 0, yes
2177058040,  IreneStefano, 1, 1, 0, yes
3303791375,  Ando43Ando, 5, 5, 0, yes
259302988,  M_VALENZA, 2, 1, 1, neutral
577522863,  CasteClaudia, 1, 1, 0, yes
1713487988,  elmadoha, 1, 1, 0, yes
4884874156,  WildeSergio, 1, 1, 0, yes
448870757,  SteCogliati, 2, 2, 0, yes
382228161,  cicciodale, 2, 2, 0, yes
852675379,  daviballa, 5, 4, 1, yes
1379007452,  ehiRicardo, 2, 2, 0, yes
299275778,  tuonov4, 1, 1, 0, yes
805827021699973120,  ettorina3, 1, 1, 0, yes
1083431718,  GaetanoPiepoli1, 1, 1, 0, yes
805827223966060545,  Patrizi13439455, 3, 1, 2, no
57041267,  fervillamizar, 1, 1, 0, yes
99924911,  Tellonia, 1, 1, 0, yes
576638518,  MatteoMarini65, 2, 2, 0, yes
278670026,  nicolotrive, 1, 1, 0, yes
874198483,  LIVIANA1956, 2, 2, 0, yes
993961856,  rizzina2005, 1, 1, 0, yes
126741105,  sabbruz, 9, 9, 0, yes
3042634613,  451a35e7a84b436, 2, 2, 0, yes
3375844990,  antonel07160276, 1, 1, 0, yes
565059018,  PietroZach, 1, 1, 0, yes
443694921,  MassimoGuercion, 1, 1, 0, yes
112462239,  amelix74, 1, 1, 0, yes
3010362874,  roberta_fyd, 1, 1, 0, yes
465830605,  xemmery, 2, 2, 0, yes
425387616,  RaffaeleFrisina, 1, 1, 0, yes
49259395,  flegro, 1, 1, 0, yes
265961838,  maxximom, 1, 1, 0, yes
306190367,  CesareCossu, 1, 1, 0, yes
1247326638,  D_Catanese, 1, 1, 0, yes
1477219380,  CSclerato, 1, 1, 0, yes
1665528704,  RitaC70, 1, 1, 0, yes
579271204,  KatyKatykatia, 1, 1, 0, yes
2358042913,  gponti_arch, 1, 1, 0, yes
477654099,  paolo_croci, 5, 2, 3, no
801062392654348288,  frarizzo1, 1, 1, 0, yes
1831672254,  GiusyCrimi, 1, 1, 0, yes
1239786445,  FeliceZambrano, 1, 1, 0, yes
2608587736,  PietroSa11, 1, 1, 0, yes
3152658663,  fosviter, 1, 1, 0, yes
784777867913723904,  LiciaAmario, 8, 8, 0, yes
2499019957,  giminut, 1, 1, 0, yes
805778838894575616,  barigoclaudio, 1, 1, 0, yes
2958469049,  carfranco61, 1, 1, 0, yes
3091026360,  Vincenzo7210, 1, 1, 0, yes
598381820,  ticcisimone, 1, 1, 0, yes
802671692774604800,  Mbayengagnesen2, 1, 1, 0, yes
474782976,  AndreaPoscia, 4, 4, 0, yes
1876822200,  FabioCampanari, 2, 2, 0, yes
444088552,  AdaVendrame, 1, 1, 0, yes
1021836865,  RaffaellaPetri, 7, 6, 1, yes
3431316856,  garciacagua1962, 1, 1, 0, yes
133480321,  cirogardi, 2, 2, 0, yes
905670343,  CarloOzella, 2, 1, 1, neutral
55007872,  giannibozzetto, 1, 1, 0, yes
304054754,  oettam_matteo, 4, 2, 2, neutral
587344620,  MaurizioCasto, 1, 1, 0, yes
570329331,  woland1964, 2, 1, 1, neutral
803533550091902977,  alberto_re14, 1, 1, 0, yes
2263808351,  AngelaTessp, 2, 2, 0, yes
450531242,  Barbagelata1, 1, 1, 0, yes
4833637485,  falegname18, 3, 3, 0, yes
113358672,  gperrone86, 2, 2, 0, yes
49573971,  Sogandnd, 1, 1, 0, yes
3067322229,  mariella_cuman, 1, 1, 0, yes
572409634,  CGuardasole, 1, 1, 0, yes
91067402,  zedr_, 1, 1, 0, yes
1490220378,  enzo_korionsrl, 1, 1, 0, yes
2157736823,  CristinaFonta24, 1, 1, 0, yes
4192391296,  LPizzochero, 1, 1, 0, yes
3001624527,  lopez_vallet, 1, 1, 0, yes
720358668739420161,  pinknoel73, 1, 1, 0, yes
488623615,  catirafaella, 3, 3, 0, yes
1064222863,  andreanappa, 1, 1, 0, yes
4865005763,  Ele_Arizona, 8, 7, 1, yes
419592621,  PclcCalo, 1, 1, 0, yes
805853807099936768,  Francesca160900, 1, 1, 0, yes
209228950,  platinodoc, 29, 26, 3, yes
1039035398,  massi_59, 1, 1, 0, yes
2152426860,  andreaballoi1, 1, 1, 0, yes
1001879178,  AnnamariaFerraz, 1, 1, 0, yes
2687036433,  GravinoNadia, 3, 2, 1, yes
4550803281,  Michelle_Tzm, 1, 1, 0, yes
392189501,  Clasiena, 2, 2, 0, yes
770822827222110208,  LucaaRaf, 1, 1, 0, yes
797928230997082112,  DamienPiazza, 1, 1, 0, yes
2301509868,  Brase77, 1, 1, 0, yes
2933811321,  teclapisco, 1, 1, 0, yes
4543326377,  giudyanni, 1, 1, 0, yes
4235169676,  rosanna0124, 3, 3, 0, yes
359263461,  mauro_rubbioli, 2, 2, 0, yes
4503390023,  giogiuspada, 1, 1, 0, yes
2966258818,  d_banchini, 3, 3, 0, yes
3352834192,  enricomilano201, 5, 5, 0, yes
782851136327909376,  Bettin_Stefano, 2, 2, 0, yes
714505879069007872,  DotoAlfonso67, 1, 1, 0, yes
258893266,  stella_star1, 1, 1, 0, yes
17047309,  giusivita, 1, 1, 0, yes
731496983886712833,  bartoli64, 1, 1, 0, yes
794578360588521473,  Giovann49180301, 3, 3, 0, yes
1377487302,  Jeanh90, 3, 3, 0, yes
4182548375,  Filippo94844120, 3, 3, 0, yes
2367491645,  vfimiani1102, 2, 2, 0, yes
2294073365,  12pasotiziana, 2, 2, 0, yes
1068485420,  GiovanniCerani, 1, 1, 0, yes
448056250,  ChiaraCastorin1, 5, 5, 0, yes
396489819,  manuelgambon, 1, 1, 0, yes
461016405,  SilviaMarketti, 1, 1, 0, yes
525654496,  MinetouMBodje, 1, 1, 0, yes
1595530165,  legionarionero, 1, 1, 0, yes
2628952445,  casali612, 5, 5, 0, yes
390374002,  teublues, 3, 3, 0, yes
432749231,  BrunoCottino, 1, 1, 0, yes
2396141007,  olgabongiascia, 1, 1, 0, yes
918863641,  IlCommentatore_, 1, 1, 0, yes
3225380362,  PaoloMss, 1, 1, 0, yes
467291442,  antomody, 2, 2, 0, yes
421090133,  GiuseppeEletto, 3, 3, 0, yes
1434133657,  compagnia_b, 2, 2, 0, yes
1911169982,  oggioni_andrea, 2, 1, 1, neutral
376942840,  teino75, 1, 1, 0, yes
1914286562,  antonlop72, 1, 1, 0, yes
489791433,  angeloricciuti, 1, 1, 0, yes
1022254674,  ZanAlessandro, 1, 1, 0, yes
756456757459881984,  vincenzodp8, 1, 1, 0, yes
3857194275,  moreno_tosatto, 1, 1, 0, yes
1092479468,  Carla_Trigilia, 1, 1, 0, yes
462177911,  amwessisla, 2, 2, 0, yes
2964681406,  silviafravo, 1, 1, 0, yes
1875401192,  eleparents, 1, 1, 0, yes
700752813979074560,  antonio58753573, 2, 2, 0, yes
819329768,  GiulianaMenchin, 1, 1, 0, yes
12551742,  alberto_cottica, 1, 1, 0, yes
2562227597,  GianlucaCarli82, 1, 1, 0, yes
2908364331,  IlaLiga97, 2, 2, 0, yes
4181758275,  AntonioFrancob3, 1, 1, 0, yes
3248796039,  sanna1_elena, 1, 1, 0, yes
374647936,  aluongo68, 1, 1, 0, yes
2781262295,  j_jessicasole, 2, 2, 0, yes
1002359352,  amelianegroni1, 1, 1, 0, yes
2978592185,  DlongoDnl, 1, 1, 0, yes
955249244,  carloinfante_, 1, 1, 0, yes
1086897067,  ComunediTeramo, 1, 1, 0, yes
2481640663,  MikiG78, 2, 2, 0, yes
805872931222024192,  mdf2007, 1, 1, 0, yes
2956619387,  vitomax202, 2, 2, 0, yes
251278335,  RudyMos, 4, 2, 2, neutral
163189003,  paganimax71, 1, 1, 0, yes
1894241174,  AndreaSaviano92, 1, 1, 0, yes
3306397287,  samier_andri, 1, 1, 0, yes
416300209,  guitrekk, 1, 1, 0, yes
1332430760,  silviomascella, 1, 1, 0, yes
431646228,  Gio_Santangelo, 1, 1, 0, yes
496247022,  primadiandare, 1, 1, 0, yes
4090464435,  Barbara75683768, 1, 1, 0, yes
357443213,  DianaFormaggio, 1, 1, 0, yes
306149997,  FIRSTonlineTwit, 2, 2, 0, yes
2359670719,  Fabioplutino, 3, 2, 1, yes
4211084913,  orlando_rob1965, 1, 1, 0, yes
470454880,  GentileAdamo, 1, 1, 0, yes
354307154,  AntonioArtiaco, 1, 1, 0, yes
1961227410,  mickybest89, 1, 1, 0, yes
49600490,  caddeove, 1, 1, 0, yes
2368538572,  ilgrima76, 1, 1, 0, yes
1004042881,  GiuseppeBadola2, 1, 1, 0, yes
3198537093,  lumachina24, 2, 1, 1, neutral
1547897641,  EmpoliPd, 2, 2, 0, yes
404252044,  DanieleFarinell, 1, 1, 0, yes
63408554,  bettymanu, 1, 1, 0, yes
2231309401,  Lordskary, 1, 1, 0, yes
499444851,  Contesto2, 1, 1, 0, yes
806068579749789696,  IuzzolinoV, 1, 1, 0, yes
3230312775,  Jovi59Giovanna, 1, 1, 0, yes
1055274062,  Ema_Florence, 1, 1, 0, yes
94142198,  LucaBurgazzi, 1, 1, 0, yes
434201413,  FrancescaEva90, 2, 2, 0, yes
1691270400,  TamburiRosita, 1, 1, 0, yes
798248939514458112,  Pietro1621, 1, 1, 0, yes
413411300,  ema_cieri, 1, 1, 0, yes
997492340,  Enricaxsempre, 1, 1, 0, yes
4504814655,  montepoggiolo, 1, 1, 0, yes
779049756,  illaka152, 4, 3, 1, yes
932232746,  VincenzoCesareo, 2, 2, 0, yes
603005791,  EneaMoscon, 5, 5, 0, yes
150271851,  maspan1968, 1, 1, 0, yes
737349727805669376,  uoopicci, 2, 2, 0, yes
370265740,  DocBrown411, 1, 1, 0, yes
439855752,  NiccoColo, 2, 2, 0, yes
1556452244,  guidolampronti, 2, 2, 0, yes
511725971,  mattiarossi78, 1, 1, 0, yes
380322793,  IdaMartone, 2, 2, 0, yes
4181647523,  Paolo79908506, 1, 1, 0, yes
2844269931,  66e334bdb1754a4, 1, 1, 0, yes
468491524,  ritadb63, 1, 1, 0, yes
247182002,  NanniMusiqo, 1, 1, 0, yes
3131562124,  LinaColatrella, 3, 3, 0, yes
1213097966,  hicmidiae, 1, 1, 0, yes
2415491657,  GrugniRenato, 1, 1, 0, yes
2884873407,  FerroniFranco, 2, 2, 0, yes
757812384,  giammieva, 1, 1, 0, yes
2184787761,  lucapasini66, 1, 1, 0, yes
168422352,  pippo95ful, 1, 1, 0, yes
81341793,  sabrazzzz, 1, 1, 0, yes
38502822,  CouncillorMcRae, 1, 1, 0, yes
554427195,  Elena_Violi, 4, 4, 0, yes
127548238,  Remedios_10, 1, 1, 0, yes
296773508,  iuAndres, 2, 1, 1, neutral
3002943947,  antoniopanella5, 3, 3, 0, yes
140391257,  fracarofalo, 4, 3, 1, yes
22038676,  mariannaaprile, 4, 4, 0, yes
944490204,  AKICE_CO, 1, 1, 0, yes
2798992084,  mariachiarabar5, 1, 1, 0, yes
1033384861,  Antonia__2012, 1, 1, 0, yes
349177126,  CarmenCraca, 1, 1, 0, yes
4365611055,  se_fra_sand, 1, 1, 0, yes
2372994106,  RFinassi, 1, 1, 0, yes
2611677391,  PaciRoby, 1, 1, 0, yes
2216375970,  paolo__moro, 1, 1, 0, yes
520370778,  laCrisNV, 1, 1, 0, yes
50316819,  sgilli73, 3, 3, 0, yes
506049158,  ALFONSOGAETA, 1, 1, 0, yes
796648335654404096,  Madi19711, 1, 1, 0, yes
805885666546581508,  digiuseppecarmi, 2, 2, 0, yes
2386643558,  MegaCuch87, 1, 1, 0, yes
505705375,  e_terranova, 9, 9, 0, yes
39941540,  insopportabile, 12, 11, 1, yes
955528736,  danielapeafesta, 1, 1, 0, yes
630259937,  Raf29567, 1, 1, 0, yes
805821695630200832,  giannimont51, 1, 1, 0, yes
955319400,  ritatredicine, 1, 1, 0, yes
4814159656,  rita_micheli, 1, 1, 0, yes
489325196,  Nico_Grappo, 3, 3, 0, yes
805829442270625794,  Luigi60937087, 1, 1, 0, yes
801143590542016513,  EmanuelaSantoni, 1, 1, 0, yes
1951164762,  BrunaVavassori, 1, 1, 0, yes
107030002,  aremaro, 1, 1, 0, yes
989581380,  dilizia52, 1, 1, 0, yes
4212645299,  piegam1950, 1, 1, 0, yes
396885087,  Pencilkey, 1, 1, 0, yes
1146131426,  Stefano_stoppa, 5, 5, 0, yes
1071886074,  LatorreVincent, 1, 1, 0, yes
805749867553374209,  rikymarchin, 1, 1, 0, yes
50625497,  henavil, 1, 1, 0, yes
44938500,  EvilInYourHeart, 1, 1, 0, yes
2878620821,  marcopaper861, 1, 1, 0, yes
4927273157,  stradanuovapv, 2, 2, 0, yes
105174688,  MartoEporedia, 2, 2, 0, yes
2411152835,  antofranzi, 1, 1, 0, yes
736723699,  pianurapadana, 2, 2, 0, yes
136039207,  rokton, 4, 4, 0, yes
418851266,  CardognaE, 2, 2, 0, yes
763310989232177152,  LoredanaNavarra, 5, 5, 0, yes
532043012,  Gacu81, 1, 1, 0, yes
4022818347,  IannacconeLella, 1, 1, 0, yes
50076978,  elifrog, 2, 2, 0, yes
479777103,  paolo_amenta, 2, 2, 0, yes
2574308256,  tullio02773848, 1, 1, 0, yes
3183126233,  gda_reset, 1, 1, 0, yes
4355780241,  MattiAngelico, 1, 1, 0, yes
276511228,  AttilaRM, 1, 1, 0, yes
2427089494,  thomasgalasso2, 1, 1, 0, yes
2933781328,  nicola56260, 1, 1, 0, yes
785794664058220544,  luigicadente, 3, 3, 0, yes
617172638,  Slvn46, 1, 1, 0, yes
2459377728,  AlexMantex, 1, 1, 0, yes
394233849,  Vpeluffo, 6, 6, 0, yes
2757478145,  LioFrankie, 2, 2, 0, yes
767266982,  a_casillo, 1, 1, 0, yes
2824658243,  ramostattoos, 3, 3, 0, yes
779589843047354368,  sesquimetrico, 3, 3, 0, yes
869965442,  ElessDavid, 2, 2, 0, yes
3082288692,  marypy16, 1, 1, 0, yes
999847074,  RENATOCARLINI1, 2, 2, 0, yes
194247825,  violaio, 3, 3, 0, yes
503399509,  leoner6, 1, 1, 0, yes
34311597,  mickopop, 1, 1, 0, yes
2347206761,  JacopoGiamundo, 3, 3, 0, yes
789118522672701440,  SimoneAlbrigi, 2, 2, 0, yes
574821986,  AleApantaloni, 1, 1, 0, yes
528732823,  domgiova, 1, 1, 0, yes
70091993,  gianlucarlesso, 3, 1, 2, no
1365265471,  SrlGiga, 1, 1, 0, yes
923098465,  AstolfiAntonio, 1, 1, 0, yes
1441118370,  gio1direction, 1, 1, 0, yes
855225974,  RTognocchi, 1, 1, 0, yes
1641186600,  CristinaVassi, 1, 1, 0, yes
1280740352,  luisa_sacchi, 1, 1, 0, yes
3294013631,  mayetta01, 2, 2, 0, yes
2366725073,  SalvatoreLice, 1, 1, 0, yes
718473198518579201,  celesti07362878, 1, 1, 0, yes
2821143773,  GiangiMele, 1, 1, 0, yes
795974599322333184,  AlbertoGiro1, 1, 1, 0, yes
1038060108,  135410, 1, 1, 0, yes
18864067,  emiliotrussardi, 1, 1, 0, yes
1036763983,  stefanocerre, 1, 1, 0, yes
492610228,  Encoma05, 1, 1, 0, yes
805856026507362304,  TintiAlfredo, 2, 2, 0, yes
1101107228,  SilviaRhonda, 3, 3, 0, yes
130794661,  Intercity55, 1, 1, 0, yes
321881471,  dariosapienz, 2, 2, 0, yes
2899253805,  VenturiPia, 2, 2, 0, yes
261741456,  glaffi, 1, 1, 0, yes
500691106,  manuelaguastini, 1, 1, 0, yes
2344660859,  GianMariaFornac, 1, 1, 0, yes
303354406,  NiccoBetti, 1, 1, 0, yes
2524993797,  RiccioDel, 5, 5, 0, yes
319527817,  GaetanoDiLillo, 2, 2, 0, yes
372859866,  musicanter, 1, 1, 0, yes
3023571627,  Roberto81650277, 1, 1, 0, yes
3370729102,  Cla_moroso, 1, 1, 0, yes
1054523772,  GiuGuazzelli, 1, 1, 0, yes
773285663961600001,  femaccions95, 1, 1, 0, yes
379327370,  salvaa6, 1, 1, 0, yes
438669292,  Fabani75, 1, 1, 0, yes
2334451799,  salvolaman, 2, 2, 0, yes
1015010252,  Mokyferro67, 1, 1, 0, yes
335239965,  luicoi, 4, 4, 0, yes
2238710393,  paulabraccini1, 2, 2, 0, yes
781867340141039616,  MaddalenaMileti, 1, 1, 0, yes
2495795415,  albani1979, 1, 1, 0, yes
805872672651546625,  Antonio67995282, 2, 2, 0, yes
453490577,  Blanco_Blu, 1, 1, 0, yes
3040391193,  orlando_vinci, 2, 2, 0, yes
426075049,  ricciofq, 7, 7, 0, yes
590996631,  fabiofilippucci, 1, 1, 0, yes
1617372829,  renvitali, 1, 1, 0, yes
706964959654187008,  19angelo78, 1, 1, 0, yes
747862737833857024,  nadia71mt, 1, 1, 0, yes
872432977,  maxdicampo, 1, 1, 0, yes
1008426252,  ClementeSchetti, 1, 1, 0, yes
2976195935,  gerbasile, 1, 1, 0, yes
2167242758,  robertonativi, 2, 2, 0, yes
796833371066351616,  MassimediTrump, 1, 1, 0, yes
2358729917,  gia6617, 2, 2, 0, yes
2885498531,  tommasobcresci, 3, 3, 0, yes
2598772198,  jug1971, 2, 2, 0, yes
1019142710,  juvenalmunubo, 2, 2, 0, yes
68963860,  vladanc, 3, 3, 0, yes
1097756916,  agoappia, 2, 2, 0, yes
2346498225,  rdavide_98, 1, 1, 0, yes
298455004,  AntonioliSandra, 5, 5, 0, yes
403551236,  a_marcoaldi, 1, 1, 0, yes
527556076,  ZACCARIAFPAOLO, 2, 2, 0, yes
986366454,  drssaisabella, 2, 2, 0, yes
1482145237,  DiegoliMarco, 2, 2, 0, yes
3416195266,  samuele_gentili, 5, 5, 0, yes
307781832,  DemZavettieri, 7, 7, 0, yes
2236428906,  Davide_Pancotti, 1, 1, 0, yes
2870408529,  MariaZafarana, 4, 1, 3, no
437535007,  ANTONIOMAUROAND, 1, 1, 0, yes
368491867,  emacosentino, 6, 6, 0, yes
2337159606,  ppellegrino1, 1, 1, 0, yes
837557287,  cavazzana4, 1, 1, 0, yes
1162086236,  tizipissi, 2, 2, 0, yes
1139422028,  100xcentoBio, 4, 3, 1, yes
418302288,  antoniodalfons1, 2, 2, 0, yes
2596684255,  Qmzpalyb, 1, 1, 0, yes
399374372,  LoredanaGentili, 12, 12, 0, yes
490643105,  eziofodera, 1, 1, 0, yes
1254165626,  unidea78luix, 4, 3, 1, yes
4884586300,  patriziasernac1, 1, 1, 0, yes
2658235405,  ciaccare67, 2, 2, 0, yes
983013728,  fflaccomio, 15, 2, 13, no
1721422970,  augustogregori3, 8, 8, 0, yes
4185618521,  giuliabertino93, 1, 1, 0, yes
2842839160,  BrunacciMatteo, 2, 1, 1, neutral
2525523881,  s_angeletti, 1, 1, 0, yes
266207346,  dfogliarini, 3, 3, 0, yes
804040087252115456,  ParmaTeresina, 2, 2, 0, yes
9623992,  carotelevip, 1, 1, 0, yes
613389643,  ColaleoLorenzo, 1, 1, 0, yes
379213798,  TommasoRoncalli, 2, 2, 0, yes
358042635,  antoniocassisa, 4, 4, 0, yes
317879480,  StudioCentro_FM, 3, 3, 0, yes
563737579,  JoeyBrigitte, 1, 1, 0, yes
799982511866740736,  Ibrahim_Nassiba, 1, 1, 0, yes
377875230,  TotCatanese, 2, 2, 0, yes
386721282,  ElisaOliveri, 2, 1, 1, neutral
1034469554,  ElisabettaGall7, 1, 1, 0, yes
796011644,  ghiraaaaaa, 1, 1, 0, yes
954210997,  robertoerarael, 6, 6, 0, yes
281198422,  marziacappelli, 1, 1, 0, yes
283283751,  PatricioTommasi, 6, 6, 0, yes
2873829929,  AnnalisaSaitta, 1, 1, 0, yes
278665812,  tia_bisso, 1, 1, 0, yes
2402701895,  fabiotave, 8, 1, 7, no
996920630,  albertodelio, 3, 2, 1, yes
2733209785,  CoccoSiffredo, 1, 1, 0, yes
630335013,  emobranco, 4, 2, 2, neutral
1052995142,  FilippoPestugia, 3, 3, 0, yes
2371058245,  terzibus, 1, 1, 0, yes
733748028813762560,  GiovannaScreme1, 1, 1, 0, yes
422182674,  Eugenio0804, 2, 2, 0, yes
2870173295,  v_pezzoni, 1, 1, 0, yes
155862175,  radiochatit, 1, 1, 0, yes
387067067,  VZaitzev, 4, 4, 0, yes
3154269976,  martinabar76, 31, 27, 4, yes
2469903331,  NicolaMazzara92, 2, 2, 0, yes
770150475358408704,  MestroMiyagiK, 2, 2, 0, yes
499109496,  yspanico, 6, 6, 0, yes
116470630,  iRubb, 20, 14, 6, yes
1066149530,  EliPatasmile, 29, 28, 1, yes
40363134,  brunicorno, 1, 1, 0, yes
1156624495,  NiccoLuisi, 7, 7, 0, yes
1455785070,  bellini281, 14, 14, 0, yes
803631325907419136,  VeronicaCrocet3, 1, 1, 0, yes
744573198163939328,  lucamlsp, 4, 4, 0, yes
2460368721,  erree02, 3, 3, 0, yes
2695614433,  afurlan4, 1, 1, 0, yes
464950259,  Andrea_Salera, 1, 1, 0, yes
1036756046,  OeiNicolette, 6, 4, 2, yes
312616250,  MadamPopper, 7, 3, 4, no
1845111228,  _GKF_, 1, 1, 0, yes
105890995,  pinosaitta, 1, 1, 0, yes
941928265,  Dany85B, 5, 5, 0, yes
801510904433147907,  CarloPanfili, 7, 6, 1, yes
269317606,  AlessandroTullo, 1, 1, 0, yes
363655218,  tom_139, 2, 2, 0, yes
1257130652,  dameate98, 2, 2, 0, yes
1056147866,  maucecch, 2, 2, 0, yes
1322180642,  TommasoGallina, 1, 1, 0, yes
1227625616,  Celestigno, 8, 5, 3, yes
772308136443076611,  casinirobe, 1, 1, 0, yes
63142390,  Giorgiopancirol, 1, 1, 0, yes
5893702,  SkyTG24, 10, 10, 0, yes
713175317,  l_veglia, 2, 2, 0, yes
1361976294,  ArmonicaEssenza, 2, 2, 0, yes
504950964,  momoerre72, 1, 1, 0, yes
410627179,  FPacenti, 3, 3, 0, yes
635171482,  andreapizzi6, 1, 1, 0, yes
3007603659,  MSalatini, 1, 1, 0, yes
4626119985,  LucianoTaglioni, 4, 4, 0, yes
787642636693798912,  AntonioAzzeo, 1, 1, 0, yes
3298321662,  claudiobi1254, 1, 1, 0, yes
318332496,  thebroker78, 1, 1, 0, yes
799983421,  milanoxrenzi, 1, 1, 0, yes
28352615,  ingdruido, 5, 4, 1, yes
273053914,  signorinij, 1, 1, 0, yes
34265728,  calvary_boy, 1, 1, 0, yes
561447448,  dani030968, 9, 3, 6, no
4165015275,  francofolinora1, 2, 2, 0, yes
791655227783077888,  demosgiovani, 2, 2, 0, yes
1962493526,  RossanaBellina, 2, 2, 0, yes
996095940,  manciobo, 16, 16, 0, yes
303730430,  RdeVincentis, 2, 2, 0, yes
1160553823,  claevosuper6, 3, 3, 0, yes
155493613,  elisabetdurante, 1, 1, 0, yes
282036745,  Antoniolavanga_, 2, 2, 0, yes
372436714,  ElisaPetitti, 1, 1, 0, yes
796782858161496065,  jarodmazzarol, 1, 1, 0, yes
147883916,  maurilio48, 2, 1, 1, neutral
1370507071,  SimoneTesolat, 1, 1, 0, yes
803597499806220288,  DanielLidonnici, 1, 1, 0, yes
390635263,  sinigagliam, 2, 2, 0, yes
1055331438,  FedericoBabboni, 4, 2, 2, neutral
427415956,  massisironi, 8, 8, 0, yes
306257847,  GRoussos1, 1, 1, 0, yes
2187052758,  TuccioAlessandr, 3, 3, 0, yes
3076820536,  francoelori1, 3, 3, 0, yes
1171952936,  manticagiuseppe, 8, 8, 0, yes
1008971185,  Umby1950, 3, 2, 1, yes
102119784,  falsario80, 4, 3, 1, yes
378789262,  pharhynx, 1, 1, 0, yes
2845221485,  batte_de, 1, 1, 0, yes
3700502176,  frenchilin, 19, 18, 1, yes
3292008420,  ing_tampas, 5, 5, 0, yes
300523330,  mezzuomo, 5, 4, 1, yes
1858224883,  NolliDanilo, 1, 1, 0, yes
803573856145391616,  celestebrandis, 3, 3, 0, yes
703666667969245184,  dad3252be043410, 2, 2, 0, yes
798739663,  antonioguccione, 1, 1, 0, yes
2460233908,  LucMuzzioli, 1, 1, 0, yes
398849602,  Massimo_Pagliai, 2, 2, 0, yes
483728459,  afsalvini, 1, 1, 0, yes
2286936794,  SmaluU, 3, 3, 0, yes
4104084562,  dariomeden, 1, 1, 0, yes
476175986,  Martiforti, 3, 3, 0, yes
2831165027,  albemoltra, 1, 1, 0, yes
455236437,  LinaBiancucci, 2, 2, 0, yes
792755936674844673,  IannetelliM, 1, 1, 0, yes
1353781825,  Fabrizio_Totaro, 4, 4, 0, yes
2846982226,  RitaNigronr, 14, 3, 11, no
2196051665,  IMuscatello, 2, 2, 0, yes
4795079603,  AnnaDesantis63, 3, 3, 0, yes
445874575,  SBragadin, 1, 1, 0, yes
488525943,  GaetanaPiazza, 1, 1, 0, yes
3955747101,  EnricoCadura, 1, 1, 0, yes
45346999,  1lb4rb4r0, 8, 6, 2, yes
2322739875,  PasLoffredo, 8, 8, 0, yes
497163792,  72maurizio, 1, 1, 0, yes
552441601,  monia_santucci, 1, 1, 0, yes
236997869,  fibosone, 1, 1, 0, yes
727850864,  acquacamera, 3, 3, 0, yes
904510224,  pdviacrema, 1, 1, 0, yes
1477920924,  lu_montrone, 1, 1, 0, yes
1470626822,  JacopoVozza, 1, 1, 0, yes
1087090213,  emavgl, 4, 4, 0, yes
443594065,  SimoneCaldani, 1, 1, 0, yes
803316734933528576,  anonimo5471, 2, 2, 0, yes
2301582795,  BrunaCestra, 1, 1, 0, yes
1889500081,  AdryFormenti, 1, 1, 0, yes
1142854800,  SabaRebecca, 1, 1, 0, yes
331067583,  orgiagi, 2, 2, 0, yes
56486080,  aleperinato, 1, 1, 0, yes
4910351614,  justcallme_sug, 2, 2, 0, yes
383256282,  giorgiapalace, 1, 1, 0, yes
720926715917307904,  andre_olce95, 1, 1, 0, yes
295786591,  ValaVanPelt, 1, 1, 0, yes
738080134960455680,  FedericoRealMan, 2, 2, 0, yes
442314209,  baronepaolo1, 8, 8, 0, yes
35289844,  bIackroses_, 4, 4, 0, yes
428994498,  giuse79, 2, 2, 0, yes
2801547296,  arcoromano2, 1, 1, 0, yes
786573428,  TaniaSpicola, 1, 1, 0, yes
1018288674,  gbenve75, 1, 1, 0, yes
2483857828,  Gabbo496, 8, 8, 0, yes
3554834061,  alex0_1412, 1, 1, 0, yes
993973322,  sp_rocco, 2, 2, 0, yes
3241941287,  MassimoStronati, 2, 2, 0, yes
118714798,  paolomicheli, 7, 6, 1, yes
13946942,  marco_ask, 3, 3, 0, yes
231753233,  stevrste, 1, 1, 0, yes
1109152964,  franciocom, 6, 6, 0, yes
292649689,  VeraQuantoBasta, 13, 3, 10, no
1360369249,  LuciaBi9, 13, 4, 9, no
2666178698,  oldzorro1, 1, 1, 0, yes
421812723,  VinceDex73, 3, 3, 0, yes
379238905,  Tholus76, 1, 1, 0, yes
4855003133,  Alessan71518733, 1, 1, 0, yes
46668313,  marcomillenium, 1, 1, 0, yes
82061464,  vitennio, 1, 1, 0, yes
2434259124,  niccolo_c, 12, 9, 3, yes
1128810810,  CosFranci, 1, 1, 0, yes
432823166,  Red_RightHand, 2, 2, 0, yes
412559412,  leonardodonega, 1, 1, 0, yes
379876413,  _MariolPeqini_, 3, 2, 1, yes
459600024,  VEfrem, 2, 2, 0, yes
2234667243,  EnricoBodin, 1, 1, 0, yes
520633976,  BerardinoZoina, 2, 2, 0, yes
2347946152,  GiovanniPallucc, 1, 1, 0, yes
170737353,  PicosZo, 2, 2, 0, yes
3928901475,  maf74ita, 7, 5, 2, yes
476121836,  arivleeloj, 5, 5, 0, yes
910930645,  ElenaMalta, 1, 1, 0, yes
514909259,  CroceAnna, 1, 1, 0, yes
2482110542,  robarzon, 1, 1, 0, yes
419824870,  kikispring, 6, 6, 0, yes
505180853,  adrygiomb, 1, 1, 0, yes
489583182,  SilviaNaldi, 1, 1, 0, yes
2654073303,  orlandapresti, 1, 1, 0, yes
2753263229,  EScalioti, 1, 1, 0, yes
754042522377318400,  savinociffo, 1, 1, 0, yes
4855083609,  belen45786937, 1, 1, 0, yes
434761742,  SteffiCecchini, 6, 6, 0, yes
31252732,  sailoversea, 1, 1, 0, yes
208582433,  _C_V, 1, 1, 0, yes
891456169,  PolettoNadia, 1, 1, 0, yes
430724357,  PaolaAndreini1, 2, 2, 0, yes
798178882235072512,  texalby, 1, 1, 0, yes
804007161139523585,  Vincenz40230646, 2, 2, 0, yes
441277571,  lorenzo_bosi, 4, 4, 0, yes
1342097004,  Zappia66, 1, 1, 0, yes
801121195802427392,  technowebsiteuk, 6, 5, 1, yes
1331543755,  g_laretta, 1, 1, 0, yes
770592827399139328,  soden55, 1, 1, 0, yes
679763,  gluca, 1, 1, 0, yes
1172741958,  InfoMenghi, 10, 10, 0, yes
2377048561,  fabionerd93, 13, 13, 0, yes
788758704975912960,  giovanni1846781, 1, 1, 0, yes
3123896707,  EleonoraEleee, 1, 1, 0, yes
2201302628,  bi_robe, 1, 1, 0, yes
2875599153,  adele_messina, 1, 1, 0, yes
133693814,  taipan38, 1, 1, 0, yes
549202587,  CALOAVVFEDERICO, 1, 1, 0, yes
2719849839,  DemaEnza, 1, 1, 0, yes
957425850,  MunStefi, 1, 1, 0, yes
1151170046,  BARRYALPH1, 3, 3, 0, yes
637147639,  REfahrer, 1, 1, 0, yes
799170061118427136,  alessiaatzori96, 1, 1, 0, yes
572661442,  ire_cor, 1, 1, 0, yes
258898957,  thevittorock, 1, 1, 0, yes
251502882,  mistersocio, 6, 6, 0, yes
432733277,  mauriziomaggia, 1, 1, 0, yes
539926402,  Barbara_Bonelli, 2, 2, 0, yes
878026549,  giovannicresce2, 1, 1, 0, yes
840243150,  BAHAYRA, 3, 3, 0, yes
801676458733240320,  carla240631, 1, 1, 0, yes
390054448,  TaverniM, 4, 4, 0, yes
54823933,  disgustatissimo, 2, 2, 0, yes
114055016,  rosatroccoli, 3, 3, 0, yes
1539420320,  CostantiniGenny, 2, 2, 0, yes
522197022,  DeGiorgioAnna, 3, 3, 0, yes
148636060,  DArcangeloLex, 2, 2, 0, yes
1139014093,  sandrobargagna, 2, 1, 1, neutral
4128423274,  Paladino70, 2, 2, 0, yes
1927901576,  Ste_Piccioli97, 1, 1, 0, yes
339060680,  SimoneFontanil1, 2, 2, 0, yes
1176872574,  GioguzziGuzzi, 1, 1, 0, yes
975969787,  Covi_M, 4, 3, 1, yes
868187180,  Altraformadv, 1, 1, 0, yes
3341471524,  d03753b1197b470, 2, 2, 0, yes
775715222594154496,  GiuliaPrimicer1, 6, 5, 1, yes
982292234,  Beretta2Laura, 1, 1, 0, yes
388140649,  rominacimaroli, 2, 2, 0, yes
125734964,  roccoit, 2, 2, 0, yes
790284336373362688,  Rosy87925160, 1, 1, 0, yes
451569884,  EnzoRoccov2, 1, 1, 0, yes
279236926,  Mandruca72, 1, 1, 0, yes
1669314613,  mmartelli63, 1, 1, 0, yes
382608504,  SandraBattisti, 1, 1, 0, yes
759446099182714881,  liberidcrederSi, 2, 2, 0, yes
342636977,  Reggiace, 1, 1, 0, yes
725294324,  onswayne, 2, 2, 0, yes
4872436589,  soloxnoia, 2, 2, 0, yes
482141121,  AlanWayneBerti, 1, 1, 0, yes
1222652900,  alicepasqualato, 2, 1, 1, neutral
2317045753,  giobarbalinardo, 2, 2, 0, yes
16778226,  Kees_Papinga, 1, 1, 0, yes
2873763154,  GiusySodi, 1, 1, 0, yes
776453054149296128,  PDFermo, 2, 2, 0, yes
1928252604,  Parliamocichia1, 1, 1, 0, yes
1069555842,  Laura_Costato, 1, 1, 0, yes
2417254837,  VillaFinu, 1, 1, 0, yes
966686160,  diacovincenzo, 1, 1, 0, yes
1220800532,  GBoggiani, 1, 1, 0, yes
718548890912481280,  GiovanniZuccara, 1, 1, 0, yes
1063955072,  StefanoGianni76, 6, 6, 0, yes
189454893,  robertotaiwan, 1, 1, 0, yes
2910692289,  BMurdocco, 5, 5, 0, yes
261206179,  marcello005, 3, 2, 1, yes
71087648,  ligregni, 5, 3, 2, yes
2874019993,  diladom2, 1, 1, 0, yes
533960426,  GcesaroCesaro, 1, 1, 0, yes
512472579,  VeraImpianti, 3, 3, 0, yes
517400567,  bruzzoner, 9, 9, 0, yes
1172540550,  mav669, 2, 2, 0, yes
2903859657,  colleanto, 5, 2, 3, no
2299564030,  Stefap86, 1, 1, 0, yes
25477483,  the_mindflayer, 13, 4, 9, no
2380234909,  SiciliaFra, 4, 4, 0, yes
392233741,  crosmau, 1, 1, 0, yes
3900766708,  cristinamontag, 2, 2, 0, yes
1076880152,  DOMENICODGD7, 3, 3, 0, yes
1078894352,  anthearossa, 1, 1, 0, yes
155335297,  nicolamadia, 2, 2, 0, yes
486781021,  ViolaEmanuele, 3, 3, 0, yes
1015433946,  AleGhirlanda, 3, 3, 0, yes
486274892,  iz5tqw, 1, 1, 0, yes
1015943185,  RLepre, 15, 15, 0, yes
762749251088678913,  AlbiRoberto1, 6, 6, 0, yes
428876092,  BBallini, 2, 2, 0, yes
1441046569,  PresPier, 1, 1, 0, yes
722828420665753600,  vicioinzerillo, 3, 3, 0, yes
238961289,  kirklord00, 3, 3, 0, yes
4188036921,  cavallochecorre, 1, 1, 0, yes
459908865,  sampdoria1946, 12, 12, 0, yes
2361074269,  annibale14, 1, 1, 0, yes
897658892,  RaffaeleSilvagg, 2, 2, 0, yes
421763043,  nic_rosato, 1, 1, 0, yes
2157261460,  cecia1958, 3, 3, 0, yes
759968227782983680,  questavoltasi, 4, 3, 1, yes
1374267032,  StefanoComida, 2, 2, 0, yes
422245324,  CristianaMapell, 2, 2, 0, yes
2870320727,  maltanamassimi1, 1, 1, 0, yes
890708022,  FlaviaRallo, 1, 1, 0, yes
770697590702825473,  GiacomoMaino, 1, 1, 0, yes
137705885,  MaxNapolitano, 2, 2, 0, yes
4089642562,  MCristynaNic, 1, 1, 0, yes
475575224,  willydontorun, 1, 1, 0, yes
293425432,  Miky_Ren, 1, 1, 0, yes
2409371534,  LorenzoPasculli, 1, 1, 0, yes
421956560,  EmilianoCarli, 6, 6, 0, yes
96945924,  Spartacus02, 2, 1, 1, neutral
509599014,  fabry_il_bomber, 1, 1, 0, yes
3708746842,  pedevilla60, 1, 1, 0, yes
704994966,  Ercolenn, 2, 2, 0, yes
460483165,  DavideCagni, 3, 3, 0, yes
106758486,  Mr_Tozzo, 5, 5, 0, yes
2306068792,  marcosara23, 2, 2, 0, yes
221202772,  davidecristi, 1, 1, 0, yes
2385763608,  lapaticoamilano, 9, 2, 7, no
1044203646,  jt_anna, 3, 3, 0, yes
3149261163,  PaoloPichierri, 6, 1, 5, no
282490012,  nessunarazza, 1, 1, 0, yes
883127682,  RudyBrunelli, 5, 5, 0, yes
441851951,  bobtrobb, 8, 3, 5, no
2352460353,  AndreaMongi, 1, 1, 0, yes
758876073614454784,  Monidalu, 1, 1, 0, yes
582646248,  SiraComelli, 1, 1, 0, yes
986866543,  sirivalse, 2, 1, 1, neutral
344552830,  aspide75, 6, 5, 1, yes
33871360,  pulcetto, 6, 3, 3, neutral
569478521,  lucyspe, 3, 2, 1, yes
380406099,  MauroFormato1, 3, 2, 1, yes
113380928,  carlocricchio, 18, 15, 3, yes
3874469260,  moma12102008, 2, 2, 0, yes
2396162744,  florianademiche, 13, 10, 3, yes
589445550,  gcalandroni, 5, 5, 0, yes
2590574511,  AMossetto, 1, 1, 0, yes
804077736188870657,  fedecolez, 2, 2, 0, yes
973720956,  CasiraghiAg, 1, 1, 0, yes
759816813752442880,  LUDUCCO1, 1, 1, 0, yes
2389245857,  sara_pals, 1, 1, 0, yes
707973899,  RaffaellaBastia, 1, 1, 0, yes
719358879,  amztvispillo, 5, 5, 0, yes
175092287,  ggarnero, 1, 1, 0, yes
115509479,  BernaTarantino, 1, 1, 0, yes
2156785945,  FormisanoGen, 3, 3, 0, yes
1069590576,  e_pasetto, 1, 1, 0, yes
799955719709671424,  Iperbole29, 2, 2, 0, yes
523133624,  Nellobellinzago, 2, 1, 1, neutral
2815444628,  Terenzioo, 1, 1, 0, yes
406431687,  fabioputaggio, 1, 1, 0, yes
38438354,  mircomorello, 26, 4, 22, no
1175514218,  NunnariA, 1, 1, 0, yes
987435908,  Entoni73, 5, 5, 0, yes
3067687355,  Oltrap18, 9, 4, 5, no
2329849949,  FraColuxx, 2, 2, 0, yes
103047287,  fabiobetti965, 4, 2, 2, neutral
526761840,  PierKing41, 2, 2, 0, yes
404410427,  CorsiPaolo, 1, 1, 0, yes
455756647,  EmmanueleBogoni, 3, 2, 1, yes
496185549,  elenamancinell1, 1, 1, 0, yes
801074276816289792,  GioviVenturini, 1, 1, 0, yes
703163427947040769,  PalmeStef, 10, 7, 3, yes
1045962650,  adelio72, 3, 2, 1, yes
3252775852,  NicoCatechismo, 3, 3, 0, yes
492497179,  Dunkeltheloser, 1, 1, 0, yes
472303145,  antonellocrucit, 2, 2, 0, yes
607400352,  DafneSerra16, 1, 1, 0, yes
891828164,  terzocavone, 5, 4, 1, yes
2322160717,  giul_bene, 2, 2, 0, yes
801830559181901824,  riccardo_pilla, 3, 3, 0, yes
1234001538,  EnriCavallari, 2, 2, 0, yes
897195240,  ArcaXRenzi, 6, 5, 1, yes
772153767718420481,  meryrub72, 1, 1, 0, yes
1875403849,  DonatellaCordio, 4, 4, 0, yes
862812493,  mayaRoversi, 3, 3, 0, yes
482197018,  LPezone, 2, 2, 0, yes
189664536,  Lore_95, 1, 1, 0, yes
259925537,  lovknklov, 1, 1, 0, yes
1227104677,  silvana_viti, 1, 1, 0, yes
57291452,  gcunico, 1, 1, 0, yes
4010000614,  stefitweeet, 2, 2, 0, yes
1124494778,  AndreBeeee77, 1, 1, 0, yes
1205815622,  Iglesiasmamma, 2, 2, 0, yes
1007254188,  a_portigliatti, 7, 7, 0, yes
1089824720,  Dbertocchini, 3, 2, 1, yes
410557390,  paoladeblasi, 2, 2, 0, yes
744498859880087552,  basta1sialviano, 1, 1, 0, yes
194976587,  saxpe, 7, 4, 3, yes
406443794,  InArteDrago, 10, 4, 6, no
1085300364,  luisaes08358633, 1, 1, 0, yes
866067241,  io_miky, 1, 1, 0, yes
1116777187,  SantoEnnio, 16, 11, 5, yes
2418463000,  RinaSparano, 2, 2, 0, yes
1035110484,  FavataMai, 1, 1, 0, yes
2552844678,  CDP_OfficialPak, 1, 1, 0, yes
1856532362,  AfzPK, 3, 2, 1, yes
427247573,  dariozaccaria, 2, 2, 0, yes
44160660,  DanieleTocci, 1, 1, 0, yes
35245638,  mastiff1988, 2, 2, 0, yes
4495330181,  patogio773, 2, 2, 0, yes
20432064,  ederoclite, 15, 12, 3, yes
16525973,  chiaraquinzii, 1, 1, 0, yes
2184890037,  marcovergaa, 1, 1, 0, yes
773899240221372416,  DStellati, 3, 2, 1, yes
149072946,  Lorigliola, 2, 2, 0, yes
754047942240108544,  AdriDaVila52, 6, 3, 3, neutral
140418760,  etvmacerata, 1, 1, 0, yes
3008589310,  CifelliCobra77, 2, 2, 0, yes
1313377164,  IngTuccio, 2, 1, 1, neutral
396685612,  aquilaSSL1900, 1, 1, 0, yes
2731735665,  myselfcla, 2, 2, 0, yes
538909656,  MincuzziLeo, 1, 1, 0, yes
273963745,  additiva2012, 1, 1, 0, yes
949651824,  francgissi, 1, 1, 0, yes
775774416768761856,  N4nn4gorl4, 9, 4, 5, no
791301733,  silvanam61, 1, 1, 0, yes
4083118379,  longagnani_m, 1, 1, 0, yes
4185660388,  gigi52335676, 3, 2, 1, yes
1894670124,  merymery85d, 1, 1, 0, yes
751427795432136704,  PapaleoAdriana, 1, 1, 0, yes
513330938,  cuccabbarra, 2, 2, 0, yes
422131372,  FranceCasini, 1, 1, 0, yes
1066998775,  panniger, 1, 1, 0, yes
778400589537566721,  mauru1974, 1, 1, 0, yes
425384977,  Fabrizio_Oddo, 3, 3, 0, yes
440369809,  CirilloMarco, 1, 1, 0, yes
589140545,  santodascola, 2, 2, 0, yes
759704358887890944,  Shuffle2005, 1, 1, 0, yes
536578518,  giogasparini20, 1, 1, 0, yes
3053878648,  fabilant_, 1, 1, 0, yes
493567872,  Sabousaid, 1, 1, 0, yes
1187399364,  SchwarzeSchafe1, 2, 2, 0, yes
798592401917022209,  pierluigisava, 2, 2, 0, yes
356464544,  RagnoNicola, 2, 2, 0, yes
62973851,  MIGUELBIONDI, 1, 1, 0, yes
3048324111,  danilocampailla, 1, 1, 0, yes
101212019,  Markatraz, 1, 1, 0, yes
291587006,  cesarearriaga, 2, 2, 0, yes
433560640,  Domedik, 1, 1, 0, yes
4267730801,  antoniomola84, 1, 1, 0, yes
2252271720,  clementinarighi, 1, 1, 0, yes
484633509,  ValeRossi13, 1, 1, 0, yes
440436024,  WhitesPhD, 6, 5, 1, yes
2804804104,  Ossidiana_G, 6, 5, 1, yes
2826747794,  mc_bullhorn, 7, 7, 0, yes
489419534,  domcap58, 1, 1, 0, yes
518499937,  Chiariello_CS, 3, 3, 0, yes
463006133,  lucalucaccini, 2, 2, 0, yes
803897147926122496,  Natalicristian7, 4, 4, 0, yes
1120381093,  AnnaPiscitelii5, 2, 2, 0, yes
736127149803995136,  ciprian54088559, 3, 3, 0, yes
478806476,  87MarinaF, 4, 3, 1, yes
3034640596,  C71Cris, 2, 2, 0, yes
2820617440,  EnzoTablet, 11, 11, 0, yes
924222074,  ItaloCantore, 4, 4, 0, yes
3077285593,  rosellapratelli, 1, 1, 0, yes
2587418206,  verdemaurili, 1, 1, 0, yes
434280541,  gabri1968, 5, 4, 1, yes
761603087274536960,  SenatoreAntoni3, 1, 1, 0, yes
1658134010,  leonecinzia2, 1, 1, 0, yes
412153660,  sarmy68, 1, 1, 0, yes
2459564876,  ACamposampiero, 2, 2, 0, yes
907758559,  FIORFIL, 1, 1, 0, yes
405432237,  Baffogigi, 1, 1, 0, yes
410208486,  ValeriaDeSimon1, 9, 9, 0, yes
2463065714,  tweetsdistilled, 2, 2, 0, yes
501784177,  archferretti, 1, 1, 0, yes
69225815,  0blake, 1, 1, 0, yes
1367876275,  marco_lenzini, 1, 1, 0, yes
435091212,  antoniodef, 3, 2, 1, yes
1073288395,  AndreaLaudadio, 4, 4, 0, yes
583579935,  betty_viola, 3, 3, 0, yes
364740628,  Enghelus, 6, 2, 4, no
288723029,  _vivoperniall, 3, 3, 0, yes
2603902967,  jeanmarc_Kouame, 2, 2, 0, yes
146858634,  Toldino, 1, 1, 0, yes
2631063233,  562628ee880c41c, 4, 2, 2, neutral
381503157,  oinotna1975, 1, 1, 0, yes
3488856435,  mrs_nonnalia, 1, 1, 0, yes
785448306465972228,  Cultura_Impresa, 3, 3, 0, yes
2727239123,  vincenzo_celso, 4, 4, 0, yes
2621137109,  marytaxi65, 10, 9, 1, yes
424076849,  originalbolo, 1, 1, 0, yes
765818905,  sherlockier, 2, 2, 0, yes
271488168,  JessicaRossetti, 4, 4, 0, yes
903512485,  Gargy987, 1, 1, 0, yes
4765765934,  Fabrizi76896705, 2, 2, 0, yes
1131588822,  LeonardRuaa, 3, 3, 0, yes
1726176709,  Mafalda52Mam, 4, 4, 0, yes
3420601067,  TeclaGrillo, 5, 2, 3, no
393650311,  EnzoRizzo1, 6, 5, 1, yes
1728170558,  pokertabs, 6, 6, 0, yes
557661740,  pieros44, 1, 1, 0, yes
2672721163,  marysansa, 1, 1, 0, yes
1258572001,  milkolalicata, 2, 2, 0, yes
1065055866,  Fabbarto, 2, 2, 0, yes
4833610773,  agosfern, 3, 3, 0, yes
182923566,  Tritolex, 2, 2, 0, yes
368533581,  Dinosabatasso, 4, 4, 0, yes
781377673,  rtv38, 2, 2, 0, yes
2429287645,  LucaMoreno2014, 3, 3, 0, yes
289823072,  EmanueleLangone, 6, 6, 0, yes
4643882248,  alessan26535674, 1, 1, 0, yes
426918182,  mattedragonetti, 1, 1, 0, yes
2888049611,  massimocubo53, 3, 3, 0, yes
423795748,  EnricoPoggiali, 1, 1, 0, yes
2874066982,  UmbertoGiardina, 2, 2, 0, yes
716413277,  JFortyseven, 2, 2, 0, yes
275102486,  gisellamonti, 2, 2, 0, yes
2672952668,  LUCAOSTI2000, 1, 1, 0, yes
730507517713911808,  Cristiangrezzi, 1, 1, 0, yes
374002317,  mirandatonio95, 1, 1, 0, yes
3664232957,  cldbrioschi, 3, 3, 0, yes
405658492,  securityaffairs, 4, 3, 1, yes
447173595,  SGallaurese, 3, 2, 1, yes
239878288,  AvvenirediCal, 8, 8, 0, yes
1481835458,  PCasolla, 3, 3, 0, yes
92516395,  spulci, 1, 1, 0, yes
2504436965,  marveldom17, 5, 3, 2, yes
81625338,  SalvCatania, 4, 4, 0, yes
498793850,  robertolino81, 1, 1, 0, yes
2877346636,  Anto84Antonella, 1, 1, 0, yes
782610241363992576,  abb6a4888ef8479, 1, 1, 0, yes
1159863588,  MatteoLugano, 1, 1, 0, yes
2380737476,  rominagiorda530, 1, 1, 0, yes
2569120848,  Toffee10luglio, 2, 1, 1, neutral
635191741,  telegraph_cove, 4, 3, 1, yes
341960665,  giuliamusella, 3, 3, 0, yes
43891997,  semeraro_g, 4, 4, 0, yes
768745544843988993,  marco_di_matteo, 2, 1, 1, neutral
399617102,  AnnaRiccardi77, 4, 3, 1, yes
635327839,  WikiPenso, 2, 1, 1, neutral
728603011094827012,  garofalo_arturo, 4, 4, 0, yes
4018800257,  maruzzu69, 1, 1, 0, yes
403295927,  cristinapalazzo, 1, 1, 0, yes
129117661,  parklaus, 1, 1, 0, yes
387906825,  LeandroAchilli, 1, 1, 0, yes
96312612,  GiAnGix92, 1, 1, 0, yes
386590405,  ale_durante1, 1, 1, 0, yes
421408360,  giovanni_tonon, 3, 3, 0, yes
321989589,  antbrg, 3, 3, 0, yes
1066017044,  AlerioMP, 1, 1, 0, yes
593494121,  _yukio___, 1, 1, 0, yes
3880024059,  LillyQueen48, 9, 6, 3, yes
3123282701,  infocolombrino, 1, 1, 0, yes
930285348,  SandroZaro, 8, 8, 0, yes
943078159,  MBassiato, 2, 2, 0, yes
414634390,  PPBaretta, 8, 8, 0, yes
801444078709837824,  giuseppestaro1, 1, 1, 0, yes
1171142498,  AlessandraDone, 1, 1, 0, yes
443167956,  CleliaMussari, 1, 1, 0, yes
2840229519,  galia_nicola, 1, 1, 0, yes
2737006611,  elydaless, 8, 8, 0, yes
421878171,  MatteoArgentino, 1, 1, 0, yes
54568284,  GiorgioRomano, 2, 2, 0, yes
2721582521,  MarcelloTallo, 1, 1, 0, yes
4899274666,  geniux61, 1, 1, 0, yes
474126377,  GiuseppeCarlo3, 1, 1, 0, yes
951187477,  coccioli_luigi, 1, 1, 0, yes
528681933,  Pep98Verduci, 1, 1, 0, yes
3354605609,  brighi3D, 4, 3, 1, yes
1401426434,  PolimeniF, 8, 8, 0, yes
772166190,  marckus70, 1, 1, 0, yes
1336214551,  NelloGragna, 1, 1, 0, yes
52995543,  romolog, 7, 6, 1, yes
124891495,  MAuADV, 1, 1, 0, yes
517872714,  AlexColomb, 2, 2, 0, yes
729909979768074240,  UnaSolution, 3, 3, 0, yes
2284416844,  GaetanoTerenzio, 2, 2, 0, yes
216488216,  AntonioDelliCar, 3, 3, 0, yes
3017279699,  ChiesaEv, 1, 1, 0, yes
413541326,  luciodigaetano, 6, 5, 1, yes
516526915,  ReginaSurbera, 1, 1, 0, yes
1949292728,  GiTeti, 2, 2, 0, yes
2368767155,  AlfonsoSgaramel, 2, 2, 0, yes
320959193,  claudiosantilli, 1, 1, 0, yes
750400945520013312,  Giusepp51658578, 7, 7, 0, yes
501598774,  eleius, 12, 11, 1, yes
804474360862019586,  robertreal99, 2, 2, 0, yes
287457353,  fredny15, 1, 1, 0, yes
735045646005227520,  juvefp211897, 5, 2, 3, no
562166504,  ingressolibero, 1, 1, 0, yes
169939494,  Infoscs, 4, 4, 0, yes
58439589,  marzagalli, 1, 1, 0, yes
706552084913655809,  fraingoglia10, 1, 1, 0, yes
804565012685717504,  CoucyEnguerrand, 1, 1, 0, yes
29045944,  claudiocerasa, 7, 1, 6, no
63403202,  centouno, 2, 2, 0, yes
441037147,  giuliopuro, 2, 2, 0, yes
392616384,  fr33b1t, 1, 1, 0, yes
3041693639,  Alfonsomino79, 1, 1, 0, yes
1260923292,  doctorgicu, 2, 2, 0, yes
2359401339,  RobyCrive, 5, 5, 0, yes
711543357898674177,  alexand48199310, 2, 2, 0, yes
784804805483061248,  ilario_novella, 1, 1, 0, yes
478122299,  P_Sparacino, 2, 2, 0, yes
2892423057,  paglemil, 1, 1, 0, yes
726295360537255936,  Ipoetisociali, 30, 7, 23, no
237808802,  anto_nobile, 3, 3, 0, yes
292984954,  GuernieriAndrea, 2, 2, 0, yes
557320177,  VieliPasquale, 1, 1, 0, yes
83227484,  ayawill, 2, 2, 0, yes
433742591,  robsacid, 1, 1, 0, yes
790054314328940545,  Pietro02742668, 7, 7, 0, yes
2815678435,  Pier_Skywalker, 2, 1, 1, neutral
22705731,  yotsIT, 1, 1, 0, yes
984640950,  ernestobosisio, 1, 1, 0, yes
1328735738,  FraC26, 4, 4, 0, yes
1211994655,  benedettapanare, 1, 1, 0, yes
302450661,  rossanissima, 1, 1, 0, yes
774226010011295745,  federicodeservi, 2, 2, 0, yes
413159874,  oscarromiti1, 1, 1, 0, yes
2225915403,  Ilascia, 4, 4, 0, yes
876655723,  fraLeaks, 3, 3, 0, yes
726295762275958784,  NotBillSharman, 1, 1, 0, yes
164025117,  PABLOVIVE1, 1, 1, 0, yes
549297681,  gdbologna, 1, 1, 0, yes
2435499830,  SandroCristini, 1, 1, 0, yes
205742791,  ale_gianfry, 1, 1, 0, yes
563747948,  vanedi1978, 2, 1, 1, neutral
264430420,  chiaroeforte, 3, 2, 1, yes
1725334004,  YaAngel00, 1, 1, 0, yes
2817083455,  HoppipollaFede, 6, 2, 4, no
1367182922,  pieropingi, 1, 1, 0, yes
455937572,  AMorzenti, 18, 18, 0, yes
463824751,  messicoale, 1, 1, 0, yes
774862543747768321,  Fabrizi48213750, 2, 2, 0, yes
1063597844,  michele5412, 1, 1, 0, yes
22601194,  mcanonic, 1, 1, 0, yes
2328920703,  unbarbatrucco, 2, 2, 0, yes
3229822833,  dentimax954, 2, 2, 0, yes
1000020710,  notti_stefano, 2, 2, 0, yes
773459151414583296,  paolosamp80, 1, 1, 0, yes
4714746507,  EgizianoD, 4, 3, 1, yes
92245370,  valemarchesini, 2, 2, 0, yes
82362273,  cmolit, 1, 1, 0, yes
285067071,  carlottaselavy, 1, 1, 0, yes
798580172341542912,  CapraGianfranc1, 1, 1, 0, yes
4856337604,  RealAnonPriest, 1, 1, 0, yes
3305434241,  vero_este, 3, 3, 0, yes
258412697,  chinellatoleo, 3, 3, 0, yes
4494780981,  mausavigni, 1, 1, 0, yes
356496234,  SimoneVazzana, 1, 1, 0, yes
2819972417,  Thegreatreturn1, 1, 1, 0, yes
3361637014,  usuario1234568, 34, 34, 0, yes
634912538,  morzentistefano, 29, 18, 11, yes
606949787,  MarcoTomadini, 1, 1, 0, yes
64145212,  EnricoDolabelli, 2, 2, 0, yes
341447721,  1955patrizia, 1, 1, 0, yes
2543169075,  delucasamuele98, 1, 1, 0, yes
3126162896,  vallefuoco_anna, 3, 3, 0, yes
113359594,  ragnolc, 1, 1, 0, yes
2286814494,  Annroveda, 2, 2, 0, yes
2900782241,  ItalyatNATO, 4, 4, 0, yes
4850286592,  HappyDa89679167, 1, 1, 0, yes
803060307384037377,  beatavirgomaria, 1, 1, 0, yes
3045640158,  AlwaysBaby934, 1, 1, 0, yes
612649328,  stolenhat, 1, 1, 0, yes
803660233612607488,  saikouminteh773, 1, 1, 0, yes
67249464,  michelerubini, 1, 1, 0, yes
2677847062,  laPatdiquarto, 1, 1, 0, yes
855410450,  ilghiozzo, 12, 5, 7, no
2962567101,  Gsc1972Giuseppe, 1, 1, 0, yes
378156995,  Pinguinoerotico, 1, 1, 0, yes
801544335594491904,  Sanfila1, 1, 1, 0, yes
994953871,  AleGirimonte, 1, 1, 0, yes
780643968,  dangerbo77, 1, 1, 0, yes
249285653,  NicolaZorzella, 1, 1, 0, yes
383059864,  antopavan, 1, 1, 0, yes
322495050,  basile_marco, 1, 1, 0, yes
315424071,  ClaudioPerconte, 1, 1, 0, yes
2919628487,  AvvCultrera, 1, 1, 0, yes
4877607875,  MACMa_Matino, 1, 1, 0, yes
541380107,  RosaAnnaArgento, 2, 2, 0, yes
2378757955,  fscodeluca, 1, 1, 0, yes
4352157376,  Tommaso140, 1, 1, 0, yes
363154472,  Silvia_PerinoV, 1, 1, 0, yes
798338688,  andrewdelloro, 1, 1, 0, yes
397478606,  gianlucaconti2, 1, 1, 0, yes
537504735,  jeanpaul_b, 7, 2, 5, no
2935726162,  giorgio1161957, 1, 1, 0, yes
447234708,  tonirombo, 3, 1, 2, no
2292906164,  italiancallboy, 1, 1, 0, yes
434816089,  l_lanzillotta, 2, 2, 0, yes
753526761724473344,  1e08e2ff8bc740a, 1, 1, 0, yes
2955476583,  MangiulloV, 2, 2, 0, yes
1707224809,  alessand1969, 2, 2, 0, yes
486566563,  NiccoloTorrini, 2, 2, 0, yes
4818219711,  Leonard94544499, 2, 2, 0, yes
452957109,  AndrewPegaso, 1, 1, 0, yes
2485728489,  rsilo1977, 5, 4, 1, yes
404934378,  LudoCFerrari, 3, 3, 0, yes
2192431237,  Angelob78582949, 2, 2, 0, yes
4197239783,  MaggioreBrizio, 1, 1, 0, yes
775000128600043520,  etciantar, 2, 2, 0, yes
798493336462098432,  Terre_Enotri, 1, 1, 0, yes
1241555917,  NataSono, 4, 3, 1, yes
3050619279,  OwsiPaola, 1, 1, 0, yes
2335845827,  summer21af, 2, 2, 0, yes
234888988,  niko7070, 2, 1, 1, neutral
137834520,  welhuda, 1, 1, 0, yes
2192475199,  CiccioCarteri, 2, 2, 0, yes
516542964,  levobi, 2, 2, 0, yes
1241792798,  donasesto, 4, 3, 1, yes
315669678,  VanniGargiulo, 2, 2, 0, yes
504573386,  MrPitons, 3, 3, 0, yes
408652604,  chilhavistorai3, 1, 1, 0, yes
1036881932,  luigi_dacc, 1, 1, 0, yes
23304197,  champion79, 2, 2, 0, yes
443811579,  ValeriaCarboneB, 2, 2, 0, yes
3295337409,  SoggiornoStampa, 2, 2, 0, yes
2740196383,  GutGameStudio, 1, 1, 0, yes
793806766408630272,  GiogioVannucchi, 1, 1, 0, yes
358169568,  elenaiacopino1, 3, 3, 0, yes
1080882642,  milanjeb, 7, 4, 3, yes
62501613,  val3riov, 2, 2, 0, yes
2148100210,  manu161294, 4, 1, 3, no
364158916,  EmmanueleDiLeo, 4, 4, 0, yes
3245465595,  Nunzia_fox, 3, 3, 0, yes
510212016,  FabiaBuglioni, 1, 1, 0, yes
52007644,  StudioSmussI, 2, 2, 0, yes
3082084121,  StefiSaccardi, 6, 6, 0, yes
701775558879875072,  antoniofolcare5, 2, 2, 0, yes
987121555,  S_Bertazzoni, 1, 1, 0, yes
186052553,  ftagliabue, 1, 1, 0, yes
3239328725,  demarchi44, 3, 2, 1, yes
2634843893,  rossanochiti, 15, 8, 7, yes
304538343,  marcoaruta1, 4, 4, 0, yes
3777004277,  SlowNews2015, 8, 7, 1, yes
1198391592,  ninnolanu, 4, 4, 0, yes
1011561122,  elebohh, 10, 6, 4, yes
75500895,  alessiovaleri, 1, 1, 0, yes
752841904669265920,  972luci, 1, 1, 0, yes
1662272886,  alnencini, 1, 1, 0, yes
708773259781795842,  Donatellabuset3, 2, 2, 0, yes
14600550,  KyAlOx, 2, 2, 0, yes
702545722386849792,  finisterrae58, 3, 1, 2, no
532361025,  _Fa_St_, 2, 2, 0, yes
1875085622,  GiovanniSartor7, 1, 1, 0, yes
538561359,  DarioAlessandri, 6, 5, 1, yes
998065292,  Partyteo_, 6, 3, 3, neutral
900201739,  KarlMunch, 4, 4, 0, yes
1131736946,  OfficialL4M, 1, 1, 0, yes
799930052423073792,  kbnadezhkina, 1, 1, 0, yes
389456567,  Stefano18978, 2, 2, 0, yes
416918748,  VicenteVin, 5, 5, 0, yes
75576699,  _MicroMega_, 3, 3, 0, yes
1320316406,  francescoresci2, 1, 1, 0, yes
567480174,  GianniNedda, 1, 1, 0, yes
1048989355,  Francesca__Rom_, 2, 2, 0, yes
944245758,  susannacadelo, 4, 4, 0, yes
456055327,  grroncon, 4, 4, 0, yes
2365219877,  rovetto68, 9, 9, 0, yes
815581470,  AlumniBocconiBs, 1, 1, 0, yes
3290370616,  joshkgallo, 1, 1, 0, yes
1103649698,  giuseppelpr37, 1, 1, 0, yes
303004257,  itagaki_unlucky, 1, 1, 0, yes
4645651102,  CorradoZanolli, 1, 1, 0, yes
2631929255,  ugoclock, 9, 9, 0, yes
237347652,  AlbertoDiCroce, 2, 2, 0, yes
273544181,  salvodf, 1, 1, 0, yes
909999054,  pantecho, 7, 4, 3, yes
4827480611,  carpaolo73, 2, 1, 1, neutral
4869219142,  AdoBottazzo, 1, 1, 0, yes
373307727,  FrancR1000, 1, 1, 0, yes
1286206279,  fralune, 18, 12, 6, yes
241554024,  Maxgiorgi, 1, 1, 0, yes
2350677641,  RandazzoME, 2, 2, 0, yes
795360958340362241,  Donatoo72, 1, 1, 0, yes
2930991531,  ElenaVaccarossa, 7, 7, 0, yes
2294843719,  AuroraDallaChie, 1, 1, 0, yes
2763984905,  stedelrio64, 1, 1, 0, yes
1566301262,  pino_zuliani, 1, 1, 0, yes
2427493826,  Enzwan, 7, 4, 3, yes
993553692,  FiaschiMax, 1, 1, 0, yes
553715474,  LucaBraia, 5, 5, 0, yes
2196817251,  68_ferrari, 1, 1, 0, yes
404890795,  luigicolombo81, 1, 1, 0, yes
98732981,  christianrocca, 8, 6, 2, yes
202839086,  ClaudFormisano, 1, 1, 0, yes
1126328364,  paoloBaldoni2, 2, 1, 1, neutral
113051649,  leomatto, 1, 1, 0, yes
1015732033,  giopagano, 3, 3, 0, yes
706808013940727810,  nicola_pellanda, 2, 2, 0, yes
787929577385492480,  ninapoto64, 2, 2, 0, yes
754009225911758848,  Marcomalfag, 5, 5, 0, yes
407983705,  andrealisci, 2, 2, 0, yes
222453488,  Trinity949494, 1, 1, 0, yes
407140422,  92Raffaella, 3, 3, 0, yes
612976602,  CristianaGallo1, 1, 1, 0, yes
469354103,  DiegoMilito92, 1, 1, 0, yes
467613883,  Mobasah, 2, 2, 0, yes
26216423,  Stefanillo, 3, 3, 0, yes
429867337,  Feya_a, 3, 3, 0, yes
1198279076,  MPiperata, 3, 3, 0, yes
454324751,  scrum998davi, 1, 1, 0, yes
551380257,  EGiachetta, 6, 6, 0, yes
1625563128,  PatrickDonchi, 1, 1, 0, yes
2740549287,  9f075c2202474fa, 2, 2, 0, yes
1130709956,  asstartaglione, 2, 2, 0, yes
412940741,  GianlucaMastrod, 1, 1, 0, yes
1883752308,  MatteoScelsa, 1, 1, 0, yes
1056201254,  Marcodepropris, 1, 1, 0, yes
1392618446,  uVecchiuViBu, 1, 1, 0, yes
3335169803,  celeste100paola, 1, 1, 0, yes
368772601,  matcan80, 39, 27, 12, yes
933339187,  VincenzoIannac1, 5, 5, 0, yes
2472223507,  multa77, 1, 1, 0, yes
474118642,  alessandroneron, 2, 2, 0, yes
491484119,  patataurk, 1, 1, 0, yes
2555038064,  ziafelice, 1, 1, 0, yes
2463650275,  TequilaKass, 1, 1, 0, yes
181148408,  Andrearey91, 1, 1, 0, yes
29452509,  Araett, 7, 7, 0, yes
3032167743,  gatto_melos, 2, 2, 0, yes
4880423020,  LiscaSo, 3, 2, 1, yes
385965801,  rudyshecat, 2, 2, 0, yes
2239071753,  pensamax, 15, 10, 5, yes
891933398,  bambola49, 1, 1, 0, yes
2941089629,  BBalosetti, 1, 1, 0, yes
188275624,  Biondoallstar, 2, 1, 1, neutral
863572548,  SimoCastelli, 2, 2, 0, yes
388960154,  GraceMora11, 2, 1, 1, neutral
804936535313416192,  Michele62443070, 1, 1, 0, yes
402846288,  mbatman60, 2, 2, 0, yes
1225619828,  C0ntewalter, 6, 6, 0, yes
328513958,  unaltroblogger, 1, 1, 0, yes
20972053,  Salvo84, 1, 1, 0, yes
1034285594,  CartaGiuliano, 1, 1, 0, yes
436101698,  fuffinaviola, 3, 3, 0, yes
3264497747,  pierrex66, 1, 1, 0, yes
342604080,  Ava8c, 1, 1, 0, yes
320964996,  MauroDiNunzio, 9, 9, 0, yes
2965159078,  NicoSanca95, 2, 2, 0, yes
386426178,  OronzoCanaOff, 1, 1, 0, yes
105092185,  pookiecruz, 4, 4, 0, yes
501757998,  AntonioInteglia, 3, 3, 0, yes
737254862799441922,  Samy23g, 2, 2, 0, yes
3035652573,  petruccibetta, 3, 3, 0, yes
2609283590,  PCocurullo, 12, 11, 1, yes
791154802549985280,  Santo82047117, 8, 2, 6, no
304543070,  GrecoMichele, 2, 2, 0, yes
56425337,  smollina, 2, 2, 0, yes
734472419273015298,  borbone_di, 1, 1, 0, yes
1678501574,  ddi_ma, 2, 2, 0, yes
791530009810927616,  franzscafati, 1, 1, 0, yes
784733597555159040,  pierolodi_cento, 1, 1, 0, yes
2438223399,  GSL50, 1, 1, 0, yes
97502899,  bikediablo, 5, 2, 3, no
342366415,  Casti_F, 6, 5, 1, yes
803147213614567425,  donatoo83, 3, 3, 0, yes
3374298405,  giovannimazza15, 1, 1, 0, yes
4885278863,  Rohman_ncr, 1, 1, 0, yes
1128241520,  longwayrun, 11, 11, 0, yes
1074495614,  EleonoraDesiata, 1, 1, 0, yes
3246731811,  EwkaKaska, 1, 1, 0, yes
4136033488,  Miss_FrancyM, 2, 2, 0, yes
396421688,  luidelmo, 1, 1, 0, yes
529679724,  ColoDeDato, 4, 3, 1, yes
404979757,  mariaquerz, 2, 2, 0, yes
115136798,  FrezzaFrezza, 2, 1, 1, neutral
2763946546,  RenatoRenycop, 1, 1, 0, yes
2423442685,  francesca0301, 2, 2, 0, yes
767875664,  ImperiaZottola, 1, 1, 0, yes
486879277,  robertoaureli1, 2, 2, 0, yes
118133195,  Eichiki_Onizuka, 5, 5, 0, yes
60281313,  arredi_sardi, 7, 3, 4, no
1409028001,  LucianoLibero, 1, 1, 0, yes
219686177,  OliStream, 1, 1, 0, yes
2889749489,  GiusBattiato, 1, 1, 0, yes
3412244357,  emanostradamus2, 1, 1, 0, yes
394191157,  rena_bianca, 1, 1, 0, yes
298462276,  vicaturo, 2, 2, 0, yes
4032723244,  yleniaarezzidue, 1, 1, 0, yes
801730510930214912,  MaryCarrozzo, 3, 2, 1, yes
4639593141,  ravelclaud, 7, 4, 3, yes
22129496,  eleonora82, 1, 1, 0, yes
792312918419341312,  erri12754919, 1, 1, 0, yes
4534673776,  FedericoImprot4, 5, 2, 3, no
453277617,  LordCompass, 4, 4, 0, yes
783364700939620352,  LucaGerINAS, 1, 1, 0, yes
2174888165,  Radelasuerte, 1, 1, 0, yes
360691669,  sjoly_ita, 2, 2, 0, yes
1618073041,  Marynci, 2, 2, 0, yes
1893394914,  Bulla_Adriano, 1, 1, 0, yes
801906268956979200,  Tidiane38855859, 5, 5, 0, yes
3404479583,  Gianni88622865, 2, 2, 0, yes
18680596,  rgm_magi, 2, 2, 0, yes
3080231404,  obartolucci1, 1, 1, 0, yes
2686321421,  Maxbar65Massimo, 2, 2, 0, yes
2355289058,  marisamoles, 2, 2, 0, yes
455238906,  FrancoisSelvagg, 1, 1, 0, yes
109284900,  dariogenna, 1, 1, 0, yes
252513275,  ValeriaPassoni, 5, 5, 0, yes
3439145415,  ErtobNoberto, 5, 5, 0, yes
775449241422618624,  ZelinskaHanna, 1, 1, 0, yes
1305594362,  Piero090460, 1, 1, 0, yes
780316421825912832,  doretto9, 1, 1, 0, yes
983610942,  MarcoAltore, 1, 1, 0, yes
3946448782,  carjuv91, 2, 2, 0, yes
504545175,  ARMANDOMAGLIONE, 10, 10, 0, yes
436076895,  emerencszabo, 2, 2, 0, yes
2942618019,  SPellizzieri, 4, 2, 2, neutral
456549972,  rigozorro, 1, 1, 0, yes
234583839,  DesmoRico, 4, 3, 1, yes
779428207749697536,  corradina78, 1, 1, 0, yes
1037834695,  scarligan, 4, 4, 0, yes
298079436,  wirko94, 5, 3, 2, yes
72579640,  TheSignorile, 4, 2, 2, neutral
3906733041,  PierangeloSaba, 1, 1, 0, yes
745500327206477824,  MariaTeresaPel7, 2, 2, 0, yes
715561850323267584,  loredanapsy, 2, 2, 0, yes
2509412809,  ArtemioTerna, 1, 1, 0, yes
416575623,  RINOFERLAUTO, 1, 1, 0, yes
1367905518,  CorradoSummer, 3, 2, 1, yes
431117026,  VissaAlan, 5, 2, 3, no
312577649,  ViaCialdini, 2, 2, 0, yes
2368789219,  casciste, 6, 6, 0, yes
475725415,  givemepupi, 2, 2, 0, yes
615027209,  AndreaGiom1, 1, 1, 0, yes
1145588754,  DeboraSca, 3, 2, 1, yes
941193336,  Mary_Kekko, 1, 1, 0, yes
558595943,  alevita2001, 1, 1, 0, yes
987578060,  f_visintainer, 1, 1, 0, yes
1449897637,  LaurenceMele, 1, 1, 0, yes
1401974312,  pedoluna, 2, 2, 0, yes
703012262,  Viarengo56, 1, 1, 0, yes
451482401,  NicolaManiezzi, 2, 2, 0, yes
761859584,  beerftaustin, 1, 1, 0, yes
805871282784976901,  Antonio20869256, 1, 1, 0, yes
378282999,  joeaffrunti, 1, 1, 0, yes
995797856,  alessia_pizzo, 1, 1, 0, yes
3228712372,  bettatonoli, 1, 1, 0, yes
579698198,  EnricoLusenti, 4, 3, 1, yes
1410586339,  BiffiSte99, 3, 3, 0, yes
3044897558,  CasulaGiuliana, 1, 1, 0, yes
4186572869,  MDRin0, 1, 1, 0, yes
480803834,  Nicola_Macerati, 2, 2, 0, yes
797040184508424192,  MarcucciArianna, 2, 2, 0, yes
1184516976,  onegin62, 1, 1, 0, yes
2507810759,  bruny_m, 1, 1, 0, yes
1315990226,  ninfasia, 1, 1, 0, yes
1376562708,  92viru92, 1, 1, 0, yes
2807459157,  3249848Alberto, 10, 3, 7, no
1534659492,  gabrycheru, 1, 1, 0, yes
378477654,  GaleoneEugenio, 2, 2, 0, yes
460648513,  lauracastelbarc, 1, 1, 0, yes
299612403,  francescomel, 1, 1, 0, yes
3213646640,  ClaudiaPorzi, 1, 1, 0, yes
2360848925,  FridaFerretti, 2, 2, 0, yes
264463684,  massimomollica, 2, 2, 0, yes
737302538542845952,  marcelloputtine, 4, 2, 2, neutral
83935614,  grazio77, 1, 1, 0, yes
3236208180,  APiccione02, 1, 1, 0, yes
3076660063,  lensibarbara, 3, 3, 0, yes
410995682,  apricena1953, 1, 1, 0, yes
4054575329,  lulina_93, 1, 1, 0, yes
2431760298,  charlesmoscarda, 1, 1, 0, yes
800064540385812480,  pcclnz, 1, 1, 0, yes
3406987503,  mundele1977, 1, 1, 0, yes
805861733520863232,  aceraso43, 1, 1, 0, yes
418992209,  Ninac_Ita, 1, 1, 0, yes
2357836734,  Nicolavene2, 1, 1, 0, yes
1497687198,  gianclaudio57, 6, 5, 1, yes
308073259,  Panna975, 4, 4, 0, yes
537329013,  SimonaCorrias1, 3, 3, 0, yes
2565616821,  monica09302830, 2, 2, 0, yes
303416468,  velanet, 3, 3, 0, yes
393260963,  ChiaraVenturi, 3, 3, 0, yes
710228256449019904,  EAlletti, 2, 2, 0, yes
805828873485217792,  Cesarebasilea, 1, 1, 0, yes
261674343,  Giugy92, 1, 1, 0, yes
473156197,  JBrahaj, 1, 1, 0, yes
944687335,  Matteocoe, 6, 3, 3, neutral
2228764271,  gabrigiacomo, 1, 1, 0, yes
1251517214,  MSentinelli, 1, 1, 0, yes
2887766638,  isabho_it, 1, 1, 0, yes
128004500,  Scalper_Man, 3, 3, 0, yes
391287219,  RenatoTubere, 2, 2, 0, yes
2188044642,  Juliette_oh, 1, 1, 0, yes
3351894484,  bartlancia77, 1, 1, 0, yes
1168780302,  MArgilli, 1, 1, 0, yes
2509690782,  barbaracaldarar, 2, 2, 0, yes
3329221485,  molpao29_3, 1, 1, 0, yes
793306465075335168,  emilio_trotta, 1, 1, 0, yes
796919018691170304,  BrazzaleFrance1, 1, 1, 0, yes
2527491007,  ivanodabologna, 1, 1, 0, yes
261355521,  ferber70, 1, 1, 0, yes
1369063057,  BlogFox2, 2, 2, 0, yes
3350895233,  aleva2408, 1, 1, 0, yes
395630959,  marcocastoro1, 2, 2, 0, yes
2945788263,  StaziAlessandro, 1, 1, 0, yes
2268497074,  LuciaAbbondante, 1, 1, 0, yes
805667555121778688,  27_rosso_27, 2, 2, 0, yes
2887433099,  erikaspezzani, 1, 1, 0, yes
787988309494628353,  twittoditutto, 3, 3, 0, yes
2684519872,  77_eu, 1, 1, 0, yes
805755990343819264,  Lauretta200014, 5, 5, 0, yes
597161042,  gpagani4, 2, 1, 1, neutral
559390497,  54lucky, 1, 1, 0, yes
761229510226436097,  1574a80803ef4e1, 1, 1, 0, yes
600485803,  ivanasca, 11, 10, 1, yes
430787200,  AlejandroPel, 1, 1, 0, yes
340855476,  AndreaMagagnato, 1, 1, 0, yes
474736876,  AdamQua, 1, 1, 0, yes
1726238318,  federicomenca, 1, 1, 0, yes
1192398493,  FAmendolito, 1, 1, 0, yes
814834027,  xxitsadreamerxx, 2, 2, 0, yes
488736433,  fabdrago, 1, 1, 0, yes
724222174307954688,  mikelanappi, 1, 1, 0, yes
4257851241,  Frances27206549, 1, 1, 0, yes
307587291,  Z3lgadis87, 1, 1, 0, yes
172790792,  GiacoSant, 3, 2, 1, yes
538461403,  fdelprato, 2, 2, 0, yes
2832500751,  vannipalazzo1, 1, 1, 0, yes
348018129,  PetraPeppe, 1, 1, 0, yes
415052189,  ulissegio, 5, 3, 2, yes
524685911,  Ste099, 1, 1, 0, yes
799375069642444801,  GraziaMarazzi, 2, 2, 0, yes
253045926,  damike27, 1, 1, 0, yes
800448907029278720,  danyelamagli, 2, 2, 0, yes
2203506110,  yssailbuono, 1, 1, 0, yes
53415342,  ireaj84, 1, 1, 0, yes
471962629,  dave_deejay, 1, 1, 0, yes
2374061797,  Ginotweet, 1, 1, 0, yes
2441189676,  antocamaiore, 3, 3, 0, yes
803307689526919169,  mcristinagiorda, 1, 1, 0, yes
532178470,  massimo2152, 1, 1, 0, yes
167322468,  feniceabdiel, 1, 1, 0, yes
426950132,  ErosDiRemigio, 1, 1, 0, yes
483643207,  SimoneMagherini, 1, 1, 0, yes
2864701374,  QueenBee, 2, 2, 0, yes
767272709105524736,  vicce63, 3, 1, 2, no
1063737978,  g_mariuz, 1, 1, 0, yes
3072007150,  Gaia_Casadei_, 1, 1, 0, yes
2166178605,  fedeturco_, 1, 1, 0, yes
181162834,  gigalupi, 1, 1, 0, yes
972491538,  domenicacarrozz, 1, 1, 0, yes
805766876928364544,  ValterVaselli, 5, 4, 1, yes
299532875,  danilocretella, 1, 1, 0, yes
490457394,  neymarci_, 1, 1, 0, yes
116219830,  chiarabollattin, 2, 2, 0, yes
403377814,  ferbetti, 1, 1, 0, yes
731500064917606404,  MecColombai, 1, 1, 0, yes
2999343509,  Luca_Vaudan, 1, 1, 0, yes
3288940697,  TiberioIris, 1, 1, 0, yes
558031145,  denismarchesan, 1, 1, 0, yes
254544089,  dedo1218, 2, 1, 1, neutral
1154561185,  GiuseppeDelGiu8, 1, 1, 0, yes
418198854,  PaolaOldani1, 1, 1, 0, yes
3056181714,  paolacasadei64, 1, 1, 0, yes
24956825,  giucampa, 2, 2, 0, yes
405994269,  Conteremita, 2, 2, 0, yes
3243922859,  Ke_Caso, 8, 6, 2, yes
424055714,  vitosdik, 1, 1, 0, yes
91343027,  Marco2k7, 1, 1, 0, yes
2726568145,  INCIPITproject, 1, 1, 0, yes
385280000,  VitalianoCaracc, 2, 1, 1, neutral
2498065328,  DesmoMauri, 1, 1, 0, yes
562823508,  denvergo7, 23, 5, 18, no
953265385,  RobertoAgo1, 29, 8, 21, no
134239951,  Falstaff60, 1, 1, 0, yes
4096454423,  seDavo01, 1, 1, 0, yes
773597556752392192,  natalycarmen24, 1, 1, 0, yes
722726421672697856,  magylarosa, 1, 1, 0, yes
804046230850568192,  healthsotesan11, 1, 1, 0, yes
2691941747,  RissoUisson75, 2, 1, 1, neutral
806059611501498368,  GregoryAversa, 1, 1, 0, yes
2890439895,  paoloduradoni, 2, 2, 0, yes
461058052,  giovannicoviel1, 1, 1, 0, yes
4876008771,  nisrinenaouiri, 1, 1, 0, yes
1236155377,  Raf48nov, 1, 1, 0, yes
780930794420334592,  filly265, 3, 2, 1, yes
2574033231,  ggargiulo3, 10, 5, 5, neutral
4882792689,  bancando2015, 1, 1, 0, yes
2763290893,  footuballon, 7, 7, 0, yes
833317171,  ElisaToscano2, 1, 1, 0, yes
218231432,  AlbanaMonti, 1, 1, 0, yes
2447961335,  EsseandEmme, 1, 1, 0, yes
2516146196,  GianniNotarnic, 3, 3, 0, yes
1254420654,  claudioagostino, 1, 1, 0, yes
273611729,  gabrio76, 1, 1, 0, yes
3239998575,  32Enricoba, 1, 1, 0, yes
2556552156,  Villo69, 1, 1, 0, yes
805564222600019969,  barbara92301055, 1, 1, 0, yes
3044525876,  elifili1976, 1, 1, 0, yes
595781998,  alessandraamo16, 5, 5, 0, yes
2215619547,  villamaggi, 1, 1, 0, yes
522446445,  ThomasThomann, 1, 1, 0, yes
304417243,  CiccioDavolos, 2, 1, 1, neutral
1216416914,  lazzaretti_c, 1, 1, 0, yes
937338294,  maxzallot, 1, 1, 0, yes
807471169,  anbrex, 1, 1, 0, yes
3701486717,  felixxx51, 3, 3, 0, yes
1075881949,  RosamiliaGilda, 1, 1, 0, yes
278607080,  travepietro, 1, 1, 0, yes
739825780293795841,  robasileus, 1, 1, 0, yes
805340051118944256,  Patrizi11961477, 1, 1, 0, yes
805874813017329664,  PellizzerMoira, 1, 1, 0, yes
284959035,  AndreaCaneva, 1, 1, 0, yes
719767770095820800,  Fantini48Loris, 1, 1, 0, yes
216129013,  hugo78370, 1, 1, 0, yes
806049544047824896,  marziuccianyco, 1, 1, 0, yes
252014535,  frossitt, 1, 1, 0, yes
1213879327,  CChiccac, 1, 1, 0, yes
713456188969639936,  SalvatoreRando4, 3, 3, 0, yes
2425020175,  m_scongia, 1, 1, 0, yes
1464468332,  elfocospy, 1, 1, 0, yes
848032550,  DavidePonzetti, 1, 1, 0, yes
416140379,  marcodorsogna, 1, 1, 0, yes
283609509,  FabioBusolo, 1, 1, 0, yes
1165552946,  OlgaScala, 1, 1, 0, yes
452038540,  SoniaPetrill, 2, 2, 0, yes
1262601242,  MorenoPizziconi, 1, 1, 0, yes
785983950539874304,  elena_spine, 1, 1, 0, yes
2873024296,  CiocaFabrizio, 1, 1, 0, yes
1340066966,  AndreaMusig, 1, 1, 0, yes
602568449,  FGiun, 2, 2, 0, yes
1418335729,  aandfau, 1, 1, 0, yes
133792370,  merlocaleb, 1, 1, 0, yes
570019665,  gpalopoli79, 6, 4, 2, yes
380072703,  RinoDAndrea, 1, 1, 0, yes
491694195,  alfredoberritto, 2, 1, 1, neutral
1231068138,  fortin_andrea, 1, 1, 0, yes
57311970,  oaccogli, 6, 6, 0, yes
567096691,  enrfili, 1, 1, 0, yes
137695496,  gloria_ben, 4, 4, 0, yes
581538550,  samueledossena, 1, 1, 0, yes
2401410004,  AnnaBaroffio, 1, 1, 0, yes
1225820378,  MarianoWAR, 1, 1, 0, yes
2298055880,  mauro3570, 1, 1, 0, yes
2310382498,  andrea_porri, 1, 1, 0, yes
2714974097,  AlessandroVerzo, 1, 1, 0, yes
8111252,  theamazer, 4, 4, 0, yes
2784392069,  marcopantaleone, 1, 1, 0, yes
3066075095,  sergio313160, 1, 1, 0, yes
772545915525660672,  KrzysztofKubon, 1, 1, 0, yes
492013978,  DiegoIadarola, 1, 1, 0, yes
736138065429811200,  Ascani2Fi, 1, 1, 0, yes
408312386,  TeodoriMarco, 1, 1, 0, yes
3741805834,  FedericoRadici, 1, 1, 0, yes
185797893,  sasazinzi10, 2, 1, 1, neutral
2895230327,  marziabc, 1, 1, 0, yes
4821052469,  Claudia69441067, 1, 1, 0, yes
541802550,  EnricoMartini78, 1, 1, 0, yes
4652479816,  CerritelliFabio, 3, 3, 0, yes
772186947938758656,  CallenJane, 1, 1, 0, yes
2571262914,  CucchiChiara, 1, 1, 0, yes
199414399,  usmaister, 1, 1, 0, yes
1318434036,  domenich4, 3, 3, 0, yes
805799125765787648,  giulia94_giulia, 1, 1, 0, yes
480541494,  ada_cavaliere, 6, 6, 0, yes
752629982371995648,  RoccoZff, 1, 1, 0, yes
3297839303,  mariadisciacca1, 1, 1, 0, yes
801535820,  andreacesqui, 1, 1, 0, yes
417095223,  hom79, 6, 1, 5, no
2241373296,  danielasperanz3, 1, 1, 0, yes
245025642,  securitiex, 2, 2, 0, yes
501063636,  carlomariaforna, 1, 1, 0, yes
2905728286,  annarita_guido, 1, 1, 0, yes
2148602578,  LoryC960, 1, 1, 0, yes
2883972201,  alextremo46, 1, 1, 0, yes
1352900252,  simonegiugni1, 1, 1, 0, yes
893434219,  Barbaravai, 1, 1, 0, yes
424892808,  gigispina, 1, 1, 0, yes
945824624,  MariaPiaTurco1, 1, 1, 0, yes
1258745312,  TempestiniG, 1, 1, 0, yes
389025458,  augusto_campo_k, 1, 1, 0, yes
2369483917,  paolosmiraglia, 1, 1, 0, yes
423406374,  PaoloRicciardel, 1, 1, 0, yes
972619634,  MoraLetizia, 1, 1, 0, yes
1381129718,  ardigrenzo, 2, 1, 1, neutral
560405524,  signo_deitempi, 1, 1, 0, yes
805796013403467776,  crieledani, 2, 2, 0, yes
351573915,  AnnaPetrazzuolo, 1, 1, 0, yes
1378845468,  pvolpones, 1, 1, 0, yes
2398543407,  SMasarati, 1, 1, 0, yes
1366974097,  idanicoli14, 1, 1, 0, yes
35491066,  Bizia, 1, 1, 0, yes
106032280,  Fideliox76, 1, 1, 0, yes
2203665905,  SteganiaG, 2, 2, 0, yes
805850672608538624,  19viv66, 1, 1, 0, yes
1479657986,  CosimoRIZZO5, 1, 1, 0, yes
1650232020,  virginia_lenzi, 1, 1, 0, yes
513700424,  WFalcioni, 1, 1, 0, yes
797374353851740160,  LaFloDem, 1, 1, 0, yes
1071770196,  raffaellaclelia, 1, 1, 0, yes
397756880,  maurizioricci2, 1, 1, 0, yes
911212639,  NTosolini, 1, 1, 0, yes
474066545,  olgaraineri, 2, 2, 0, yes
299762723,  federica_bu, 1, 1, 0, yes
370642806,  Verorikke, 4, 3, 1, yes
366623698,  Hiruma83, 1, 1, 0, yes
2563393296,  ValinaMa, 1, 1, 0, yes
2843591326,  a367c7f48f444f9, 1, 1, 0, yes
595706327,  FabioSavelli2, 2, 2, 0, yes
3372343222,  skinnymand, 1, 1, 0, yes
1093140308,  dambrodan, 1, 1, 0, yes
1117820726,  epictecte, 1, 1, 0, yes
1067779500,  smastro63, 5, 4, 1, yes
3221203091,  omniamutantur66, 3, 3, 0, yes
192845233,  ClaudioCosetti, 1, 1, 0, yes
806067361010876416,  gberardi1996, 1, 1, 0, yes
1443152474,  refertoAnuj, 3, 3, 0, yes
244087436,  Langhet, 1, 1, 0, yes
3236723727,  casarolafrank, 1, 1, 0, yes
806066493284880385,  Mikismo83, 1, 1, 0, yes
84028730,  Poio1982, 1, 1, 0, yes
344175877,  RiccardoMamini, 1, 1, 0, yes
504305349,  crimat10, 6, 6, 0, yes
1514597545,  laviperellaella, 1, 1, 0, yes
856558687,  FrancescaCuore2, 1, 1, 0, yes
916409767,  gio_mancuso91, 1, 1, 0, yes
2941043711,  DeiseQuintilia1, 1, 1, 0, yes
493169550,  BiancorsMacchia, 1, 1, 0, yes
287086333,  emanuelenarici, 1, 1, 0, yes
378803372,  rspizzichino, 2, 2, 0, yes
389456032,  frmandelli, 3, 1, 2, no
1570523761,  Franca112Maria, 1, 1, 0, yes
3420892277,  silviamasini87, 1, 1, 0, yes
4166495819,  DanielaPenduick, 1, 1, 0, yes
2889358817,  bblattuada, 1, 1, 0, yes
46086135,  carlogalassi, 1, 1, 0, yes
1435168926,  alberto51059, 1, 1, 0, yes
783641344367587328,  Rudyvdwalle, 1, 1, 0, yes
392561345,  DuccioManetti, 8, 8, 0, yes
2363271545,  giacomostr, 2, 2, 0, yes
799315797768372225,  C____2062, 3, 3, 0, yes
997913233,  A__Annalisa, 1, 1, 0, yes
2900952982,  Omeronline7, 1, 1, 0, yes
254299051,  giamba_a, 1, 1, 0, yes
1405190712,  GuidaperFirenze, 1, 1, 0, yes
98631516,  beatricescutari, 4, 4, 0, yes
3404057164,  carmenzeni, 1, 1, 0, yes
885136549,  tizietiziana, 1, 1, 0, yes
222139456,  Penelope48a, 2, 2, 0, yes
606283452,  FARAONE655, 1, 1, 0, yes
391336798,  ArtesiGiacinto, 1, 1, 0, yes
15298375,  minushabens, 1, 1, 0, yes
497095258,  guiccia, 1, 1, 0, yes
491155423,  magatinaca, 1, 1, 0, yes
1863493537,  _polytropos, 2, 2, 0, yes
829730856,  ilClaNit, 4, 4, 0, yes
4502240597,  DiegoLar1998, 6, 6, 0, yes
990408180,  AxiaTibi, 3, 3, 0, yes
441091166,  maramaolo, 1, 1, 0, yes
436044724,  mplatorre, 1, 1, 0, yes
3293354852,  FeliPastaLover, 2, 2, 0, yes
1305566606,  zonimariagrazia, 4, 4, 0, yes
715993935668228096,  stock310878, 3, 3, 0, yes
143211412,  Geberele, 1, 1, 0, yes
3117515938,  Mario_Supermd, 3, 3, 0, yes
429848799,  EliaTorrisi, 4, 4, 0, yes
499718301,  Bottija7, 1, 1, 0, yes
239328870,  diegonoisevic, 1, 1, 0, yes
2897706765,  alebevo, 1, 1, 0, yes
2207927540,  MarcoBiasotti, 6, 2, 4, no
2426878565,  AquilinoFabio, 1, 1, 0, yes
3224481191,  36c241a69c6b488, 1, 1, 0, yes
2223286957,  vallarinochiara, 1, 1, 0, yes
2816903759,  anadelaroche67, 1, 1, 0, yes
268292521,  mcpiccioli, 1, 1, 0, yes
619992702,  DonatelloBiscio, 5, 5, 0, yes
421316277,  biolo7231, 5, 5, 0, yes
1004249953,  miChetEmPeSTA, 1, 1, 0, yes
53537624,  Alisola, 1, 1, 0, yes
103050495,  melaniantonio, 1, 1, 0, yes
4415419402,  Marcell85862289, 1, 1, 0, yes
113876551,  Saridduzzu, 1, 1, 0, yes
791384182056443904,  roby50441602, 1, 1, 0, yes
724171094027042816,  Artemide27, 1, 1, 0, yes
589763370,  flaviomax63, 2, 2, 0, yes
53631979,  COMPARINI, 2, 2, 0, yes
429241235,  lgustf, 1, 1, 0, yes
806044397397807104,  PoteriDeboli, 2, 2, 0, yes
4923331546,  cirocapaccio197, 1, 1, 0, yes
1101127794,  tempestasergio, 1, 1, 0, yes
3336638973,  Mattiacampisi1, 1, 1, 0, yes
785559089132830720,  gra_giovanna, 1, 1, 0, yes
754304004461658112,  donatellamarc15, 2, 2, 0, yes
326026685,  massimo_cardone, 1, 1, 0, yes
203878616,  skarval, 1, 1, 0, yes
394845076,  PasqualeCampese, 1, 1, 0, yes
488263275,  slatanivan, 1, 1, 0, yes
275035792,  fabiogori, 1, 1, 0, yes
767823852957274119,  prideonlineit, 5, 4, 1, yes
3044673580,  ArtnFoodNews, 1, 1, 0, yes
423011868,  ganosk, 7, 2, 5, no
151087089,  agri_caserena, 1, 1, 0, yes
2176829876,  SabrinaBalda, 1, 1, 0, yes
421828602,  silvanaoggi, 2, 2, 0, yes
223095671,  pietrorc80, 2, 2, 0, yes
357508884,  Guille_Piquero, 1, 1, 0, yes
801012209195352064,  gabrighetti, 1, 1, 0, yes
502618667,  luckylu1970, 3, 3, 0, yes
3652275443,  gentile_greta, 1, 1, 0, yes
2330832715,  GianfryDiMizio, 1, 1, 0, yes
3038910641,  PaulBertoli, 2, 1, 1, neutral
392754320,  CSgobbio, 1, 1, 0, yes
449115350,  NaturaleForever, 1, 1, 0, yes
618717774,  Mario_Merante1, 1, 1, 0, yes
803852928805195776,  letme263, 1, 1, 0, yes
747917978,  filippopos, 3, 3, 0, yes
11600382,  giocorbisiero, 1, 1, 0, yes
389512004,  FaustoRecchia, 1, 1, 0, yes
1270332710,  marcelito60, 9, 9, 0, yes
411173552,  PeppeGla, 1, 1, 0, yes
2848348516,  JoMarch197, 14, 13, 1, yes
500937685,  aldomaggi, 2, 2, 0, yes
2185789423,  cristianosil2, 3, 3, 0, yes
2782316723,  caterinaciacch1, 1, 1, 0, yes
2270299820,  NuovoSud, 2, 1, 1, neutral
705213484238282752,  a_terranova_, 1, 1, 0, yes
224180160,  ALan__61, 7, 6, 1, yes
412581816,  GiacomoMarchese, 1, 1, 0, yes
2948103358,  antoniofato2014, 2, 1, 1, neutral
473445891,  daria_meinardi, 7, 6, 1, yes
2943801525,  heylebon, 2, 2, 0, yes
3309780779,  lievito_madre, 1, 1, 0, yes
3587587647,  VecchietJadran, 11, 7, 4, yes
1209817032,  DragaRocchi, 1, 1, 0, yes
1241026327,  Indignato129, 3, 3, 0, yes
528802425,  maurosquorte, 2, 2, 0, yes
1159825519,  mariarosabar, 2, 2, 0, yes
947888533,  Tittiminu, 1, 1, 0, yes
379386530,  davidino2011, 1, 1, 0, yes
3062119739,  d1ce0e2932df40b, 2, 2, 0, yes
75816965,  Farieri, 3, 3, 0, yes
831717836,  marco020879, 2, 2, 0, yes
756462476045250560,  AndreaSabbatucc, 2, 1, 1, neutral
41926516,  SandroSca, 4, 2, 2, neutral
739740119477915648,  MarinaCeccarel7, 1, 1, 0, yes
4838146889,  FlaminioAn, 1, 1, 0, yes
1041743982,  DanieleMasini16, 16, 16, 0, yes
138539547,  dafargi, 1, 1, 0, yes
802115795329355776,  iulius66, 1, 1, 0, yes
197414153,  mgiusi, 2, 2, 0, yes
96838560,  leonardobasile, 1, 1, 0, yes
430475387,  giuseppe_picone, 6, 5, 1, yes
422124007,  GiovanniDelGia, 1, 1, 0, yes
446408100,  LuciaPorzio, 1, 1, 0, yes
4904675895,  lucia_fortini, 3, 3, 0, yes
775760049562083328,  Mel_Ti_Giudica, 1, 1, 0, yes
2513363275,  forzaalto, 1, 1, 0, yes
44152801,  robjunior27, 1, 1, 0, yes
173442871,  nina240557, 1, 1, 0, yes
151126721,  fragiardina, 1, 1, 0, yes
3045127324,  MarzioMalizia, 2, 2, 0, yes
493055341,  alan3789, 1, 1, 0, yes
3364072065,  DangeloG82, 2, 2, 0, yes
1028781468,  soniacatti, 1, 1, 0, yes
3382799745,  8_cita_21, 2, 2, 0, yes
2958779025,  danieleleone77, 4, 4, 0, yes
54188283,  alioti, 4, 4, 0, yes
1256727451,  elviocovino, 2, 2, 0, yes
2621194049,  laprofgaia, 2, 2, 0, yes
189264868,  MatteoWebDesign, 2, 2, 0, yes
162468280,  eletueletu, 2, 2, 0, yes
1325008650,  lmx69, 8, 3, 5, no
2518577318,  ElioPD, 8, 5, 3, yes
2939955946,  megbi6, 1, 1, 0, yes
54978599,  simcapp, 2, 1, 1, neutral
986634228,  milob76, 1, 1, 0, yes
91966622,  graziellacuocci, 1, 1, 0, yes
2318220141,  LatellaAnne, 4, 4, 0, yes
782274382496423938,  corradogiorgio1, 1, 1, 0, yes
802265762320805889,  BiggiCristiano, 1, 1, 0, yes
1106694271,  AlexDetto, 1, 1, 0, yes
3369603479,  MaxZeppelin81, 1, 1, 0, yes
1168976773,  gbbisogno, 1, 1, 0, yes
96522273,  arkito25, 3, 2, 1, yes
3302080187,  1cd809581fbd438, 2, 2, 0, yes
923992932,  quercete, 1, 1, 0, yes
600035007,  Alfonso76Nard, 2, 2, 0, yes
88528666,  PieroMicheletti, 1, 1, 0, yes
256230769,  phootial, 2, 2, 0, yes
30098168,  Gaudenzio, 3, 3, 0, yes
429932242,  PinoMarcone, 1, 1, 0, yes
527149082,  michelelizzi, 4, 4, 0, yes
1737643734,  LorCavalaglio, 1, 1, 0, yes
3179765383,  Alexys_510, 2, 2, 0, yes
804389679789469696,  Pmariagro1, 2, 2, 0, yes
4031345951,  sofvanda, 1, 1, 0, yes
117360683,  magico122, 3, 3, 0, yes
493293179,  roccogi52, 1, 1, 0, yes
487792546,  PaoloBIANCHI70, 9, 9, 0, yes
2322216944,  Palfarano, 2, 2, 0, yes
458267707,  PikkolaCandy, 6, 6, 0, yes
734395909,  BOSSIMARIO, 1, 1, 0, yes
706816325495169024,  EcoFinPy, 1, 1, 0, yes
2433632885,  ZarconeSandro, 2, 2, 0, yes
772825836093399040,  zampieri1988, 2, 2, 0, yes
695253284781715456,  FrancaDellaval1, 1, 1, 0, yes
396222670,  DancoPier, 1, 1, 0, yes
261311218,  LupoAlberto70, 3, 3, 0, yes
45393303,  pecorarilelenew, 5, 3, 2, yes
801334903308767232,  GA_Luiso, 6, 6, 0, yes
797081173516292096,  Omar10018971, 2, 1, 1, neutral
779341502292131840,  firenze_live, 2, 2, 0, yes
802869362264829952,  IMolgagrandi, 7, 7, 0, yes
2658856484,  raykarter2, 1, 1, 0, yes
1522851475,  EGiacomazzi, 1, 1, 0, yes
767825173097680897,  oraziocastel55, 4, 4, 0, yes
1959533262,  AlbertCantarell, 3, 3, 0, yes
88048507,  nickpan21, 1, 1, 0, yes
1392007184,  mao59maurizio, 2, 1, 1, neutral
1153796610,  AlessiaSabani, 1, 1, 0, yes
302437167,  tsumio4, 1, 1, 0, yes
368951406,  Mickey19_62, 1, 1, 0, yes
765606442686619648,  domenic76494650, 7, 7, 0, yes
594501913,  smile_ioana, 1, 1, 0, yes
402749703,  felicekuro, 2, 2, 0, yes
731566352268447744,  WalterTuzz, 1, 1, 0, yes
477232430,  MaioMommi, 2, 2, 0, yes
2769296806,  MSarti52, 3, 3, 0, yes
1135306920,  AViorelCosma, 3, 2, 1, yes
98719187,  MaurizioCopelli, 4, 2, 2, neutral
4592488702,  torx75, 1, 1, 0, yes
1688546294,  LuchinoSpa, 1, 1, 0, yes
295232530,  Ettore_Costa, 2, 2, 0, yes
4861512059,  frontegiu, 1, 1, 0, yes
389715698,  riccardoena66, 4, 3, 1, yes
2264336711,  sofimar75, 1, 1, 0, yes
2613948811,  Mi_compani, 4, 4, 0, yes
50236559,  iColomboA, 6, 4, 2, yes
768494852656996352,  Olga49251073, 2, 2, 0, yes
1050588654,  SalvatoreDN, 7, 6, 1, yes
3127307961,  GPaci63, 1, 1, 0, yes
720667018,  francescodideco, 3, 3, 0, yes
153384793,  MIZIO65, 1, 1, 0, yes
168072615,  messalino, 2, 2, 0, yes
2589921788,  calimer09578625, 7, 6, 1, yes
140040761,  gennaphotograph, 5, 4, 1, yes
453961328,  ba_batti, 4, 4, 0, yes
2172738673,  giulio_lora, 1, 1, 0, yes
1307479952,  domecapone, 1, 1, 0, yes
1931968532,  Machiavelli_Aki, 1, 1, 0, yes
734499385321652224,  GraziaDini, 2, 1, 1, neutral
2472788760,  orchideareale64, 1, 1, 0, yes
602813142,  FredaVin1774, 2, 2, 0, yes
424368906,  salvafaustoceli, 2, 2, 0, yes
413103125,  vincenzo_savino, 7, 5, 2, yes
1288696170,  ValeriaValente_, 15, 14, 1, yes
803155774096756736,  social_indi, 6, 5, 1, yes
3006232925,  GianlucaSoncin, 2, 2, 0, yes
347459140,  AGUARDUCCI, 1, 1, 0, yes
1571310138,  feddinagliati, 1, 1, 0, yes
2973245817,  SteDeRubis, 5, 5, 0, yes
415822734,  salvio1962, 1, 1, 0, yes
194974765,  ALBANO225, 1, 1, 0, yes
27913369,  fermoreno, 5, 4, 1, yes
2781801681,  simari_pasquale, 1, 1, 0, yes
554263314,  lorenzi_c, 5, 5, 0, yes
1227284359,  Ernesto_Nobile, 2, 2, 0, yes
728263259225268224,  polygree, 1, 1, 0, yes
408734757,  infdave, 1, 1, 0, yes
1364707398,  lucabag8, 1, 1, 0, yes
2939472880,  vpolverari, 1, 1, 0, yes
1186827446,  fausto57130622, 1, 1, 0, yes
390800807,  provaperderti, 1, 1, 0, yes
912845659,  debugsi, 3, 1, 2, no
2162526944,  andrea020682, 5, 5, 0, yes
1603328808,  peppinoischia, 1, 1, 0, yes
3346736632,  Uyi814Uyi, 1, 1, 0, yes
2233208533,  ripetizioniunic, 1, 1, 0, yes
433237063,  alevatte, 1, 1, 0, yes
3019734856,  rebeltweeets, 3, 3, 0, yes
242470301,  p_mangano, 1, 1, 0, yes
4506308787,  iosono_nene, 1, 1, 0, yes
397326726,  IGiangrieco, 12, 7, 5, yes
733785341476384769,  MBMB20839858, 9, 4, 5, no
1326332772,  ceciliatagliati, 19, 12, 7, yes
194310769,  SebCutrona, 1, 1, 0, yes
407666309,  SimoManico, 2, 2, 0, yes
3334850685,  Edisi70, 1, 1, 0, yes
1337049217,  LorenzoBianch20, 1, 1, 0, yes
2589552909,  CasellaFilippo, 2, 2, 0, yes
786225772226678785,  filipparogaini, 1, 1, 0, yes
475908911,  CeccariniAndrea, 1, 1, 0, yes
804061479070814213,  SalveCarmine, 1, 1, 0, yes
711700109495504896,  OrioloMaria, 2, 2, 0, yes
1145799926,  MontaniniValter, 1, 1, 0, yes
1601862823,  peccia_carlo, 11, 2, 9, no
435266308,  Callinedda87, 1, 1, 0, yes
3099675839,  marconi_carla, 11, 11, 0, yes
797348458881515520,  bsl02112505, 1, 1, 0, yes
417104189,  gianpiero63, 2, 2, 0, yes
804650682586435584,  filippocutr, 1, 1, 0, yes
12167402,  PaoloMargari, 2, 2, 0, yes
238595448,  massi_marino, 1, 1, 0, yes
2162857184,  CantiniL, 3, 2, 1, yes
2787386366,  BarchettiMarco, 1, 1, 0, yes
471190865,  SalvatoreMess12, 7, 7, 0, yes
701084233322905600,  Bizzi_Andrea, 1, 1, 0, yes
2736602051,  fagliabattizio, 1, 1, 0, yes
3348148149,  Alessan58742357, 2, 2, 0, yes
752137834077749248,  ilgalletto79, 9, 8, 1, yes
3371334340,  qu42antadue, 6, 5, 1, yes
1165460864,  cristinalepenne, 2, 1, 1, neutral
1046050586,  ProfetaGiacomo, 1, 1, 0, yes
398209378,  dora_markus, 1, 1, 0, yes
137315106,  DanieleCaverni, 3, 3, 0, yes
3057389291,  prototype_LAB, 1, 1, 0, yes
455110436,  GiacomoBezzi, 2, 2, 0, yes
45523540,  ffasi, 1, 1, 0, yes
412200626,  gianlu41, 4, 4, 0, yes
585877918,  albi2556, 2, 2, 0, yes
131946542,  omykamal, 1, 1, 0, yes
802626172802764800,  ross_ciani, 1, 1, 0, yes
4602588857,  043b2896ed8f49e, 1, 1, 0, yes
1504584834,  Jacko977may, 1, 1, 0, yes
522454023,  ringhio1962, 2, 2, 0, yes
485172855,  frankhomer79, 1, 1, 0, yes
2194463882,  M_Della10, 1, 1, 0, yes
2752389489,  tracy_corleone, 4, 4, 0, yes
449250646,  SminchioCose, 1, 1, 0, yes
3309758770,  tassone_f, 1, 1, 0, yes
2255386492,  alberto_rodolfi, 6, 5, 1, yes
20689573,  SergioDL, 2, 2, 0, yes
548268871,  mmax50, 1, 1, 0, yes
605185987,  AntonioMaria59, 1, 1, 0, yes
800434872414138369,  giuliodivo, 1, 1, 0, yes
420325945,  PaterMundi, 1, 1, 0, yes
1540884073,  YKallo, 1, 1, 0, yes
1377164353,  MariaGraziaLala, 1, 1, 0, yes
83041759,  NicolaCaputo, 1, 1, 0, yes
128616566,  lemasabachthani, 1, 1, 0, yes
2490820075,  LuisaVassallo1, 1, 1, 0, yes
537841055,  pietromanuele, 1, 1, 0, yes
243665564,  emazzucco, 2, 2, 0, yes
3300284133,  SoleBarcaccia, 1, 1, 0, yes
2735400227,  patticorti, 1, 1, 0, yes
359256835,  Ponytaildriver, 3, 3, 0, yes
804353457268420608,  AndreaCasu74, 1, 1, 0, yes
717970219596165120,  iside50, 8, 8, 0, yes
2992578520,  OnceWereWarri0r, 1, 1, 0, yes
4861121656,  TomassiRenata, 1, 1, 0, yes
1691036046,  roberto96803596, 1, 1, 0, yes
2251958424,  PD_Firenze, 4, 4, 0, yes
52354783,  cmazzonis, 1, 1, 0, yes
3024722596,  QuaratoLuca, 1, 1, 0, yes
2208033796,  giorgiocipollo, 2, 2, 0, yes
1098845929,  AlbertoIsoardo, 4, 4, 0, yes
186008438,  fabgrim, 2, 2, 0, yes
1708224529,  LositoMari, 2, 1, 1, neutral
789455911521845248,  missbroadit, 1, 1, 0, yes
792217289613533184,  ornybo, 2, 2, 0, yes
358040213,  ManuelaBoni, 3, 3, 0, yes
185557505,  thuridilla, 3, 3, 0, yes
3037864168,  dea916d05251438, 3, 3, 0, yes
338946050,  LudovicaSsS, 1, 1, 0, yes
709629978988711936,  AleMartusciello, 1, 1, 0, yes
4881458512,  luizivitali, 1, 1, 0, yes
289968649,  RetoKromer, 3, 3, 0, yes
416261733,  ferrarigenny, 2, 2, 0, yes
801490412099825665,  CiascoGiuseppe, 1, 1, 0, yes
141508118,  110hs, 2, 1, 1, neutral
2163496143,  gremonaprej, 1, 1, 0, yes
422173760,  MaxBrisigotti, 1, 1, 0, yes
152323149,  pmarinesi, 1, 1, 0, yes
2860075751,  mazzinga2009, 2, 2, 0, yes
2251693238,  filatexsas, 1, 1, 0, yes
96540920,  anivarGatisereT, 1, 1, 0, yes
772799394315894784,  Antonio62646213, 1, 1, 0, yes
22343118,  Micheleplati, 3, 1, 2, no
751336554564583424,  pepperikka82, 1, 1, 0, yes
1037057821,  GFilauri, 8, 8, 0, yes
451284372,  giovanniperlett, 1, 1, 0, yes
2949661109,  GTandure, 1, 1, 0, yes
4821717928,  fedeffotography, 1, 1, 0, yes
227213706,  Nick9759, 2, 2, 0, yes
182374164,  dinfh, 1, 1, 0, yes
320840126,  dilnick24, 5, 3, 2, yes
553529776,  MpMau, 9, 7, 2, yes
2176841538,  FraDiBello1983, 1, 1, 0, yes
937620956,  DanieleValle3, 3, 1, 2, no
595804316,  gloriadell2, 1, 1, 0, yes
1922703656,  TIGNARDYANIS, 1, 1, 0, yes
2807235070,  fedegrandesso, 1, 1, 0, yes
718388154663890944,  6745476023f7473, 1, 1, 0, yes
159587152,  luigi_misasi, 1, 1, 0, yes
722071862843412481,  RSzeya, 1, 1, 0, yes
1028263898,  annabeggins, 1, 1, 0, yes
415796020,  Unappa1, 1, 1, 0, yes
397153745,  PARATATONINO, 1, 1, 0, yes
1015924872,  dariomercallo, 1, 1, 0, yes
138864573,  Frankquar, 1, 1, 0, yes
718105328416632833,  concettastrazz2, 2, 2, 0, yes
1524465355,  AlbertoAitini, 3, 3, 0, yes
1122699595,  GFeltrinelli, 4, 3, 1, yes
2474741607,  sarahgbrlncks, 1, 1, 0, yes
2475551926,  Karyniulu, 1, 1, 0, yes
2449208155,  RerunJ791, 1, 1, 0, yes
469193428,  mastroclaudio2, 1, 1, 0, yes
3065693110,  KingFern26, 1, 1, 0, yes
3065868435,  NuOmega__NUPES, 1, 1, 0, yes
1074250160,  enzor868, 3, 2, 1, yes
594793423,  gba65, 9, 2, 7, no
483334668,  mirko_scape, 1, 1, 0, yes
755662034390384640,  Ilaria_Libera, 1, 1, 0, yes
38741263,  Pier78, 1, 1, 0, yes
738067912439824384,  umbriasanitaSI, 3, 2, 1, yes
176942223,  RossanoAntonio, 4, 4, 0, yes
802465369633996800,  LeonardoTummino, 2, 2, 0, yes
743151944437501952,  fra_me_e_te, 3, 1, 2, no
787968814709366784,  Janfigores, 1, 1, 0, yes
802885446065917952,  silviaquebela, 1, 1, 0, yes
411743444,  RAtzeni, 2, 2, 0, yes
572606248,  MarianiTiziano, 2, 2, 0, yes
141875715,  bragagnimaurizi, 2, 2, 0, yes
381735568,  gigiatwenty, 2, 2, 0, yes
377943357,  andreaconticini, 1, 1, 0, yes
442337884,  GianMarcoPescar, 5, 5, 0, yes
2225499673,  MalanMassimo, 1, 1, 0, yes
2199751192,  giampaolochiriv, 1, 1, 0, yes
799365446688456704,  alec060969, 2, 2, 0, yes
3036341843,  gioventra63, 5, 5, 0, yes
1061367398,  McGadda, 5, 5, 0, yes
2166568844,  raosivan1, 4, 4, 0, yes
953654809,  Castaway_, 6, 6, 0, yes
300583424,  emypass, 3, 3, 0, yes
700891754,  GiovanniPasto10, 3, 3, 0, yes
122063756,  lucfrl, 1, 1, 0, yes
3870563897,  PdPontassieve, 3, 3, 0, yes
4653749241,  PiroIl, 1, 1, 0, yes
432943176,  mariatroiano1, 3, 2, 1, yes
3426254951,  DAffaniti, 1, 1, 0, yes
768275844,  bacci7_bacci, 7, 6, 1, yes
486564638,  penna_daniele, 1, 1, 0, yes
399880400,  carloccarli, 1, 1, 0, yes
955409628,  didio_dio, 7, 7, 0, yes
2303691173,  CasiniGianluca, 1, 1, 0, yes
716233077715038209,  vittoriomiele77, 1, 1, 0, yes
754394011931176960,  nadiamomu, 1, 1, 0, yes
549566404,  RobertoFerreri1, 4, 4, 0, yes
492564736,  vanitimicael, 2, 2, 0, yes
3396939819,  FregoneseAndrea, 1, 1, 0, yes
388510073,  mauriziolucchi, 1, 1, 0, yes
351500115,  MgMidu, 3, 3, 0, yes
788850487768522752,  mauro130468, 3, 3, 0, yes
326674366,  beniapiccone, 3, 3, 0, yes
278509054,  drepania, 1, 1, 0, yes
1897408008,  i_am_francy, 1, 1, 0, yes
2962700505,  Daniela85037568, 2, 2, 0, yes
788730285609328640,  00hnceklno, 1, 1, 0, yes
910487292,  ropaglioroberto, 1, 1, 0, yes
215396540,  RiccardoGuidi87, 1, 1, 0, yes
4885821551,  elena_zeni, 3, 2, 1, yes
82636356,  marvar75, 3, 2, 1, yes
2919601721,  IgumaSunny, 1, 1, 0, yes
852460950,  CristianFilieri, 1, 1, 0, yes
3046570409,  saveriodic_di, 2, 1, 1, neutral
433380672,  ivan051282, 2, 2, 0, yes
248620480,  uncadunca, 1, 1, 0, yes
3342010805,  Doc22Inter, 2, 2, 0, yes
2882163783,  Francibra12, 3, 3, 0, yes
504290176,  matteo19631, 3, 1, 2, no
411377231,  odinocepernich, 3, 3, 0, yes
614152258,  MMazzotti, 2, 2, 0, yes
801841816794525697,  nsolution3, 1, 1, 0, yes
352513450,  EnzoCurzi, 2, 2, 0, yes
2754393250,  RMarianaro, 2, 2, 0, yes
100954040,  Br1nico, 1, 1, 0, yes
2971258355,  31c753365fba41c, 1, 1, 0, yes
14784783,  bandan, 1, 1, 0, yes
735162920,  rastycmr, 4, 4, 0, yes
93900537,  pevalfrengol, 1, 1, 0, yes
240335199,  x_LaliMiOrgullo, 1, 1, 0, yes
2434254386,  pallaro51, 6, 2, 4, no
1518699715,  gillafigus, 1, 1, 0, yes
1235554272,  AngeloMannini, 3, 3, 0, yes
4876039581,  stelle_tre, 3, 3, 0, yes
1589180610,  MasciaSomone, 1, 1, 0, yes
419828092,  alle_iccir, 1, 1, 0, yes
2329428259,  gfgravina, 2, 2, 0, yes
970457850,  LucioPasqualini, 1, 1, 0, yes
754403166460968960,  Mohamme57284986, 1, 1, 0, yes
547699314,  hfsnhl, 9, 8, 1, yes
2824837708,  rosaria_vita, 1, 1, 0, yes
307895169,  filodavi, 5, 5, 0, yes
574392687,  AlanIlMagi, 1, 1, 0, yes
723385019218059264,  Alfredo32342951, 2, 2, 0, yes
2960469293,  imeldacrivello1, 10, 6, 4, yes
327374107,  PaoloCernuschi, 1, 1, 0, yes
3255716545,  ThorioumBr, 2, 2, 0, yes
4838990793,  NogeVichi, 6, 5, 1, yes
229980245,  pino1810, 1, 1, 0, yes
469658794,  renvichi, 1, 1, 0, yes
754982030992109570,  massiavv, 1, 1, 0, yes
873313188,  danielacuccuru, 1, 1, 0, yes
2746678529,  NataliFausto, 1, 1, 0, yes
2707234834,  KarmenArnone, 2, 2, 0, yes
372333948,  filippo_noto, 1, 1, 0, yes
126958404,  youmakemesing_, 3, 2, 1, yes
715608001579712517,  sara_paleari, 1, 1, 0, yes
138708420,  matteonardini, 1, 1, 0, yes
1189072956,  JackRoberto61, 1, 1, 0, yes
4472738662,  martangelica68, 2, 2, 0, yes
96782626,  VinceIT, 5, 4, 1, yes
955020858,  rapagna, 1, 1, 0, yes
862793352,  SebastianoRizz1, 1, 1, 0, yes
802230069179666433,  FiammaNazFI, 4, 2, 2, neutral
97861422,  aleiobbi, 2, 2, 0, yes
153034254,  lucaspagni, 5, 5, 0, yes
730116080694382594,  marcoricchi75, 1, 1, 0, yes
1074097184,  ffranzaroli, 1, 1, 0, yes
1853534322,  cirulli_chiara, 1, 1, 0, yes
300273764,  PieroNaldoni, 1, 1, 0, yes
783762422721048576,  fraffri85, 7, 1, 6, no
129465862,  27061968, 3, 3, 0, yes
925089097,  giacomotambo, 6, 2, 4, no
780542019030487040,  Ketty55551267, 1, 1, 0, yes
713017686,  snow1502, 1, 1, 0, yes
916320301,  ManaraPaolo, 1, 1, 0, yes
2385899408,  J27Butterfly, 1, 1, 0, yes
2349431357,  GalaxysPino, 1, 1, 0, yes
411076021,  PierMaran, 6, 6, 0, yes
54543162,  Jorg85, 1, 1, 0, yes
2529756920,  mauro_rotondi, 3, 2, 1, yes
120383498,  gfarfaneti, 1, 1, 0, yes
426943285,  Ferri71Ferri, 1, 1, 0, yes
786480676145168384,  grazia230414, 1, 1, 0, yes
2509183641,  GmailNeroni, 1, 1, 0, yes
293702585,  Pdipatti, 2, 2, 0, yes
798535442610188289,  robertigraziot1, 11, 2, 9, no
179059785,  Diariodelweb, 11, 4, 7, no
436499309,  RobertaLuciani1, 7, 6, 1, yes
587614054,  MarinaFogli, 3, 2, 1, yes
50616524,  salvosq, 1, 1, 0, yes
2407041331,  calca501, 2, 2, 0, yes
2998582120,  BellaniGiovanna, 1, 1, 0, yes
378521973,  SergioBellano, 4, 4, 0, yes
4855812923,  Dragone08871677, 1, 1, 0, yes
413908796,  GrazianoAltieri, 2, 2, 0, yes
3580823957,  LuigiaCestaro, 2, 2, 0, yes
937781161,  LucaMarturano, 4, 2, 2, neutral
610457895,  LouGiordano, 1, 1, 0, yes
1156583330,  tizzzz17, 2, 2, 0, yes
1151882539,  ArnaldaBolzoni, 1, 1, 0, yes
1065188138,  Sergio_Pirani, 1, 1, 0, yes
312704516,  AndreaSantoro76, 1, 1, 0, yes
303193150,  purs53, 1, 1, 0, yes
320640593,  ilnikkio, 1, 1, 0, yes
1150670402,  Saribba, 5, 4, 1, yes
356655235,  deejaytonic71, 1, 1, 0, yes
800699001687273473,  verdi_erika, 4, 4, 0, yes
898133066,  BoenceSport, 1, 1, 0, yes
732970367434825728,  CorsoAlfredo, 3, 3, 0, yes
969804560,  ciambelinda, 1, 1, 0, yes
3387386231,  LolloIuliano, 1, 1, 0, yes
163860196,  DavideBertone, 1, 1, 0, yes
823163340,  a_lamans, 1, 1, 0, yes
713001370987704320,  marzia_cappelli, 3, 3, 0, yes
2804118049,  circondatodiblu, 3, 2, 1, yes
437039612,  francomilk, 1, 1, 0, yes
556262929,  ciako1970, 1, 1, 0, yes
2906781857,  cosiparlonice, 5, 5, 0, yes
2326462552,  joker270879, 3, 1, 2, no
453367163,  barisionematteo, 1, 1, 0, yes
2504528224,  FeracoFiore, 8, 3, 5, no
477658096,  ElioAnese, 1, 1, 0, yes
2359459770,  Nokkyx, 2, 2, 0, yes
559518086,  pierbarone, 3, 2, 1, yes
432079773,  faberfoz, 1, 1, 0, yes
4536073635,  0a1dfb461bb2423, 4, 4, 0, yes
4548204501,  Fabrizi70914451, 3, 3, 0, yes
1061795252,  sarasiniandrea, 1, 1, 0, yes
2269074549,  giovannigiord1, 1, 1, 0, yes
1582558796,  anninamarion, 4, 4, 0, yes
719183489749422080,  UbertiniMarina, 1, 1, 0, yes
601660948,  piricoddi, 3, 3, 0, yes
2424514454,  alejogallotti, 1, 1, 0, yes
106670846,  giocarpediem69, 2, 2, 0, yes
223404787,  fabioliucci, 7, 7, 0, yes
39940281,  Viaggi_Carmen, 1, 1, 0, yes
978937388,  monachellaelisa, 1, 1, 0, yes
803951825112231937,  1975_pino, 1, 1, 0, yes
3345594861,  thecoach8607, 12, 12, 0, yes
917889090,  abelclausius, 19, 13, 6, yes
2991900808,  maxtzr1971, 1, 1, 0, yes
762325800544862208,  Mike92038857, 2, 2, 0, yes
1566826093,  SerZorzi, 1, 1, 0, yes
465551550,  telotwitto, 1, 1, 0, yes
622392024,  ferroConsani, 1, 1, 0, yes
803232312137809920,  Eugenio12349, 1, 1, 0, yes
1371773550,  fabiobarc, 1, 1, 0, yes
973890739,  Marco_Casellato, 4, 3, 1, yes
262206469,  minadepascalis, 2, 2, 0, yes
746057083456528384,  CaptainCook_67, 5, 5, 0, yes
389451698,  ghigorino, 1, 1, 0, yes
3318793277,  MuloSeduto, 2, 2, 0, yes
829378842,  valmulini, 1, 1, 0, yes
427673107,  GraceDama, 11, 9, 2, yes
275455208,  romperis, 6, 2, 4, no
765670693,  lolli_luca, 2, 2, 0, yes
252019649,  gaunilone, 1, 1, 0, yes
4813244901,  CesareCapriott2, 3, 3, 0, yes
618124225,  RTaverBella, 16, 12, 4, yes
628307463,  CekkMauro, 3, 3, 0, yes
376867553,  _MTPisani, 1, 1, 0, yes
1254765228,  maurivarisco, 1, 1, 0, yes
1949844973,  LottiLuca, 1, 1, 0, yes
2797823098,  albertazzi66, 2, 2, 0, yes
1082526932,  franco_massi, 1, 1, 0, yes
425887100,  GNUEMUMU, 2, 2, 0, yes
752592752303607808,  SteaCarbone, 3, 3, 0, yes
4163985387,  EmanueleArnabo1, 1, 1, 0, yes
1066738070,  GiulioRagosta, 2, 2, 0, yes
2259933559,  AntoninoGiaimo1, 1, 1, 0, yes
493525638,  giovannamottini, 1, 1, 0, yes
308986490,  chiara_monte, 1, 1, 0, yes
2960670521,  SDieng87, 2, 2, 0, yes
735708052788121600,  Mary621996, 6, 6, 0, yes
361186188,  pino_sc, 1, 1, 0, yes
408304298,  ManueleDalBello, 1, 1, 0, yes
2246691160,  stellaeantonio, 3, 3, 0, yes
615121842,  discivile82, 1, 1, 0, yes
728996434318655489,  CacciariStefano, 3, 3, 0, yes
2966806611,  aldpao, 1, 1, 0, yes
4744618343,  enzo_vin52, 11, 7, 4, yes
722872031553806336,  dona2803, 1, 1, 0, yes
56692061,  Giampanet, 2, 2, 0, yes
381150459,  checipossofare, 1, 1, 0, yes
589248909,  frau_luigi, 1, 1, 0, yes
801539825216212993,  DarkSideMB95, 1, 1, 0, yes
546015671,  Trillisunny, 3, 2, 1, yes
141458510,  marza64, 2, 2, 0, yes
392918362,  boschimarco65, 1, 1, 0, yes
1170175068,  PaoloFisanotti, 1, 1, 0, yes
394060095,  gino8collesei, 2, 2, 0, yes
1281125448,  pinocerullo, 1, 1, 0, yes
534066819,  domestop, 2, 2, 0, yes
302765721,  LetiAcciaro, 3, 1, 2, no
255554157,  alelima82, 1, 1, 0, yes
1884307555,  giuliettomazzig, 2, 2, 0, yes
3817767454,  Monism0, 1, 1, 0, yes
2305365956,  JeckyAndria, 6, 5, 1, yes
2893201293,  VladZaff, 1, 1, 0, yes
391679046,  nomefil, 1, 1, 0, yes
489509762,  eledim2012, 1, 1, 0, yes
418227596,  pippetto77, 2, 2, 0, yes
1356311990,  Rossella__P, 2, 2, 0, yes
45637935,  vitosalerno, 1, 1, 0, yes
1610111144,  CosimoDurante2, 1, 1, 0, yes
584746037,  mottinelli, 1, 1, 0, yes
3872353503,  falconecile, 2, 2, 0, yes
96343932,  Giuzunche, 1, 1, 0, yes
136976570,  YarnoCeleghin, 2, 1, 1, neutral
747482787993747456,  pietroagostine3, 1, 1, 0, yes
719147371045765120,  GiuliaT_95_luce, 8, 2, 6, no
151900842,  aanselmetti, 1, 1, 0, yes
136585599,  MatteZanichelli, 2, 1, 1, neutral
804070542311587840,  Nino96402217, 1, 1, 0, yes
2559157745,  manololandia, 1, 1, 0, yes
68175251,  tayana37, 1, 1, 0, yes
406555651,  NextPaolo, 7, 5, 2, yes
3145664759,  9384a8136c31451, 8, 8, 0, yes
1564128108,  paolosintini68, 1, 1, 0, yes
725402137031774209,  ConteMascetti1, 1, 1, 0, yes
803142542946693120,  manuela77g, 4, 4, 0, yes
2421012193,  vireccimarco, 3, 2, 1, yes
462046600,  Bsailscrew, 2, 2, 0, yes
2969384565,  AnselmoPapi, 1, 1, 0, yes
1377240775,  slyarianne, 1, 1, 0, yes
794919425027833861,  AndreaCocchini, 1, 1, 0, yes
453926304,  bendepatre, 1, 1, 0, yes
44925381,  claudia_nt, 1, 1, 0, yes
439531149,  matteo_novara, 1, 1, 0, yes
572582980,  alla_carlona, 1, 1, 0, yes
2365230765,  claudiagiardin2, 2, 2, 0, yes
1098999823,  FabriziaGiulian, 2, 2, 0, yes
1321276069,  LeandroDiGemma, 1, 1, 0, yes
468301243,  mpappada, 1, 1, 0, yes
799667660510416897,  QuereloTutti, 1, 1, 0, yes
322559236,  AntoGiannuzzi, 1, 1, 0, yes
703101064,  jessmilani, 1, 1, 0, yes
4257315664,  pigio47, 1, 1, 0, yes
427418997,  RoncagliaAle, 18, 16, 2, yes
33526991,  FacciaDiBoe, 1, 1, 0, yes
733032658943541248,  Giovann86645703, 1, 1, 0, yes
574849235,  MarioNardiMusic, 1, 1, 0, yes
532050164,  leonellolancell, 2, 2, 0, yes
258246841,  lorenzoronzitti, 1, 1, 0, yes
359852107,  umberto_testa, 1, 1, 0, yes
66975806,  batmarco, 9, 4, 5, no
980094828,  alex82psr9000, 3, 3, 0, yes
795924884614508544,  Riccardo0505194, 1, 1, 0, yes
1437752334,  luciano1lupo, 1, 1, 0, yes
794572110274428928,  sara_Filippi6, 3, 3, 0, yes
2173603415,  emme_lisa, 2, 2, 0, yes
623936681,  GermanoVerrone, 2, 2, 0, yes
790260453540790278,  onin0760, 1, 1, 0, yes
919526072,  LucioMalan, 10, 3, 7, no
3007395941,  piemontese54, 2, 2, 0, yes
489397857,  SaverioLozitiel, 1, 1, 0, yes
2221450163,  PietroSantoro93, 1, 1, 0, yes
1301012280,  ildeluca80, 1, 1, 0, yes
747498212672561152,  1970mikail, 1, 1, 0, yes
520251134,  chiarafed75, 7, 3, 4, no
780053471722700800,  TancrediDG, 1, 1, 0, yes
1150604383,  toniste77, 4, 4, 0, yes
26278755,  ClarkBentson, 1, 1, 0, yes
19854174,  Nikstrade, 1, 1, 0, yes
4233092909,  carlochuck, 3, 3, 0, yes
804304569761144832,  Maometto54, 1, 1, 0, yes
2394671383,  RickTersi, 1, 1, 0, yes
142434221,  Gesusalva, 1, 1, 0, yes
904102814,  inca2002, 1, 1, 0, yes
165108578,  ivanot77, 2, 1, 1, neutral
258835686,  AsinuPress, 1, 1, 0, yes
141709502,  Mr_Sharif, 5, 4, 1, yes
1006699670,  topo1966, 1, 1, 0, yes
2314315157,  SimoRussoNa83, 5, 2, 3, no
767002093253197824,  Dino29075965, 1, 1, 0, yes
410948663,  Salvonic, 2, 2, 0, yes
599542475,  DamiBelli, 1, 1, 0, yes
2657417687,  acitpaola, 2, 2, 0, yes
391575977,  Dena_koko, 1, 1, 0, yes
2831439225,  obertipie, 1, 1, 0, yes
1073236824,  antilopeP, 1, 1, 0, yes
119719875,  barbarapardini, 4, 4, 0, yes
77414996,  sirfersulver, 2, 2, 0, yes
147254260,  paolo_vox, 2, 2, 0, yes
553002283,  the_masterplan_, 1, 1, 0, yes
147293373,  simonefeder, 6, 5, 1, yes
773546924863619072,  massimi22946879, 3, 3, 0, yes
2576915331,  SimSvizzera, 5, 2, 3, no
918656593,  NicolaCardascia, 1, 1, 0, yes
397599288,  Mbalo71, 1, 1, 0, yes
2992614868,  Presfede, 1, 1, 0, yes
164320486,  Aferilli, 1, 1, 0, yes
2375114416,  massimiliano68b, 1, 1, 0, yes
733661694027829248,  franco7603, 1, 1, 0, yes
1859884705,  mimmo1805, 3, 3, 0, yes
1114681735,  Emagorno, 11, 11, 0, yes
972350694,  mugnaldo86, 2, 2, 0, yes
173122880,  frafra00, 1, 1, 0, yes
2760685711,  annamariagalan7, 1, 1, 0, yes
1115449826,  deltaflyer60, 5, 3, 2, yes
38941185,  MrPokoto, 1, 1, 0, yes
802056233654087680,  FrancescoBrivio, 1, 1, 0, yes
761651515325030401,  loredana_luzi, 1, 1, 0, yes
1087281432,  uastellagiorgio, 1, 1, 0, yes
3042783753,  march7788paul, 1, 1, 0, yes
128816286,  mentitespoglie, 1, 1, 0, yes
397340658,  AnnaMontagnoli, 1, 1, 0, yes
4830691179,  zamma_98, 2, 2, 0, yes
329923237,  JenniferConroy, 2, 2, 0, yes
1226073056,  Simonaruss, 1, 1, 0, yes
1169529054,  AngelaNitto, 1, 1, 0, yes
265512336,  inblueblood, 4, 4, 0, yes
4018951198,  Francesco2Mari, 1, 1, 0, yes
2462025474,  Sandrodream74, 8, 7, 1, yes
3308415681,  giuditti, 1, 1, 0, yes
1252339764,  renzobagarolo, 1, 1, 0, yes
754849045,  GioVasta1981, 6, 4, 2, yes
459293817,  Donatellasga, 2, 2, 0, yes
2833652902,  StefanoAietti, 1, 1, 0, yes
761526741525487616,  cristina__cri_, 1, 1, 0, yes
2950060684,  docomeco, 2, 2, 0, yes
589995887,  alfrig409, 1, 1, 0, yes
711652640938205184,  contebenso, 2, 1, 1, neutral
3085041983,  paxmax80, 1, 1, 0, yes
421403169,  villanivincenzo, 1, 1, 0, yes
2173115843,  RalloMatteoAR, 3, 3, 0, yes
354816962,  pombo1976, 3, 2, 1, yes
2198940267,  geniuscompresus, 1, 1, 0, yes
3391877111,  pasqualerecch, 1, 1, 0, yes
514344717,  97pie, 1, 1, 0, yes
710829874773155840,  TrincavelliL, 5, 5, 0, yes
1229391188,  CAFONAUTA87, 3, 2, 1, yes
2181837838,  rivalta_danilo, 2, 1, 1, neutral
2867322416,  roberta24135291, 1, 1, 0, yes
3077550544,  2770fc7489f84cc, 2, 2, 0, yes
15331638,  MarcoViappiani, 1, 1, 0, yes
760015703101546496,  massimosaguatt1, 1, 1, 0, yes
2912599330,  miriettaferri, 2, 2, 0, yes
282484568,  fraazen, 1, 1, 0, yes
520706665,  francesco7022, 1, 1, 0, yes
272152104,  mauriziomaurodj, 1, 1, 0, yes
797550098582503424,  michele_picchi, 1, 1, 0, yes
244867902,  gabriellasola, 2, 2, 0, yes
2814189047,  acafrancy, 1, 1, 0, yes
435801815,  paolo_rigamonti, 1, 1, 0, yes
1192193401,  ut1vinci, 2, 2, 0, yes
252774715,  pllpwr, 1, 1, 0, yes
84155751,  Massimo_MF, 1, 1, 0, yes
1419892279,  macasie1959, 2, 1, 1, neutral
276102090,  Pepei55, 1, 1, 0, yes
3291812223,  corcionesuccivo, 2, 2, 0, yes
412282966,  Mikdabramo, 5, 5, 0, yes
468607926,  emmegir, 6, 5, 1, yes
126940808,  racsone06, 1, 1, 0, yes
754252315142529024,  Pane_Secc0, 3, 3, 0, yes
761184517847654401,  fenderlele1, 1, 1, 0, yes
554391220,  LCaldarini, 1, 1, 0, yes
429159152,  Malkilan, 3, 3, 0, yes
336689321,  lucafamoso, 2, 2, 0, yes
474068493,  OneDakamybreath, 7, 7, 0, yes
184724490,  luigirenna, 1, 1, 0, yes
4851227477,  AnnabrunoBruno, 1, 1, 0, yes
782537281492123648,  luciapellegri13, 1, 1, 0, yes
519667803,  annabbbbbb, 3, 3, 0, yes
1945176385,  Marti_Baratto, 1, 1, 0, yes
1034872262,  tre_vigiano, 2, 2, 0, yes
614129819,  Gcanzian, 2, 2, 0, yes
338646883,  stegara68, 1, 1, 0, yes
912313495,  RSgambetterra, 1, 1, 0, yes
747263,  furetto, 1, 1, 0, yes
211675763,  Jacopobarberis, 2, 2, 0, yes
631778192,  MarsicoP, 1, 1, 0, yes
595789525,  LSferruzzi, 1, 1, 0, yes
219540465,  thewalkingpepo, 3, 3, 0, yes
451303376,  bigpaul1978, 1, 1, 0, yes
256689270,  fnucera, 6, 6, 0, yes
2503806893,  IInNtGer, 3, 3, 0, yes
611543327,  OrtiMary, 5, 5, 0, yes
1319843784,  StefanoCuda, 1, 1, 0, yes
3353193405,  folgore1939, 2, 1, 1, neutral
425033450,  MassimoCorsaro, 4, 3, 1, yes
1451771017,  im_manente, 2, 1, 1, neutral
51486290,  dferrazza, 10, 10, 0, yes
369585128,  LImpiccione, 2, 2, 0, yes
296717811,  MauroCelestini, 3, 3, 0, yes
1406934528,  salvotrazz, 3, 2, 1, yes
1046985805,  LhostBruno, 4, 4, 0, yes
799223913347747840,  iolovedoerivedo, 3, 3, 0, yes
334750846,  domenicozaccone, 2, 1, 1, neutral
325102968,  LorenzoRossiFlo, 8, 7, 1, yes
631884951,  MariamLivebox, 1, 1, 0, yes
141566267,  robertobella88, 1, 1, 0, yes
1379069714,  caucp81, 1, 1, 0, yes
2494203453,  roc_palmieri, 1, 1, 0, yes
14570287,  LucaTNT, 1, 1, 0, yes
789417368103419904,  lamarylella, 13, 13, 0, yes
3752394153,  strada_melissa, 3, 2, 1, yes
509885417,  rosispes, 1, 1, 0, yes
3130730889,  MarcoMrsch, 1, 1, 0, yes
771702640019402752,  bovina84, 5, 5, 0, yes
397446416,  francesca651, 1, 1, 0, yes
434126218,  JPiccinetti, 2, 1, 1, neutral
778450760,  stormmuifa, 1, 1, 0, yes
726813235782012932,  Pasqiale3, 7, 7, 0, yes
3386338173,  pederismo, 1, 1, 0, yes
804071341867540480,  RoccoSantoro89, 1, 1, 0, yes
1361466631,  cenci_f, 2, 2, 0, yes
2225303307,  emilioarlotta, 1, 1, 0, yes
17544028,  dundacil, 1, 1, 0, yes
3331225373,  DomenicoDeSim14, 4, 4, 0, yes
2479055167,  LaNapolyonica, 5, 5, 0, yes
704319761027612672,  Danyscioea, 2, 1, 1, neutral
2762706833,  RealeClaudio, 5, 3, 2, yes
1283861509,  ScaroneLuca, 10, 6, 4, yes
586401250,  GiuseppeCima, 9, 9, 0, yes
730685457529511936,  pieroebasta, 4, 1, 3, no
3427047832,  DolceRosanna, 3, 3, 0, yes
243402188,  mino1962, 2, 2, 0, yes
505772004,  rikygiorc, 1, 1, 0, yes
376745169,  doctorgren, 2, 1, 1, neutral
59555436,  vladesl, 1, 1, 0, yes
1429999842,  GianniBorsa, 1, 1, 0, yes
299034958,  ALESSANDRONOLI, 1, 1, 0, yes
803635803121324034,  a_corbos, 1, 1, 0, yes
3053267033,  nikoromeo71, 1, 1, 0, yes
792353515884711936,  Lamby_46, 1, 1, 0, yes
77308774,  freebiondo, 2, 2, 0, yes
2394430171,  piero8501, 2, 2, 0, yes
406523890,  FrancyPaolieri, 6, 6, 0, yes
2217238576,  renzettil91, 7, 7, 0, yes
4874825699,  Qing_Lung, 5, 4, 1, yes
307100830,  PerCatania, 7, 7, 0, yes
3040245794,  colly996, 1, 1, 0, yes
1580685588,  carlonichelatti, 2, 2, 0, yes
1314087421,  simona3105, 16, 14, 2, yes
343925514,  luca_biasi, 1, 1, 0, yes
802089998275215361,  Annafra00548276, 3, 3, 0, yes
432471147,  edelweiss_real, 1, 1, 0, yes
786137066514051073,  filomenavizza, 5, 4, 1, yes
503351518,  lucia676, 7, 5, 2, yes
809406648,  LuciLuci78, 3, 3, 0, yes
2853887183,  cekka77, 1, 1, 0, yes
448430045,  Ema_Be, 1, 1, 0, yes
712391983541723137,  Vincenz96063454, 8, 8, 0, yes
744590647223521280,  robertomandani3, 2, 2, 0, yes
3337657533,  Scorazzata, 3, 3, 0, yes
594518368,  bauhouse65, 1, 1, 0, yes
545000238,  lil_nuh, 1, 1, 0, yes
529606550,  marioafrica, 5, 5, 0, yes
629466551,  CPruccoli, 1, 1, 0, yes
1728795780,  padronediopheli, 3, 3, 0, yes
1083726745,  ero856, 10, 6, 4, yes
178078826,  dolcemajie, 1, 1, 0, yes
151956681,  svanzy, 2, 2, 0, yes
4127255831,  immda89, 1, 1, 0, yes
364411935,  renzogalliano, 1, 1, 0, yes
408870593,  IreneMuzzupappa, 1, 1, 0, yes
476933615,  gobbo973, 1, 1, 0, yes
913244311,  fumaca1973, 1, 1, 0, yes
1163888480,  matjiasmenna, 11, 11, 0, yes
3192045783,  CiancioloTony, 3, 3, 0, yes
390868440,  Nikielin, 2, 2, 0, yes
97042350,  lorfran, 1, 1, 0, yes
472264716,  damore_laura, 1, 1, 0, yes
3090856842,  GiulianoAmati, 1, 1, 0, yes
2971298662,  DisteSalvo, 1, 1, 0, yes
703664439044734976,  CarlaAmato6, 2, 2, 0, yes
47746002,  rcravero, 1, 1, 0, yes
488582331,  petruspiero, 4, 4, 0, yes
91206257,  maxdemartini, 1, 1, 0, yes
1345163496,  buccia66, 1, 1, 0, yes
455729797,  rpp_tweet, 14, 13, 1, yes
2722775576,  ECCOMIQUA11, 1, 1, 0, yes
616632747,  leddapl, 1, 1, 0, yes
4308879929,  PD_TSAM, 2, 2, 0, yes
23468822,  lucas_zanotto, 1, 1, 0, yes
528358773,  GMajeli, 1, 1, 0, yes
1854349454,  84Raizen84, 2, 2, 0, yes
1104271206,  ElenaCisarella, 2, 2, 0, yes
212393456,  matteopesenti, 1, 1, 0, yes
138773287,  Laura30Mars, 3, 3, 0, yes
800017894943948800,  georgestweet1, 1, 1, 0, yes
969771096,  laraseramondi, 2, 2, 0, yes
1341499153,  liber_tario, 1, 1, 0, yes
1063798752,  enzoelettro, 1, 1, 0, yes
1722369487,  franconotte, 2, 2, 0, yes
3370931632,  5cceb1b0b2c349d, 2, 2, 0, yes
2438730064,  ase6sj104, 1, 1, 0, yes
234708467,  Ferie80, 1, 1, 0, yes
1898384390,  antonypett, 4, 3, 1, yes
29251859,  evkmusic, 1, 1, 0, yes
941501082,  robgalimberti, 2, 2, 0, yes
13549192,  gavagai, 2, 2, 0, yes
764542387750305792,  MarroFederico, 1, 1, 0, yes
783599386785972224,  padcan19, 2, 2, 0, yes
780303584936202240,  LucianaAntinol1, 1, 1, 0, yes
428422306,  FabyAlias, 2, 1, 1, neutral
803708569325600768,  Paola200056, 1, 1, 0, yes
106542896,  gianluigipiras, 1, 1, 0, yes
515625469,  giannivinello, 3, 3, 0, yes
3039297455,  FPopolano, 1, 1, 0, yes
143462095,  Emiliano_Max, 1, 1, 0, yes
1259939756,  caprara777, 1, 1, 0, yes
829032654,  DantiNicola, 3, 3, 0, yes
1089317964,  RodolfoMirri1, 1, 1, 0, yes
323240531,  saverio_AP, 5, 5, 0, yes
2775400715,  stefanprincipe, 1, 1, 0, yes
515703114,  graziellasorian, 4, 3, 1, yes
593270648,  daniele_coppin, 1, 1, 0, yes
217783935,  agenzia2748, 1, 1, 0, yes
4560988763,  SusyZanne, 1, 1, 0, yes
522615564,  BENVENUTOMACEDO, 2, 1, 1, neutral
2482419258,  levi_eboli, 1, 1, 0, yes
2498198917,  Favale25, 1, 1, 0, yes
1685021330,  NewsandCom, 2, 2, 0, yes
2355211278,  mgmessineo, 1, 1, 0, yes
1975733520,  m87650633, 5, 4, 1, yes
2925130378,  simcaros, 2, 2, 0, yes
397526279,  TommasoMac, 2, 2, 0, yes
2224062058,  rlamantea, 1, 1, 0, yes
2769490962,  Nicolazingaro2, 1, 1, 0, yes
776897408143912960,  LiberiSI_Italia, 3, 3, 0, yes
113902301,  eduardosponda, 2, 2, 0, yes
960574614,  leonardoimpegno, 2, 2, 0, yes
193810402,  TaniuzzaCalabra, 13, 9, 4, yes
3031169168,  BrunoBelvedere1, 1, 1, 0, yes
555056989,  mazzeo_marco, 1, 1, 0, yes
70681443,  DanielTruchet, 1, 1, 0, yes
1675561561,  flwsdare, 1, 1, 0, yes
1468520424,  GhitaVee, 1, 1, 0, yes
255546772,  michelongo77, 2, 2, 0, yes
1089420056,  MrDoom717, 3, 3, 0, yes
765924879531184129,  fasolirenzo1, 1, 1, 0, yes
1938496747,  CADENTELuigi, 7, 7, 0, yes
405858201,  grazgolf, 1, 1, 0, yes
126665874,  silviotomasevic, 1, 1, 0, yes
2867740125,  stefanopapalov, 4, 1, 3, no
2924372112,  ccf_16, 1, 1, 0, yes
401214266,  gerfoglie, 1, 1, 0, yes
722062343673376770,  Auropuggioni, 1, 1, 0, yes
722148199797035008,  Paolo_Modafferi, 1, 1, 0, yes
242659088,  t23121, 1, 1, 0, yes
1275803334,  mauro_mantovan, 1, 1, 0, yes
47442234,  GianlucaRispo, 1, 1, 0, yes
83903656,  varrtina, 1, 1, 0, yes
798225947837288448,  Paolo70240090, 7, 7, 0, yes
1107151848,  PyPina, 1, 1, 0, yes
323505072,  Marcollsn, 1, 1, 0, yes
1008854306,  GiusiCosentino, 1, 1, 0, yes
762706167680397312,  GiuseppeSinito_, 1, 1, 0, yes
2552589025,  famosoantonio1, 1, 1, 0, yes
462024407,  Mezzacla, 2, 2, 0, yes
2876387074,  Alessandro_SBAM, 8, 2, 6, no
434379062,  free6265, 4, 2, 2, neutral
1172545135,  MaferFerri, 3, 3, 0, yes
2866503860,  zagralorenzi1, 1, 1, 0, yes
1345176139,  MichelaSerrenti, 1, 1, 0, yes
701667882149744640,  ZaroneAldo, 2, 2, 0, yes
29412932,  julius70, 1, 1, 0, yes
405595269,  giancosimo64, 1, 1, 0, yes
771530410291363840,  MezutzOzil, 1, 1, 0, yes
437833782,  treluci, 5, 5, 0, yes
1477028552,  CarmineBotta1, 1, 1, 0, yes
899849222,  BXLRENZI, 2, 2, 0, yes
784071937823760384,  LiberiPadani, 1, 1, 0, yes
459601113,  EleonoraQuarta1, 1, 1, 0, yes
2887891006,  Can884, 3, 3, 0, yes
944606934,  roybatty99, 3, 3, 0, yes
1063141806,  germanfranci, 1, 1, 0, yes
696214495543296000,  Carlo2Salzano, 1, 1, 0, yes
2788783275,  LargoLanciani, 1, 1, 0, yes
368769631,  MassimoBaldi1, 1, 1, 0, yes
3065802795,  erlksundelof, 1, 1, 0, yes
2310515650,  RUZSTE, 5, 5, 0, yes
475292830,  viacortona, 1, 1, 0, yes
478825673,  avvcammarata, 1, 1, 0, yes
3063366495,  valeriomologni, 1, 1, 0, yes
785779065617846272,  marco71153510, 14, 10, 4, yes
625161318,  FederGiuseppe, 1, 1, 0, yes
887290825,  DavideLeone44, 1, 1, 0, yes
22013422,  magibe, 4, 4, 0, yes
1622520061,  MoiBalbi, 1, 1, 0, yes
4891674807,  Geronimod77, 3, 3, 0, yes
132233895,  Federico_Pieri, 5, 5, 0, yes
2158619688,  gabriellazilian, 3, 3, 0, yes
385590574,  CSegalen, 1, 1, 0, yes
1524796764,  NMuzzu, 2, 2, 0, yes
261264162,  Juvemiamor, 8, 6, 2, yes
2701881606,  Sherrilyn59, 1, 1, 0, yes
480625889,  alessandrougol, 1, 1, 0, yes
702775260849033216,  marcoma07539625, 4, 4, 0, yes
214418541,  calocannella, 1, 1, 0, yes
2766164451,  sikay2014, 1, 1, 0, yes
776152342425198596,  clara_ticci, 2, 2, 0, yes
22018055,  Alessandro_Oddo, 6, 5, 1, yes
1054518055,  gabrielefumai, 1, 1, 0, yes
727548236710481920,  NoiSalvini, 6, 4, 2, yes
801397532958031872,  EttoreMajoranaa, 9, 4, 5, no
321879271,  PDSaronno, 5, 5, 0, yes
799246755414048768,  gianfrancootta2, 17, 6, 11, no
479909176,  PFM6, 2, 2, 0, yes
2941186311,  r0s1001, 1, 1, 0, yes
417284653,  Scalpomatto, 1, 1, 0, yes
704019337070387200,  Elyfkt, 3, 2, 1, yes
3316108751,  FabioGhironi, 1, 1, 0, yes
80868448,  valeficent_, 2, 2, 0, yes
281534623,  drdany71, 1, 1, 0, yes
104566770,  Imbecilla, 2, 2, 0, yes
258286288,  VESEVIU, 1, 1, 0, yes
2977115987,  ilamauri1, 2, 2, 0, yes
347776169,  francescapaolam, 2, 1, 1, neutral
737358292398317570,  tonino00183, 1, 1, 0, yes
585492287,  biba_55, 1, 1, 0, yes
4737094055,  mpech15, 1, 1, 0, yes
1916723844,  corgen65, 2, 2, 0, yes
1229263142,  DSacerdoti, 1, 1, 0, yes
717746924414181378,  raffpignetti, 2, 2, 0, yes
27882426,  mascety, 3, 3, 0, yes
397565868,  ClaraMartoccia, 1, 1, 0, yes
714011222,  la_gata_lova, 3, 3, 0, yes
964764067,  maraff2, 4, 1, 3, no
2198073307,  AlessandroPom84, 2, 1, 1, neutral
418619389,  e_urzimondo, 1, 1, 0, yes
462379750,  MonicaMalagoni, 2, 2, 0, yes
38223194,  armandofrancia, 2, 2, 0, yes
487396163,  lorenzo_serio, 2, 2, 0, yes
476344106,  Hayden__khalil, 1, 1, 0, yes
724185847050960896,  margarita_vapig, 1, 1, 0, yes
1386907261,  Apo_Lyde_now, 3, 3, 0, yes
403327746,  AALESSIA76, 1, 1, 0, yes
2384935087,  supparaffaele, 1, 1, 0, yes
205694039,  pazzoperrep, 10, 10, 0, yes
428510416,  MassimoMonti10, 1, 1, 0, yes
548950700,  78Cavallo, 2, 2, 0, yes
799959985358864384,  Michele73749780, 1, 1, 0, yes
496910513,  pdnerviquinto, 1, 1, 0, yes
980044394,  TeresaCaon, 2, 2, 0, yes
2395137555,  piracci10, 1, 1, 0, yes
437772319,  figliodannibale, 1, 1, 0, yes
704247911211728896,  macalusopilar, 1, 1, 0, yes
1068491160,  v_verusca, 11, 5, 6, no
4385175135,  Silvi_Lar, 1, 1, 0, yes
1490717322,  BrestStefano, 1, 1, 0, yes
792331078459621376,  tessterry25, 5, 5, 0, yes
488750612,  sottanelli, 1, 1, 0, yes
337187902,  Valter_Ts, 7, 7, 0, yes
403530668,  Tuttoscuola, 3, 3, 0, yes
362084700,  nellomex80, 1, 1, 0, yes
293652330,  FabioLuciano21, 1, 1, 0, yes
1900401260,  242salvatore, 1, 1, 0, yes
386543302,  BeppeDAmbrosio, 1, 1, 0, yes
747517176,  chiaraglam77, 1, 1, 0, yes
514917907,  AugustoSchieppa, 1, 1, 0, yes
2792094531,  hannykis, 3, 2, 1, yes
476294926,  EdwardRedfern, 3, 3, 0, yes
804375705471610881,  il_marxista, 1, 1, 0, yes
417792931,  epivincenzo, 1, 1, 0, yes
2431022396,  Shikerobi, 1, 1, 0, yes
504893071,  CianniAntonio, 1, 1, 0, yes
458826010,  PLAITANOraffy, 1, 1, 0, yes
50259224,  Shabine7, 6, 6, 0, yes
1733662116,  ItalyinMelb, 3, 3, 0, yes
279448213,  docSturchio, 1, 1, 0, yes
477420585,  BiscardiAngelo, 3, 2, 1, yes
625840243,  64ferrari, 1, 1, 0, yes
540717953,  AnastasiaCurcio, 4, 4, 0, yes
3408589414,  AriannaBeninca3, 1, 1, 0, yes
418288322,  ClaudiaeGibo, 1, 1, 0, yes
145596826,  Mike83_asr, 1, 1, 0, yes
1667741250,  _erica_simone, 1, 1, 0, yes
521442128,  Vally_m, 1, 1, 0, yes
22052294,  mynollo, 1, 1, 0, yes
430944569,  NanaRosiana, 1, 1, 0, yes
528865870,  enricoug, 1, 1, 0, yes
2157209369,  MauroVignola1, 1, 1, 0, yes
803876371164499968,  DaniloCrav, 1, 1, 0, yes
3346445038,  aggio_taggio, 2, 2, 0, yes
3428700177,  Gilbert56295109, 1, 1, 0, yes
1334520595,  maura_locantore, 4, 4, 0, yes
4817987205,  Marco96468033, 1, 1, 0, yes
1396678406,  IncoronataG, 2, 2, 0, yes
519407953,  maryEalby, 1, 1, 0, yes
778944190256414720,  demiscopelliti, 5, 3, 2, yes
815187396,  moderatore1989, 1, 1, 0, yes
784744302,  ArteDesign_1985, 3, 3, 0, yes
808787629,  twittakia, 1, 1, 0, yes
2242773811,  natbogo, 1, 1, 0, yes
114008010,  vazoma, 1, 1, 0, yes
2361006903,  MarioOro1, 1, 1, 0, yes
1231986655,  RBonfi, 2, 1, 1, neutral
291022933,  picetes, 2, 2, 0, yes
900076614,  IgnazioCozzoli, 1, 1, 0, yes
1428789079,  mario_felicioni, 1, 1, 0, yes
764067416448073728,  oracolo7, 1, 1, 0, yes
1370493529,  Luigi71Ieno, 1, 1, 0, yes
53374435,  ArmandoCapone, 3, 2, 1, yes
3930502942,  5bdeaa7ecdd741d, 2, 2, 0, yes
25305111,  lucabernardi85, 1, 1, 0, yes
130844890,  f_pasquinelli, 2, 2, 0, yes
202569701,  russolillo79, 1, 1, 0, yes
482829596,  mon_thomas, 4, 3, 1, yes
26286452,  yesterdaysMVP, 1, 1, 0, yes
305236970,  WRicciardi, 3, 3, 0, yes
4025768757,  PetrusApuliae, 2, 1, 1, neutral
3752183374,  renza_rolando, 1, 1, 0, yes
782557051352453120,  adele_nos, 1, 1, 0, yes
2817304093,  sputnik_italia, 3, 3, 0, yes
1890582806,  fracortese, 2, 2, 0, yes
795911679611703297,  TinaTolo02, 1, 1, 0, yes
2404087721,  markopaglia, 1, 1, 0, yes
500548272,  AndreaBalsimell, 1, 1, 0, yes
9234892,  paolodecastro, 1, 1, 0, yes
769593057792651265,  BirbaMire, 2, 1, 1, neutral
416243016,  Vito_Sanitate, 2, 2, 0, yes
419432851,  omnika, 3, 2, 1, yes
1176472178,  viviana56273890, 1, 1, 0, yes
463483195,  VincenzoDellaVa, 2, 2, 0, yes
289866230,  casertace, 1, 1, 0, yes
801055910747586561,  korankarim22, 1, 1, 0, yes
802193363076345856,  20161125bn, 1, 1, 0, yes
738090520866623489,  chiara_villano, 8, 4, 4, neutral
133652275,  Bvzpao, 3, 3, 0, yes
129433502,  Torquemada77, 1, 1, 0, yes
4187739622,  FigiSoda, 1, 1, 0, yes
336952789,  poisonmaf, 1, 1, 0, yes
94300919,  AnnaRomanelli65, 6, 3, 3, neutral
1594210574,  mimmopolito83, 1, 1, 0, yes
786503466604699648,  ToscanaAres, 1, 1, 0, yes
472966889,  ilmanifesto, 10, 9, 1, yes
2951327686,  Marco_N_70, 1, 1, 0, yes
572713059,  pierangelo_63, 1, 1, 0, yes
427268031,  RonnyMazzocchi, 3, 2, 1, yes
479050983,  GiuseppeDiSanzo, 1, 1, 0, yes
472780261,  antoniocasaro, 1, 1, 0, yes
635972473,  martello_antoni, 6, 6, 0, yes
2992011118,  rondelligiulio1, 1, 1, 0, yes
625585624,  GianfrancoChia2, 1, 1, 0, yes
149443381,  yvanlaterza, 2, 2, 0, yes
32434282,  MarkDittli, 1, 1, 0, yes
300709891,  fra_badiali, 1, 1, 0, yes
141555857,  sowadally, 1, 1, 0, yes
733592241663397888,  cosedelmondo, 1, 1, 0, yes
785078541356503040,  GrahamChadrick6, 1, 1, 0, yes
384201277,  AGEFIS_asso, 1, 1, 0, yes
462131304,  SandroDonati10, 1, 1, 0, yes
4278193949,  RO__DAlessandro, 1, 1, 0, yes
2877751768,  corradobordona1, 3, 3, 0, yes
704699840442269696,  GianlucaRizzi8, 1, 1, 0, yes
4376552003,  gabrypastrychef, 1, 1, 0, yes
1608490903,  DonghiMauro, 7, 2, 5, no
1200882961,  marietto85, 5, 2, 3, no
2892569338,  maxbon1953, 1, 1, 0, yes
782312271200522240,  Alessio46238379, 3, 3, 0, yes
2573479167,  genova_guido, 1, 1, 0, yes
788419621426782208,  camurripaolo, 1, 1, 0, yes
486693717,  leonardo_paoli, 1, 1, 0, yes
2300657586,  Joel_S_Beaumont, 1, 1, 0, yes
563989172,  AndreaDagioni, 10, 10, 0, yes
226902916,  daninthesky, 3, 3, 0, yes
175553619,  psycoy, 1, 1, 0, yes
2160962193,  DavideZulia, 1, 1, 0, yes
723957867011837952,  Stefani11328176, 1, 1, 0, yes
237480935,  Borger_911, 1, 1, 0, yes
887103068,  Aurelio_Basile, 1, 1, 0, yes
255220545,  atecheseilunica, 8, 7, 1, yes
2411037432,  Luca29182855, 1, 1, 0, yes
255560499,  marcaia, 1, 1, 0, yes
521437803,  Enrico_Peru, 2, 2, 0, yes
758508568941387778,  MA46932, 1, 1, 0, yes
489662866,  PragFriedhof, 1, 1, 0, yes
183037334,  Cesare_VR, 3, 2, 1, yes
91763958,  Luca_EI, 1, 1, 0, yes
436842525,  EbleoPadua, 1, 1, 0, yes
390228893,  Carpioration, 3, 2, 1, yes
767377143848439808,  _Ballea5stelle, 3, 2, 1, yes
1963222586,  Frank75White, 3, 3, 0, yes
410715437,  PieroAlario, 1, 1, 0, yes
474947789,  GasGalli, 3, 3, 0, yes
2367385878,  AuroraMaccari, 1, 1, 0, yes
142423926,  mr_giani, 1, 1, 0, yes
2360232808,  CarloSardini, 1, 1, 0, yes
795384502734487552,  leopoldino2392, 3, 1, 2, no
2210329063,  coach_kar, 1, 1, 0, yes
4691106229,  Patrizi82656872, 2, 2, 0, yes
30420610,  damianoide, 1, 1, 0, yes
3426419753,  dollyh4ze, 3, 3, 0, yes
756025024717418497,  lorenzocatullo, 4, 4, 0, yes
493367276,  sirio_er, 1, 1, 0, yes
458460908,  MatteoDodi, 7, 5, 2, yes
733755778784497665,  MariaAn79921955, 5, 5, 0, yes
569189279,  heipein, 4, 4, 0, yes
1104311228,  gerino_carla, 2, 2, 0, yes
315766838,  Mariattias, 4, 4, 0, yes
1596075248,  eliboth, 2, 2, 0, yes
995283966,  mzulbi1, 5, 2, 3, no
914681120,  mikeshamash, 1, 1, 0, yes
2400060760,  RobertoBattillo, 1, 1, 0, yes
517293793,  BoccaD, 1, 1, 0, yes
758774171312816128,  carocovarelli, 1, 1, 0, yes
3260857271,  marangoni61, 1, 1, 0, yes
423483578,  MassimoPeporini, 2, 2, 0, yes
780814827279175680,  SVAVarte, 2, 2, 0, yes
442826762,  begigins, 1, 1, 0, yes
94310323,  Phylo13, 1, 1, 0, yes
2475306529,  riccardovincen3, 5, 4, 1, yes
630264862,  zampolladonato, 5, 5, 0, yes
3399782626,  haelyn78, 7, 5, 2, yes
2493287096,  saxybeast_, 1, 1, 0, yes
2846751645,  afrodite2175, 2, 2, 0, yes
2307942183,  BoffredoFabio, 1, 1, 0, yes
68657408,  FraUzsTer, 1, 1, 0, yes
749664710,  GianniMarongiu, 3, 3, 0, yes
1366494049,  bovenzi_f, 1, 1, 0, yes
1209808212,  IlariaDainelli2, 1, 1, 0, yes
3079251951,  pietrogennaro12, 18, 18, 0, yes
549223489,  NicolaiMorawitz, 3, 3, 0, yes
803671772516257793,  lagovernantedi, 1, 1, 0, yes
591941991,  GiulioTieri, 1, 1, 0, yes
765925788029943809,  buonaiuto1996, 1, 1, 0, yes
86494166,  andreavigneri, 1, 1, 0, yes
771821289669533696,  giovb72, 2, 2, 0, yes
1184060185,  APlutino, 1, 1, 0, yes
3245675775,  DelBono_Alfredo, 2, 2, 0, yes
578163085,  premudy, 2, 2, 0, yes
77893023,  francesco_music, 3, 3, 0, yes
4005101235,  SCyranoDB, 2, 2, 0, yes
264673317,  svilupp, 1, 1, 0, yes
986744112,  alemancio96, 3, 3, 0, yes
2916464285,  andzizzo, 2, 2, 0, yes
716640728,  FucciLorenzo, 3, 3, 0, yes
256443028,  eugeniovario, 1, 1, 0, yes
1321204867,  marco_mezza1977, 2, 2, 0, yes
4384882048,  LuisaCavaliere3, 4, 4, 0, yes
1893744416,  ThorinPie, 1, 1, 0, yes
389517594,  lunarossa69, 1, 1, 0, yes
172853293,  elio_calidori, 1, 1, 0, yes
1413539035,  MoscatelliFabio, 1, 1, 0, yes
503022745,  267us, 4, 4, 0, yes
132464028,  Nemb0, 1, 1, 0, yes
2289825608,  POP_sandroboeri, 1, 1, 0, yes
3400017947,  LinoAaaa, 1, 1, 0, yes
803900441075601408,  isag00644061, 1, 1, 0, yes
2259395426,  Soulsurfam, 7, 7, 0, yes
738889466849439748,  Emanuel46201818, 1, 1, 0, yes
23560257,  ValeriaCampello, 2, 2, 0, yes
113884626,  AlviGe, 1, 1, 0, yes
2533819656,  mentalist1959, 2, 2, 0, yes
2620904945,  joja2005, 7, 5, 2, yes
14561447,  spasiba_, 4, 2, 2, neutral
115350671,  antimocaniglia, 1, 1, 0, yes
1055998016,  uicisienaonlus, 2, 2, 0, yes
765583217067974656,  marcidesiderato, 1, 1, 0, yes
477092880,  alezinno, 2, 2, 0, yes
449976315,  PalumboErnesto, 1, 1, 0, yes
323740874,  albertozucconi, 1, 1, 0, yes
1067127176,  marcoo630, 1, 1, 0, yes
512159462,  demafab, 1, 1, 0, yes
482005245,  Nicola90Corradi, 1, 1, 0, yes
603434549,  nico_berardi, 1, 1, 0, yes
25824939,  Andrefra, 5, 5, 0, yes
2814378399,  ambaldassarre, 1, 1, 0, yes
218560212,  acalosso, 2, 2, 0, yes
1873172964,  GioITA2, 4, 3, 1, yes
377926212,  AlbertoBiondi, 1, 1, 0, yes
2457973651,  clava1001, 1, 1, 0, yes
444943220,  MarienDAuria, 2, 2, 0, yes
3227077433,  PDOpenBocconi, 3, 3, 0, yes
2625842403,  danilo_desi, 5, 5, 0, yes
3226575651,  PatriziaMazzon5, 1, 1, 0, yes
880480675,  SchirruLaura, 2, 2, 0, yes
376373625,  Alefr95, 2, 2, 0, yes
798528782172880896,  CrBruno90, 1, 1, 0, yes
384233151,  agenziadentice, 1, 1, 0, yes
2573378881,  grazy__87, 1, 1, 0, yes
2679507545,  GabrieleMammi, 4, 4, 0, yes
13913762,  kylenoel812, 2, 2, 0, yes
2174723477,  medea2480, 1, 1, 0, yes
327862293,  Gerry_1965, 9, 6, 3, yes
2252441148,  SorinPaun3, 1, 1, 0, yes
609374879,  annadei13, 2, 2, 0, yes
997982544,  EmanueleBesi, 8, 4, 4, neutral
346108294,  ninoattinasi, 1, 1, 0, yes
798756052225298432,  Angelo68652348, 1, 1, 0, yes
120588962,  jason05_, 3, 2, 1, yes
1315271774,  ASIACESARE, 1, 1, 0, yes
136006220,  FBuccino, 6, 5, 1, yes
2299157254,  rigoni50, 2, 2, 0, yes
1462623842,  alessiojtraino, 5, 5, 0, yes
1249983648,  NicolaPenza, 1, 1, 0, yes
724906599735812096,  Rositano360gma1, 4, 3, 1, yes
804024349321756672,  Giorgio59181052, 1, 1, 0, yes
786519390779011072,  valdisieve_si, 4, 4, 0, yes
2356696237,  BombBer8078, 1, 1, 0, yes
356353903,  Liceee_, 1, 1, 0, yes
2181992971,  facor71, 1, 1, 0, yes
770989240545120256,  Paolo71360112, 1, 1, 0, yes
46934586,  mauropretolani, 1, 1, 0, yes
419607944,  Mozzarella_DOP, 1, 1, 0, yes
1678352208,  maumanni, 3, 2, 1, yes
332403969,  Sgreji, 2, 2, 0, yes
2464437033,  irwin_laugh, 1, 1, 0, yes
1282958953,  f_calabretta, 1, 1, 0, yes
715581212425850880,  SorrisoCattivo, 1, 1, 0, yes
417994871,  noctara, 1, 1, 0, yes
484968881,  alessandro_1509, 1, 1, 0, yes
3245368049,  Re49745145, 4, 2, 2, neutral
3295022861,  Miciomicione76, 1, 1, 0, yes
3208363431,  A64Arena, 1, 1, 0, yes
925439816,  AlessandroDon15, 1, 1, 0, yes
797457221563121664,  TomassoniEugen1, 1, 1, 0, yes
2676514813,  IreneCartei, 1, 1, 0, yes
2232778082,  ferro_lisa, 1, 1, 0, yes
955313736,  cellini_luca, 4, 3, 1, yes
804063658309517312,  Frances47884531, 2, 2, 0, yes
1063947145,  ThinkFlowSquare, 2, 1, 1, neutral
517802726,  StePerri, 5, 3, 2, yes
567739842,  FatOldSun71, 1, 1, 0, yes
92937715,  Casertasette, 3, 3, 0, yes
567060667,  RossiZaccaria, 1, 1, 0, yes
865892366,  GiusBuscema, 1, 1, 0, yes
751762035050967041,  passione_tv, 1, 1, 0, yes
1224757622,  I_Mercati, 2, 2, 0, yes
531624652,  bojano1, 1, 1, 0, yes
3036958852,  jalebhadevi, 1, 1, 0, yes
108304886,  donatopiccinino, 3, 3, 0, yes
522664131,  giulia_zollo, 1, 1, 0, yes
2173351823,  FChiaversoli, 3, 2, 1, yes
790654235008532480,  ATeramani, 1, 1, 0, yes
377438069,  PatriziaGurian, 1, 1, 0, yes
535359844,  PerottiDiego85, 1, 1, 0, yes
901626432,  PaoloFuschi1, 1, 1, 0, yes
426160683,  dambrosioclaudi, 1, 1, 0, yes
310226600,  enzo_sciarra, 2, 1, 1, neutral
228203275,  dDinoPirri, 2, 2, 0, yes
340149240,  robbyrancido71, 1, 1, 0, yes
2362702303,  Fuscaldofr, 2, 2, 0, yes
3457138463,  efisio97455768, 1, 1, 0, yes
2631454677,  MiciaeMorosito, 1, 1, 0, yes
517797716,  ottaviogentile, 3, 3, 0, yes
2690465089,  lavelli_r, 1, 1, 0, yes
2869618227,  ricifari, 1, 1, 0, yes
146986005,  Poesia2punto0, 1, 1, 0, yes
4872622198,  eremita_franco, 1, 1, 0, yes
15760943,  massideconca, 1, 1, 0, yes
735080318412181504,  ritadue2, 1, 1, 0, yes
585934053,  VinisioDT, 2, 2, 0, yes
788414501049753600,  us_basex, 1, 1, 0, yes
314392100,  rcociancich, 5, 4, 1, yes
356423863,  cemirit73, 1, 1, 0, yes
270418337,  fabrybuh, 6, 4, 2, yes
3294160288,  ClaudioAlibran1, 1, 1, 0, yes
439479080,  SMannapoli, 1, 1, 0, yes
293386882,  Valdecampi, 1, 1, 0, yes
418312648,  FranceValerio, 2, 1, 1, neutral
2743381085,  SSzatti, 5, 5, 0, yes
583125254,  LuisaZuffi, 1, 1, 0, yes
413325906,  Pinodifino, 1, 1, 0, yes
1369173655,  lawetorder, 2, 2, 0, yes
891579169,  ClarkeRuggeri, 1, 1, 0, yes
429780274,  costantinogiov1, 2, 2, 0, yes
1045986391,  RosarioMadejr, 2, 2, 0, yes
759759052981227520,  marguerite_88, 1, 1, 0, yes
771649594509791232,  FTiriolo, 3, 1, 2, no
396835736,  AndreaColavitto, 2, 2, 0, yes
472869908,  veronicaiozzi, 5, 5, 0, yes
397444524,  rinus69, 4, 4, 0, yes
788674443052711936,  TiaSipontina, 1, 1, 0, yes
318294517,  davidsdvd1, 1, 1, 0, yes
16594261,  rileybillups, 1, 1, 0, yes
2921922543,  linusRe74, 3, 3, 0, yes
1369349910,  federicaferro79, 2, 2, 0, yes
2335442976,  rita_stefania, 4, 4, 0, yes
455556244,  danilobianchi4, 3, 3, 0, yes
798255279708274689,  marcoboccardi, 1, 1, 0, yes
60571894,  DQuaggiotto, 1, 1, 0, yes
3795933213,  AleAlf81, 6, 2, 4, no
516709840,  kremasch, 2, 2, 0, yes
1888878594,  sdellamotta, 5, 2, 3, no
38040832,  Lo_Spano, 2, 2, 0, yes
101458782,  neveivan, 1, 1, 0, yes
96454153,  Michelangelo14, 1, 1, 0, yes
54289962,  visalv, 1, 1, 0, yes
1055125351,  NivolaAndrea, 1, 1, 0, yes
547915825,  Silvio_Ascoli, 2, 2, 0, yes
401600711,  An_Coa, 3, 3, 0, yes
222578228,  massisarto, 4, 4, 0, yes
1491372432,  fabgab65, 1, 1, 0, yes
2496656412,  BertuzLuca, 1, 1, 0, yes
167066499,  camillaborn, 1, 1, 0, yes
1130909718,  31Nighthawk, 1, 1, 0, yes
4053087753,  OscuroDino, 1, 1, 0, yes
442012328,  roby79b, 1, 1, 0, yes
106552315,  GianLucaNeddha, 1, 1, 0, yes
3309215673,  089251c4611a4be, 2, 1, 1, neutral
507591413,  guidofumei, 1, 1, 0, yes
474992169,  lbrumont, 1, 1, 0, yes
39809891,  camillacolombo, 1, 1, 0, yes
3416106556,  kemal_can06, 3, 3, 0, yes
2865452456,  Lorenzo_Solari, 2, 2, 0, yes
1598347068,  FabioMeledandri, 3, 2, 1, yes
2363469345,  AlessandraFore9, 1, 1, 0, yes
2509843140,  nickcaccia82, 1, 1, 0, yes
399575489,  princeLove957, 1, 1, 0, yes
483143078,  pity581, 4, 4, 0, yes
325488865,  NicoDones, 2, 2, 0, yes
733001238313373697,  ZanelliFederica, 1, 1, 0, yes
418203531,  patriziaramini1, 2, 2, 0, yes
48834654,  llimantul, 3, 3, 0, yes
3173945848,  robi_rossini, 1, 1, 0, yes
179513167,  Ome85, 1, 1, 0, yes
747118301210349568,  AlikeSapri, 2, 2, 0, yes
730389591140782081,  claupetruzzi, 1, 1, 0, yes
427402721,  bayiskendr, 2, 2, 0, yes
799559721866948608,  SergioLanziere, 1, 1, 0, yes
201180170,  MisterRux, 2, 2, 0, yes
784239264,  stelom82, 1, 1, 0, yes
802515553,  UMarroni, 4, 4, 0, yes
910255969,  MNavarchi, 1, 1, 0, yes
1014815928,  minarompa, 2, 1, 1, neutral
827734921,  eligre, 3, 3, 0, yes
2348168913,  33_saravo, 1, 1, 0, yes
264154603,  youlia83, 1, 1, 0, yes
930443094,  Mr_Torax, 7, 5, 2, yes
256443765,  grg_motta, 2, 2, 0, yes
112413094,  marcofromsicily, 2, 2, 0, yes
41331013,  joancalabuig, 1, 1, 0, yes
520256703,  paolaelisaconte, 5, 2, 3, no
397979358,  JonathanDeCaria, 1, 1, 0, yes
321233623,  potsina, 5, 5, 0, yes
870589680,  PiergiorgioAios, 2, 2, 0, yes
376707743,  matteoalbeggian, 3, 2, 1, yes
512932071,  Cipo_Dani, 10, 1, 9, no
2360523472,  MManfredino, 9, 9, 0, yes
531821962,  skyeltonblues, 4, 3, 1, yes
508848957,  ErreCiVi, 2, 2, 0, yes
1333977013,  FranzaChiara, 1, 1, 0, yes
2394281482,  marcanza79, 2, 2, 0, yes
751505772404674560,  AltieroSergio, 2, 2, 0, yes
4482291975,  MariaAn73204057, 1, 1, 0, yes
177293554,  rikcaso, 1, 1, 0, yes
2887534066,  lenrduzisergio, 1, 1, 0, yes
594705744,  Roxanne_______, 1, 1, 0, yes
554211646,  francor20516993, 1, 1, 0, yes
1198402074,  zelluso74, 6, 5, 1, yes
2517546142,  MarcoRonchi126, 1, 1, 0, yes
210665291,  PaoloValeri, 1, 1, 0, yes
390814833,  davide_digiorgi, 7, 7, 0, yes
701538514219962368,  vclaudio7, 1, 1, 0, yes
1882717945,  Catana1974, 7, 7, 0, yes
453501061,  tomalberini, 1, 1, 0, yes
2492956680,  CarloSxxx78, 2, 1, 1, neutral
23109758,  papsad, 2, 2, 0, yes
338660611,  AntonioDeNardo, 2, 2, 0, yes
2348504302,  Gianfranca81, 1, 1, 0, yes
2193041926,  ilovefazietto, 5, 5, 0, yes
2763523690,  CPecol, 4, 4, 0, yes
415373883,  AntoMakeda, 2, 2, 0, yes
1910621256,  giuseppetuccio, 6, 5, 1, yes
3293781916,  CallionSuzanne, 1, 1, 0, yes
510329104,  Adelinamei, 1, 1, 0, yes
2348629739,  amodeisilvia, 1, 1, 0, yes
288799307,  gilbusti, 1, 1, 0, yes
851801738,  Mapi581, 1, 1, 0, yes
786936358908653568,  CassanodAdda_SI, 3, 3, 0, yes
2254265692,  7Volee, 1, 1, 0, yes
3133784326,  raxilia_r, 3, 2, 1, yes
2460388670,  sirmax84, 1, 1, 0, yes
521152875,  fantinifabrizio, 1, 1, 0, yes
1165385690,  viale66, 1, 1, 0, yes
2835184227,  RL094, 1, 1, 0, yes
390032856,  officer_14, 1, 1, 0, yes
4110960034,  Fly_Wanderlust, 1, 1, 0, yes
129607314,  salvadess, 1, 1, 0, yes
406920424,  ferrarorocco, 4, 4, 0, yes
368770389,  marioloiacono, 1, 1, 0, yes
409286226,  luciocori, 1, 1, 0, yes
1295764892,  enricaraschilla, 1, 1, 0, yes
2474434594,  antoniocardi, 5, 3, 2, yes
473842449,  alfredobazoli, 2, 2, 0, yes
301923545,  ChiccaReds, 2, 1, 1, neutral
440809589,  Lucadavo, 2, 2, 0, yes
9012462,  simitan, 1, 1, 0, yes
717129274789138433,  Luigi83340837, 1, 1, 0, yes
1176925574,  Isabeauqueen, 2, 2, 0, yes
845450934,  AnjaLupfer, 1, 1, 0, yes
3350684301,  mic_fusco, 2, 2, 0, yes
201325441,  Biencin, 1, 1, 0, yes
2734471781,  DideddaMichele, 1, 1, 0, yes
400663633,  andrea_gape, 1, 1, 0, yes
410959301,  SFormicola, 2, 2, 0, yes
938748409,  oriundo74, 1, 1, 0, yes
1650688393,  antoniopaolo5, 2, 2, 0, yes
440202538,  AnnalisaPla, 1, 1, 0, yes
965956884,  DavideCelli1, 4, 2, 2, neutral
95873112,  dom___72, 1, 1, 0, yes
388989529,  g63flower, 1, 1, 0, yes
137303843,  PatrizioL, 2, 2, 0, yes
3346430393,  Italia85816918, 9, 5, 4, yes
801883547724349441,  francml_95, 1, 1, 0, yes
752519305087029248,  nonnoprof, 1, 1, 0, yes
191902258,  patriziopinnaro, 1, 1, 0, yes
176786645,  Spippo64, 2, 2, 0, yes
3436734430,  Elena66V, 2, 2, 0, yes
431416460,  FabrizioBurro, 1, 1, 0, yes
1924748329,  PontiChristian, 3, 1, 2, no
571248360,  LucaLodiLOUD, 3, 3, 0, yes
2692382110,  AgataBoccaccio, 1, 1, 0, yes
481575282,  admcip, 4, 4, 0, yes
434108665,  LeonardoArsen, 1, 1, 0, yes
424447890,  fabio_farinelli, 1, 1, 0, yes
15056379,  Lidalgirl, 1, 1, 0, yes
1655302813,  PrProsperi, 3, 3, 0, yes
105559805,  omicar22, 1, 1, 0, yes
866911332,  473_luca, 4, 3, 1, yes
25872072,  fannycarrier, 1, 1, 0, yes
17272265,  Elsa_Laska, 1, 1, 0, yes
323715534,  Vito_TmD, 6, 3, 3, neutral
3248622305,  photorelict, 1, 1, 0, yes
1561368925,  vixpz, 1, 1, 0, yes
754070712185450496,  corsato_andrea, 1, 1, 0, yes
798875254093447168,  GuidoNapolitan3, 1, 1, 0, yes
159488235,  Michelefanesi, 4, 3, 1, yes
1700240226,  Cesco_Cele, 1, 1, 0, yes
1047367440,  gatto61, 1, 1, 0, yes
548450155,  PakNeroazzurro, 2, 2, 0, yes
767425400175722496,  LuigiVodafon, 1, 1, 0, yes
1390344757,  pmsaccani, 1, 1, 0, yes
428222407,  signorpru, 3, 3, 0, yes
53888674,  pepperobino, 1, 1, 0, yes
1867073203,  Skiti_Valter, 2, 2, 0, yes
484804704,  LUIGIVIMERCATI, 1, 1, 0, yes
151463135,  Beppesanza, 4, 4, 0, yes
54016278,  VictorCahat, 2, 2, 0, yes
2440183745,  RateoC, 4, 4, 0, yes
105509137,  raceforce, 6, 3, 3, neutral
274202080,  mighelalbo, 1, 1, 0, yes
586675940,  annamariaghinas, 5, 4, 1, yes
287793277,  gianlucagiustiz, 1, 1, 0, yes
547500719,  FulviaVentura, 1, 1, 0, yes
114221945,  lorenzosalvador, 1, 1, 0, yes
1452224784,  BeppeAstegiano, 4, 3, 1, yes
283048119,  guybonet, 1, 1, 0, yes
189042220,  MaxFedrizzi, 5, 3, 2, yes
2370099336,  Bea_Serafini1, 1, 1, 0, yes
511638239,  DePeppino47, 1, 1, 0, yes
1083432877,  MeretBaumann, 1, 1, 0, yes
364925203,  StellaTeodonio, 1, 1, 0, yes
75124368,  ascartez, 1, 1, 0, yes
95498838,  elyfav, 1, 1, 0, yes
1039274630,  BeppeZamperetti, 4, 4, 0, yes
2949205359,  santo_gullo, 2, 2, 0, yes
1979495443,  Florionola, 2, 1, 1, neutral
350915658,  A_Osellame, 1, 1, 0, yes
91639261,  SLASHjr84, 1, 1, 0, yes
212967917,  relazionando, 1, 1, 0, yes
757556644234596352,  ualfran_g, 1, 1, 0, yes
745165565342343171,  maicuntent, 2, 2, 0, yes
2214308771,  gaeta_nicola, 5, 2, 3, no
29411886,  AlessiaManca, 6, 2, 4, no
260284812,  maurowave, 1, 1, 0, yes
263630963,  marcelloscurria, 1, 1, 0, yes
122089746,  vinznap, 1, 1, 0, yes
352926719,  Anakoni92, 4, 2, 2, neutral
478985096,  FCovili, 1, 1, 0, yes
178684663,  maurotrapani, 1, 1, 0, yes
1011541518,  erosini81, 1, 1, 0, yes
487041845,  maurizio_tinti, 1, 1, 0, yes
551173848,  AntoMilazzo61, 1, 1, 0, yes
2222069596,  petalo225, 1, 1, 0, yes
1037837432,  ArenaGbar, 1, 1, 0, yes
2423281223,  gianni_prato, 1, 1, 0, yes
738438614124761088,  mick_twitr, 1, 1, 0, yes
4853093967,  PaoloStrazzella, 2, 2, 0, yes
460669878,  Alber2it, 3, 3, 0, yes
2863489435,  verafamiglia, 1, 1, 0, yes
2389082973,  LSerroni, 1, 1, 0, yes
522906124,  cammarata7, 1, 1, 0, yes
53345590,  Amalia1962, 4, 4, 0, yes
3044887245,  utente_ubuntu, 1, 1, 0, yes
4524443609,  ArmandoArdito, 2, 2, 0, yes
797186906064875520,  GiankysBern, 1, 1, 0, yes
1636360536,  jove1908, 3, 3, 0, yes
398345813,  cmoriz, 4, 2, 2, neutral
513535487,  andrea_beardo, 1, 1, 0, yes
4544241749,  lorussocarmela1, 1, 1, 0, yes
1112974033,  Benhur_Gill, 1, 1, 0, yes
711197636553003008,  cristo33_gesu, 1, 1, 0, yes
50689313,  TizianaFerrario, 1, 1, 0, yes
3608513603,  saravalentini_, 1, 1, 0, yes
579677765,  Chancione, 2, 1, 1, neutral
749307262955614208,  Patrizi25321307, 1, 1, 0, yes
1062533047,  giannielia2, 1, 1, 0, yes
4829453499,  BarbaraPicciri4, 1, 1, 0, yes
83072323,  giuseppelore, 5, 5, 0, yes
398050252,  pezzoliivano, 1, 1, 0, yes
2461911077,  formis81, 1, 1, 0, yes
448170908,  joelansdale1, 5, 4, 1, yes
725601025831395328,  ilSignorGi, 1, 1, 0, yes
2180427250,  robydigi, 10, 2, 8, no
793826143,  PaoloMercuri77, 1, 1, 0, yes
804213653075558400,  daniel_gibiino, 1, 1, 0, yes
7722172,  botolo86, 5, 4, 1, yes
2856165242,  iii_prad33p, 1, 1, 0, yes
336447434,  pellikan71, 1, 1, 0, yes
1143351211,  fede_mh, 3, 3, 0, yes
366066995,  gaebia, 1, 1, 0, yes
767382137678987264,  ilMarcoC, 1, 1, 0, yes
3101800545,  littlerick63, 2, 1, 1, neutral
4707564705,  Giova46766543, 1, 1, 0, yes
452281866,  mind_the_gasp, 2, 2, 0, yes
371409870,  apalagiano, 1, 1, 0, yes
405685047,  PietroGLaRosa, 2, 2, 0, yes
385847046,  Clemente_DiDato, 2, 2, 0, yes
486653074,  benedettamaini, 3, 2, 1, yes
710238049213550593,  apulderico, 2, 2, 0, yes
2335228303,  BobboMirco, 1, 1, 0, yes
811792008,  MariaRitaFranc4, 1, 1, 0, yes
65773162,  ZeroTredici, 2, 1, 1, neutral
392005261,  poldiuberalles, 2, 2, 0, yes
384301504,  paolo_mesto, 4, 4, 0, yes
1359943117,  ale_ramondetti, 1, 1, 0, yes
363160035,  DiegoCassetti, 9, 2, 7, no
2367227585,  Valeria26422122, 1, 1, 0, yes
1150698020,  claudioale2011, 2, 2, 0, yes
103272004,  EldaMartone, 2, 2, 0, yes
3488504303,  frankrosini, 8, 2, 6, no
365537396,  fiffoofficial, 1, 1, 0, yes
412522858,  NoveErBove, 1, 1, 0, yes
2382986236,  NicoliniTitta, 1, 1, 0, yes
77304182,  papanonn, 1, 1, 0, yes
165756513,  ferro931, 5, 4, 1, yes
535498042,  cavelante, 1, 1, 0, yes
1068098070,  vicoloamato, 1, 1, 0, yes
760178360442036225,  Emigallo1Gallo, 2, 2, 0, yes
31713757,  Fede__Messina, 1, 1, 0, yes
991768927,  TiberioVibert, 5, 4, 1, yes
138052071,  aldo_perotti, 2, 2, 0, yes
105259719,  peppedellaquila, 4, 4, 0, yes
122778931,  cristinaenne, 4, 4, 0, yes
400750207,  sirionn, 2, 2, 0, yes
78078844,  francy_81, 1, 1, 0, yes
160496617,  donniedarko1039, 1, 1, 0, yes
420198701,  MaBerengan, 1, 1, 0, yes
449619945,  io_nonesisto, 8, 7, 1, yes
2906271375,  studioianni2012, 3, 3, 0, yes
1280190198,  alnferrari, 5, 5, 0, yes
46424280,  LorenzoMosna, 2, 1, 1, neutral
3338443151,  e780163d17dd4cf, 1, 1, 0, yes
801524815282769920,  marcovetropa, 1, 1, 0, yes
800273738805583872,  malatestacesare, 1, 1, 0, yes
27632226,  brunolovesbrit, 1, 1, 0, yes
2846105403,  MsilvioM, 1, 1, 0, yes
1616125219,  MaremmaGolf, 1, 1, 0, yes
795743491137695745,  Antony66064466, 2, 2, 0, yes
2869467525,  Ferru48, 1, 1, 0, yes
166623495,  frenz_70, 1, 1, 0, yes
724373012124938240,  giuseppep744, 1, 1, 0, yes
2891328287,  aripicci73, 1, 1, 0, yes
2165797386,  juliebabyar, 2, 2, 0, yes
33257450,  artafrica, 1, 1, 0, yes
3065796675,  UCIIntiCenter, 1, 1, 0, yes
3017874879,  cusinatomauriz1, 5, 5, 0, yes
3250755929,  nicolatedesco21, 5, 5, 0, yes
433473950,  DavideCesariLeo, 6, 5, 1, yes
1915200546,  SorialGiorgio, 1, 1, 0, yes
353610180,  Pablodesarasate, 1, 1, 0, yes
461438695,  luigilaudicino, 2, 1, 1, neutral
3028867078,  silviabichon, 1, 1, 0, yes
10686632,  Nartano, 9, 8, 1, yes
757279526,  AndreaCero95, 2, 2, 0, yes
739017070944395264,  Miry97854425, 1, 1, 0, yes
3422522277,  RenzoOgliaro, 1, 1, 0, yes
1978670191,  amortentja, 1, 1, 0, yes
334071453,  CameraMauro, 2, 2, 0, yes
610908085,  LoryCatrin, 1, 1, 0, yes
723239801193926656,  clarubatto, 1, 1, 0, yes
260464075,  gabriele_penati, 1, 1, 0, yes
2185435235,  BorsariLorena, 3, 3, 0, yes
1495618316,  mimmorem, 3, 2, 1, yes
9862602,  ceccoangiolo, 1, 1, 0, yes
4134928156,  MARIP1978, 1, 1, 0, yes
2539709073,  FranchellaMauro, 1, 1, 0, yes
3357094834,  AnnalisaTuri, 1, 1, 0, yes
52367440,  Fiorentinanews, 1, 1, 0, yes
3068603681,  L_L_FERRI, 1, 1, 0, yes
797847675999756288,  Quinto07795933, 1, 1, 0, yes
529626160,  albertolabrado1, 2, 2, 0, yes
973961406,  UgoTerzo, 1, 1, 0, yes
772527454481223680,  Rolandopompili1, 1, 1, 0, yes
15015396,  gerdavax, 1, 1, 0, yes
2618347693,  devonosoffrire, 1, 1, 0, yes
387042070,  fmicelotta, 1, 1, 0, yes
2871466162,  MauroGaudino, 1, 1, 0, yes
2855366680,  MarcoOrsini68, 1, 1, 0, yes
416588407,  faustodeiesu, 1, 1, 0, yes
2364479547,  FilippoMariaGra, 3, 3, 0, yes
1018179343,  GianniSantoro5, 1, 1, 0, yes
69009732,  enricopetro, 1, 1, 0, yes
429749287,  GiankaBar, 1, 1, 0, yes
795583068996255744,  si_lecce, 2, 2, 0, yes
2219209768,  fabionatale77, 1, 1, 0, yes
266667380,  dadal75, 1, 1, 0, yes
1346272327,  papagiulio2, 3, 3, 0, yes
782557250728656897,  cesare64252141, 2, 2, 0, yes
137791432,  ormuz23, 3, 3, 0, yes
797354121900781568,  Alessan26633690, 1, 1, 0, yes
506579724,  CostantinoLico, 1, 1, 0, yes
3977573897,  vitatrentina26, 2, 2, 0, yes
1037877168,  albertoriki, 1, 1, 0, yes
132665876,  alexandro1964, 1, 1, 0, yes
2427099170,  EUmoocs, 1, 1, 0, yes
216329365,  sese4982, 1, 1, 0, yes
928297514,  _albos_, 4, 4, 0, yes
1034769188,  Go73Oriana, 1, 1, 0, yes
4134002751,  Riccardo_thenex, 1, 1, 0, yes
1176775316,  ciposnow, 2, 1, 1, neutral
2423236055,  g_defeo, 5, 5, 0, yes
2494167582,  LiCauli, 1, 1, 0, yes
794590661714604032,  radicaliberi, 1, 1, 0, yes
481607457,  sgaliena, 1, 1, 0, yes
752115771174686720,  kwametb80, 1, 1, 0, yes
410284875,  lucidada, 2, 1, 1, neutral
718853934291546112,  LuciaRuffoni, 1, 1, 0, yes
727569808540225537,  relaona, 1, 1, 0, yes
713145420,  maumazzantini, 2, 2, 0, yes
330577430,  Martissima85, 1, 1, 0, yes
364750418,  Albus961, 1, 1, 0, yes
1273496268,  SalvatoreChime, 6, 6, 0, yes
393981611,  gianpierozampal, 6, 5, 1, yes
870290785,  LinkBari, 1, 1, 0, yes
952400288,  rosatisilvia, 2, 2, 0, yes
892942010,  mtmimmo, 1, 1, 0, yes
149944913,  messina1956, 1, 1, 0, yes
2997687555,  tiganisandro, 2, 2, 0, yes
3165797395,  gabritoffoletti, 1, 1, 0, yes
2581669887,  deianaangelo52, 1, 1, 0, yes
279996303,  francescoerrani, 1, 1, 0, yes
1042150843,  bisio_erica, 1, 1, 0, yes
1093092662,  FraBonomo, 1, 1, 0, yes
3926557947,  Roberto62Zago, 1, 1, 0, yes
721321945225162752,  cicciobello1968, 1, 1, 0, yes
431471830,  giacomomelodia, 1, 1, 0, yes
932396101,  MariniEliane, 3, 3, 0, yes
3922410442,  AugustoTarani, 2, 2, 0, yes
534669109,  CBisogniero, 4, 4, 0, yes
440826435,  antotdriver, 1, 1, 0, yes
281957028,  laurarudy686, 1, 1, 0, yes
2436476639,  Abdullah__van, 1, 1, 0, yes
2480231230,  STARS__Reppin, 1, 1, 0, yes
3065293335,  1WorkerRights, 1, 1, 0, yes
772044030007992321,  agocalcagno71, 1, 1, 0, yes
2482753367,  Xyphine__Doll, 1, 1, 0, yes
108447810,  alemilan86, 1, 1, 0, yes
880912130,  caledfwylch, 1, 1, 0, yes
490490446,  Ely_Fede, 2, 2, 0, yes
66672821,  endiomed, 1, 1, 0, yes
771343689662795776,  AlessandroNuti4, 1, 1, 0, yes
490438110,  pardini_ale, 1, 1, 0, yes
1339566332,  alliekenneynyc, 1, 1, 0, yes
88782615,  Elio_Caldora, 2, 2, 0, yes
4826632497,  IPierang, 1, 1, 0, yes
3120975586,  BonvFab, 1, 1, 0, yes
2406904744,  PzagniZagni, 1, 1, 0, yes
779798718455377920,  rossella195686, 1, 1, 0, yes
172679085,  debiasium, 4, 4, 0, yes
3046386205,  bassma__falahi, 1, 1, 0, yes
2486870561,  DejaaM0rgs, 1, 1, 0, yes
270242796,  bagonzbart62, 1, 1, 0, yes
2450054256,  massage__envy, 1, 1, 0, yes
480526600,  Ela63M, 1, 1, 0, yes
367137042,  FGuidolin, 1, 1, 0, yes
2481514407,  mhizzcute2, 1, 1, 0, yes
785232470149046272,  GiulioBaldolini, 1, 1, 0, yes
4804439175,  KarimFranceschi, 1, 1, 0, yes
802885117857431552,  Annamaria62ale, 1, 1, 0, yes
733949610,  AshleyCiampi, 1, 1, 0, yes
214558009,  ivanolongh, 1, 1, 0, yes
714554670375677959,  CSMsince1899, 1, 1, 0, yes
2994467687,  catalano_noemi_, 1, 1, 0, yes
1372335043,  ritapaola17, 2, 2, 0, yes
4885275489,  dogs_logic, 1, 1, 0, yes
705902091793883136,  lawbarrett55, 1, 1, 0, yes
2050601,  DanieleVatta, 1, 1, 0, yes
132194086,  viverefermo, 2, 2, 0, yes
717033742947233792,  carmen27542, 7, 7, 0, yes
1691392106,  sergiofiocchi1, 1, 1, 0, yes
3966584425,  C967Valerio, 1, 1, 0, yes
229783431,  MEPoss, 8, 8, 0, yes
507066425,  robfreddy, 3, 1, 2, no
390878676,  vasiento, 1, 1, 0, yes
1454186066,  RiccardoDelzo, 1, 1, 0, yes
779236559908442112,  natolibero68, 9, 4, 5, no
2232011448,  Veruska_79, 1, 1, 0, yes
458618399,  MarcoPisani91, 1, 1, 0, yes
2182818134,  MONIK321, 1, 1, 0, yes
391936079,  ciccio_cvl, 5, 5, 0, yes
431810750,  kleinestoda, 1, 1, 0, yes
800778423450730497,  giuseppetag969, 1, 1, 0, yes
329047789,  keroglee, 1, 1, 0, yes
742703335,  G_Casaletto, 2, 2, 0, yes
2524372471,  PinoLuci, 1, 1, 0, yes
33451984,  jorgersimao, 1, 1, 0, yes
804256689260298241,  VivG79, 1, 1, 0, yes
436711245,  AlSpadaro, 1, 1, 0, yes
50616952,  antonello179, 1, 1, 0, yes
2328811540,  TomManara, 1, 1, 0, yes
3005727892,  Alessia_Bettini, 6, 6, 0, yes
803583904376569856,  andreagrillese, 2, 2, 0, yes
95891990,  marcepittella, 4, 4, 0, yes
2448044848,  signoraminu53, 2, 2, 0, yes
265011025,  fabriziosannico, 1, 1, 0, yes
798204913297883136,  giangi67258434, 2, 2, 0, yes
4456357995,  MaxKarma3, 1, 1, 0, yes
504734866,  giorgiostracqu2, 1, 1, 0, yes
2759114062,  man_krip, 5, 5, 0, yes
3910018822,  ssow3264, 1, 1, 0, yes
1692197918,  Francesca_M_V, 1, 1, 0, yes
803045655270793219,  FrancoDaverio, 2, 2, 0, yes
804461614795816960,  blaznewslegdne1, 1, 1, 0, yes
326774832,  albemutti, 8, 4, 4, neutral
28876399,  Pussy_Veronique, 1, 1, 0, yes
4899540190,  SerenaPerrone1, 2, 2, 0, yes
549258092,  Andreacafaro98, 2, 2, 0, yes
409066494,  nunziome, 1, 1, 0, yes
429026802,  RBaccelliere, 4, 3, 1, yes
404069171,  M_Rachele, 4, 4, 0, yes
1031176249,  DarioSantoro8, 2, 2, 0, yes
779719795675717633,  AldOne10011959, 1, 1, 0, yes
490545089,  micheleperuzzi, 1, 1, 0, yes
22614847,  aidanosullivan, 1, 1, 0, yes
45558248,  Ebic960, 1, 1, 0, yes
2597970638,  Nic_libertella, 2, 2, 0, yes
478607229,  FrancescoGent16, 14, 8, 6, yes
156445152,  gianluca_budano, 3, 3, 0, yes
977005526,  r_stevanato, 1, 1, 0, yes
628186961,  elisagam, 7, 4, 3, yes
1205237797,  armi56, 1, 1, 0, yes
553317766,  FulvioTatini, 3, 3, 0, yes
552183139,  Gioggy29, 2, 2, 0, yes
3055057510,  miriamferretti1, 3, 3, 0, yes
708570614190252033,  NitroNigel77, 2, 2, 0, yes
338231881,  Vince_Scavello, 1, 1, 0, yes
602038473,  055firenze, 1, 1, 0, yes
3230736075,  GaleoneDino, 3, 3, 0, yes
2862877348,  fluID70, 5, 4, 1, yes
18176150,  vacacafe, 1, 1, 0, yes
871666933,  PontaniSerena, 4, 4, 0, yes
17164027,  maXPlat, 1, 1, 0, yes
1931840917,  TullioCasadei, 2, 2, 0, yes
572098257,  SaverioCanonico, 1, 1, 0, yes
422562567,  ToninoCastaldo, 1, 1, 0, yes
444061344,  PasqualeChiuso, 2, 2, 0, yes
27436503,  iggyHT, 7, 7, 0, yes
2491997012,  Muller_Holk, 2, 1, 1, neutral
531327471,  tedeschiantoni1, 1, 1, 0, yes
800021935,  UrbaniNoemi, 7, 1, 6, no
2891325731,  MarinaReverberi, 1, 1, 0, yes
750399735626928128,  rgblix, 1, 1, 0, yes
1387377014,  PaolaVenanzi, 1, 1, 0, yes
138922382,  Damseisette, 4, 4, 0, yes
11378152,  castaldipaolo, 1, 1, 0, yes
4898337471,  DanAslan90, 2, 2, 0, yes
2459691055,  MargherCB2, 1, 1, 0, yes
69947093,  IngoDejaco, 1, 1, 0, yes
263898903,  gemmabiagiotti, 1, 1, 0, yes
1474220623,  Michelangelotst, 7, 4, 3, yes
726477726039814144,  roventini1972, 1, 1, 0, yes
391965620,  PiccoliLorenzo, 1, 1, 0, yes
469666813,  mauraverra, 1, 1, 0, yes
4898648187,  margheritachim, 15, 15, 0, yes
528216670,  FilippoAttili, 5, 5, 0, yes
486470778,  francodamiano1, 3, 2, 1, yes
469218793,  tico_palabra, 1, 1, 0, yes
2446530796,  lupaceleste, 1, 1, 0, yes
3346675893,  Red_Blue90, 1, 1, 0, yes
115175546,  brutasguangia64, 3, 3, 0, yes
3130674241,  MalucchiSilvia, 1, 1, 0, yes
2834174511,  raffa953, 1, 1, 0, yes
251059714,  maurizio6, 2, 1, 1, neutral
377274712,  cavapeppe, 2, 2, 0, yes
2198251743,  longobardimauro, 4, 3, 1, yes
345250157,  giovannilizzi, 1, 1, 0, yes
2527090033,  GiacomoFassina, 1, 1, 0, yes
1288483735,  abbocc_rn, 7, 4, 3, yes
707727883,  captain_europe, 1, 1, 0, yes
585526923,  lauracrescenzo, 2, 2, 0, yes
54833190,  piggi79, 1, 1, 0, yes
789417338433142784,  p_peretta, 3, 3, 0, yes
725273262519902208,  AlastairMacIver, 1, 1, 0, yes
518478147,  federicougo, 2, 2, 0, yes
964636567,  benedetta_09, 1, 1, 0, yes
62334247,  zurobets, 10, 10, 0, yes
789735337664839680,  MatteoPapiani, 1, 1, 0, yes
87491338,  jrteruel, 1, 1, 0, yes
3349757049,  _liquidmind, 1, 1, 0, yes
3090706071,  CarmenGalgano, 1, 1, 0, yes
430588633,  garyy646, 1, 1, 0, yes
794136385,  nmonesi, 5, 5, 0, yes
1347495193,  chietatiana, 1, 1, 0, yes
2741298700,  francescoliuz14, 2, 2, 0, yes
107175960,  asky1977, 4, 3, 1, yes
477922867,  Corgna, 2, 2, 0, yes
2331936378,  KrapulaPhD, 2, 2, 0, yes
2740139597,  ste010970, 7, 5, 2, yes
2336820800,  mnlfarmacisti, 3, 3, 0, yes
1960029780,  marcochiadorana, 1, 1, 0, yes
2351724810,  PAOLOCOTIGNOLI, 1, 1, 0, yes
769569035533025280,  srkevinnunez, 1, 1, 0, yes
4420194503,  1eea6fcc407c426, 2, 2, 0, yes
756587459312517120,  mauroandrea58, 8, 8, 0, yes
2890739260,  PeppePilla, 1, 1, 0, yes
181171727,  milena131168, 3, 3, 0, yes
8873182,  byoblu, 2, 2, 0, yes
4875148079,  mario99511336, 3, 1, 2, no
1551547838,  AlbaChiara_77, 1, 1, 0, yes
14287542,  Bonnie_Reloaded, 1, 1, 0, yes
3211651612,  miodona4, 1, 1, 0, yes
294161837,  fabrifoxy, 1, 1, 0, yes
262195345,  mamuzzina, 1, 1, 0, yes
416516232,  fnapoli_org, 1, 1, 0, yes
419404365,  FabriLuffarelli, 2, 2, 0, yes
403350392,  Userfirst_eu, 1, 1, 0, yes
608420247,  marisaviti, 10, 8, 2, yes
981465396,  DolceScorbutica, 1, 1, 0, yes
2357602941,  ant_boemio, 1, 1, 0, yes
705395674213441536,  RosangelaDellon, 3, 3, 0, yes
2831682317,  colonnello16, 2, 2, 0, yes
482958648,  antonello161, 4, 3, 1, yes
782820304854933504,  Yuripinx, 2, 1, 1, neutral
1135256400,  AVita1954, 2, 2, 0, yes
803962307474849794,  RccrdCntn, 1, 1, 0, yes
718710455250853888,  Carmelo26141734, 1, 1, 0, yes
61877999,  pietroraffa, 1, 1, 0, yes
538872389,  ChiaraViscusi, 1, 1, 0, yes
1339161012,  LucioGallina, 1, 1, 0, yes
580133799,  gaetanoconsagra, 2, 2, 0, yes
1301115739,  grecocor, 2, 2, 0, yes
804604604143038464,  RuffinengoG, 2, 2, 0, yes
2843581449,  angelo80biscot1, 6, 5, 1, yes
231724256,  gixxxerk7, 1, 1, 0, yes
1657888950,  SabriCapozzolo, 3, 3, 0, yes
951306680,  RivieccioNicola, 1, 1, 0, yes
712378228678258688,  Lucy_Barbagallo, 3, 3, 0, yes
437527197,  Grunger80, 1, 1, 0, yes
2310048524,  angelobachis, 1, 1, 0, yes
3555274821,  AssiZevio, 2, 2, 0, yes
801142630168010752,  nicola_moressa, 1, 1, 0, yes
2960938695,  filcap76, 3, 1, 2, no
384433392,  BruxeLollo, 6, 6, 0, yes
3502446675,  OGottardi, 1, 1, 0, yes
91677868,  giacomoalpago, 1, 1, 0, yes
1032768960,  giovanni_morici, 1, 1, 0, yes
827573690,  MarinellaLelli, 2, 2, 0, yes
2768281341,  LGordiani, 1, 1, 0, yes
210007161,  leonidafem, 2, 2, 0, yes
91585950,  intermarketblog, 8, 8, 0, yes
353921058,  MaurizioGamberi, 3, 3, 0, yes
3193132799,  fravolo76, 3, 3, 0, yes
2755953768,  andreadetata, 1, 1, 0, yes
1255359818,  MinVeritas, 1, 1, 0, yes
627684503,  AlbertoRosa22, 1, 1, 0, yes
779949607,  BacchiBac, 2, 2, 0, yes
1073989142,  il_londinese, 1, 1, 0, yes
299321848,  spartanbc80, 3, 3, 0, yes
2896493224,  Cris_Tina22, 2, 2, 0, yes
311545336,  giacomococchi, 2, 2, 0, yes
99522784,  LorenzoBombara, 1, 1, 0, yes
269935838,  marco10ero, 2, 2, 0, yes
130624381,  JHeywood89, 1, 1, 0, yes
807552572,  andreabanchelli, 3, 2, 1, yes
635779806,  simonebarni78, 1, 1, 0, yes
306272532,  cristinasalmena, 4, 4, 0, yes
105511487,  FLuccisano, 4, 4, 0, yes
17647246,  Zebbolo, 6, 5, 1, yes
548701342,  purpledreamer71, 2, 1, 1, neutral
130930180,  roccoilaria, 1, 1, 0, yes
607037928,  PaoloPala_, 1, 1, 0, yes
425743569,  andrea_vitolo, 1, 1, 0, yes
122025999,  fiamma1990, 3, 3, 0, yes
393385466,  ValeriaRondena, 2, 2, 0, yes
331136295,  GlobalProgresMB, 1, 1, 0, yes
411789902,  Rofuoco, 4, 4, 0, yes
5847962,  ciropellegrino, 3, 2, 1, yes
560127853,  1974Anto, 4, 3, 1, yes
1384301958,  rockpolitics, 12, 11, 1, yes
3175896388,  AlemuS_ROCK2016, 4, 4, 0, yes
722400848,  gbuttironi89, 1, 1, 0, yes
295340364,  ascattone, 8, 4, 4, neutral
434152729,  FedeMalagoni, 2, 2, 0, yes
1625746267,  davidbusato, 1, 1, 0, yes
442869239,  donarjan77, 2, 2, 0, yes
32492443,  retlaw_ivert, 1, 1, 0, yes
2242233450,  fmachille, 2, 2, 0, yes
484754066,  EloisaMore, 1, 1, 0, yes
1912387975,  pier_rosini, 2, 2, 0, yes
426472202,  ovgu_pinar, 1, 1, 0, yes
408589249,  ale_di_matteo, 2, 2, 0, yes
123274082,  Wilbacher, 1, 1, 0, yes
35420133,  JPellicano, 1, 1, 0, yes
416433824,  guidostaffieri, 4, 4, 0, yes
433509729,  natixym, 1, 1, 0, yes
813486253,  LPavoncello, 1, 1, 0, yes
182915556,  davideRdV, 2, 1, 1, neutral
14158218,  albertourgu, 1, 1, 0, yes
708797206493581312,  giramondo57, 1, 1, 0, yes
178426415,  gaearmao, 1, 1, 0, yes
873601818,  SilviaPispico, 1, 1, 0, yes
14097053,  catalanog, 1, 1, 0, yes
61905153,  marcodonats, 6, 6, 0, yes
171941344,  gispedicato, 3, 3, 0, yes
712214882859532289,  AntoniettaCarm3, 2, 2, 0, yes
2416164429,  RobJrSilveri, 4, 2, 2, neutral
502736412,  diego_martinisi, 1, 1, 0, yes
2753920042,  BellonSimone, 3, 3, 0, yes
444094538,  AstridMune, 16, 11, 5, yes
522410382,  FSottili, 1, 1, 0, yes
80403663,  PavlinaAmalie, 1, 1, 0, yes
2380839169,  tinagoTV, 1, 1, 0, yes
132891478,  bibibertoni, 2, 2, 0, yes
255482588,  CinziaPasquini, 2, 2, 0, yes
280822435,  unodelosBuendia, 1, 1, 0, yes
177333841,  amnesia1973, 1, 1, 0, yes
1395271422,  mttgsp, 1, 1, 0, yes
410685770,  guerdaniel, 2, 2, 0, yes
225941303,  iRobydl, 2, 2, 0, yes
314440375,  BenettiLuisa, 3, 3, 0, yes
1086411373,  frankmaugeri, 2, 2, 0, yes
2353694533,  RicardoConceiRR, 1, 1, 0, yes
358900883,  GiuseppePeppon1, 2, 2, 0, yes
380852967,  martinacecchide, 1, 1, 0, yes
1081274514,  AleBru73, 1, 1, 0, yes
413092209,  HerberMax, 2, 2, 0, yes
2379982425,  MausartMs, 4, 4, 0, yes
122738127,  weightofawar, 1, 1, 0, yes
552985612,  hasDarkHorse, 5, 4, 1, yes
499071250,  giottonove, 1, 1, 0, yes
303729690,  SalvoGambuzza, 1, 1, 0, yes
3262065807,  CFri55, 2, 2, 0, yes
51793633,  vietinas, 4, 4, 0, yes
381837893,  alessiolepri, 1, 1, 0, yes
2151672697,  ilronziodellape, 2, 1, 1, neutral
255616151,  ReinoutBosman, 1, 1, 0, yes
357663897,  micdal74, 2, 2, 0, yes
944588666,  360Giornale, 4, 3, 1, yes
22168956,  andreavreede, 1, 1, 0, yes
4141896917,  Fbecce59, 2, 2, 0, yes
524727784,  ClaraVarano, 1, 1, 0, yes
2270243846,  __BeeKeeper__, 2, 2, 0, yes
144204953,  _emmegi, 2, 2, 0, yes
68638274,  antomagro, 2, 2, 0, yes
77717510,  michelas_, 2, 2, 0, yes
805547798020100096,  dicook85, 2, 2, 0, yes
499020672,  Sam_f90, 3, 3, 0, yes
286215205,  scaprioli75, 1, 1, 0, yes
67277783,  footymac, 1, 1, 0, yes
1201149241,  raoulbar, 2, 2, 0, yes
26319569,  madforfree, 15, 14, 1, yes
407810895,  zafesova, 2, 2, 0, yes
135541896,  antogorrasi, 2, 2, 0, yes
1159817323,  Divino_2, 2, 2, 0, yes
342637843,  J_MartinezRubio, 1, 1, 0, yes
450121688,  AnnalisaPiccol1, 4, 4, 0, yes
118425061,  GiordanCorrenti, 2, 2, 0, yes
2508691499,  Ferrero71Guido, 2, 2, 0, yes
600280086,  KathZing, 2, 2, 0, yes
246547123,  marco7511, 7, 6, 1, yes
19680237,  jprat, 7, 6, 1, yes
1405967683,  MatBald, 1, 1, 0, yes
510450172,  QdiCuori2012, 3, 2, 1, yes
496394048,  TeresaBatista86, 1, 1, 0, yes
2462089650,  FiorenzoSorba, 1, 1, 0, yes
1269794072,  Nodoistda, 1, 1, 0, yes
830732730,  gaglianogiorgio, 1, 1, 0, yes
396794954,  Dige85, 5, 5, 0, yes
284029698,  sandropetrecca, 1, 1, 0, yes
216326779,  dbonf, 6, 6, 0, yes
433246317,  Orietta396, 11, 10, 1, yes
70444875,  GGiammatteo, 1, 1, 0, yes
435032307,  LucaGiovagnoni, 1, 1, 0, yes
336007986,  giopank, 1, 1, 0, yes
754699206263238656,  giudittaclerici, 2, 2, 0, yes
381912031,  cat2179, 1, 1, 0, yes
44742853,  PieroSignani, 5, 3, 2, yes
109593777,  antonellaser, 1, 1, 0, yes
51061269,  fromanss, 4, 4, 0, yes
3048860115,  mattiarossi98, 2, 2, 0, yes
82074657,  Charlievdk, 1, 1, 0, yes
2477352612,  cirosaltarelli, 1, 1, 0, yes
114503431,  GiosyB, 2, 2, 0, yes
4052097376,  monti_anton, 1, 1, 0, yes
2173312541,  motikat, 1, 1, 0, yes
48527937,  zikitibu, 1, 1, 0, yes
14291795,  karinaasb, 1, 1, 0, yes
3568519397,  er_td4, 1, 1, 0, yes
37776787,  karinavoets, 1, 1, 0, yes
2559355769,  gdinolfo25, 5, 1, 4, no
748767565996957696,  biancareichelt1, 1, 1, 0, yes
798871038,  AlbertoZacheo, 10, 9, 1, yes
4845798017,  ThinkingAboutEU, 1, 1, 0, yes
2301697382,  MCGrimaldi, 3, 3, 0, yes
3862475835,  marialves53, 1, 1, 0, yes
300925744,  casajuntoalrio, 1, 1, 0, yes
634816166,  mattcresci, 1, 1, 0, yes
1193072802,  liola08, 2, 2, 0, yes
1375038438,  SFREILONE, 6, 6, 0, yes
370665533,  NicolaAgo, 1, 1, 0, yes
2539720395,  mattiaceracchi, 5, 5, 0, yes
96338614,  lorenz987, 6, 5, 1, yes
339492973,  AntonioCivile, 1, 1, 0, yes
90404836,  EneriEmrap, 1, 1, 0, yes
1022690089,  Alessandrotapaz, 2, 2, 0, yes
20949648,  richardkhughes, 2, 2, 0, yes
79116387,  jack_menta, 2, 2, 0, yes
534380185,  garmandpilon, 1, 1, 0, yes
117756151,  bartolomeo46, 1, 1, 0, yes
356812357,  FabioMelchiorre, 1, 1, 0, yes
206832384,  marziocresci, 1, 1, 0, yes
378665161,  ElenaMattiuzzo, 3, 3, 0, yes
1011885265,  basicisko, 1, 1, 0, yes
546725622,  PhWalkowiak, 1, 1, 0, yes
233577896,  skyistillblue, 1, 1, 0, yes
332740913,  fish_75, 4, 4, 0, yes
1090170871,  frangel83, 1, 1, 0, yes
504329845,  cicciopalu, 6, 2, 4, no
1089832122,  GA_Cicero, 3, 3, 0, yes
782675156,  ortensia18, 1, 1, 0, yes
245493433,  happydant, 1, 1, 0, yes
446426646,  krisbuz76, 7, 4, 3, yes
453279579,  pietrosaw, 2, 1, 1, neutral
489609915,  tommi_cas, 1, 1, 0, yes
533119982,  DAddioAntonio, 1, 1, 0, yes
1218662587,  libinf1, 1, 1, 0, yes
132836044,  vinterosso, 1, 1, 0, yes
359651483,  DiogoFNunes, 1, 1, 0, yes
383783096,  _garibaldi_, 5, 3, 2, yes
164676609,  tiz_milan, 1, 1, 0, yes
82092767,  Animamigrante, 1, 1, 0, yes
367686054,  StefanoAleman, 2, 2, 0, yes
247375493,  DaniBernad, 1, 1, 0, yes
735464642143739904,  valdambrin, 2, 1, 1, neutral
791657369021378561,  AbbizziFanclub, 2, 2, 0, yes
401482509,  tatjanaaleksic, 1, 1, 0, yes
400170938,  hanslucam, 1, 1, 0, yes
2567793440,  sredivo1, 3, 3, 0, yes
2849440473,  silver84014, 1, 1, 0, yes
858537067,  VilainPerrine, 1, 1, 0, yes
805185874791174144,  2gobbo, 1, 1, 0, yes
500764827,  Niklaus_R, 6, 6, 0, yes
1231174662,  stefanob13, 1, 1, 0, yes
521239224,  JeanCloudKriket, 1, 1, 0, yes
320697906,  MattiaMurnigott, 4, 4, 0, yes
359541795,  VirginiaInverni, 4, 4, 0, yes
1222640652,  Vale_Mela, 5, 5, 0, yes
624563241,  AndreaCandelmo, 1, 1, 0, yes
418248440,  TizianoTerrazzi, 1, 1, 0, yes
593777073,  M_Colagrossi, 4, 3, 1, yes
76287489,  Fabbrizz, 1, 1, 0, yes
133663801,  BFMTV, 1, 1, 0, yes
66712199,  _jedm, 1, 1, 0, yes
40244378,  bennaker, 1, 1, 0, yes
438459243,  EnricoPivetta, 3, 3, 0, yes
709708186752847872,  MariaLu37955574, 1, 1, 0, yes
2180063050,  Dirienzog84, 3, 3, 0, yes
386061380,  lore_viga, 1, 1, 0, yes
526656455,  MauroBasso_, 1, 1, 0, yes
804796778553942016,  FrancescoPioMo1, 1, 1, 0, yes
495951549,  fabraqui, 4, 2, 2, neutral
753837313,  piva_a, 11, 10, 1, yes
2971477468,  FonteAntoine, 1, 1, 0, yes
3972492568,  912Flo, 5, 5, 0, yes
323291104,  DaRonz82, 1, 1, 0, yes
3402382157,  Parmenide7, 4, 2, 2, neutral
24041437,  anto_maior, 3, 2, 1, yes
3436700817,  7rancescoCerqua, 2, 2, 0, yes
4235865260,  Supiermario, 1, 1, 0, yes
374611906,  piergiuseppef, 1, 1, 0, yes
410865425,  Vale_cell, 1, 1, 0, yes
985239918,  VincenzoPalma77, 1, 1, 0, yes
472390924,  simongiov, 1, 1, 0, yes
173497601,  Boda5188, 1, 1, 0, yes
392170270,  pieraandrani, 2, 2, 0, yes
241498207,  goodbeansami, 3, 3, 0, yes
499796533,  CONCETTAROLI, 1, 1, 0, yes
73131674,  Fvillacampa, 1, 1, 0, yes
4868926511,  mognatolaura50, 1, 1, 0, yes
2615835660,  remain_human_, 2, 2, 0, yes
3059265761,  abeaell, 1, 1, 0, yes
442235388,  rossrd, 3, 2, 1, yes
93663057,  mirkopuccio, 2, 2, 0, yes
498125899,  EmaGranelli_Cap, 2, 1, 1, neutral
238929112,  MilloeManu, 1, 1, 0, yes
419110859,  bepponato, 1, 1, 0, yes
992889084,  favalem, 1, 1, 0, yes
298411154,  AldoGaraffa, 1, 1, 0, yes
3997189043,  CiroPisacani, 2, 2, 0, yes
254121905,  luca4sc, 2, 2, 0, yes
483166694,  AMonticone, 5, 3, 2, yes
168630765,  m_domenech, 1, 1, 0, yes
2942626198,  antonellamarco7, 1, 1, 0, yes
73599190,  GiovanniFerrar, 5, 5, 0, yes
151149604,  Efod, 2, 2, 0, yes
533469922,  Darvilvil, 1, 1, 0, yes
447334135,  Zenone_di_Elea, 1, 1, 0, yes
1050614810,  FabioGoj, 3, 2, 1, yes
480643742,  davide_nicita24, 2, 1, 1, neutral
546235270,  AugustoComm, 1, 1, 0, yes
703512296388222976,  AlienoIt, 1, 1, 0, yes
66081832,  AlbiUs1919, 1, 1, 0, yes
477015826,  guido_pao, 2, 2, 0, yes
3707323155,  NicoloBisso, 1, 1, 0, yes
2470528594,  michelevasts, 2, 2, 0, yes
65444000,  francescoseghez, 1, 1, 0, yes
93034295,  valedest93, 1, 1, 0, yes
385629965,  mariacafagna, 2, 2, 0, yes
303932486,  AleDeGregoriis, 3, 1, 2, no
198600936,  matteoriso, 17, 11, 6, yes
596292748,  amangelone, 1, 1, 0, yes
235129566,  lykkefriis, 1, 1, 0, yes
45463439,  Renatus84, 1, 1, 0, yes
109651861,  ONadde, 13, 10, 3, yes
140419227,  alaskaHQ, 4, 4, 0, yes
785812924350726144,  AlbertoMastron1, 1, 1, 0, yes
385612993,  SouthofAlps, 1, 1, 0, yes
158897236,  giu_capone, 1, 1, 0, yes
435271670,  paolazito1, 4, 4, 0, yes
372324338,  Pierlun, 5, 5, 0, yes
2946019469,  SimonaBianchi70, 1, 1, 0, yes
3076814813,  Alistair_xnigo, 1, 1, 0, yes
95664521,  Dtikitakaqueen, 2, 2, 0, yes
331743274,  JakeYassa, 1, 1, 0, yes
119512352,  elegiovio, 1, 1, 0, yes
2903237263,  MontaninoUSA, 1, 1, 0, yes
2494318632,  gpuzzonia, 2, 2, 0, yes
591417883,  lablegia, 3, 3, 0, yes
1257758318,  Edocicco93, 2, 2, 0, yes
211089537,  Riccardo89to, 1, 1, 0, yes
723993440283951104,  AlfredoCeratto, 2, 2, 0, yes
205163614,  pjcella, 1, 1, 0, yes
289042899,  acquacinzy, 2, 2, 0, yes
303307834,  DanielaEster5, 9, 4, 5, no
497231993,  almostangelicc, 2, 2, 0, yes
143149328,  TereCarretero, 1, 1, 0, yes
516741709,  IavaroneSara, 2, 1, 1, neutral
1128071294,  NewEuropeans, 1, 1, 0, yes
2474293979,  CupelliLuca, 1, 1, 0, yes
515420818,  giusyiorlano, 1, 1, 0, yes
2789456279,  GranchiMauro, 2, 2, 0, yes
311552815,  nicolaborri, 1, 1, 0, yes
105872867,  GIOVATira, 1, 1, 0, yes
22143960,  JaapJansen, 1, 1, 0, yes
773438122101211137,  UndecimoAndrea, 4, 3, 1, yes
856466665,  ChiaraBuccini, 1, 1, 0, yes
751482508798103553,  MadridMagical, 1, 1, 0, yes
385638204,  samoaman, 1, 1, 0, yes
51274770,  vascopirri, 1, 1, 0, yes
59393368,  Livesquawk, 1, 1, 0, yes
390101976,  diegonanni76, 3, 2, 1, yes
418168264,  esmeralda_78, 1, 1, 0, yes
492151193,  faggianoroberto, 3, 3, 0, yes
526249679,  lucalazz, 3, 2, 1, yes
407050591,  federiconovella, 1, 1, 0, yes
361098398,  cascschroeder, 1, 1, 0, yes
66826404,  Justin_sw1, 1, 1, 0, yes
37225216,  kiainga, 1, 1, 0, yes
19674853,  pedromamede, 1, 1, 0, yes
465617570,  Mariaconqueso, 1, 1, 0, yes
4344764241,  Ekt__CE, 6, 6, 0, yes
60657057,  LucaEffeTW, 1, 1, 0, yes
2715264191,  IacSax, 1, 1, 0, yes
1904332136,  Le_Nius, 1, 1, 0, yes
1688184049,  Marscognamiglio, 2, 2, 0, yes
492519306,  ForseCercavi, 1, 1, 0, yes
200028163,  Lettera43, 1, 1, 0, yes
1488736524,  sergioruperez94, 2, 2, 0, yes
19603201,  naebula, 2, 2, 0, yes
48406126,  GiorgioPiddini, 4, 4, 0, yes
252465124,  tito_ri, 1, 1, 0, yes
482611925,  Nerys__, 1, 1, 0, yes
153384940,  mammanodavid, 7, 7, 0, yes
2661595185,  lattuga99, 3, 3, 0, yes
362554662,  NielsKvale, 1, 1, 0, yes
410718782,  LeylaMonanni81, 1, 1, 0, yes
220729251,  Maxime_Bouyer, 1, 1, 0, yes
290513880,  RobertoRicchini, 4, 3, 1, yes
115147722,  henkjanormel, 1, 1, 0, yes
349696027,  JakeCalderone, 2, 2, 0, yes
188413323,  G20ICT, 2, 2, 0, yes
210573372,  davidallegranti, 1, 1, 0, yes
605674534,  laurapalladino1, 1, 1, 0, yes
976978526,  Guillaume_Alv, 1, 1, 0, yes
2220310769,  AlessiaDragoni, 1, 1, 0, yes
58165791,  Mattiabuonocore, 2, 2, 0, yes
557018960,  MargheBordino, 4, 4, 0, yes
273897097,  gael99, 1, 1, 0, yes
543613098,  GrecoCrescenzo3, 3, 3, 0, yes
22613308,  sergiolorusso14, 1, 1, 0, yes
400603743,  AntonelloRusso, 1, 1, 0, yes
459066349,  Robertamarchet, 1, 1, 0, yes
623931473,  antomariella79, 1, 1, 0, yes
2738069398,  Av7Villa, 1, 1, 0, yes
419074999,  gabriandreozzi, 1, 1, 0, yes
1068769693,  Matteodome17, 1, 1, 0, yes
86507069,  clafer1, 1, 1, 0, yes
615093219,  ANDREAVIVOLI, 1, 1, 0, yes
304082066,  paky_92, 7, 7, 0, yes
528367527,  kuketto, 1, 1, 0, yes
551427696,  ValeRagonesi, 3, 1, 2, no
343286112,  gfnastasi, 2, 2, 0, yes
311433836,  lalborghetti, 1, 1, 0, yes
22656265,  dbellasio, 4, 2, 2, neutral
286733758,  uncincin, 1, 1, 0, yes
1560199374,  flaminia_2, 2, 2, 0, yes
419633448,  StyleandTrouble, 3, 2, 1, yes
760588458498854918,  AleTeachesYou, 1, 1, 0, yes
1351714225,  athousandguards, 1, 1, 0, yes
284099686,  Mrojas_, 1, 1, 0, yes
456171419,  DavMon76, 2, 2, 0, yes
8646432,  marcogiacosa, 1, 1, 0, yes
1048417428,  Bevilacqua_93, 1, 1, 0, yes
350855832,  Luca__Ferrari, 1, 1, 0, yes
2396967532,  0nE_Nerd, 1, 1, 0, yes
474213280,  Luca_coco93, 8, 6, 2, yes
265512733,  polterra23, 1, 1, 0, yes
447381426,  bertoni3112, 3, 3, 0, yes
2894887551,  Ire_Air, 1, 1, 0, yes
1186996866,  gfmurrone, 2, 2, 0, yes
4598939601,  leoijan, 2, 2, 0, yes
354309546,  peecak, 1, 1, 0, yes
342783459,  SPattuglia, 1, 1, 0, yes
1969013042,  ArrighiTommaso, 1, 1, 0, yes
285635680,  GiuliaCostetti, 4, 3, 1, yes
3329769819,  31ffa2b9aae94fd, 2, 2, 0, yes
42733221,  lindaemme, 1, 1, 0, yes
624478048,  4ndr34f3l1c3, 2, 2, 0, yes
557943728,  andreeee99, 1, 1, 0, yes
2243752217,  GiancarlGarozzo, 4, 4, 0, yes
107582221,  alessioviola, 3, 1, 2, no
412160943,  natalialigas, 2, 2, 0, yes
2302289098,  BistiValentina, 1, 1, 0, yes
265974982,  casamazzi, 1, 1, 0, yes
1001753942,  aledipie, 7, 2, 5, no
44886581,  pierluigiluceri, 39, 35, 4, yes
884596956,  FSicchiero_, 1, 1, 0, yes
3170228729,  TheLullaby, 6, 6, 0, yes
243394042,  MarcoLorux, 5, 3, 2, yes
290494233,  Giovanni817, 1, 1, 0, yes
477855820,  abbiatecritico, 1, 1, 0, yes
1535118270,  ingra2227, 1, 1, 0, yes
397578064,  SilviaMocchetti, 2, 2, 0, yes
53309000,  marcobertucci, 1, 1, 0, yes
498984865,  Salvus57, 1, 1, 0, yes
540757316,  mamoantonioli, 1, 1, 0, yes
399627582,  AntonioPZ83, 2, 2, 0, yes
2836635263,  B_Gianky, 2, 2, 0, yes
805668789744504836,  fioravantecaf, 2, 2, 0, yes
2524595418,  santuliana13, 1, 1, 0, yes
1106018335,  BPedicone, 1, 1, 0, yes
365067542,  RealRickyPV89, 1, 1, 0, yes
3075307013,  LaraFior, 1, 1, 0, yes
2327489276,  enricomartinel9, 1, 1, 0, yes
50318057,  alienare, 1, 1, 0, yes
13200642,  wildmonkey, 1, 1, 0, yes
2435710940,  esisteancheques, 1, 1, 0, yes
392797615,  Nadia461096, 2, 2, 0, yes
405040481,  emi_bertelli, 4, 4, 0, yes
191963491,  areaminzoni, 1, 1, 0, yes
2385940537,  APropositoDiAle, 3, 1, 2, no
701173846729216000,  8DaBa8, 2, 1, 1, neutral
3033470859,  Gabry1957, 2, 2, 0, yes
509367674,  YariGiovannini, 1, 1, 0, yes
3290602895,  DiYomyom, 3, 3, 0, yes
558799253,  jeanneass, 1, 1, 0, yes
1731860900,  natali_serena, 1, 1, 0, yes
1007205026,  cafaro99, 1, 1, 0, yes
310865669,  CatiaMarchesi, 2, 2, 0, yes
2359317084,  MimmoFiorani, 1, 1, 0, yes
2864518829,  pupadelganster, 2, 2, 0, yes
1640744514,  thierno75011, 1, 1, 0, yes
720438957,  SamueleRegio96, 1, 1, 0, yes
607598585,  hobignee, 1, 1, 0, yes
775419626285043712,  marchesediripal, 4, 4, 0, yes
727092780942643204,  votanorenzi, 1, 1, 0, yes
717089806384242688,  carmelazero0000, 1, 1, 0, yes
233220745,  psychopixel, 2, 2, 0, yes
343509212,  Noodles105, 1, 1, 0, yes
503360674,  SinTenza_, 1, 1, 0, yes
396838440,  LoreMutto1992, 3, 2, 1, yes
517454878,  KRAKKATO62, 4, 4, 0, yes
458269919,  AndreaPutzu83, 1, 1, 0, yes
363575946,  Paol0m, 1, 1, 0, yes
716644863849140224,  emichir, 2, 2, 0, yes
2762141323,  MariannaSantese, 12, 12, 0, yes
3397152070,  KonstantinosBXL, 2, 2, 0, yes
151461482,  gimbo73, 3, 3, 0, yes
319232531,  00ste, 2, 2, 0, yes
146143681,  LorenzoMicheloz, 1, 1, 0, yes
316673355,  Francesco80m, 1, 1, 0, yes
1243943708,  DanMinelli, 1, 1, 0, yes
2447675622,  gregori231097, 3, 2, 1, yes
1397094164,  Gaara980, 2, 2, 0, yes
771276968054718464,  lunaneresss, 1, 1, 0, yes
48719146,  october_web, 7, 6, 1, yes
1257016538,  Claudiokarpa, 2, 2, 0, yes
951562536,  marxangelux, 3, 3, 0, yes
185368634,  oscarfio, 1, 1, 0, yes
2300182119,  IvanaGiovannin1, 3, 3, 0, yes
2341649217,  pezone_vito, 1, 1, 0, yes
75024545,  il_Dom81, 2, 2, 0, yes
3366222670,  terzolupin112, 1, 1, 0, yes
712285514586570752,  luppo84, 9, 9, 0, yes
732693948506890240,  michele_gallo7, 2, 2, 0, yes
43588209,  silviame, 1, 1, 0, yes
509925169,  fede89fg, 6, 6, 0, yes
1251714114,  santoro_p, 1, 1, 0, yes
68821833,  richie_hough, 1, 1, 0, yes
1049970506,  MartinaRendo, 1, 1, 0, yes
779339688964399104,  bombina_angela, 1, 1, 0, yes
2351303368,  lelli_massimo, 2, 2, 0, yes
2328994740,  licia35540898, 3, 2, 1, yes
450982888,  AvvCulla, 1, 1, 0, yes
2368979529,  alemivime, 1, 1, 0, yes
2267746965,  deborah73764083, 2, 2, 0, yes
2417465334,  misterpennyy, 2, 2, 0, yes
2445645806,  SabrinaPileri67, 16, 5, 11, no
3870612845,  angeladessimon1, 1, 1, 0, yes
37296672,  yocassis, 1, 1, 0, yes
187873156,  RedMithra, 2, 2, 0, yes
713019672808005632,  EmanuelePeri99, 1, 1, 0, yes
3995707457,  enzocasamento, 2, 2, 0, yes
1001479656,  pierluigirolli, 8, 4, 4, neutral
475877968,  gigimark76, 1, 1, 0, yes
972447571,  walesky359, 1, 1, 0, yes
1648565634,  AnimaInViaggio, 6, 6, 0, yes
2360933014,  frankroma73, 2, 2, 0, yes
3794715136,  tine151515, 2, 2, 0, yes
802522326315266048,  Eleonor38538753, 1, 1, 0, yes
70174464,  MallmannRocks, 1, 1, 0, yes
802074705641537536,  88Caterina, 1, 1, 0, yes
439358950,  lilly91_7, 1, 1, 0, yes
4092958605,  sharingschool, 1, 1, 0, yes
3396602141,  Polarizer1, 1, 1, 0, yes
760834031412019201,  Hey_Caty, 1, 1, 0, yes
430967902,  ClaudioPliskeen, 1, 1, 0, yes
4590616163,  sebatosa, 2, 2, 0, yes
493332534,  Falsy92, 1, 1, 0, yes
755322696301481984,  Basta1siAltChia, 1, 1, 0, yes
1329126331,  C_Brigida, 1, 1, 0, yes
163132166,  WALTEReRENATA, 1, 1, 0, yes
489519253,  GingerJCB, 2, 2, 0, yes
3750926914,  Ferrari58Monica, 10, 10, 0, yes
2430707253,  ToninBardhi, 1, 1, 0, yes
2347523763,  yellow66papa, 1, 1, 0, yes
2435216339,  miscy26, 4, 4, 0, yes
423785778,  salvatorecicer1, 1, 1, 0, yes
783238895362248704,  giulia_campa, 1, 1, 0, yes
328881868,  LostInJDBeyes, 3, 3, 0, yes
173958624,  EleLovesBritney, 3, 3, 0, yes
495955147,  GiudiciCristina, 2, 2, 0, yes
707575131,  OrlandiDavide1, 2, 2, 0, yes
1183990536,  DalilaDiscianni, 1, 1, 0, yes
4817938426,  mikileonardi, 2, 2, 0, yes
153456743,  SergiVilanova_, 1, 1, 0, yes
403336262,  NotLBogani, 7, 4, 3, yes
251377969,  marcomaioli1, 4, 4, 0, yes
365614776,  enricopremu, 3, 3, 0, yes
3094759949,  michizztti, 1, 1, 0, yes
555434484,  marcotomasi70, 1, 1, 0, yes
1596483368,  LiefLayer, 7, 7, 0, yes
2481102927,  MrzTaytayBabbli, 1, 1, 0, yes
55162151,  EnverConde, 1, 1, 0, yes
467630706,  vdmstateofmind, 1, 1, 0, yes
91929755,  sanchezperales, 1, 1, 0, yes
261290781,  Francitua, 1, 1, 0, yes
2960981945,  Mariagr011969, 1, 1, 0, yes
911297924,  StefyAntonini, 3, 3, 0, yes
1702774057,  monicacorti3, 2, 1, 1, neutral
712219588,  maria52rm, 1, 1, 0, yes
83217508,  gomezsmirage, 2, 2, 0, yes
261838075,  Marco_Sarra, 6, 1, 5, no
131155940,  samantadamore, 1, 1, 0, yes
780137172741550080,  giadibernardini, 3, 3, 0, yes
778658894335864832,  Rosimburgia, 1, 1, 0, yes
82496128,  marituni, 2, 2, 0, yes
2439344587,  chucky_liz, 1, 1, 0, yes
2934255201,  tillimarianna, 1, 1, 0, yes
323243060,  priscadenisi, 2, 2, 0, yes
714132635711315968,  gramii9, 1, 1, 0, yes
713156266,  AleAnziano, 2, 2, 0, yes
2875826428,  ResiBianchi, 1, 1, 0, yes
525853329,  allemacc, 8, 5, 3, yes
329811439,  DoctorDrugFree, 1, 1, 0, yes
745573404196114432,  arabacche53, 1, 1, 0, yes
2401313720,  BrandO_tweet, 2, 2, 0, yes
613293565,  spig815, 1, 1, 0, yes
4388447321,  CamillaLaCre, 1, 1, 0, yes
1584560774,  matteoliberotti, 1, 1, 0, yes
2363994704,  paoloskilla, 3, 3, 0, yes
19003183,  pereirajoaof, 1, 1, 0, yes
723482781121175552,  realspicyman, 1, 1, 0, yes
989814066,  enricobugi, 1, 1, 0, yes
805709071,  francescocrs, 3, 2, 1, yes
2508723677,  asterx_pa, 1, 1, 0, yes
1438745833,  LegatoMich, 1, 1, 0, yes
28185506,  fam0913, 1, 1, 0, yes
2978706729,  pecos1998, 5, 4, 1, yes
342825472,  JackieBecc, 1, 1, 0, yes
336488922,  ariiiainvena, 1, 1, 0, yes
2405008039,  IVAN_CALDARELLI, 1, 1, 0, yes
58840033,  djdanger, 1, 1, 0, yes
583057027,  DaviMxtaa, 1, 1, 0, yes
733374037091614720,  fioreok19, 2, 2, 0, yes
2770272936,  MarinellaTA62, 3, 3, 0, yes
746148438,  _Boobear31, 1, 1, 0, yes
622140145,  SlashNews1, 1, 1, 0, yes
1189646264,  alessan60866372, 2, 1, 1, neutral
543574568,  CristinaLannia, 1, 1, 0, yes
22795333,  PeppeBove75, 1, 1, 0, yes
470442272,  fedemaglione, 1, 1, 0, yes
805560292616847361,  Roberto535889, 3, 3, 0, yes
359886824,  recchiedgomm, 5, 2, 3, no
179178004,  moeinaba, 1, 1, 0, yes
391894508,  GiuseppeLopardi, 4, 3, 1, yes
436247374,  valeriabottelli, 1, 1, 0, yes
4202236235,  diego29071998, 2, 2, 0, yes
407185526,  MarcoVerduz, 1, 1, 0, yes
451023399,  LorenzoCaselli2, 1, 1, 0, yes
2875939606,  DmgGiuseppe, 1, 1, 0, yes
229807601,  Drusolp, 1, 1, 0, yes
115175651,  RitaCioce, 1, 1, 0, yes
2396425583,  AHMEDagn, 2, 2, 0, yes
76695906,  adyglio, 5, 3, 2, yes
2355308906,  Lord_Bullingdon, 1, 1, 0, yes
4183604675,  cgdmzlp1907, 1, 1, 0, yes
936524736,  Francesco_Sarac, 4, 4, 0, yes
351931233,  cwilksuk, 4, 4, 0, yes
71491680,  Deviance_, 7, 4, 3, yes
746069832966209536,  narcopastello, 2, 2, 0, yes
792030950,  IRaffetto, 1, 1, 0, yes
750946396409389056,  Carlomilo74, 2, 2, 0, yes
4345220957,  CiclaminoF, 2, 1, 1, neutral
1146738356,  EnzoA24, 16, 15, 1, yes
484305195,  Ddcastibanque, 1, 1, 0, yes
350178204,  jan_des, 1, 1, 0, yes
3088516941,  kuangalia_tw, 2, 2, 0, yes
15398493,  castellettir, 6, 5, 1, yes
1329275215,  paologucc, 2, 2, 0, yes
367219085,  simcappellanti, 1, 1, 0, yes
725368372024774657,  AntoJackson99, 2, 2, 0, yes
174178027,  poldo_stop, 2, 1, 1, neutral
2290224547,  ASKNOT4, 3, 3, 0, yes
34717108,  AndreaAliverti, 1, 1, 0, yes
51695120,  Orange_buD, 1, 1, 0, yes
76322484,  FXtrader_remco, 1, 1, 0, yes
437704468,  Pura_Vida69, 6, 6, 0, yes
3097180523,  emili_patrizia, 1, 1, 0, yes
69395839,  micolsar, 3, 3, 0, yes
76320044,  Leoman3000, 1, 1, 0, yes
451460002,  preppy57, 7, 7, 0, yes
526814945,  SoyLuisiana, 3, 3, 0, yes
500551562,  OscarCarnevale, 7, 6, 1, yes
276195384,  ElenaFranca, 2, 2, 0, yes
2897136909,  USTweetsDistill, 1, 1, 0, yes
31093748,  FrancoBechis, 2, 2, 0, yes
55212559,  mariocalabresi, 1, 1, 0, yes
1185046638,  BrandonUSA3, 1, 1, 0, yes
274517867,  abupepi, 1, 1, 0, yes
715801854,  CristinaNizzoli, 3, 3, 0, yes
549956970,  RiccardoRoversi, 1, 1, 0, yes
424310780,  lucaubaldeschi, 2, 2, 0, yes
2210469522,  kosta53_a, 3, 3, 0, yes
49690604,  mavrein, 2, 2, 0, yes
2867575709,  gianlucahmd, 1, 1, 0, yes
453027094,  Orialiso, 2, 2, 0, yes
780796377148162048,  cechidiceNO27, 2, 1, 1, neutral
459137740,  CarlitoPeralta, 2, 2, 0, yes
999162090,  chiara_bert, 5, 5, 0, yes
432585401,  Innovandiamo, 4, 3, 1, yes
468614205,  CovinoCarmine, 1, 1, 0, yes
255248303,  terencita, 1, 1, 0, yes
557011202,  ntomasse, 2, 2, 0, yes
3318775559,  MARCHITERESAMT, 1, 1, 0, yes
55177392,  ssandrici, 1, 1, 0, yes
2652672676,  MarcucciEdoardo, 3, 3, 0, yes
232396998,  twittevanes, 1, 1, 0, yes
568203227,  pietrozano, 3, 3, 0, yes
796942074,  mazzolenifrance, 1, 1, 0, yes
2468250104,  AndreaDalFabbro, 1, 1, 0, yes
101047801,  campuswave, 8, 6, 2, yes
255715189,  satricum, 3, 2, 1, yes
903898838,  EleonoraCamilli, 2, 2, 0, yes
13821512,  micky_genova, 7, 7, 0, yes
1063887331,  angelo_albanese, 2, 2, 0, yes
77575418,  elisdono, 9, 9, 0, yes
794785297,  ValeriaVolponi, 2, 2, 0, yes
474219450,  ElyBorgia, 2, 1, 1, neutral
2720195295,  giuliascicchi33, 1, 1, 0, yes
579318663,  gfiorelli1951, 8, 5, 3, yes
936441901,  Ritagliati_RCdC, 5, 3, 2, yes
391681730,  MrGioGio77, 1, 1, 0, yes
7773732,  gba_mm, 17, 16, 1, yes
254706967,  aenavazio, 2, 2, 0, yes
2997605013,  zur_este, 1, 1, 0, yes
418244992,  Dardersailing, 3, 3, 0, yes
380911650,  Amentiae, 3, 3, 0, yes
505704669,  GiuliaLaLumia, 1, 1, 0, yes
3020602515,  andreacasciari, 1, 1, 0, yes
461240191,  Peppe16Marino, 1, 1, 0, yes
1333369999,  Rinaldi_euro, 8, 7, 1, yes
96327773,  Lelio85, 1, 1, 0, yes
1586484625,  AGuercy, 1, 1, 0, yes
579259601,  Matteo_Crino, 1, 1, 0, yes
385408308,  tfabiani2, 6, 6, 0, yes
141132592,  catoverton_99, 1, 1, 0, yes
19417982,  RenaNetjes, 1, 1, 0, yes
454092710,  PaoloIori14, 1, 1, 0, yes
306137883,  nnppdqpw2011, 7, 7, 0, yes
175729390,  piccolinovr, 1, 1, 0, yes
755049789025386496,  ivanzattarin, 1, 1, 0, yes
805423495777812480,  massy_piga, 1, 1, 0, yes
2176994608,  charlie_valerio, 1, 1, 0, yes
174747861,  GiovaFortuna, 5, 5, 0, yes
148481393,  marcolaudonio, 6, 4, 2, yes
152370369,  Politoleri, 1, 1, 0, yes
473838165,  Elsorio, 5, 2, 3, no
271445727,  FrancaFloris, 2, 1, 1, neutral
347169589,  AndreaZitelli_, 3, 3, 0, yes
203858701,  AlbertoLaudati, 2, 1, 1, neutral
862707546,  francescacolan6, 2, 2, 0, yes
465973960,  MinistroCiencia, 1, 1, 0, yes
333055041,  AndreaMascoloNA, 1, 1, 0, yes
768437296194519041,  damiana_trincia, 1, 1, 0, yes
2494817107,  JeanLucOesch, 1, 1, 0, yes
27209043,  Margo_Channing, 1, 1, 0, yes
4030291397,  giupolros, 1, 1, 0, yes
90884236,  papyPC, 1, 1, 0, yes
2589972278,  Vecchi_Paolo, 4, 4, 0, yes
720642565,  Sir_Fantasia, 4, 4, 0, yes
733041565174771712,  xcheiosoio, 1, 1, 0, yes
14783126,  simmessa, 3, 3, 0, yes
2661305224,  BoschiClaudio, 1, 1, 0, yes
317388287,  fabriziolongo11, 1, 1, 0, yes
529355511,  AnthonyAiello2, 16, 1, 15, no
775484752166002689,  francescoristo, 3, 3, 0, yes
488772562,  ParodiAl, 4, 4, 0, yes
3230940346,  nikitanero73, 1, 1, 0, yes
2914473202,  zanello82, 1, 1, 0, yes
835456226,  diggino, 9, 7, 2, yes
3095804676,  maemarsii, 3, 3, 0, yes
413096886,  AleCerb, 3, 3, 0, yes
265001674,  triesteprima, 1, 1, 0, yes
339598443,  Telecolore, 7, 7, 0, yes
92823785,  VulcanoStatale, 1, 1, 0, yes
403657321,  FabienFarge, 4, 4, 0, yes
1329938618,  Vale_Iorio91, 2, 2, 0, yes
421858288,  licia__, 1, 1, 0, yes
2319707989,  ViaPerini141, 2, 1, 1, neutral
113061775,  adistylish, 2, 2, 0, yes
2893755717,  EramoIndios71, 1, 1, 0, yes
930600896,  _katoida, 2, 2, 0, yes
2478370856,  AndreaBarbuto28, 5, 5, 0, yes
930039654,  robertabologna1, 4, 4, 0, yes
490960831,  Gaporion, 1, 1, 0, yes
160881012,  Brettkappa, 2, 1, 1, neutral
427443288,  IvanoIai, 2, 2, 0, yes
805549841132716032,  MontalbanoDavi, 1, 1, 0, yes
508124611,  IlariaModena, 2, 2, 0, yes
585121222,  benedipol, 1, 1, 0, yes
472541948,  FiMaltese, 2, 1, 1, neutral
3280573716,  DiMartinoBooth, 1, 1, 0, yes
414629229,  AndreaNobiliT, 6, 5, 1, yes
236542872,  ettoredn, 1, 1, 0, yes
563254489,  1Picard74, 8, 8, 0, yes
456546189,  Andreaarmellin2, 2, 1, 1, neutral
2785078203,  SCeredi, 1, 1, 0, yes
389222335,  daphnedicinto, 1, 1, 0, yes
2686672923,  GpPancaro, 2, 1, 1, neutral
262388409,  MattiaBorsani, 1, 1, 0, yes
91790583,  EmaGiulianelli, 3, 2, 1, yes
28823223,  elenaschiavon, 1, 1, 0, yes
1055604996,  AGRAPRESS, 7, 7, 0, yes
477734917,  PamelaTavalazzi, 2, 2, 0, yes
237672328,  pragadoro, 2, 2, 0, yes
989712787,  brodsky56, 2, 2, 0, yes
1543155518,  GiuseppeLipariP, 7, 3, 4, no
797830129309417472,  MM__MARCELLA, 1, 1, 0, yes
307838906,  boberto60, 3, 3, 0, yes
772396134593654784,  eleonorafino, 1, 1, 0, yes
370079705,  achispd, 3, 3, 0, yes
69959408,  Tg3web, 12, 6, 6, neutral
548259024,  MColzato, 2, 2, 0, yes
205992433,  Francis82MaFrIT, 2, 1, 1, neutral
286225445,  LukeKidrauhl, 1, 1, 0, yes
366173280,  DanielaColomb, 2, 2, 0, yes
577968872,  SofiaQuaglia1, 3, 3, 0, yes
2408713359,  LencioniMl, 3, 3, 0, yes
104538719,  EABlair1975, 1, 1, 0, yes
2443574665,  ManuMusino, 1, 1, 0, yes
365592373,  PolidoroDaniele, 5, 5, 0, yes
836523541,  PnuccO, 1, 1, 0, yes
395994754,  BerjaBona, 2, 2, 0, yes
3567660616,  PChittolini, 1, 1, 0, yes
264728020,  vatipuz, 6, 3, 3, neutral
42013583,  antoalessio, 3, 3, 0, yes
2364588930,  slmsmrc, 1, 1, 0, yes
762374157011128320,  paginaazzurri, 2, 1, 1, neutral
4653903869,  nikpali_r, 1, 1, 0, yes
2350218452,  Pedro60338854, 1, 1, 0, yes
2335767424,  MariaRosi1975, 4, 4, 0, yes
47163400,  EllyPrincy, 2, 1, 1, neutral
1049172253,  Peppe_Mena, 2, 2, 0, yes
631136166,  EPJas2, 2, 2, 0, yes
922013508,  frali163, 1, 1, 0, yes
3202494790,  benedetta_one, 1, 1, 0, yes
461916437,  robykkk, 2, 2, 0, yes
733411574656978944,  DonatoVaccaro61, 1, 1, 0, yes
446213406,  gianlucaponte, 1, 1, 0, yes
2617009825,  luisa_atzori, 1, 1, 0, yes
13599912,  depetro, 1, 1, 0, yes
1315333075,  avv_garofalo, 5, 5, 0, yes
294314591,  OmarNews24, 2, 1, 1, neutral
976455469,  AlessandroTama4, 5, 4, 1, yes
4864383970,  tomliinsoff, 3, 3, 0, yes
453360717,  SBongia, 1, 1, 0, yes
3331873017,  ghezzi1960, 1, 1, 0, yes
3063451467,  barbara_brakel, 1, 1, 0, yes
794264221324341248,  mario5572, 1, 1, 0, yes
726853664,  AnitaSa14, 3, 3, 0, yes
2609555951,  Giuliodallez, 1, 1, 0, yes
303291310,  biocangi, 1, 1, 0, yes
970257962,  YleniaGifuni, 3, 3, 0, yes
144203675,  ricart82, 1, 1, 0, yes
144630446,  6NiKal, 1, 1, 0, yes
893805163,  gianba27, 1, 1, 0, yes
1893014244,  denise_groppo, 1, 1, 0, yes
4819001765,  canonfilly, 1, 1, 0, yes
4327485993,  lari_antonio, 3, 3, 0, yes
1299200132,  BraccoEraldo, 1, 1, 0, yes
223576606,  Pino197z, 2, 2, 0, yes
805735920620212224,  AntonellaPagno3, 1, 1, 0, yes
540120833,  djjekki, 2, 1, 1, neutral
805736549677727745,  Arianna57156089, 1, 1, 0, yes
204924428,  cicciosle, 1, 1, 0, yes
3047716579,  ec84b5aa2c294b1, 1, 1, 0, yes
762195348,  ACMilan_KaKa22, 1, 1, 0, yes
1114527932,  woltron2, 1, 1, 0, yes
572656052,  ilcasoumanoTW, 2, 2, 0, yes
767426795348062209,  mariaelisafrige, 1, 1, 0, yes
717343435678728192,  Ester_okay_, 1, 1, 0, yes
465886953,  zagor2006, 1, 1, 0, yes
1170119629,  patriziaciotti1, 1, 1, 0, yes
4129699222,  MirellaAnania, 3, 3, 0, yes
2431878815,  tesser_diletta, 1, 1, 0, yes
248379084,  tripletejose71, 2, 2, 0, yes
732993640365182976,  BiancaBonazzola, 1, 1, 0, yes
66337575,  fenderjbman, 2, 2, 0, yes
805717237147533312,  IrisCima, 1, 1, 0, yes
1086406746,  minerbolo, 1, 1, 0, yes
16509455,  dlogiudice, 1, 1, 0, yes
207233000,  Led_chris, 1, 1, 0, yes
4396078653,  humanhallyt, 1, 1, 0, yes
396737385,  luigi_gigio, 2, 2, 0, yes
805728659835416576,  drcappellari1, 1, 1, 0, yes
461169685,  franciliegia, 1, 1, 0, yes
2180672901,  CitterioPietro, 1, 1, 0, yes
805735154153046016,  fraema74, 1, 1, 0, yes
312161747,  DonadioAnna, 1, 1, 0, yes
2350390362,  DanieleFrosi, 1, 1, 0, yes
712874959,  Antonino_Caridi, 1, 1, 0, yes
240413678,  zefmongodi, 1, 1, 0, yes
717075917638672384,  gobbofiero34, 3, 3, 0, yes
1451390510,  giorgiocatalano, 1, 1, 0, yes
312881453,  fvastarelli, 2, 2, 0, yes
518896852,  GChiovelli, 1, 1, 0, yes
805564735756337153,  lo_renzoM89, 1, 1, 0, yes
495799379,  PaoloGaucho80, 1, 1, 0, yes
1659078080,  sweet_michela, 1, 1, 0, yes
2360892285,  podda__andrea, 2, 1, 1, neutral
425307305,  AnnaZavaritt, 4, 4, 0, yes
2237969899,  pepdonadio, 4, 2, 2, neutral
46743341,  RosieBor, 1, 1, 0, yes
421318891,  rial71, 1, 1, 0, yes
402558602,  ale_disanto, 4, 4, 0, yes
3437713355,  juvedream, 2, 2, 0, yes
1921207994,  Metodo_, 5, 5, 0, yes
2361818105,  petitbon_, 1, 1, 0, yes
133219755,  fdgri, 3, 2, 1, yes
268787801,  PepCurrado, 1, 1, 0, yes
1398246427,  STRICNINApura, 1, 1, 0, yes
2859618597,  francesca7smail, 2, 2, 0, yes
390331641,  Arnone_Antonio, 2, 1, 1, neutral
1040143056,  ottoboni456, 2, 2, 0, yes
3146969855,  AmossiMarco, 2, 2, 0, yes
53632842,  uambrosoli, 1, 1, 0, yes
147560199,  DettaBBi, 1, 1, 0, yes
522547698,  maurofrangicomo, 1, 1, 0, yes
160002994,  Qaal360, 1, 1, 0, yes
396773212,  NICOLEBOGO1, 1, 1, 0, yes
3340697902,  PMCharlesDay, 1, 1, 0, yes
418144082,  CIannaccone, 1, 1, 0, yes
1272984061,  NicoFastelino, 1, 1, 0, yes
2351465241,  michele_chine, 1, 1, 0, yes
3260502889,  BoldestBet, 3, 3, 0, yes
353717248,  MicheleImberti, 1, 1, 0, yes
499959991,  giuliano_manco, 1, 1, 0, yes
805559479907610624,  beingalice88, 1, 1, 0, yes
277951604,  Annish87, 1, 1, 0, yes
961312165,  ciccio2581, 1, 1, 0, yes
978622326,  Snoringuita, 3, 3, 0, yes
108441703,  mighiwa, 1, 1, 0, yes
773893138775740416,  enisoldo, 2, 2, 0, yes
1363867321,  RosalbaVergani, 1, 1, 0, yes
431964768,  FiMyInDaHoUsE89, 2, 2, 0, yes
427383626,  BiffiLuca, 1, 1, 0, yes
720157781324656641,  MauroFuso, 7, 2, 5, no
15858969,  dachared, 1, 1, 0, yes
516541524,  Fran_Cioe, 1, 1, 0, yes
409256468,  edubayon_, 3, 3, 0, yes
408551247,  MaryJurjo, 1, 1, 0, yes
805558787604094976,  ANCORAP51, 3, 3, 0, yes
2688654033,  LevunIgor, 1, 1, 0, yes
1062855008,  BasileSal, 1, 1, 0, yes
809527578,  Swxnn, 1, 1, 0, yes
1610336689,  plaidoyer, 1, 1, 0, yes
798914053989167104,  Anto06146746, 5, 5, 0, yes
1371016687,  Chattesurletoit, 10, 10, 0, yes
2352923336,  AloMazzella, 2, 2, 0, yes
634910134,  AngeloMilan96, 2, 2, 0, yes
984887612,  Cattivo81, 1, 1, 0, yes
584274351,  Rosevelz, 1, 1, 0, yes
3054451772,  zachsavage_86, 1, 1, 0, yes
296507637,  deejaymichaeldj, 3, 3, 0, yes
454806432,  LeoneEnrica, 2, 2, 0, yes
560384993,  Franc_Erica, 1, 1, 0, yes
2896389341,  BonaCNW, 2, 2, 0, yes
379238628,  Egocentrico7, 2, 2, 0, yes
725731303992221697,  DimarioFederica, 1, 1, 0, yes
259661377,  ManuelCoter, 1, 1, 0, yes
343304780,  lmazzeo52, 2, 2, 0, yes
2961865803,  mario_ciliberti, 2, 2, 0, yes
50275861,  m1mmo, 4, 4, 0, yes
2365794027,  donacola78, 1, 1, 0, yes
421270227,  DOMENICACOLAIAN, 3, 3, 0, yes
2540661005,  RebeccaChiadini, 5, 5, 0, yes
989162658,  APutoto, 1, 1, 0, yes
802163376461938689,  merokebab, 1, 1, 0, yes
267752485,  millotto92, 1, 1, 0, yes
3178283482,  pinoberruti, 1, 1, 0, yes
142244141,  andrebone87, 1, 1, 0, yes
152409116,  WalterVMG, 1, 1, 0, yes
106763876,  JamieMcConkey, 1, 1, 0, yes
759035534,  Dario_Gazzi, 2, 2, 0, yes
2628442186,  claudiamarini13, 2, 2, 0, yes
2711517837,  zuzzolo9, 1, 1, 0, yes
349100429,  andreasambo23, 1, 1, 0, yes
116261615,  fra_gem, 3, 3, 0, yes
2254775121,  CriLomazzi, 1, 1, 0, yes
611568194,  paolo_cotugno, 2, 2, 0, yes
460365628,  aggy005, 1, 1, 0, yes
1495337089,  KekkoCard, 2, 2, 0, yes
968576689,  JoseRamalho_PT, 1, 1, 0, yes
2835135555,  stefano5931, 1, 1, 0, yes
805427717424431104,  MaurizioSarotto, 1, 1, 0, yes
548726151,  fede_lomba, 1, 1, 0, yes
182373017,  IORIODj, 1, 1, 0, yes
3306604445,  EdAndrini, 4, 4, 0, yes
381450155,  SebaTimpanaro, 1, 1, 0, yes
614579877,  FabioBusellini, 3, 3, 0, yes
549152961,  PietroFaggion, 3, 3, 0, yes
1153173667,  paoloforneris, 7, 5, 2, yes
2880833578,  barbaraconsigl1, 3, 3, 0, yes
2364544504,  AAurora81, 2, 2, 0, yes
3093191073,  sabrytau, 3, 3, 0, yes
373985944,  SFedeSeven, 4, 4, 0, yes
289477066,  _MT3V, 1, 1, 0, yes
483706907,  aleubdecap, 2, 2, 0, yes
771845959697530881,  Djesybig, 2, 2, 0, yes
985194488,  arielebenti, 1, 1, 0, yes
763885171,  AntonioRandazz5, 5, 3, 2, yes
122398700,  castellimika, 1, 1, 0, yes
2516038952,  Elenansia, 1, 1, 0, yes
405850646,  GuendaFaz, 4, 2, 2, neutral
1410689696,  gdc011964, 2, 2, 0, yes
711299643,  Vale, 1, 1, 0, yes
357528468,  justinheartx, 9, 9, 0, yes
622256827,  Michael_Proc, 1, 1, 0, yes
132666338,  otto2211, 1, 1, 0, yes
367672490,  zahra_ian, 1, 1, 0, yes
1858779734,  Siux_Cotroneo, 1, 1, 0, yes
2341933116,  GiovanniPompeo, 1, 1, 0, yes
452441801,  lafurbetta, 1, 1, 0, yes
113945129,  Giornalista_79, 2, 2, 0, yes
362849408,  sformisano, 3, 3, 0, yes
1089046286,  AntFatTogni, 1, 1, 0, yes
6059472,  sandrix, 2, 2, 0, yes
364197474,  daniellaabb, 4, 4, 0, yes
2339253516,  vlcostantini, 2, 2, 0, yes
91668426,  AndreaPetoletti, 1, 1, 0, yes
2364674403,  Gio65Giovy, 1, 1, 0, yes
477651492,  soniabaraghini, 1, 1, 0, yes
1183219723,  disajared, 1, 1, 0, yes
590782282,  DoctorDeathStar, 4, 3, 1, yes
295065559,  esmeralda_u, 2, 2, 0, yes
434832938,  gabriellainsana, 6, 6, 0, yes
200667456,  Gentisadikovic, 1, 1, 0, yes
428930253,  riccardoaffo, 1, 1, 0, yes
3087366739,  LiliDeLorenzis, 2, 2, 0, yes
547807130,  proghettolab, 1, 1, 0, yes
2528280986,  Antonie47662021, 1, 1, 0, yes
428482416,  FabrizioPannon3, 1, 1, 0, yes
14541696,  JeromeTomasini, 3, 3, 0, yes
396836245,  AndreaBarbara89, 4, 4, 0, yes
805532372330512384,  renny_ramones, 1, 1, 0, yes
426689328,  mbierr, 1, 1, 0, yes
72590658,  jdalbuquerque, 2, 2, 0, yes
802658868,  mariadero1973, 1, 1, 0, yes
273397369,  Soniavimo, 2, 2, 0, yes
528771509,  FabryMario, 1, 1, 0, yes
2959376631,  mavilove85, 1, 1, 0, yes
237422784,  Frankiez86, 3, 1, 2, no
336065418,  Fiorello15, 1, 1, 0, yes
1915572721,  Andrea_pep, 7, 6, 1, yes
176354657,  giadecaro, 2, 2, 0, yes
1313425808,  UmbertoDeLellis, 2, 2, 0, yes
73720086,  mariandola, 4, 4, 0, yes
349303116,  terricenum, 2, 2, 0, yes
987391272,  AleArmenia1, 1, 1, 0, yes
529358224,  niccontro, 1, 1, 0, yes
424393445,  SimoneMarinoCal, 1, 1, 0, yes
330386552,  designdcl, 5, 5, 0, yes
397519730,  joelcrema, 3, 3, 0, yes
111364826,  tamapisan, 2, 2, 0, yes
247202551,  mariazb8, 3, 3, 0, yes
237331862,  MonicaFortino, 1, 1, 0, yes
2444401000,  Chicco6924, 2, 2, 0, yes
2380994875,  SCarmeno, 2, 1, 1, neutral
308991253,  Salvo_ice7, 1, 1, 0, yes
318666694,  50shadesofmrdth, 1, 1, 0, yes
497360914,  MarioCarbone95, 1, 1, 0, yes
422899265,  GiulioLauri, 4, 4, 0, yes
1868309899,  Salvatore58Papa, 1, 1, 0, yes
14264233,  sibiola, 1, 1, 0, yes
19980374,  mcolombolondon, 2, 2, 0, yes
2230057237,  BeMelt, 2, 2, 0, yes
3234115692,  qancaro360, 1, 1, 0, yes
1063623216,  laziadaniela, 2, 1, 1, neutral
160893414,  danielabrienza, 1, 1, 0, yes
709299796,  boscarino_s, 1, 1, 0, yes
2351044055,  FlebaDickinson, 1, 1, 0, yes
632806488,  MirkoMigliorati, 1, 1, 0, yes
624980762,  IlMagodiIos, 1, 1, 0, yes
2496152132,  Enzozzi, 1, 1, 0, yes
959215531,  BenerusRusso, 3, 3, 0, yes
584021122,  GianfrancoDeNig, 1, 1, 0, yes
802670803103977472,  ArceAgurto, 1, 1, 0, yes
1044498092,  AvvDileo, 1, 1, 0, yes
798153609309462532,  DcomplicateS, 1, 1, 0, yes
36903387,  connettivista, 1, 1, 0, yes
1585503301,  ESComunicazione, 1, 1, 0, yes
367626839,  PicenoTime, 1, 1, 0, yes
614566110,  ManuelCrepaldi, 2, 1, 1, neutral
39265477,  aswich, 3, 3, 0, yes
598932565,  citiamo, 4, 1, 3, no
3397298757,  Susanna_fair, 1, 1, 0, yes
802629107787960320,  oliverus88, 1, 1, 0, yes
3385563579,  Giuliani85Fabio, 1, 1, 0, yes
1011657595,  Cleo960, 1, 1, 0, yes
721456681683693569,  Francescadifra7, 2, 2, 0, yes
2343563478,  vagaribelle, 1, 1, 0, yes
4429400908,  AYerashenkava, 1, 1, 0, yes
293109507,  marthebrossier, 2, 2, 0, yes
1086803960,  Domenicomanfre4, 1, 1, 0, yes
2531274057,  PaulieBirch, 1, 1, 0, yes
3511306816,  PraPrimo, 1, 1, 0, yes
278503681,  sicgra, 1, 1, 0, yes
306162902,  PaoloLatini, 2, 2, 0, yes
318538251,  robertacarlini, 1, 1, 0, yes
3059382495,  apdc70, 4, 4, 0, yes
2246935354,  alfonso_farina, 2, 2, 0, yes
426616593,  ALEJOHNNY86, 1, 1, 0, yes
3292705355,  GBasilico70, 1, 1, 0, yes
805711956992729088,  DOMENICO_1972, 4, 4, 0, yes
2949717057,  de_decricri, 6, 4, 2, yes
418874919,  piatru, 2, 1, 1, neutral
23765103,  windruffle, 2, 2, 0, yes
767820208228732929,  GiuseppeScagl16, 1, 1, 0, yes
1339501164,  zerbi_silvia, 2, 2, 0, yes
2961260590,  fioretti_bruno, 4, 4, 0, yes
407240144,  Paoloantoniog, 1, 1, 0, yes
4622527179,  Benedo1205, 4, 3, 1, yes
895943784,  MiccoliDonato, 1, 1, 0, yes
117363440,  ricci_davide77, 5, 4, 1, yes
196586897,  radioserpe, 1, 1, 0, yes
1052239855,  LomboDavide, 1, 1, 0, yes
3148498593,  giampierotomas5, 28, 22, 6, yes
2761811845,  bancaa62, 1, 1, 0, yes
772908959598579712,  setidicessi, 1, 1, 0, yes
2804360437,  grandespesa, 2, 2, 0, yes
1241549911,  geviAnziano, 11, 11, 0, yes
446999468,  lbertero, 2, 1, 1, neutral
1627547640,  chiarabd, 2, 2, 0, yes
229637673,  giordalbano, 1, 1, 0, yes
1283829570,  rosmus63, 1, 1, 0, yes
175344168,  Hardcore3000, 1, 1, 0, yes
463866926,  federico_pagani, 1, 1, 0, yes
1065271796,  peppev1975, 1, 1, 0, yes
253594450,  glminotti, 3, 2, 1, yes
420620863,  SerenaSignorile, 1, 1, 0, yes
3068635497,  Merygatto, 2, 2, 0, yes
741331243,  carlaandreani1, 1, 1, 0, yes
4851133229,  Eleberto03, 1, 1, 0, yes
578127658,  enricovannelli, 3, 3, 0, yes
2773639269,  GuidSarti, 1, 1, 0, yes
3388751235,  I_Epifani, 1, 1, 0, yes
3297505190,  ruttoah, 1, 1, 0, yes
2523003921,  saudavde, 1, 1, 0, yes
775430995,  teresina70, 1, 1, 0, yes
144800374,  babidelsala, 4, 2, 2, neutral
396740288,  MGallai, 3, 2, 1, yes
702230762679099392,  progna11, 1, 1, 0, yes
356964669,  dlp6666, 1, 1, 0, yes
3094627961,  faunaticss, 1, 1, 0, yes
456669008,  Matteo_Boscolo, 2, 2, 0, yes
410985556,  wendyaramis, 1, 1, 0, yes
728079451,  EmilienTonner, 2, 2, 0, yes
18972220,  anidride, 1, 1, 0, yes
1449773773,  APolieri, 1, 1, 0, yes
706922707137466368,  joyerivoluzione, 1, 1, 0, yes
2985820509,  gardi_2, 1, 1, 0, yes
3334915792,  AddageCulappis, 1, 1, 0, yes
1460233874,  guidofavotto, 1, 1, 0, yes
1272245834,  NPagliazzo, 1, 1, 0, yes
788371122815377408,  moonlightbaemoo, 1, 1, 0, yes
798743185,  ehjswift, 1, 1, 0, yes
103395147,  brusa69, 2, 2, 0, yes
3325113766,  0062Enza, 2, 2, 0, yes
3350536221,  Giadabigone, 2, 2, 0, yes
2291206839,  PuntariSilvia, 1, 1, 0, yes
990881832,  patrizietta63, 1, 1, 0, yes
1474200126,  ReFulvio, 1, 1, 0, yes
779405054147190784,  ototsinnavoig, 5, 5, 0, yes
1275209630,  giandomenicotur, 1, 1, 0, yes
724688353,  GiuseppeSavio68, 1, 1, 0, yes
2214021765,  ConcyeFrancesco, 8, 5, 3, yes
775382070793269249,  encarnamartin72, 1, 1, 0, yes
803895871993769984,  Corazonsociali, 1, 1, 0, yes
987492506,  vero_vevvi, 2, 2, 0, yes
1041829394,  mrosatizenit, 2, 2, 0, yes
375296840,  francescoprof, 3, 3, 0, yes
451348851,  Ebo888, 1, 1, 0, yes
856077841,  G_Gambardella_, 1, 1, 0, yes
1320807512,  falvocel, 1, 1, 0, yes
386685841,  madliber, 3, 3, 0, yes
950448152,  AlbertoSette, 5, 3, 2, yes
2229631676,  8linus, 3, 2, 1, yes
4310313034,  CarmeloLodato, 1, 1, 0, yes
114178520,  sergiopassariel, 1, 1, 0, yes
773906320965636097,  VillanovaChiara, 1, 1, 0, yes
1332329335,  Lory5346, 1, 1, 0, yes
2364668066,  OrnellaCarmenRo, 1, 1, 0, yes
3304876522,  sakkett1, 1, 1, 0, yes
257898123,  M_aruxa, 1, 1, 0, yes
3028964029,  stefano251170, 1, 1, 0, yes
3400573631,  MsAlexandraG, 1, 1, 0, yes
431075866,  rtefatto, 1, 1, 0, yes
352395973,  DarioZ86, 1, 1, 0, yes
1342441609,  FrancoPeli, 1, 1, 0, yes
805744495836983296,  pierolaforgia72, 4, 4, 0, yes
2558894673,  ClaytonTouchton, 1, 1, 0, yes
1169922139,  massimo_zanoni, 1, 1, 0, yes
2850238844,  FiataF, 1, 1, 0, yes
2155593669,  lapattyoscar, 1, 1, 0, yes
53744037,  b51br, 2, 2, 0, yes
746361392974929920,  Sergio28644342, 2, 2, 0, yes
472266275,  cesare_emilio, 1, 1, 0, yes
596487636,  _LeonSD_, 2, 2, 0, yes
4143037823,  elisanekka, 4, 4, 0, yes
805748126921478145,  LoveraMichele, 1, 1, 0, yes
805652276098506752,  Vincenzo83K, 1, 1, 0, yes
73612964,  MaryDT7, 3, 3, 0, yes
4309625183,  carinaolly, 2, 2, 0, yes
805751783352127488,  Alberto45687180, 2, 2, 0, yes
1274877708,  Silvia1F, 3, 3, 0, yes
2386218969,  MadauAndrea, 1, 1, 0, yes
2394377735,  cleri_luigi, 2, 1, 1, neutral
702886645012496385,  NicolaRz11, 3, 3, 0, yes
3086806317,  CanalePolitico, 1, 1, 0, yes
2440037826,  sergiog0852, 1, 1, 0, yes
1002420390,  babipepe, 2, 2, 0, yes
2372056838,  DJphilrop, 1, 1, 0, yes
3133644364,  GerlandoPiazza, 1, 1, 0, yes
2979093669,  NomeCognome1983, 1, 1, 0, yes
1635677815,  FabioFulgheri, 1, 1, 0, yes
340852625,  vito_falcone, 2, 2, 0, yes
1241466834,  OCiancarelli, 1, 1, 0, yes
1278146580,  luciapolets, 2, 1, 1, neutral
470440954,  bcoppolab, 1, 1, 0, yes
424129589,  Gianmarco_ace, 1, 1, 0, yes
340845843,  sergisuarezm, 1, 1, 0, yes
700785096853495808,  stefaninopato, 1, 1, 0, yes
300747842,  figidast, 2, 2, 0, yes
243100646,  slide75, 1, 1, 0, yes
615526160,  SalaGiuliano, 2, 2, 0, yes
444611981,  Francescovetro, 1, 1, 0, yes
805704733356916736,  MariaCorronca, 2, 2, 0, yes
2868144198,  AlNiCo88, 1, 1, 0, yes
725677299505463297,  fabio_banana, 1, 1, 0, yes
1401984294,  daludr, 1, 1, 0, yes
2968165661,  p26483193, 1, 1, 0, yes
709573328,  AlexaRava24, 2, 2, 0, yes
785985792032333824,  MarcelloRinal12, 1, 1, 0, yes
116278363,  zymetta, 1, 1, 0, yes
29541358,  grgcln, 1, 1, 0, yes
436639077,  naswuic, 1, 1, 0, yes
805706600392642560,  PVentrella52, 1, 1, 0, yes
712760049039450113,  filippozingales, 1, 1, 0, yes
4808051859,  swiatzmarsa, 2, 2, 0, yes
439448960,  ACorraa, 1, 1, 0, yes
1182936842,  robinetitaly, 1, 1, 0, yes
435145706,  0Dark_Knight0, 1, 1, 0, yes
559461859,  ninoalfio64, 1, 1, 0, yes
288221412,  vittoriocann, 1, 1, 0, yes
385828862,  xavolt65, 1, 1, 0, yes
280495327,  Rivalevante, 1, 1, 0, yes
1017562789,  GiovanniB14, 2, 2, 0, yes
705594306,  r_capitelli, 1, 1, 0, yes
84053797,  simosimonetti, 2, 2, 0, yes
4117718308,  accidentiame, 1, 1, 0, yes
555192641,  ciastensperfume, 2, 2, 0, yes
634024815,  hugmeemma, 1, 1, 0, yes
1106420090,  StefanoBarondi, 1, 1, 0, yes
2867041523,  forzatro, 1, 1, 0, yes
554826116,  StylianosChas, 1, 1, 0, yes
264939350,  mauri1947, 1, 1, 0, yes
2349155478,  FrancescoSalust, 3, 3, 0, yes
712588248,  scadutiano, 2, 2, 0, yes
1081169252,  grazia_natola, 3, 1, 2, no
1313965278,  AndreasLandeck, 1, 1, 0, yes
2365766426,  ZaffinoMonika, 3, 3, 0, yes
1018334928,  lallalio, 1, 1, 0, yes
3351742565,  giamminuti, 2, 2, 0, yes
852752916,  marietti64, 3, 3, 0, yes
1079394200,  Fede89Rica, 1, 1, 0, yes
2844801753,  babyversy, 3, 3, 0, yes
1916823222,  daniela_pippi, 2, 2, 0, yes
4404268156,  angelamula_, 2, 2, 0, yes
569450807,  olyzan, 1, 1, 0, yes
756738252741173248,  MicheleFlorio75, 1, 1, 0, yes
701309834612834304,  CalzatureAlis, 1, 1, 0, yes
481914528,  Unapistaavanti, 1, 1, 0, yes
805673545326088192,  Garla90, 1, 1, 0, yes
536382318,  rupitsch_dani, 1, 1, 0, yes
76052454,  giupino, 2, 1, 1, neutral
510751101,  AgneseG66, 1, 1, 0, yes
424023407,  enzoagadir, 1, 1, 0, yes
404014024,  AndreaHAWKSala, 2, 2, 0, yes
8077262,  trinamilan, 1, 1, 0, yes
1269849498,  vinicioceriolo, 1, 1, 0, yes
412409340,  marcorabitti, 2, 2, 0, yes
2852089005,  francocondiorio, 1, 1, 0, yes
2808781408,  BrunoBosello, 1, 1, 0, yes
1294287236,  MBrengola, 1, 1, 0, yes
558776811,  FloradeaMarina, 1, 1, 0, yes
613009095,  marycacciola, 1, 1, 0, yes
792736317931126784,  aquavtansa, 1, 1, 0, yes
1558337898,  LBonotti, 1, 1, 0, yes
4865074755,  Fire_z_z, 1, 1, 0, yes
1073430469,  LMussardo, 1, 1, 0, yes
2472194584,  maryann_terre, 2, 2, 0, yes
1241355780,  serging77, 3, 1, 2, no
566458191,  stuppoj, 1, 1, 0, yes
423717140,  masfond, 1, 1, 0, yes
840510163,  CristianaNaddeo, 1, 1, 0, yes
190591610,  BravaBeba, 1, 1, 0, yes
1158249168,  mieleastorino, 1, 1, 0, yes
33164109,  floramc, 1, 1, 0, yes
786308228095340544,  annasuprema, 1, 1, 0, yes
2207550247,  metodus1, 2, 2, 0, yes
1039613491,  aristillus2005, 1, 1, 0, yes
257109868,  ziananna, 1, 1, 0, yes
1374637550,  ZonaJuventina, 2, 2, 0, yes
323878685,  LucaMorandi1, 1, 1, 0, yes
2667057603,  VeraldiMaria, 1, 1, 0, yes
488851237,  mariaberrini, 1, 1, 0, yes
223130096,  redphoinix, 1, 1, 0, yes
428860185,  ChiricoJulia, 2, 2, 0, yes
385352177,  sciurok, 1, 1, 0, yes
631294299,  MariaTrozzi1, 2, 2, 0, yes
713757367884713987,  MagicoNapoli74, 1, 1, 0, yes
97220033,  f_fornaroli, 2, 2, 0, yes
801142783461457920,  Ilpaia2, 1, 1, 0, yes
389702935,  GFurfaro, 1, 1, 0, yes
49430646,  saved_design, 1, 1, 0, yes
313834398,  reasal1976, 1, 1, 0, yes
2876671889,  albertoboetto1, 2, 2, 0, yes
818182363,  irinac11, 1, 1, 0, yes
191071364,  FedeBertani, 2, 2, 0, yes
2956235267,  raffaeleschett, 1, 1, 0, yes
122082911,  VLizzi, 2, 2, 0, yes
1566553698,  GianniCuperIoPD, 5, 1, 4, no
722928812,  FraMuscolino, 1, 1, 0, yes
542818828,  Sussa89, 2, 2, 0, yes
469505249,  MarcoMacagnino, 1, 1, 0, yes
714202052281376769,  ela_dona, 3, 3, 0, yes
225000119,  vituz82, 2, 2, 0, yes
212534833,  FranciTitti, 1, 1, 0, yes
1189893553,  di_mdg, 2, 2, 0, yes
2425499532,  SerafinaF94, 1, 1, 0, yes
418218418,  alessandromanc5, 1, 1, 0, yes
435697521,  micdv, 2, 2, 0, yes
407134990,  PieroPutzu, 3, 3, 0, yes
2318542022,  Bglmaster, 7, 7, 0, yes
966116808,  Etrusco1947, 1, 1, 0, yes
3309282801,  iDemLab, 2, 2, 0, yes
2475090007,  defeostefano, 1, 1, 0, yes
2248753854,  RegoloLeonis, 1, 1, 0, yes
188657817,  campiglioweb, 2, 1, 1, neutral
1261756135,  beatricemanarin, 1, 1, 0, yes
253280534,  jadorelesshoes, 2, 2, 0, yes
2891120987,  vittosepe, 4, 4, 0, yes
198422919,  romymaggi, 1, 1, 0, yes
921732799,  alberti_simone, 1, 1, 0, yes
805768460802412544,  Chiara07366528, 1, 1, 0, yes
501931987,  Savesua5, 3, 2, 1, yes
407005066,  caterinachiera, 1, 1, 0, yes
2369389563,  lucianoiacone, 1, 1, 0, yes
2231611506,  fucxthesystemxx, 3, 3, 0, yes
312582218,  lizymontiel, 6, 5, 1, yes
2224174931,  allegro_paolo, 2, 2, 0, yes
2742139576,  dany9133, 1, 1, 0, yes
2788092205,  alekosur, 1, 1, 0, yes
22606965,  antokrx, 2, 2, 0, yes
2496227263,  RotaLivia, 1, 1, 0, yes
1154864036,  RitaBarbiero, 1, 1, 0, yes
3818006541,  lisi36120711, 7, 7, 0, yes
434893071,  GloriaPanicucci, 2, 2, 0, yes
2312580235,  jeromegrataloup, 1, 1, 0, yes
631399903,  manuelquattrini, 1, 1, 0, yes
87661977,  alea70, 1, 1, 0, yes
2369517341,  CampiRoberta, 1, 1, 0, yes
549409525,  ybor17, 1, 1, 0, yes
403703062,  mauromanassero, 2, 1, 1, neutral
421083877,  la_may1999, 2, 2, 0, yes
4736405595,  Lino074, 1, 1, 0, yes
439809336,  pennepazze10, 1, 1, 0, yes
759957008904818688,  FrancescoStra83, 2, 1, 1, neutral
633715398,  OrricoCarmine, 2, 2, 0, yes
721911823,  voltagemat, 3, 3, 0, yes
488493171,  Milly5161, 2, 2, 0, yes
16823632,  celticskoda, 1, 1, 0, yes
805643698520358913,  Angela42735350, 1, 1, 0, yes
346548309,  chiellangelo, 1, 1, 0, yes
785452529341571073,  luisa71709376, 2, 2, 0, yes
101348150,  fel_molina, 3, 3, 0, yes
393644544,  catia_t, 2, 1, 1, neutral
2812037741,  ElenaferrariIt, 1, 1, 0, yes
712972584804040704,  signoraerrore, 2, 1, 1, neutral
147483450,  alex69rm, 1, 1, 0, yes
235078393,  setegeco, 2, 2, 0, yes
2151500878,  CaridiMassimo, 1, 1, 0, yes
4918510954,  RoLag21, 2, 2, 0, yes
408554419,  tomcarlisi, 1, 1, 0, yes
4765129729,  NicoND96, 2, 1, 1, neutral
509261632,  GoGoDemyNihon, 1, 1, 0, yes
32830281,  pvechi, 6, 1, 5, no
156408151,  emafederigo, 1, 1, 0, yes
1145851867,  FaveroLaura, 1, 1, 0, yes
449654453,  Fabrizio_Baggi, 6, 6, 0, yes
357926721,  AlessandroC_93, 3, 2, 1, yes
704675757138825217,  lorenzo_lollo3, 1, 1, 0, yes
749172945520627712,  gerrycapone721, 8, 8, 0, yes
471610331,  joelombardii, 1, 1, 0, yes
926178380,  FabrizioNanni3, 2, 2, 0, yes
221581460,  corradoval, 12, 5, 7, no
52413488,  jegutierrezr, 1, 1, 0, yes
805574809136615424,  pietro_tasselli, 2, 2, 0, yes
805577950414376960,  Marcololita11, 2, 2, 0, yes
200880124,  guiesbroglio, 1, 1, 0, yes
904262064,  Samusamros, 1, 1, 0, yes
805570344593616896,  ErraGaetano, 1, 1, 0, yes
151382530,  Avallo2, 1, 1, 0, yes
1319007457,  simone_moriconi, 1, 1, 0, yes
497805650,  domak89, 1, 1, 0, yes
406832777,  GianniPetta, 5, 5, 0, yes
268789878,  huguenau, 2, 1, 1, neutral
14639500,  thomas_quinlan, 1, 1, 0, yes
400689705,  SimNardone, 1, 1, 0, yes
420990645,  CarlaGison_, 1, 1, 0, yes
780073135429255168,  AlsOb_Originale, 1, 1, 0, yes
919808533,  vinsurfer, 1, 1, 0, yes
702974057642397698,  Dontellher, 3, 3, 0, yes
2916200512,  scatofranco, 1, 1, 0, yes
2994415060,  tessatessitrice, 1, 1, 0, yes
226911890,  Fbarone_, 1, 1, 0, yes
201931602,  _Rikachan92, 1, 1, 0, yes
3065674659,  mara_alai, 1, 1, 0, yes
60358136,  giovanna_dan, 1, 1, 0, yes
7205502,  lviggiano, 2, 2, 0, yes
801178866,  marcololo14, 1, 1, 0, yes
1049083952,  Antibiogramma, 1, 1, 0, yes
369504287,  a_nocera, 2, 2, 0, yes
2506952330,  lenor1799, 1, 1, 0, yes
1134246404,  sacchi_bula2000, 1, 1, 0, yes
2455581933,  AnassorLp, 1, 1, 0, yes
721591701958193152,  AliceBelli6, 1, 1, 0, yes
1377393654,  FiorellaNavarra, 1, 1, 0, yes
957357619,  sabrina_rilievo, 5, 1, 4, no
200111887,  AlfonsoZamb, 1, 1, 0, yes
427766337,  SdmsMario, 3, 2, 1, yes
987564762,  ErricoTestai, 2, 2, 0, yes
72423039,  fefyno, 1, 1, 0, yes
195421730,  matteoleo17, 3, 1, 2, no
360001807,  savManganelli91, 1, 1, 0, yes
997853018,  gioiaesu, 1, 1, 0, yes
410808183,  frankh4f, 1, 1, 0, yes
88757516,  carolaferrero, 1, 1, 0, yes
805707555926315008,  dicmardi, 1, 1, 0, yes
170205783,  EdoNicolino, 2, 2, 0, yes
707247204067627008,  Salvato26215899, 3, 3, 0, yes
3081713651,  SpolaorMichele, 1, 1, 0, yes
1127594510,  stefanienko, 1, 1, 0, yes
784828953726951428,  Orazio60449363, 2, 1, 1, neutral
124345123,  PlaGrillo86, 1, 1, 0, yes
468430275,  maxinosilvagni, 1, 1, 0, yes
2165200374,  miredoma, 1, 1, 0, yes
269250682,  jechusrl, 1, 1, 0, yes
2547561248,  gattitudine1, 1, 1, 0, yes
1440871855,  Sabrina191268, 1, 1, 0, yes
244601988,  daniemma79, 1, 1, 0, yes
2459671716,  bludivetro, 1, 1, 0, yes
1359325890,  KatiaMendonca2, 3, 3, 0, yes
3081602615,  GhiribelliIvana, 5, 3, 2, yes
32426416,  gual89, 7, 6, 1, yes
805784088040841216,  RoscioliTerry, 2, 2, 0, yes
2521800327,  DBignardelli, 1, 1, 0, yes
463896170,  felice11112, 1, 1, 0, yes
298084931,  mikio68, 2, 2, 0, yes
2561389675,  MallamoV, 1, 1, 0, yes
715252826100908032,  FortesEric, 2, 2, 0, yes
526310900,  ManucorRanucci, 1, 1, 0, yes
4735786301,  Dani60612766, 1, 1, 0, yes
300890546,  mentresfiorisci, 1, 1, 0, yes
379181606,  Pivvicci, 1, 1, 0, yes
2672988437,  AvvNava, 1, 1, 0, yes
147523248,  sara_mou, 1, 1, 0, yes
2330617431,  vitrus04, 1, 1, 0, yes
717368319720996864,  argenzianoandre, 2, 2, 0, yes
15201435,  iMestie, 2, 2, 0, yes
484720090,  Micheledso, 1, 1, 0, yes
47146332,  paoloerrico, 3, 3, 0, yes
410815523,  pisantarcangelo, 1, 1, 0, yes
787384443468120064,  emilianolicata8, 1, 1, 0, yes
2888782565,  AngelicaLussoso, 2, 1, 1, neutral
996099361,  dariolopez995, 1, 1, 0, yes
1204787492,  halloreus, 1, 1, 0, yes
2193130324,  euanjoc8, 1, 1, 0, yes
1516887624,  ManuMarzullo, 6, 6, 0, yes
428436694,  Ceansemo1, 2, 2, 0, yes
430117441,  sergiogranata, 3, 3, 0, yes
96190394,  NedGoodmorning, 2, 2, 0, yes
17675379,  HeyTony, 2, 2, 0, yes
51848164,  danielelussana, 1, 1, 0, yes
2365717887,  roccopepe74, 1, 1, 0, yes
12944312,  frafacchini, 1, 1, 0, yes
1001373350,  MargheritaIngog, 2, 2, 0, yes
489375718,  DomenicaMita, 4, 3, 1, yes
495912591,  Rikybow, 2, 2, 0, yes
899426814,  GiovanniGuit, 1, 1, 0, yes
953901380,  paolaxmi, 4, 3, 1, yes
2390828979,  calippo4, 1, 1, 0, yes
2376749525,  AngelaM04894863, 3, 3, 0, yes
14430452,  paolafurlanetto, 4, 4, 0, yes
527721535,  irLemure, 3, 2, 1, yes
416285453,  UdelSorbo, 1, 1, 0, yes
226134529,  nadiaferrigo, 5, 4, 1, yes
263285610,  alegrade, 2, 2, 0, yes
3063242561,  Romanticgirl82, 3, 3, 0, yes
3330742059,  idrogenosagunti, 1, 1, 0, yes
1083117258,  JennyHalo, 1, 1, 0, yes
1491589495,  lawfulbusiness, 1, 1, 0, yes
734086367567810563,  PalmentieriAnna, 2, 2, 0, yes
2315532764,  GioGiachetti, 1, 1, 0, yes
4184747841,  georgemary17, 3, 2, 1, yes
755723976089997312,  claudiofedalto2, 1, 1, 0, yes
96232247,  fiorallo, 1, 1, 0, yes
74995813,  claudioguerrini, 2, 2, 0, yes
18488759,  montyke, 1, 1, 0, yes
888388093,  GianMariaRossi1, 2, 2, 0, yes
2435464324,  lorenzoo_97, 1, 1, 0, yes
805550712843276288,  Lidia93929192, 6, 6, 0, yes
2968709417,  bibi_1969, 2, 2, 0, yes
120283561,  juliomondongo, 1, 1, 0, yes
799748562451955712,  i4tuttofare, 1, 1, 0, yes
1215114912,  MelilloGiulio, 5, 5, 0, yes
141930503,  mbellog, 1, 1, 0, yes
61882487,  supermaries, 1, 1, 0, yes
1976143964,  salvalamamma, 1, 1, 0, yes
1926850398,  charliect95, 1, 1, 0, yes
250380546,  Guidisu, 1, 1, 0, yes
168412461,  lauragrazio, 1, 1, 0, yes
33569608,  gaiajeanne, 5, 5, 0, yes
305227298,  defrasimo, 1, 1, 0, yes
391429640,  francafi, 1, 1, 0, yes
759939776,  Jerryfurmanto, 1, 1, 0, yes
112729300,  ilMenestrelloh, 2, 2, 0, yes
128202270,  francescosonic, 1, 1, 0, yes
48297226,  koalacurioso, 2, 2, 0, yes
3562838476,  stefano_lanari, 1, 1, 0, yes
94542389,  AlessioRib, 1, 1, 0, yes
2710368439,  AglioAndrea, 1, 1, 0, yes
952076750,  stepoli94, 2, 2, 0, yes
265440620,  mateuramonell, 1, 1, 0, yes
595452139,  Marco_La_To, 1, 1, 0, yes
2300003405,  BriatOro, 2, 2, 0, yes
108347060,  briseide89, 1, 1, 0, yes
108296587,  alexcente, 1, 1, 0, yes
2406163925,  RobertoTacchett, 2, 2, 0, yes
789357774148960256,  StefanoViscon10, 2, 1, 1, neutral
516917231,  AlbyMazzocco, 2, 2, 0, yes
322138898,  ErvisShyti, 1, 1, 0, yes
827633586,  margherita_be, 1, 1, 0, yes
88492487,  Barbaras96, 1, 1, 0, yes
781598569153388545,  catychris, 1, 1, 0, yes
131877405,  robertoparrilla, 2, 2, 0, yes
98117211,  federicoquarato, 1, 1, 0, yes
428035326,  orazio007, 3, 3, 0, yes
114057696,  JUANdeITALIA, 1, 1, 0, yes
600912795,  fedegiullari, 2, 2, 0, yes
870169790,  MimmoGy88, 22, 2, 20, no
751419456,  GuastellaMirko, 1, 1, 0, yes
3142613151,  uvastro, 3, 1, 2, no
55279199,  omedmit, 1, 1, 0, yes
2196113158,  ifloridia, 1, 1, 0, yes
527970508,  rosannapavarini, 1, 1, 0, yes
1300155240,  CoerenzaBat, 2, 2, 0, yes
101038138,  AndreaBramante, 2, 2, 0, yes
2450320905,  REDUAN65897763, 1, 1, 0, yes
701133873892167680,  DB0723, 1, 1, 0, yes
204783320,  andree_it, 1, 1, 0, yes
35312284,  iorioleandro01, 2, 2, 0, yes
2438601076,  FilippoSantucc1, 1, 1, 0, yes
2900771690,  marcoc121, 1, 1, 0, yes
1019961229,  Cri_Mariani, 1, 1, 0, yes
311497321,  stefaniacav, 2, 2, 0, yes
499933495,  cacciotto, 1, 1, 0, yes
718346647,  GabriLazza, 1, 1, 0, yes
2253550327,  HisSoftHands, 4, 4, 0, yes
392720673,  JavierRengel33, 2, 2, 0, yes
427621676,  GiuliaZanga, 1, 1, 0, yes
764232175789178881,  chris_lovati98, 1, 1, 0, yes
1498406557,  lucabelisari, 1, 1, 0, yes
16630237,  pasqualemerella, 2, 2, 0, yes
261910864,  gianniPerrino, 10, 1, 9, no
1612882855,  valecapitani13, 1, 1, 0, yes
555569966,  Be_atrox, 4, 3, 1, yes
491710642,  FrankieCapp, 1, 1, 0, yes
1961961876,  Gingy47, 1, 1, 0, yes
732971994577260544,  RosaGirasole2, 1, 1, 0, yes
428157959,  MicGovernatori, 1, 1, 0, yes
2778766991,  Guida2Guida, 1, 1, 0, yes
574404666,  PaoloMPeroni, 1, 1, 0, yes
144305807,  WaleZeta, 1, 1, 0, yes
83980107,  dianaleyva, 1, 1, 0, yes
805553665104875521,  Wild42661527, 2, 2, 0, yes
108231021,  writingvee, 1, 1, 0, yes
359318553,  inzainapaolo, 2, 2, 0, yes
2524638900,  laurapez77, 1, 1, 0, yes
402442314,  ItaliusIt, 1, 1, 0, yes
592710075,  RoriaVittogo, 4, 2, 2, neutral
983393083,  AnUnholymind, 2, 2, 0, yes
3025920266,  f_altavilla, 6, 5, 1, yes
15780010,  danielevilla, 1, 1, 0, yes
710941585,  rotoloso, 1, 1, 0, yes
388346603,  gditom, 2, 2, 0, yes
2352436189,  iAmNotAI, 1, 1, 0, yes
787674705914425344,  Giovann50859711, 1, 1, 0, yes
2741796327,  DanDanielbd, 3, 2, 1, yes
428219212,  duccio55, 2, 2, 0, yes
481972353,  AndreaBrussi, 4, 3, 1, yes
2809647934,  fiammetta2401, 2, 2, 0, yes
25388119,  HenkStrating, 2, 2, 0, yes
91606617,  andreazanardo, 1, 1, 0, yes
62247336,  mulbi, 1, 1, 0, yes
14724500,  carloalberto, 4, 4, 0, yes
525426895,  diananastasi, 1, 1, 0, yes
370144551,  FloClucas, 1, 1, 0, yes
1887983425,  benemor93, 1, 1, 0, yes
326678478,  ValeriaC85, 4, 4, 0, yes
1090184910,  Sara_1DGiaccari, 6, 4, 2, yes
32921266,  Darkshewitsch, 1, 1, 0, yes
420482362,  sfogliariccia, 1, 1, 0, yes
195149491,  leo_mastromauro, 5, 5, 0, yes
2189164361,  ArashBayani, 1, 1, 0, yes
386479091,  lucianoaprea, 1, 1, 0, yes
2605678901,  meriam_k7, 1, 1, 0, yes
148789621,  ottodj8, 2, 2, 0, yes
89947367,  isabelledaniel, 1, 1, 0, yes
629282840,  tritacibo, 1, 1, 0, yes
2895608547,  martinariva_, 4, 4, 0, yes
50649238,  marcobava, 10, 5, 5, neutral
739646939998900224,  CharlyTheSurfer, 4, 1, 3, no
788754994262581248,  dantonidario1, 3, 1, 2, no
4076026275,  PensieriCanini, 1, 1, 0, yes
418226638,  GaiaAlia, 4, 4, 0, yes
88640824,  MartaRocknRoll, 1, 1, 0, yes
253334452,  Ezequiel_3010, 1, 1, 0, yes
2847486503,  EmmaEmmacordero, 4, 2, 2, neutral
2372115242,  Euroit01, 4, 4, 0, yes
385031350,  avenue1975, 2, 2, 0, yes
2875009713,  tomasin_luca, 2, 2, 0, yes
978059748,  annacastellari1, 2, 2, 0, yes
730500481,  LucDeco7, 1, 1, 0, yes
19148041,  tigerymous, 1, 1, 0, yes
319191175,  InigoSFC, 1, 1, 0, yes
4240215975,  enricatommaso, 1, 1, 0, yes
55376849,  trecarte, 6, 6, 0, yes
1481592145,  CereschiChiara, 1, 1, 0, yes
51048212,  youssefsalah, 1, 1, 0, yes
492345799,  ratatre, 1, 1, 0, yes
2543873678,  minholdme, 2, 2, 0, yes
2315393595,  WalterGualtieri, 3, 3, 0, yes
576924347,  letiziatognetti, 1, 1, 0, yes
1270353937,  Giullyx, 1, 1, 0, yes
264978128,  Ale_Spike77, 3, 1, 2, no
761328090,  CrissAlle, 1, 1, 0, yes
524159323,  TheRealPalva, 1, 1, 0, yes
802111613218226176,  AndreaSQZNDR, 1, 1, 0, yes
636850241,  VirginiaGiovann, 1, 1, 0, yes
709667591896301568,  ManuelaDiMiero, 2, 2, 0, yes
3289025019,  lucabertosso, 1, 1, 0, yes
49756656,  enricouberti, 1, 1, 0, yes
1649236650,  Hyori_M, 1, 1, 0, yes
968097420,  porcostark, 1, 1, 0, yes
728896590077890561,  Androme43310523, 1, 1, 0, yes
70483547,  IreneCampi, 1, 1, 0, yes
2345750573,  APetetti, 3, 1, 2, no
101805791,  micipanvi, 1, 1, 0, yes
2326650571,  rti922, 1, 1, 0, yes
338354087,  margolouda, 1, 1, 0, yes
301472331,  htan987, 1, 1, 0, yes
735939947862069248,  basel_RF, 1, 1, 0, yes
436778483,  LisaRimini, 1, 1, 0, yes
3033115726,  tatianasprea61, 1, 1, 0, yes
758790612548194305,  Isastoccarda, 1, 1, 0, yes
794144671236812801,  leobenning, 1, 1, 0, yes
3222471694,  antoniotnera, 1, 1, 0, yes
4209310042,  Walterdegiu, 1, 1, 0, yes
104206983,  axeman_74, 1, 1, 0, yes
792985680125231104,  MariaAnnaRB, 1, 1, 0, yes
1474056793,  broccato1, 1, 1, 0, yes
725563716830433281,  ConcettaAra, 1, 1, 0, yes
182852214,  fabri_firenze, 1, 1, 0, yes
483016672,  stefanenkon, 1, 1, 0, yes
765911000499519488,  GatBudini, 1, 1, 0, yes
1040102317,  spumantina, 1, 1, 0, yes
549238410,  PaolaGlas, 1, 1, 0, yes
2316595409,  manu8_manuela, 3, 2, 1, yes
3394136717,  Andrea22CVDB, 1, 1, 0, yes
718051387507081217,  mattiazzo_anna, 1, 1, 0, yes
785958926084874241,  escoconfederica, 1, 1, 0, yes
758041897583648769,  lelas2016, 1, 1, 0, yes
2864983579,  s_a_n_t_i__n_o, 1, 1, 0, yes
1091771214,  therealpallazzo, 1, 1, 0, yes
709312725063745536,  tifoso_nontanto, 2, 2, 0, yes
1083672512,  TomeoPina, 2, 2, 0, yes
100964035,  umbertoliuzzo, 4, 4, 0, yes
18225368,  Mirjam_Fischer, 1, 1, 0, yes
2825948777,  lilly_venturi, 2, 2, 0, yes
359831779,  twmobillo, 1, 1, 0, yes
381962971,  bertazza1, 1, 1, 0, yes
1696402724,  AsfaltoDaniela, 2, 2, 0, yes
715756233433739264,  moriz61, 2, 2, 0, yes
3296033922,  AdaMicoli, 1, 1, 0, yes
68735558,  serpente1, 15, 1, 14, no
631802744,  Gianlu_Biscotti, 1, 1, 0, yes
1220918803,  bvittori2910, 1, 1, 0, yes
805007670063362048,  MarcelloAgosti4, 2, 1, 1, neutral
3089603359,  fedeciravegna, 1, 1, 0, yes
484091132,  ari_tweety, 2, 2, 0, yes
4646639727,  agilulfo99, 3, 2, 1, yes
392605313,  lorenzocadoni, 2, 1, 1, neutral
497707343,  BonaccorsoGiusi, 2, 2, 0, yes
387722961,  FlaviaGiugliano, 3, 3, 0, yes
185762697,  Nontwittatemi, 1, 1, 0, yes
569239961,  PortosoAntonio, 1, 1, 0, yes
2961103684,  yokovoice, 1, 1, 0, yes
439057342,  AlexSorgiovanni, 1, 1, 0, yes
1039222730,  augustavolonte, 1, 1, 0, yes
804779536026075136,  Lucio04543229, 1, 1, 0, yes
2641778662,  lucyluna1717, 1, 1, 0, yes
781120631651860485,  valeria_cozza, 2, 2, 0, yes
417772714,  GiorginiLuca, 2, 2, 0, yes
1106502974,  YookETembol, 1, 1, 0, yes
942291529,  MontagnaRosario, 4, 1, 3, no
305795020,  micheleleone3, 1, 1, 0, yes
39086167,  Vinokurov12, 1, 1, 0, yes
829603081,  ehimats, 1, 1, 0, yes
507764433,  IleniaQueen89, 5, 4, 1, yes
2854719148,  Grujic_Sergio, 7, 1, 6, no
203036196,  ALEMAMMOLO, 1, 1, 0, yes
507148157,  tocca1975, 3, 3, 0, yes
2320342343,  JackUgolini, 1, 1, 0, yes
398794197,  ExpoVitto, 1, 1, 0, yes
2892619148,  CosmaiLuca, 1, 1, 0, yes
4248771682,  Vincenz87871065, 8, 8, 0, yes
4876282354,  caputoribe, 1, 1, 0, yes
375147790,  fulvio42195, 1, 1, 0, yes
805537816004399104,  angia0503, 1, 1, 0, yes
44434107,  IlariaMe, 1, 1, 0, yes
4029616391,  paolo_rubicon, 3, 3, 0, yes
176493175,  fracristelli, 1, 1, 0, yes
434516255,  mirkomarinangel, 2, 2, 0, yes
1473203750,  fyrfos43, 2, 2, 0, yes
702901779512610816,  BI_Italia, 4, 4, 0, yes
1055347010,  dgr810, 3, 3, 0, yes
3374659810,  brancadoro66, 1, 1, 0, yes
34921877,  alparoneM5S, 2, 2, 0, yes
367884372,  barbarabononi, 1, 1, 0, yes
845386194,  ITALIA_REALE, 1, 1, 0, yes
215802504,  axw1975, 1, 1, 0, yes
447258138,  Orisfabio, 1, 1, 0, yes
430857804,  RDaquila, 8, 8, 0, yes
399915364,  Elypgl, 1, 1, 0, yes
47957761,  unicaiole, 1, 1, 0, yes
286682835,  fuss998, 4, 4, 0, yes
371671735,  AntoninoGentile, 1, 1, 0, yes
280794591,  EduardoSG_, 1, 1, 0, yes
484433561,  RenataErgas, 3, 3, 0, yes
4408432037,  OlgaAcuto, 3, 3, 0, yes
593164921,  PolattiVittori, 4, 4, 0, yes
805764128346411008,  Fabrizi10055682, 1, 1, 0, yes
410968783,  Elenaandsam, 7, 5, 2, yes
216458235,  Stedici7, 2, 1, 1, neutral
255106819,  andebonis, 1, 1, 0, yes
2211027499,  MiriaBenv, 4, 4, 0, yes
200235787,  paoloceriani, 3, 3, 0, yes
786532659560378368,  14f7040881a44b4, 1, 1, 0, yes
701115812887863296,  antopana58, 1, 1, 0, yes
804945744440557568,  Procopiovic, 2, 1, 1, neutral
236114749,  federicaMos, 2, 2, 0, yes
1392759961,  Luz_Color_PMA, 5, 5, 0, yes
1449105295,  giorgina_genova, 1, 1, 0, yes
1159508454,  EdoardoAdinolfi, 2, 2, 0, yes
3006534209,  mames2009, 2, 1, 1, neutral
375035919,  stranciadj, 13, 9, 4, yes
218669136,  carmelacascardi, 1, 1, 0, yes
176761511,  bedlamGibo, 1, 1, 0, yes
2612207642,  MJhiantash, 2, 2, 0, yes
375067842,  magia500, 2, 2, 0, yes
1007480737,  carlo21947, 4, 4, 0, yes
2379093554,  TeresaOrvitti, 1, 1, 0, yes
991798530,  Raffywinx, 1, 1, 0, yes
1640956932,  gigserra, 1, 1, 0, yes
2486830840,  wdad635, 1, 1, 0, yes
1072273849,  GrilliGabriella, 1, 1, 0, yes
511817789,  AmatiRosa, 1, 1, 0, yes
372413560,  FedericoVilla2, 1, 1, 0, yes
3854643994,  trippottina69, 1, 1, 0, yes
2704876576,  r_lopardo, 1, 1, 0, yes
3096568605,  MPernozzoli, 1, 1, 0, yes
805764744405729280,  Frances28674570, 1, 1, 0, yes
40073347,  serendipityhope, 2, 2, 0, yes
2929353701,  manucomodo, 2, 2, 0, yes
233296056,  Luca_Doc, 1, 1, 0, yes
2813387405,  MartaSic_u92, 2, 2, 0, yes
1377055243,  magio5152, 1, 1, 0, yes
716602053594886144,  Toni5417, 1, 1, 0, yes
392442764,  AlexSicuro, 1, 1, 0, yes
2908377789,  goncalogouveia5, 2, 2, 0, yes
1688883962,  ErnestoTomovari, 2, 1, 1, neutral
104067089,  pjcorno, 3, 3, 0, yes
2226879815,  sticazzibook, 1, 1, 0, yes
858745213,  LaReginadelGass, 2, 2, 0, yes
587422277,  Filippo_Cannata, 4, 3, 1, yes
470454833,  RobyStelly, 1, 1, 0, yes
784363401086640128,  alcott_e, 1, 1, 0, yes
209128079,  viva2pa, 1, 1, 0, yes
447972229,  zaserflux, 1, 1, 0, yes
87951840,  Moissiadis, 1, 1, 0, yes
2995618624,  LauraLana16, 3, 2, 1, yes
1139353296,  mingo_tel, 1, 1, 0, yes
117685917,  Biancamim, 2, 2, 0, yes
1597905877,  tordizuin, 2, 2, 0, yes
35008728,  _DorianGray_, 2, 2, 0, yes
412126193,  CavallaroMario, 2, 2, 0, yes
2385082842,  OrnellaRocchi70, 1, 1, 0, yes
2877038855,  ciopparider, 2, 1, 1, neutral
284665608,  flawyles, 1, 1, 0, yes
2151532925,  glia_ta, 1, 1, 0, yes
2389014177,  MimmoRuvioli, 1, 1, 0, yes
972924974,  Lupus_Italicus, 1, 1, 0, yes
424485335,  PandolfiAntonio, 1, 1, 0, yes
151235181,  DaroDictar, 1, 1, 0, yes
192899133,  fam_cristiana, 3, 3, 0, yes
2163384082,  raffasoda, 1, 1, 0, yes
2428289656,  deluna_marco, 1, 1, 0, yes
799003630758219779,  lilloelilla, 1, 1, 0, yes
256697871,  carluc0811, 6, 5, 1, yes
2330062987,  CoppaLandini, 1, 1, 0, yes
556976779,  enzoceci1, 1, 1, 0, yes
3001281077,  AleLib94, 1, 1, 0, yes
396892501,  mprimucci, 1, 1, 0, yes
1521273655,  Fabrizio_Rig, 1, 1, 0, yes
3306834975,  elGiuG, 3, 3, 0, yes
165033852,  loniparn, 1, 1, 0, yes
804756049634922496,  BOUVIER511, 1, 1, 0, yes
776168190225346563,  Almar_6, 1, 1, 0, yes
2774510831,  FCRayleigh, 1, 1, 0, yes
34917834,  Angeloconte, 2, 1, 1, neutral
1037729216,  donutcake74, 1, 1, 0, yes
198315154,  asadex, 1, 1, 0, yes
2980162055,  LiliCastellini_, 14, 13, 1, yes
2751643757,  FVerdi79, 3, 1, 2, no
2245748490,  MicheleC_FARE, 1, 1, 0, yes
413416371,  agoman1, 2, 1, 1, neutral
534850953,  RobertoConsalvi, 2, 2, 0, yes
406332113,  paolotoselli, 1, 1, 0, yes
706421092706086912,  ikramharchi8, 1, 1, 0, yes
387136877,  alberto_bottini, 2, 2, 0, yes
3317884030,  renoir1960, 1, 1, 0, yes
2243615111,  ramonapauna90, 1, 1, 0, yes
268901808,  titolare61, 1, 1, 0, yes
3081612340,  borelli_simona, 2, 2, 0, yes
3011033356,  ggalluzzo78, 1, 1, 0, yes
109061479,  diegovallante, 1, 1, 0, yes
979266637,  pietrochiavari, 2, 2, 0, yes
712363182761877505,  Pacesempreora1, 1, 1, 0, yes
292605943,  BabyBlainers, 1, 1, 0, yes
475706168,  gabryjuly, 1, 1, 0, yes
799706128430952449,  Paolo67Carboni, 1, 1, 0, yes
71093090,  gian5conti, 3, 3, 0, yes
1119918066,  ArcHeisenberg, 3, 2, 1, yes
302781617,  gioscia1, 6, 4, 2, yes
1334981161,  rmacchiarelli1, 2, 2, 0, yes
559645302,  MicheleSoldato, 2, 2, 0, yes
763364971443027969,  craniopensante, 1, 1, 0, yes
431883303,  AdolfoRamirezS, 1, 1, 0, yes
1407784639,  ChiaraRommi, 5, 5, 0, yes
4795922362,  lomanto_fabio, 1, 1, 0, yes
2335271666,  Scioglievolex, 9, 7, 2, yes
69018873,  yasodah, 2, 2, 0, yes
194903681,  stedanese, 1, 1, 0, yes
573003143,  decrescenzo1963, 1, 1, 0, yes
791503408167608320,  luca69cor, 1, 1, 0, yes
36545286,  GUASABARAeditor, 1, 1, 0, yes
805012756831305728,  PasqualeCardin5, 2, 2, 0, yes
1628503506,  massimolorenti1, 2, 2, 0, yes
799218961774690304,  italianthings1, 1, 1, 0, yes
581716019,  fran_fabbro, 1, 1, 0, yes
188324305,  MarcoSalamina, 1, 1, 0, yes
283602058,  Luciosalis, 5, 2, 3, no
797114336732999680,  projectworkhub, 4, 2, 2, neutral
2575324780,  LuigiPignedoli, 1, 1, 0, yes
484337760,  francoinzirillo, 7, 1, 6, no
3137839473,  adriamopucella, 1, 1, 0, yes
312924932,  Kloin77, 1, 1, 0, yes
131538215,  vitoingparrotta, 1, 1, 0, yes
430192436,  MarioFranco73, 1, 1, 0, yes
2456331929,  Emilianomcm77, 1, 1, 0, yes
491322691,  match1975, 1, 1, 0, yes
67863892,  ciro_delsorbo, 3, 3, 0, yes
2963779595,  robertosol82, 1, 1, 0, yes
79435745,  gmenzietti, 2, 1, 1, neutral
3064658200,  AleBott88, 1, 1, 0, yes
1240934724,  waltergiannobi, 1, 1, 0, yes
4044499913,  Stefano_roca, 1, 1, 0, yes
1965439219,  logoriabilita, 1, 1, 0, yes
3254304580,  FerinaGiuseppe, 1, 1, 0, yes
2560462612,  LiciaLeone, 5, 5, 0, yes
1035435139,  544robby, 1, 1, 0, yes
994877034,  antoniofemia1, 1, 1, 0, yes
406916341,  1946joseph, 1, 1, 0, yes
1479710359,  mistral0342, 6, 5, 1, yes
53538705,  fred19hki, 1, 1, 0, yes
3353000968,  nelena_elena, 1, 1, 0, yes
796343050452795392,  OCrzr, 4, 4, 0, yes
300888596,  BencivengaPierf, 9, 5, 4, yes
10239182,  Vagabondsky, 1, 1, 0, yes
2726843513,  desolanoana, 3, 3, 0, yes
1833184711,  andreabortoluz2, 1, 1, 0, yes
130793905,  BobFierro, 1, 1, 0, yes
596841850,  DELIOCASSIANI, 3, 3, 0, yes
398609882,  PasqualiPaolo, 15, 7, 8, no
79139618,  RicScotti, 2, 2, 0, yes
4287057201,  GFRANCOGIL, 2, 1, 1, neutral
1513014650,  fpugliese_conad, 3, 3, 0, yes
7491772,  SimoneBressan, 1, 1, 0, yes
231857335,  FluidoGiallo, 1, 1, 0, yes
488470857,  RomuskaTakuya, 1, 1, 0, yes
1326556136,  francescogarro, 1, 1, 0, yes
629172230,  ernie6617, 1, 1, 0, yes
530969708,  giuvil_g, 4, 2, 2, neutral
499699824,  FrancescoLaFata, 1, 1, 0, yes
1926698492,  macrocredit, 1, 1, 0, yes
2246672993,  oznerolelatan, 2, 2, 0, yes
312933863,  SalNatoli, 1, 1, 0, yes
2778755675,  alli_galli2002, 3, 3, 0, yes
782890990269001729,  matteopetruz, 12, 11, 1, yes
415710724,  SartoriAngelica, 1, 1, 0, yes
1086639097,  AldoGebbia, 1, 1, 0, yes
64702834,  valentinoben, 3, 1, 2, no
54523440,  jaken23, 2, 2, 0, yes
3217218965,  NicGiulia, 21, 14, 7, yes
2295234958,  EBruttomesso, 2, 2, 0, yes
4726407682,  DanieleCebrelli, 1, 1, 0, yes
991663225,  risiculo, 2, 2, 0, yes
787550937430757376,  maurizietto1975, 1, 1, 0, yes
1389629858,  EdoardoFanucci, 1, 1, 0, yes
720789192,  LucianoMainardi, 1, 1, 0, yes
457592928,  AndreaPorcu_77, 1, 1, 0, yes
318316637,  LiciaRonzulli, 3, 3, 0, yes
2842050328,  Oliv950T, 1, 1, 0, yes
162073378,  PoemaQ, 1, 1, 0, yes
609462000,  Albertop2125, 1, 1, 0, yes
4328724748,  morsetto2, 1, 1, 0, yes
459007894,  vincenzodamore2, 2, 2, 0, yes
99579093,  pierpaologallo, 1, 1, 0, yes
97445316,  marcopixi, 1, 1, 0, yes
516918469,  SergioArzenton, 1, 1, 0, yes
213199539,  bergiov1, 2, 2, 0, yes
790222368216117248,  Corrado98235172, 1, 1, 0, yes
801140052,  TriathBlade, 2, 2, 0, yes
209012915,  ProgettoRENA, 1, 1, 0, yes
51045288,  frarusso, 1, 1, 0, yes
2953117947,  neri5301, 2, 2, 0, yes
253762746,  salvo_sic, 2, 2, 0, yes
311374813,  gravaioli, 1, 1, 0, yes
754791792281878529,  Ascall0, 1, 1, 0, yes
4909074515,  14ludo10, 2, 2, 0, yes
2795715798,  kimoduinne, 2, 2, 0, yes
414633804,  GGambatesa, 1, 1, 0, yes
194577734,  stellina58, 1, 1, 0, yes
436730674,  Pat_Gagliardi, 11, 11, 0, yes
191769619,  ElyBenni, 1, 1, 0, yes
798589575929233408,  Gabriel91556309, 2, 2, 0, yes
718865323559096320,  MaryPediatra, 1, 1, 0, yes
780154938529812480,  Massimi52761430, 2, 2, 0, yes
241658981,  upacill74, 3, 2, 1, yes
463954032,  somma_lello, 2, 2, 0, yes
3380276151,  juki_macario, 1, 1, 0, yes
3039370893,  grazzy_graziano, 2, 2, 0, yes
521136839,  ragnialdo, 4, 4, 0, yes
724835013959815168,  SalvatoreCusu10, 1, 1, 0, yes
745866738403770373,  bobsharing, 1, 1, 0, yes
593478988,  giambaloc, 8, 4, 4, neutral
783280828231086080,  toski78, 1, 1, 0, yes
713392370742591489,  serenagrillo9, 2, 2, 0, yes
167046497,  giusepperagno, 2, 2, 0, yes
126137269,  CervelloInFerie, 2, 2, 0, yes
2833623327,  MErpidio, 1, 1, 0, yes
471141787,  SilvanoBattisti, 1, 1, 0, yes
1068545209,  ClaudioSilvestt, 2, 2, 0, yes
1366883666,  StefVaccari, 1, 1, 0, yes
610201346,  Lupociccio67, 1, 1, 0, yes
431572135,  SpinaAngela, 1, 1, 0, yes
1260416479,  geniocola, 1, 1, 0, yes
25331169,  ezack, 1, 1, 0, yes
705342913371312129,  vaprios, 1, 1, 0, yes
521353975,  CarloCorigliano, 1, 1, 0, yes
800345488180379649,  guor88, 1, 1, 0, yes
537412181,  LorenzPellico, 2, 2, 0, yes
54565467,  albertobari, 1, 1, 0, yes
738666991091896320,  giuliolomba035, 1, 1, 0, yes
1077795050,  widgetball, 1, 1, 0, yes
792134704363347968,  pisapiucurt, 2, 2, 0, yes
4720298007,  dominyksenti, 3, 1, 2, no
1412429815,  MMagistretti, 5, 5, 0, yes
1456466460,  stepanz70, 1, 1, 0, yes
435909048,  GIUSEPPEAA54, 1, 1, 0, yes
2601323458,  RobCarluccio, 1, 1, 0, yes
245516428,  _AlePamy_, 1, 1, 0, yes
4166695155,  SalvoAsciutto1, 1, 1, 0, yes
405819831,  hardtobesomeone, 4, 2, 2, neutral
396141158,  riccpi, 5, 4, 1, yes
2878983657,  vp20614, 1, 1, 0, yes
615255838,  Galileo41427139, 1, 1, 0, yes
490443507,  ElisaMoschella, 2, 1, 1, neutral
479027922,  galante_fabio, 2, 2, 0, yes
1618708034,  EduNobis, 1, 1, 0, yes
760921830769197056,  davaso75, 1, 1, 0, yes
294518892,  ChiaraBaldi86, 3, 3, 0, yes
783278969294553088,  eleflor_249, 3, 3, 0, yes
1052882882,  quasimododk, 1, 1, 0, yes
1216881517,  76zg, 1, 1, 0, yes
753581765109907456,  crefalco, 1, 1, 0, yes
3971443769,  Peppeave, 1, 1, 0, yes
2196699974,  CuccuValter, 1, 1, 0, yes
497729635,  PasqualeRumm, 1, 1, 0, yes
969068376,  martino_pell, 2, 2, 0, yes
155022277,  giorgio_mat, 1, 1, 0, yes
3760582096,  carbone_ge, 1, 1, 0, yes
1017971648,  GBrlabate, 1, 1, 0, yes
2788479895,  GiordanoD7, 6, 6, 0, yes
2987269049,  rob_biondi, 1, 1, 0, yes
741166313893138436,  mpuccio77_tw, 1, 1, 0, yes
757481263976574976,  ElleBo94, 1, 1, 0, yes
559481937,  SofiaMarzari, 1, 1, 0, yes
1076974416,  tulipanoros, 1, 1, 0, yes
631428101,  LaMiaLazio1900, 3, 1, 2, no
2901785282,  LoreCostanza, 1, 1, 0, yes
490346051,  baldessarimic, 1, 1, 0, yes
789486371270455297,  EuropeTD, 3, 3, 0, yes
962048647,  dandidodi, 1, 1, 0, yes
475980392,  SabiMg, 2, 2, 0, yes
351089250,  EleonoraScafaro, 1, 1, 0, yes
707772913,  emi_confa, 4, 4, 0, yes
2753421268,  BramucciMatteo, 3, 3, 0, yes
794528604470317056,  gigimaie17, 2, 1, 1, neutral
1606737974,  jordiabras, 1, 1, 0, yes
39300792,  teddy1807, 3, 3, 0, yes
50244275,  firescratch, 6, 6, 0, yes
913122355,  VittorioAncona, 1, 1, 0, yes
31762979,  BlitzQuotidiano, 1, 1, 0, yes
328708920,  ApoBaro8, 1, 1, 0, yes
747081876536463360,  GrigioDaryl, 6, 4, 2, yes
790809578028032002,  Domenic74889403, 1, 1, 0, yes
2555881691,  Michael05851102, 4, 4, 0, yes
2159302390,  bonobolabo, 1, 1, 0, yes
1286102366,  PotterheadSnape, 1, 1, 0, yes
465048265,  SignorAnderson, 6, 6, 0, yes
801042392237428737,  Alessan57731219, 1, 1, 0, yes
731897851769438210,  infanzianuova, 12, 12, 0, yes
49069028,  lugora, 1, 1, 0, yes
2154753205,  Dawkinsmatt, 1, 1, 0, yes
2904263897,  vp2405, 2, 1, 1, neutral
2611122405,  crisandy1990, 1, 1, 0, yes
736732339,  LorenzPlatania, 2, 2, 0, yes
337313260,  roberto27051979, 1, 1, 0, yes
715074827481128960,  FabrizioGalliBL, 1, 1, 0, yes
804704678202273792,  flussante, 1, 1, 0, yes
488682459,  daniel_petrica, 1, 1, 0, yes
541622296,  DavideGrasso17, 1, 1, 0, yes
858028831,  LuliBusolini, 1, 1, 0, yes
452073619,  marlofor, 2, 2, 0, yes
397462479,  NicoFabrini, 1, 1, 0, yes
21573433,  ddtelevision, 1, 1, 0, yes
1227969776,  Bruce8691, 11, 4, 7, no
1399403005,  BenAllotta, 1, 1, 0, yes
39749733,  marpresutti, 5, 5, 0, yes
948264493,  aishyte, 1, 1, 0, yes
1039420669,  massimobendoni, 1, 1, 0, yes
411372439,  bisopa50, 1, 1, 0, yes
2437297384,  DionisiMar, 4, 4, 0, yes
791242213321834496,  BeneNicotera, 3, 3, 0, yes
621290757,  Boomerang60, 1, 1, 0, yes
1939212175,  FacoettiGma, 2, 2, 0, yes
414777806,  MarckZe, 1, 1, 0, yes
2521741671,  CarmineMigale, 2, 2, 0, yes
126747525,  NikonModena, 1, 1, 0, yes
740228516,  GiTiMatrix, 1, 1, 0, yes
514899678,  MarcoCompagno, 4, 3, 1, yes
3930476356,  Verveine70, 4, 3, 1, yes
518892155,  mariaritaelena, 1, 1, 0, yes
4011301000,  MHR1612, 1, 1, 0, yes
756834230940893188,  klaudia2367, 2, 2, 0, yes
250569060,  mauroprov, 1, 1, 0, yes
509220970,  AndreaSilla1, 1, 1, 0, yes
73341052,  lcibrario, 1, 1, 0, yes
606556971,  adrianalombard8, 1, 1, 0, yes
500754712,  preziusin, 1, 1, 0, yes
4096695196,  PoliticScorrett, 1, 1, 0, yes
4526847503,  giovinebaroni, 3, 2, 1, yes
343328591,  enricoforte1, 1, 1, 0, yes
2565960103,  pietro58338892s, 1, 1, 0, yes
231358262,  francescocavali, 1, 1, 0, yes
2268908958,  LorenzoG197, 1, 1, 0, yes
406556949,  blusimchi, 1, 1, 0, yes
1065328867,  paola_muni, 4, 3, 1, yes
876454694,  blasfede, 7, 2, 5, no
4031173343,  ndrea7791, 1, 1, 0, yes
804733582447087616,  DarioParodi4, 1, 1, 0, yes
479840172,  Lorfab83, 1, 1, 0, yes
3024070996,  AntoniettaPiga, 6, 6, 0, yes
486517856,  Alejester, 6, 3, 3, neutral
403695419,  massimilianoce, 2, 2, 0, yes
708223750622343168,  autopartecipa, 1, 1, 0, yes
130491898,  freequadro, 1, 1, 0, yes
788777410829443073,  Kaysersoze19, 1, 1, 0, yes
407106629,  EMaravalli, 1, 1, 0, yes
1595880547,  CaciolliTommaso, 2, 2, 0, yes
502992856,  MonicaPenna76, 1, 1, 0, yes
275105873,  marinopetrelli, 1, 1, 0, yes
336728071,  IvanaCassara, 2, 2, 0, yes
383831798,  rolandroli97, 3, 3, 0, yes
440404937,  EdenCibej, 4, 4, 0, yes
712248883678732288,  lucanovellis917, 1, 1, 0, yes
304933975,  massimotrux, 1, 1, 0, yes
803672406606880768,  speechless_hs, 1, 1, 0, yes
3552200295,  antonioscardam, 2, 2, 0, yes
2204552612,  AdrianaFloris, 1, 1, 0, yes
1861238622,  MassimoStark, 1, 1, 0, yes
704394556884787202,  BaldiniPasquale, 1, 1, 0, yes
788792562651897857,  elisaesu81, 1, 1, 0, yes
558831374,  98Antonaci, 1, 1, 0, yes
2214804177,  raffajair, 2, 2, 0, yes
1283058698,  MaglianoGiacomo, 1, 1, 0, yes
140077603,  pavone03, 1, 1, 0, yes
531726691,  Edenteach, 1, 1, 0, yes
1459533954,  GiuliFerr, 1, 1, 0, yes
802836012279930884,  giannimarraca63, 1, 1, 0, yes
528877295,  cguarnaccia69, 1, 1, 0, yes
497158268,  otellobarducci, 4, 4, 0, yes
2746620365,  stefaniaroncal1, 4, 4, 0, yes
796057683451412480,  DrArbia, 1, 1, 0, yes
554971568,  karineChevalier, 3, 3, 0, yes
851698128,  63pbravi, 4, 4, 0, yes
4367710696,  PigiPensosi, 1, 1, 0, yes
1279935774,  IPizzacchiere, 1, 1, 0, yes
277410004,  labevannucci, 1, 1, 0, yes
1520043966,  buavin, 1, 1, 0, yes
1015741482,  sarafunaro, 3, 3, 0, yes
440949548,  LatinDancer97, 4, 3, 1, yes
1115415468,  TricomiF, 5, 5, 0, yes
424294051,  VincenzoScalzo, 1, 1, 0, yes
777075864248913920,  cgc_cesena, 1, 1, 0, yes
228879550,  devitocarmine, 1, 1, 0, yes
1459429184,  EcoCretin, 1, 1, 0, yes
4822018295,  ruscioannamari1, 4, 2, 2, neutral
501029021,  vincenzocatino1, 1, 1, 0, yes
3600966322,  pdnovoli, 2, 2, 0, yes
738792369609396224,  Eleonorapezzot2, 3, 2, 1, yes
944638987,  backtoHalabama, 4, 3, 1, yes
703453868,  forse6, 1, 1, 0, yes
51990337,  MarioBerlanda, 1, 1, 0, yes
800800679807754240,  Flavia46106744, 1, 1, 0, yes
3760514895,  familya22, 2, 2, 0, yes
787211216355782656,  sam_lucre, 1, 1, 0, yes
226325978,  ventunaprile, 3, 2, 1, yes
804810861986664448,  nunzio_totaro, 1, 1, 0, yes
47781917,  Joanne_Estefani, 1, 1, 0, yes
2407080273,  LunardiDeborah, 2, 2, 0, yes
872466012,  francescat75, 2, 2, 0, yes
394802771,  Marco_Ercolani, 1, 1, 0, yes
470178824,  Darillico, 1, 1, 0, yes
241641367,  numar61, 3, 2, 1, yes
968970415,  gianni956, 1, 1, 0, yes
387643307,  AlessandroCenti, 3, 3, 0, yes
2357042582,  itchange2, 1, 1, 0, yes
2399299434,  BRE_Spa, 1, 1, 0, yes
334069557,  Emiliano_Beltra, 1, 1, 0, yes
2348777737,  Edoardo23090568, 1, 1, 0, yes
1099289419,  Handwriting01, 3, 1, 2, no
311950992,  Maurilio76, 2, 2, 0, yes
2355347340,  carloutc_, 1, 1, 0, yes
2647398867,  Hemskindahot, 1, 1, 0, yes
379305863,  chicasicari, 3, 3, 0, yes
131517252,  Robycm, 1, 1, 0, yes
289825793,  CLonati, 2, 2, 0, yes
4885325417,  loziocane_, 4, 1, 3, no
569330691,  Francescoholden, 1, 1, 0, yes
3137320963,  SofiaSofia1206, 5, 5, 0, yes
83079940,  matteocentola, 1, 1, 0, yes
736176575213916160,  Helena_Fabbi, 5, 5, 0, yes
2428809937,  GaeDArienzo, 1, 1, 0, yes
753551108119924737,  comitatonapoli, 1, 1, 0, yes
396049482,  AndreStrati, 2, 2, 0, yes
326601986,  gilardifabio, 2, 2, 0, yes
751074752803004416,  noriforme, 3, 3, 0, yes
3704496436,  ErminioZac, 1, 1, 0, yes
721068668944314372,  andrea_comotti, 7, 7, 0, yes
783670848267882496,  Benito900448781, 1, 1, 0, yes
705859207791308801,  littlethingsmar, 1, 1, 0, yes
2728828858,  GcCattozzi, 3, 3, 0, yes
727479058045480961,  AlbertoLonghi69, 1, 1, 0, yes
2467892087,  ambroisesolomon, 1, 1, 0, yes
2495071257,  187bd2061e53423, 3, 3, 0, yes
320688882,  grinaldi97, 2, 2, 0, yes
610572173,  Domenico_Galimi, 3, 3, 0, yes
1694632363,  NedaFerrara, 1, 1, 0, yes
2998767579,  White_Monkey95, 2, 2, 0, yes
710095757282508801,  cditempora, 1, 1, 0, yes
804115086893875201,  Danielelupin, 2, 2, 0, yes
737670987504848896,  CleliaIsimbaldi, 2, 2, 0, yes
130445779,  vaurux10, 1, 1, 0, yes
2948714567,  ComancheIvan, 1, 1, 0, yes
585768033,  KenzoRoberti, 3, 3, 0, yes
1736250799,  micflorio, 1, 1, 0, yes
780124088706691073,  e_sachs, 3, 3, 0, yes
430724086,  loredeluca98, 1, 1, 0, yes
2738342715,  FraLisci75, 4, 4, 0, yes
427674701,  FabioFiscaletti, 1, 1, 0, yes
746285129899868160,  cavalcanti013, 2, 2, 0, yes
3254132591,  simomartifla, 5, 3, 2, yes
562389461,  AlbertomBerti, 3, 3, 0, yes
429177543,  aleagostiniat, 3, 3, 0, yes
3797445322,  larosaworld, 11, 10, 1, yes
176348052,  DaDoOF, 1, 1, 0, yes
437495062,  simonemparizzi, 1, 1, 0, yes
511922371,  gipy66, 1, 1, 0, yes
706517290842513408,  perazzolo58, 1, 1, 0, yes
398678429,  _klodi, 1, 1, 0, yes
186401735,  clementiemilia, 1, 1, 0, yes
443105638,  RossellaSirtori, 1, 1, 0, yes
4019528128,  AleMu1983, 1, 1, 0, yes
1001628942,  mclanari, 3, 2, 1, yes
35732371,  pda69, 1, 1, 0, yes
233142843,  PietroCaimmi, 1, 1, 0, yes
1227480588,  renzamoroni, 1, 1, 0, yes
300226654,  sarah_shb, 4, 1, 3, no
749702161496477696,  Nicolalochis, 1, 1, 0, yes
2367326215,  bertero_g, 1, 1, 0, yes
789390786991263744,  maura_rocca, 6, 2, 4, no
1131601790,  ACeresoli61, 1, 1, 0, yes
3039742403,  spiritodel94, 4, 3, 1, yes
235533586,  AndreaBonaccini, 1, 1, 0, yes
14314686,  maxcontri, 6, 5, 1, yes
2835133733,  paldrea, 1, 1, 0, yes
997771998,  savebers, 4, 4, 0, yes
2357412028,  Enrico_Caso, 1, 1, 0, yes
2923416304,  antanispa, 1, 1, 0, yes
867589260,  pensatoescritto, 1, 1, 0, yes
579324575,  AntSilLONDRA, 1, 1, 0, yes
320041908,  spazzaman, 2, 2, 0, yes
804754770682609664,  noemi0696, 2, 2, 0, yes
2555980091,  canonico_, 1, 1, 0, yes
1403285563,  babyzenzy, 3, 3, 0, yes
213031371,  AtaualpaPF, 1, 1, 0, yes
4664753836,  GaiaSchiavonato, 1, 1, 0, yes
2785280723,  francoprocesi, 1, 1, 0, yes
2891397993,  riccardo_godi, 1, 1, 0, yes
626472264,  StefaFinotello, 2, 2, 0, yes
3088206555,  ThomasBoldrin75, 6, 6, 0, yes
498950954,  jextempe, 1, 1, 0, yes
344638691,  ClaudioBarte, 1, 1, 0, yes
1082118776,  parentiannalisa, 1, 1, 0, yes
425919170,  AndriPergo, 1, 1, 0, yes
2539362027,  vincecirillo, 3, 3, 0, yes
1018323662,  francicorbi, 2, 2, 0, yes
2303319868,  aledellagatta, 1, 1, 0, yes
552707647,  AlfanoEugenio, 6, 6, 0, yes
1205250264,  ScarpatoCarlo, 2, 2, 0, yes
55246808,  asagge, 1, 1, 0, yes
727548236710481920,  ZioBenito_, 7, 5, 2, yes
376302409,  marcoluci1, 1, 1, 0, yes
791374241123926016,  dr_maalox, 1, 1, 0, yes
2608180804,  EWallnofer, 1, 1, 0, yes
375785540,  1989Lorenzo, 2, 2, 0, yes
3344614767,  giusycasatides1, 3, 3, 0, yes
398939919,  spadlore, 1, 1, 0, yes
414998753,  gioliscio, 1, 1, 0, yes
2352831452,  FabrizioDiBona, 1, 1, 0, yes
1958902520,  sandroz_it, 2, 2, 0, yes
710519044571537409,  lifeonmars1234, 1, 1, 0, yes
165556057,  ste_86_, 1, 1, 0, yes
554397803,  Alfa72ap, 2, 2, 0, yes
1345285440,  Kiaradiflo, 2, 2, 0, yes
2502501779,  LecceSamanta, 1, 1, 0, yes
3018797151,  PDigiacomo57, 2, 2, 0, yes
2889609213,  SignoriElena, 1, 1, 0, yes
749166528898228224,  laidalisa, 2, 2, 0, yes
421845819,  Paolo_Boffa, 2, 1, 1, neutral
1360367094,  toptrading009, 1, 1, 0, yes
443589130,  DaveModesti, 1, 1, 0, yes
417403008,  MariaGiovannaAn, 1, 1, 0, yes
470392811,  RoccoTremoglie, 1, 1, 0, yes
2729672105,  b77200ee31c848b, 2, 2, 0, yes
2676441156,  elisa_8mishmo, 1, 1, 0, yes
507021681,  windonsea, 1, 1, 0, yes
380000975,  FrancaEntringer, 1, 1, 0, yes
462772665,  RaiGio69, 6, 6, 0, yes
828107509,  pamoore4, 1, 1, 0, yes
1126627632,  huntxrhayes, 1, 1, 0, yes
3078186189,  MGianpaola, 3, 2, 1, yes
3195997103,  isaprevi71, 1, 1, 0, yes
297497413,  Issoela, 1, 1, 0, yes
885325464,  ChiaraBressani, 2, 2, 0, yes
1060514324,  kraulos87, 1, 1, 0, yes
100036070,  jmarcthevenon, 1, 1, 0, yes
72591452,  RobyArkiRosta, 3, 3, 0, yes
243408449,  uomoconlabarba, 2, 2, 0, yes
3384545219,  lancial8, 1, 1, 0, yes
461257438,  domaliberti, 3, 3, 0, yes
422667556,  NSalcuni, 1, 1, 0, yes
2333388469,  AlbertMaltese, 3, 1, 2, no
493071820,  m_pietro, 1, 1, 0, yes
4831397626,  CptLittleTruths, 1, 1, 0, yes
370182507,  RobyGuarino, 13, 5, 8, no
2314907279,  AnnamariaPoggi, 1, 1, 0, yes
253687198,  gabriella_bedin, 1, 1, 0, yes
386582756,  RM_Maiorano, 6, 5, 1, yes
2745834673,  LanciniLucia, 5, 2, 3, no
951681288,  luca_74, 1, 1, 0, yes
12315822,  demonsmaycry, 1, 1, 0, yes
805692461213487104,  Cirivr, 1, 1, 0, yes
352257760,  DenisCELCIMA, 1, 1, 0, yes
767934323366428672,  Dario68174481, 3, 3, 0, yes
784372637497688064,  ClaudiaIntrono, 1, 1, 0, yes
285238291,  PrinceEchelon89, 1, 1, 0, yes
111860209,  Inquisitore71, 1, 1, 0, yes
1691875730,  _dajedepunta_, 2, 2, 0, yes
3108658288,  robertopoci0, 1, 1, 0, yes
586411382,  Robiprestifil, 1, 1, 0, yes
481245436,  AndreaTroiani2, 1, 1, 0, yes
2758055709,  ninocarbonello, 1, 1, 0, yes
734073756025540608,  Melania71279, 1, 1, 0, yes
802475642721800192,  admbookheart, 3, 3, 0, yes
783670680491552768,  ermitica58, 1, 1, 0, yes
3025716337,  EsseTi76, 1, 1, 0, yes
1359807542,  sammy1996q, 1, 1, 0, yes
804538604,  ILDELIO99, 6, 3, 3, neutral
2174820051,  13Vag, 1, 1, 0, yes
81797113,  ElphabaLondon, 1, 1, 0, yes
767629247221465088,  Machine19571, 1, 1, 0, yes
402653752,  DarioPuricelli, 1, 1, 0, yes
801315098409271296,  1967milly, 1, 1, 0, yes
493222250,  giadabellato, 1, 1, 0, yes
2353320273,  nicol_nodari, 1, 1, 0, yes
508029782,  ddipietro67, 2, 2, 0, yes
412553405,  Succio77, 1, 1, 0, yes
2915521882,  rrituccia1, 1, 1, 0, yes
357793162,  NexusTorino, 1, 1, 0, yes
2378011925,  nicolorion, 1, 1, 0, yes
3390731416,  s_giuda, 2, 2, 0, yes
529539547,  giovy8110, 1, 1, 0, yes
721678188280221696,  MidoloMario, 1, 1, 0, yes
1409523199,  _Sorre_, 2, 2, 0, yes
1013236680,  L_ale87, 3, 3, 0, yes
921429056,  BasanisiGabri, 2, 2, 0, yes
257511513,  DarkeneFabiana, 1, 1, 0, yes
460074981,  elena_cirillo, 2, 2, 0, yes
423759090,  mamy1977, 1, 1, 0, yes
398618779,  minomazz, 2, 2, 0, yes
53351885,  Floris_Fabio, 1, 1, 0, yes
2203380455,  dsgianniderosa, 1, 1, 0, yes
372968459,  cristianambr, 1, 1, 0, yes
2325335162,  DPistacchi, 2, 2, 0, yes
375769318,  mimmogangemi, 2, 2, 0, yes
2151321367,  RossoParma, 7, 7, 0, yes
372836969,  Davide86J, 1, 1, 0, yes
2419001599,  agnesesumma, 1, 1, 0, yes
104172944,  cribeta, 1, 1, 0, yes
14933426,  fstraps, 1, 1, 0, yes
347911632,  Gianluca_2205, 4, 4, 0, yes
469776688,  andtronci, 3, 3, 0, yes
203477490,  Ale_Sandra_12, 1, 1, 0, yes
271819395,  MZohaibShafiq, 1, 1, 0, yes
1035554172,  bornjuventino, 1, 1, 0, yes
153215465,  DiegoMaradonaJr, 1, 1, 0, yes
38151491,  Fedefici, 1, 1, 0, yes
579158086,  simona_lilla, 1, 1, 0, yes
3331139295,  EPolice15, 2, 2, 0, yes
1978717158,  munnoileana, 2, 2, 0, yes
1343847084,  SoniaDengo, 1, 1, 0, yes
703548928,  lolli211049, 1, 1, 0, yes
2504480725,  LordAlgar, 1, 1, 0, yes
2893060011,  marco_boccato, 3, 3, 0, yes
144693448,  emacarnaca, 1, 1, 0, yes
3432002601,  nadiadevenezia, 2, 1, 1, neutral
2236769841,  _giuliabassani, 1, 1, 0, yes
479432242,  VitoDaid, 1, 1, 0, yes
805740516797190144,  tizianafratini, 1, 1, 0, yes
802146270089461761,  The_Channel_OfP, 1, 1, 0, yes
703082655601008640,  taxiapostolo, 1, 1, 0, yes
269194001,  pierobert, 1, 1, 0, yes
774750753118384129,  ThinkTwt, 3, 3, 0, yes
199372783,  fabiofantoni, 1, 1, 0, yes
428920899,  deliacrobu, 1, 1, 0, yes
777236453533290496,  Tonyaprete, 1, 1, 0, yes
716737076956434432,  TeodoricoIII, 1, 1, 0, yes
2891883520,  paolaliciam, 1, 1, 0, yes
1125456126,  gzambini1, 1, 1, 0, yes
30688131,  idevox, 1, 1, 0, yes
2334305618,  fobe_jules, 4, 3, 1, yes
2466414818,  giostrazza, 1, 1, 0, yes
1012046600,  Annamaratoneta, 5, 5, 0, yes
836445570,  mizio61, 1, 1, 0, yes
3370523565,  debora_brien, 1, 1, 0, yes
4193761697,  enzo77enzoo, 3, 2, 1, yes
461866456,  Micol_9, 1, 1, 0, yes
1706736698,  ZappettaManu, 1, 1, 0, yes
787437065935917057,  mgio66, 2, 2, 0, yes
2780637435,  catyrullo, 2, 2, 0, yes
2800476646,  pnikko65, 1, 1, 0, yes
473813294,  BETTINinfo, 1, 1, 0, yes
467600345,  BrunoLigari, 1, 1, 0, yes
805737372545675264,  Roanfwolf, 2, 2, 0, yes
550025801,  AlfredoGiambro, 1, 1, 0, yes
713186874,  abueno56, 1, 1, 0, yes
4805537831,  vespucci78, 1, 1, 0, yes
83105351,  CruelTweets, 1, 1, 0, yes
22407223,  a2ronsama, 1, 1, 0, yes
505803378,  ellysisland, 3, 1, 2, no
935649073,  paolaperna_, 1, 1, 0, yes
4181867075,  said77760, 1, 1, 0, yes
3105881217,  SeleneMuser, 1, 1, 0, yes
433671491,  GraziaTz, 1, 1, 0, yes
1540835622,  RiegertBernd, 2, 2, 0, yes
2560478303,  Sabrina79791673, 1, 1, 0, yes
1620890454,  Milashiro07, 1, 1, 0, yes
552163225,  zioraffy2005, 2, 2, 0, yes
4794876481,  tombwq, 2, 1, 1, neutral
1278294324,  ElenaCesca, 1, 1, 0, yes
421050354,  Milenaceti, 9, 7, 2, yes
380539381,  NicoTriglione, 1, 1, 0, yes
244936627,  optimistique_, 7, 3, 4, no
1094917687,  Gigi0209Gm, 1, 1, 0, yes
2185762925,  1D_IlVolo_Lover, 67, 62, 5, yes
805785364631851009,  gilrossi01, 1, 1, 0, yes
101011191,  alittlebitofb, 1, 1, 0, yes
754855801,  Ivanlobello1, 1, 1, 0, yes
1026398936,  dibibi20, 2, 2, 0, yes
55786271,  michaelblanga, 1, 1, 0, yes
564481358,  trillybiba, 1, 1, 0, yes
1410444858,  carlabruzzi1, 6, 3, 3, neutral
1330084448,  PieraSalvati, 3, 2, 1, yes
390065826,  AndreaZanola, 1, 1, 0, yes
557750382,  DennisMontisci, 2, 2, 0, yes
1465687267,  __martah, 3, 2, 1, yes
383902382,  marco0190, 1, 1, 0, yes
50683243,  LiliOB, 2, 2, 0, yes
218247950,  stefanopes, 2, 1, 1, neutral
2183796807,  aurelia_61, 1, 1, 0, yes
2521516907,  daniela00365230, 1, 1, 0, yes
502131041,  fede_cato, 4, 4, 0, yes
2772204826,  daniele0580, 2, 2, 0, yes
462905683,  lorelajne, 2, 2, 0, yes
2260328994,  maryawk, 1, 1, 0, yes
206151011,  CorradoAbate, 2, 2, 0, yes
774578326795059204,  superRitafusi, 2, 2, 0, yes
707652990,  Betta9323, 2, 2, 0, yes
353645009,  manliomarino, 1, 1, 0, yes
805764313919193088,  giustinoiori, 1, 1, 0, yes
202278912,  alexdifede, 1, 1, 0, yes
1506479251,  fade0612, 1, 1, 0, yes
594548423,  matteglam, 7, 1, 6, no
1075133658,  ppagani27, 1, 1, 0, yes
2713179867,  GiroCarlo, 2, 2, 0, yes
992563164,  RDVibes, 1, 1, 0, yes
422497226,  Elisabetta_L, 2, 2, 0, yes
751526872278822912,  Armando87709271, 1, 1, 0, yes
393551216,  elisal48, 1, 1, 0, yes
802227407394578432,  cimminofranco9, 1, 1, 0, yes
863410866,  franc_mirizzi, 1, 1, 0, yes
4459286415,  37GIO, 1, 1, 0, yes
805768869180829698,  eleonorapant85, 1, 1, 0, yes
300847002,  DorianoB, 1, 1, 0, yes
2344874769,  DavideCanetti, 1, 1, 0, yes
2449550496,  MauriIannitti, 3, 2, 1, yes
2749896161,  FinallyGio459, 3, 3, 0, yes
716630573641555968,  ItalianeNene, 4, 4, 0, yes
1016066683,  redstone1982, 14, 7, 7, neutral
2362978798,  BrunoBongi, 1, 1, 0, yes
508709778,  borzi_borzi, 2, 2, 0, yes
1089529176,  stepogba14, 1, 1, 0, yes
403325227,  carloborio, 1, 1, 0, yes
872565936,  quirlucy, 2, 2, 0, yes
526664415,  Flavioporsche, 1, 1, 0, yes
25065774,  rudynicoletti, 1, 1, 0, yes
772429490756681728,  Mirko24087099, 1, 1, 0, yes
406809065,  faberardi55, 3, 2, 1, yes
347503470,  kteixeirapontes, 3, 3, 0, yes
716432480966942722,  tatuvm, 2, 2, 0, yes
150456616,  tweetfromriky, 1, 1, 0, yes
805489275391344641,  InPoliticalnew, 2, 1, 1, neutral
1694530675,  StopDimentica1, 1, 1, 0, yes
711370887543529472,  LuisaVaggioli, 1, 1, 0, yes
805051386601865216,  martifuga90, 1, 1, 0, yes
2983228427,  trasportigrillo, 2, 2, 0, yes
2910843603,  sabrinazpp, 1, 1, 0, yes
151195438,  antodiub, 1, 1, 0, yes
455855824,  riki_stc, 1, 1, 0, yes
35102347,  Marfho, 1, 1, 0, yes
708916797580419072,  linailygregorio, 2, 2, 0, yes
1171339730,  alextardelli, 2, 2, 0, yes
893367824,  AnnaPelagotti, 2, 2, 0, yes
2380461960,  Strarotto0, 2, 2, 0, yes
2157740007,  bubyepupo, 1, 1, 0, yes
3031629415,  serenaleone8, 1, 1, 0, yes
415134614,  brunellamattei, 2, 1, 1, neutral
2423714223,  c_camarda, 1, 1, 0, yes
303759481,  thesubmarineman, 2, 2, 0, yes
889694360,  AligiFois, 1, 1, 0, yes
30182444,  apadova, 1, 1, 0, yes
453088992,  LassaPerdere, 2, 2, 0, yes
440167242,  GioiaGualtieri, 1, 1, 0, yes
1241733120,  MTornitore, 1, 1, 0, yes
337644410,  Marxtrixx, 10, 3, 7, no
247437768,  VictoriaDalmas, 1, 1, 0, yes
443649906,  walter_pozzoli, 1, 1, 0, yes
3309471153,  AntonellaCovell, 1, 1, 0, yes
560296447,  GMartelli66, 1, 1, 0, yes
1399325755,  vitto_72, 2, 2, 0, yes
1207540662,  giio_riccardo, 1, 1, 0, yes
1379840682,  dicesaredicesar, 1, 1, 0, yes
397440368,  alicecolautti, 1, 1, 0, yes
727915998100238338,  mariopepe77, 6, 6, 0, yes
2857035293,  antonio_mambro, 2, 2, 0, yes
805553571198619652,  Ilariaaaserraa, 5, 5, 0, yes
1009617660,  francesca_faini, 1, 1, 0, yes
2324030130,  olivietta5, 1, 1, 0, yes
358709192,  salvoalgeri, 4, 2, 2, neutral
21363569,  CaesarOtavianus, 5, 5, 0, yes
130561661,  danitors, 2, 2, 0, yes
3039663933,  ZioRaylovato, 1, 1, 0, yes
2777885025,  SaraTruki, 1, 1, 0, yes
547992296,  FabioPolisi1, 4, 4, 0, yes
405072283,  kiki_tmk, 1, 1, 0, yes
976070742,  MkpMpe, 1, 1, 0, yes
35438538,  girosauro, 1, 1, 0, yes
805668986373492736,  vaccari_flavia, 1, 1, 0, yes
460061801,  papaverorosa, 1, 1, 0, yes
796725262264238080,  chiarasala1175, 2, 2, 0, yes
22651519,  get2down, 1, 1, 0, yes
82829181,  derfel83, 1, 1, 0, yes
247486840,  fraterarvalis, 3, 3, 0, yes
805668566599081984,  stefaniamigia, 4, 4, 0, yes
17720572,  Gabriele_Rumi, 1, 1, 0, yes
63751398,  nellaz90, 1, 1, 0, yes
120601148,  maupas72, 1, 1, 0, yes
126903762,  SAREYELDIN, 1, 1, 0, yes
538026138,  TDeCristofaro, 1, 1, 0, yes
504919754,  fravverella, 1, 1, 0, yes
320698278,  AmelieMy, 1, 1, 0, yes
494450207,  giuliano_rinax, 1, 1, 0, yes
3989249843,  wilma26417972, 2, 2, 0, yes
251822213,  thisisroby, 2, 2, 0, yes
255700472,  lucrezja, 1, 1, 0, yes
786925281168748544,  ajsaverino, 1, 1, 0, yes
2326906821,  inogniviaggio, 1, 1, 0, yes
4690883617,  Fosco61413507, 1, 1, 0, yes
2267522596,  carmenbonvil, 1, 1, 0, yes
435593541,  poleggi, 1, 1, 0, yes
734511896,  monetaddicted, 1, 1, 0, yes
484149605,  UnoTipoMe, 1, 1, 0, yes
2894149576,  Ele23Maria, 1, 1, 0, yes
740455499536162816,  MassimoMasi10, 1, 1, 0, yes
2735906812,  KKKKlaudio, 2, 2, 0, yes
501044103,  pennina1982, 1, 1, 0, yes
1010106986,  fciofetti, 3, 3, 0, yes
39282077,  bretamax, 2, 1, 1, neutral
2463140385,  OrecGiovanni, 1, 1, 0, yes
286064951,  gacostantino, 1, 1, 0, yes
3619108397,  Francireggia, 2, 2, 0, yes
464834581,  lillisedd, 1, 1, 0, yes
206150503,  gianpierogmb, 2, 2, 0, yes
465663519,  The_Air_Square, 1, 1, 0, yes
1914532375,  enr96, 1, 1, 0, yes
131102560,  sammyserraino, 1, 1, 0, yes
890374897,  andmarfot, 1, 1, 0, yes
486811448,  licari_salvator, 4, 4, 0, yes
733168113672413185,  Giovannbalsamo1, 2, 2, 0, yes
1591807034,  ll_late, 1, 1, 0, yes
736314886154768384,  zyzshop, 3, 2, 1, yes
380345077,  danosco, 1, 1, 0, yes
2486355202,  LauraOliveri5, 1, 1, 0, yes
381968867,  Alone_76, 1, 1, 0, yes
4219440381,  luisalustri, 1, 1, 0, yes
897426966,  lorenzabarelli, 1, 1, 0, yes
4186539586,  giorgiasalvati7, 1, 1, 0, yes
974136103,  lorenzacassetta, 1, 1, 0, yes
390350879,  Romolo46, 1, 1, 0, yes
2326573022,  ranocchia3, 5, 5, 0, yes
483241099,  VENERAGFADER, 1, 1, 0, yes
175735147,  BelliTiziano, 1, 1, 0, yes
1089695654,  Savo_Narola, 2, 2, 0, yes
2354744221,  Fauno_BB, 1, 1, 0, yes
473995136,  CyberSpampi, 2, 2, 0, yes
805668783520120832,  Arianna79535805, 1, 1, 0, yes
75875137,  emilianomi, 1, 1, 0, yes
1063119836,  AlinaPreger, 1, 1, 0, yes
2808930117,  giogigante84, 1, 1, 0, yes
2341833863,  ManolaDaverio, 1, 1, 0, yes
796504515394551808,  MovementItalian, 1, 1, 0, yes
754518585112944641,  fatest0, 4, 4, 0, yes
2379342470,  Zaffo_Inter_91, 1, 1, 0, yes
755904103956578305,  Pasquino2018, 2, 2, 0, yes
3417259449,  venturinig73, 1, 1, 0, yes
754049285206007808,  FantomasFrance, 2, 2, 0, yes
514298890,  dergassia, 1, 1, 0, yes
1689224755,  fabio_ang77, 1, 1, 0, yes
2557455004,  AlexInRome, 1, 1, 0, yes
1075132603,  DimennoDi, 1, 1, 0, yes
2654757931,  Fede_Bezzi, 2, 2, 0, yes
2423506239,  CarlaStones79, 1, 1, 0, yes
118093941,  constantdcn, 2, 2, 0, yes
4871567830,  Paolo77900268, 3, 1, 2, no
4560441256,  arianatorconfir, 2, 2, 0, yes
2262042713,  GabGiacobino, 2, 2, 0, yes
832899218,  ElisaMGiannetto, 1, 1, 0, yes
812886115,  SicaTony, 1, 1, 0, yes
41172178,  BarbySustourism, 1, 1, 0, yes
3075865347,  OmarGibelli, 9, 8, 1, yes
3043800583,  lagioiafulvio1, 1, 1, 0, yes
874002174,  scarincio13, 3, 3, 0, yes
396726440,  santamarioto, 2, 2, 0, yes
2565448658,  Investor_Luke, 1, 1, 0, yes
381714246,  niksubra, 7, 6, 1, yes
566718537,  EnricaModena, 1, 1, 0, yes
783062302388056064,  alf_arnone89, 2, 1, 1, neutral
2950904957,  gabbiadinielena, 2, 2, 0, yes
3559475297,  ladivadelkom, 1, 1, 0, yes
277975888,  Eslias94, 1, 1, 0, yes
35202108,  toninicaterina, 1, 1, 0, yes
2831480482,  idolatrino, 1, 1, 0, yes
773825985590484992,  matdep88, 8, 2, 6, no
732218122846011392,  mastorasgr, 1, 1, 0, yes
3007710135,  kaemax70, 1, 1, 0, yes
759487561,  ImagineveniceFT, 1, 1, 0, yes
129978050,  Mozkovich, 1, 1, 0, yes
377252203,  ValliAlfio, 1, 1, 0, yes
455345649,  nicolopiccione, 2, 2, 0, yes
500970014,  BosiAlessandro, 1, 1, 0, yes
4260517294,  GianniEuropa, 1, 1, 0, yes
2604065315,  datguyfedz, 1, 1, 0, yes
493270285,  Sterix93, 1, 1, 0, yes
964950798,  estranea1, 1, 1, 0, yes
3027771161,  preziosi56, 1, 1, 0, yes
1618048597,  Ritapati7Rita, 1, 1, 0, yes
929859818,  nickchirilli, 1, 1, 0, yes
2313632045,  RagoneRagone2, 1, 1, 0, yes
238321285,  peppemarici, 1, 1, 0, yes
3230048619,  donalessia15, 1, 1, 0, yes
611580827,  WalterSmek, 1, 1, 0, yes
1351717566,  mafrasime, 1, 1, 0, yes
720632573639192577,  laura_liepertz, 1, 1, 0, yes
162862124,  Nyantho, 1, 1, 0, yes
50579220,  cyxix, 1, 1, 0, yes
3155012400,  arqlisatejeda, 1, 1, 0, yes
173392709,  Falco_rocks, 1, 1, 0, yes
2394128916,  ConsInka, 2, 1, 1, neutral
490229337,  AntonioCurro1, 1, 1, 0, yes
462401192,  Carla_Reale, 2, 2, 0, yes
203758372,  Reodica45, 4, 4, 0, yes
1490192347,  lasara82, 1, 1, 0, yes
3131305143,  barramoni, 1, 1, 0, yes
118039326,  GreatBites, 1, 1, 0, yes
4046262857,  Isoad1, 1, 1, 0, yes
1516105712,  barbramarie, 2, 2, 0, yes
478427328,  AleTedescoXXX, 1, 1, 0, yes
178389234,  liuxtheone, 2, 1, 1, neutral
77813903,  edwinmaria, 1, 1, 0, yes
2372355289,  zannapod79, 1, 1, 0, yes
329830899,  mig_box, 9, 1, 8, no
315374132,  mak_ruben, 1, 1, 0, yes
172006433,  annemazoyer, 2, 2, 0, yes
320802018,  NicolaBattista, 1, 1, 0, yes
1368863274,  hdebonnevolonte, 17, 17, 0, yes
2360340419,  BeppeBidi, 1, 1, 0, yes
740006454246187012,  AlfioBertino, 6, 6, 0, yes
574617630,  marcoamatii, 4, 4, 0, yes
154482436,  giuseppemunao, 2, 2, 0, yes
145592403,  goffredodotcom, 4, 1, 3, no
301711105,  josh3090, 1, 1, 0, yes
805737083008675840,  gigel090773, 1, 1, 0, yes
435671501,  PaolaToccaceli, 5, 2, 3, no
1039138658,  ElenaBosciano, 2, 2, 0, yes
418061861,  isiciliani, 1, 1, 0, yes
483793650,  AleixAlmirall, 1, 1, 0, yes
431891913,  ESalani, 1, 1, 0, yes
349569586,  PeppeStout, 1, 1, 0, yes
600786321,  fr_rizzo, 1, 1, 0, yes
44322156,  ilporcorosso, 1, 1, 0, yes
423657969,  GiacomoBisoffi, 2, 2, 0, yes
224251499,  lucarom70, 1, 1, 0, yes
792098223804583936,  BanIlDito, 1, 1, 0, yes
390653554,  PIETROFRUCI, 1, 1, 0, yes
719901382808072197,  katiarcoleo, 1, 1, 0, yes
3331461831,  magicinsound, 2, 2, 0, yes
249353095,  MinelliMatteo, 1, 1, 0, yes
1055182616,  Chris_Z1975, 3, 3, 0, yes
4522911016,  BScaloni, 3, 3, 0, yes
12712562,  rosanna_de_rosa, 1, 1, 0, yes
714845919288692737,  annadibarium, 7, 1, 6, no
595378009,  andreaparking, 1, 1, 0, yes
790211752273338372,  SalentinoGF, 2, 2, 0, yes
33597486,  SaverioSavio89, 2, 2, 0, yes
805773220674764800,  nicoli67roberto, 1, 1, 0, yes
805780305961517058,  ocamigrante67, 1, 1, 0, yes
805755461677019140,  75ocinemod, 1, 1, 0, yes
60026019,  pier_dr, 1, 1, 0, yes
788369731212443648,  leialisbon, 1, 1, 0, yes
4909214488,  enricobreve, 1, 1, 0, yes
948497078,  midr79, 1, 1, 0, yes
1477704894,  Ivan17Anto21, 2, 2, 0, yes
440956917,  Goghgemini, 1, 1, 0, yes
753871352453562368,  UnicoSettimanal, 1, 1, 0, yes
2322490036,  Marcello_1759, 2, 2, 0, yes
802143377391239168,  Marco50042467, 1, 1, 0, yes
623715563,  LPiccinni, 3, 2, 1, yes
739819589379469312,  carlina2465, 2, 2, 0, yes
1384661526,  NigroNicol, 1, 1, 0, yes
186182336,  mofabia, 2, 2, 0, yes
707322600117116928,  AlessandroCen17, 1, 1, 0, yes
2829662494,  Roma3Radio, 1, 1, 0, yes
465066623,  M_Manzoni, 2, 2, 0, yes
1036849046,  FabriGent, 1, 1, 0, yes
993575304,  StarsSystemTv, 1, 1, 0, yes
2879542605,  davidmariotti82, 1, 1, 0, yes
28434730,  astridnausicaa, 1, 1, 0, yes
473799347,  loredanaguerro, 2, 2, 0, yes
805721957605998592,  seghezzie, 1, 1, 0, yes
391972415,  _Angel_Diamond_, 3, 3, 0, yes
355465240,  raimondofrau, 1, 1, 0, yes
147730115,  rocco_cosentino, 1, 1, 0, yes
3030315699,  wrtzs, 2, 2, 0, yes
711478776878800896,  francescomas1, 1, 1, 0, yes
1316007410,  Andrea_Aloisio, 14, 6, 8, no
570835534,  justfederinaldi, 1, 1, 0, yes
67612595,  Simondejano, 4, 4, 0, yes
56047664,  caiolo, 2, 2, 0, yes
2735320865,  betta_paciotti, 1, 1, 0, yes
796451053784862720,  PepeBreizh, 1, 1, 0, yes
250130380,  ManuCustodioM, 2, 2, 0, yes
254102291,  ross969, 1, 1, 0, yes
1187215075,  Martina_Crusco, 1, 1, 0, yes
4853557018,  PaduaFranci, 2, 2, 0, yes
1016043164,  GiacomoCorongiu, 6, 4, 2, yes
1470108962,  antangi42, 1, 1, 0, yes
254526827,  icoloridelmondo, 1, 1, 0, yes
102962669,  fabiomenazza, 1, 1, 0, yes
1107334237,  FlaminiaY, 1, 1, 0, yes
483736929,  memolabile, 4, 3, 1, yes
140606748,  FilippoRe, 5, 4, 1, yes
1451522948,  FrCrOr, 1, 1, 0, yes
3399300046,  paolo_scappiti, 1, 1, 0, yes
2810246253,  lennonzuardi17, 1, 1, 0, yes
759056540439490565,  EdoardoFracassi, 1, 1, 0, yes
4326562221,  sergiobar1976, 1, 1, 0, yes
706836086,  liviom80, 1, 1, 0, yes
41909882,  robforconi, 1, 1, 0, yes
739541589018693637,  GoVale46, 1, 1, 0, yes
3182465583,  lellar2, 1, 1, 0, yes
1288975146,  JuicyAG, 4, 4, 0, yes
744231081889640448,  CinziapaolaD, 1, 1, 0, yes
463020092,  RossanaCaserta, 1, 1, 0, yes
335249469,  Suryasusanna, 1, 1, 0, yes
1033198226,  chirillopaolo, 1, 1, 0, yes
493568384,  AdrianoSemproni, 2, 2, 0, yes
758356940858744832,  this_ismydesign, 1, 1, 0, yes
796256136810942465,  Delinquente72, 2, 2, 0, yes
916711892,  MauriCapone, 3, 3, 0, yes
402369594,  MorganoGiovanni, 5, 5, 0, yes
766577500050849792,  Chiara_Altomare, 1, 1, 0, yes
1018174934,  fivesec0fniall, 2, 2, 0, yes
301404616,  tserrap, 1, 1, 0, yes
2376974370,  effoortless, 2, 2, 0, yes
1131628525,  danilo32819024, 1, 1, 0, yes
2780097609,  MariaScacchia, 2, 2, 0, yes
1028180126,  TysonPERA, 14, 1, 13, no
3106907127,  11annidib, 5, 5, 0, yes
2873838833,  GiorgioFreschi, 1, 1, 0, yes
1180302133,  pierKampus, 1, 1, 0, yes
434270820,  ittommitom, 1, 1, 0, yes
168761446,  lawfox65, 2, 2, 0, yes
305223798,  albertofisogni, 1, 1, 0, yes
1935171007,  coniglio_mattia, 2, 2, 0, yes
2225761913,  elena_martello, 2, 1, 1, neutral
1042701044,  SylviaWriter, 2, 2, 0, yes
805647024993501184,  Lillaro74, 1, 1, 0, yes
498776396,  FabriFerriani, 1, 1, 0, yes
569363142,  Antonietta_95, 3, 3, 0, yes
712574295336050688,  Wtfaho, 3, 3, 0, yes
4128316425,  kinggmendess, 1, 1, 0, yes
2788545681,  MCL65, 2, 2, 0, yes
1023796488,  Luna___80, 1, 1, 0, yes
198061659,  keniars40, 1, 1, 0, yes
778177707234451457,  IlPresidente4, 8, 1, 7, no
21310060,  tomasonidiego, 3, 3, 0, yes
714741687277461504,  lapresutti, 2, 2, 0, yes
772691551998840832,  cristianasparv1, 1, 1, 0, yes
433463947,  EnricoCrippa, 4, 4, 0, yes
993105006,  studiopiccinini, 1, 1, 0, yes
410307541,  AMarianancy, 2, 2, 0, yes
504217726,  damycasa, 1, 1, 0, yes
80109220,  gloriavanni, 4, 4, 0, yes
142611704,  gppebasta, 2, 2, 0, yes
2613528768,  wthinpax, 1, 1, 0, yes
3037978047,  valentgulino, 1, 1, 0, yes
838011836,  martinadimaria9, 1, 1, 0, yes
507696309,  poleMacOS, 1, 1, 0, yes
261676003,  rmb112, 1, 1, 0, yes
541712787,  bearbutte2009, 2, 2, 0, yes
3428792885,  clasac70, 1, 1, 0, yes
549199571,  fr4nMonti, 1, 1, 0, yes
61195468,  isolda20, 1, 1, 0, yes
389935007,  stedebo23, 1, 1, 0, yes
2262340023,  Faustobetti67, 2, 2, 0, yes
3069555215,  1959maryrose, 5, 1, 4, no
628610113,  MariArena79, 2, 2, 0, yes
2557737167,  anto17964, 1, 1, 0, yes
1053475112,  CConsuelo76, 1, 1, 0, yes
720313152965980162,  procula_claudia, 1, 1, 0, yes
429949093,  Benji_Extreme, 1, 1, 0, yes
752116327578476544,  Francy_hope8, 2, 2, 0, yes
37505400,  tuttosergio, 1, 1, 0, yes
43505930,  Mdlabajova, 1, 1, 0, yes
1052445828,  elisa_ris, 1, 1, 0, yes
284501529,  iamtheluka, 2, 1, 1, neutral
986474239,  nicorangelo, 1, 1, 0, yes
3384497961,  BenjiGrall, 1, 1, 0, yes
1060714188,  saraparod, 1, 1, 0, yes
259827061,  cristianabeltra, 1, 1, 0, yes
709552914,  Patri80_C, 1, 1, 0, yes
412233943,  kavurzio, 1, 1, 0, yes
84394594,  mrbernini, 1, 1, 0, yes
3187566119,  AniaDiAngelo, 1, 1, 0, yes
561428972,  MatteDj23, 1, 1, 0, yes
1053516114,  hamjka, 1, 1, 0, yes
230498344,  everydemon, 2, 2, 0, yes
79994087,  ViewFromItaly, 1, 1, 0, yes
1924697041,  lfdiaz13, 1, 1, 0, yes
113619413,  dorinmoise, 1, 1, 0, yes
526080826,  CestariCarmine, 1, 1, 0, yes
2558754280,  Pina48, 2, 2, 0, yes
510021804,  stefaniaserra7, 1, 1, 0, yes
400358699,  lg10_, 1, 1, 0, yes
865001173,  CorryLoddo, 7, 4, 3, yes
628584631,  gbfitch, 1, 1, 0, yes
1047362311,  cortesi_u, 2, 2, 0, yes
3424404081,  crdsar, 1, 1, 0, yes
1963232000,  EleonoraFugazz2, 1, 1, 0, yes
593788361,  alepapa1964, 2, 1, 1, neutral
800016372185124865,  carlosottile67, 3, 3, 0, yes
2184707792,  annemariebotta, 2, 2, 0, yes
1106888090,  LauraMariotti5, 1, 1, 0, yes
3221685154,  fonsidjdecuba, 3, 3, 0, yes
795345194585620481,  monicamagni_rm, 2, 2, 0, yes
477776987,  Fede180475, 2, 2, 0, yes
1695893004,  gattonero76, 1, 1, 0, yes
465703306,  JoyaToninu, 2, 2, 0, yes
2352665079,  GGarcialopez2, 1, 1, 0, yes
2193933849,  GFornasa, 2, 2, 0, yes
3419131339,  chiaralmaffei, 1, 1, 0, yes
805756027174055936,  SabrinaGreco11, 1, 1, 0, yes
3538953856,  Kr3mixMC, 4, 4, 0, yes
2534356083,  loveisnoisee, 1, 1, 0, yes
3246342550,  GioLo5, 1, 1, 0, yes
2982341974,  peppedamia, 1, 1, 0, yes
805736904423567360,  TonyBrusca, 2, 2, 0, yes
827211547,  pietrolucacass, 3, 3, 0, yes
1047235944,  SergioSfondrini, 1, 1, 0, yes
2416213261,  Alekos1941, 1, 1, 0, yes
4762591823,  Martina30091985, 1, 1, 0, yes
156588203,  SRK_PC_my_jaan, 1, 1, 0, yes
783922958314115072,  luigim56, 2, 2, 0, yes
252512780,  antoclerici, 1, 1, 0, yes
3063187205,  CaforioClotilde, 2, 2, 0, yes
805751723365175296,  AntonelloR86, 1, 1, 0, yes
2231942952,  mlmattioli, 2, 2, 0, yes
1155078768,  RenataZib, 1, 1, 0, yes
593551587,  o_petrucci, 2, 2, 0, yes
1140335684,  fumasterni, 1, 1, 0, yes
1406041933,  EzeMastaki, 3, 2, 1, yes
792030332,  hundericocco, 1, 1, 0, yes
526922467,  interoprimi, 1, 1, 0, yes
4625583033,  ClaFiore1995, 1, 1, 0, yes
270563971,  GiuseMang, 2, 2, 0, yes
3374281462,  StartupTheWorld, 1, 1, 0, yes
2357228447,  l_michiara, 5, 5, 0, yes
805755978696237057,  iralessia, 1, 1, 0, yes
2860777154,  dany_ors, 1, 1, 0, yes
1280004949,  massi_me, 1, 1, 0, yes
793813860436348929,  enrdar1, 1, 1, 0, yes
463905339,  FichFra, 2, 2, 0, yes
593752035,  BuffyZanotti, 4, 4, 0, yes
1608414217,  ManifPourTousIt, 3, 2, 1, yes
797862852526821376,  eligarbico, 1, 1, 0, yes
805753818663284736,  Angela18021975, 1, 1, 0, yes
2429234237,  Anna52772839, 1, 1, 0, yes
535260242,  BarbyBug, 2, 2, 0, yes
1121568522,  AngeloGotti1, 1, 1, 0, yes
2425240244,  martina8596, 6, 6, 0, yes
2771049051,  SilviaCapellupo, 1, 1, 0, yes
397012996,  marco_tonini, 3, 3, 0, yes
252755806,  MarTeMasciocchi, 3, 3, 0, yes
703920714676641792,  leoagosto66, 1, 1, 0, yes
3007369708,  PatriziaFurini, 2, 2, 0, yes
2442948483,  SacchiSusy, 2, 2, 0, yes
207137673,  ytsom, 1, 1, 0, yes
1081233134,  PZuntini, 4, 2, 2, neutral
428466457,  eureka1954, 1, 1, 0, yes
987286098,  ClaudioGColombo, 1, 1, 0, yes
497277430,  soniacosta70, 2, 2, 0, yes
136637812,  marcocast84, 1, 1, 0, yes
1346074165,  Adea_Guillot, 1, 1, 0, yes
422894611,  GioiaVincenzo, 1, 1, 0, yes
281435013,  ideaplatonica74, 3, 3, 0, yes
317607384,  marco_bovolenta, 1, 1, 0, yes
986389286,  giusbrogi, 1, 1, 0, yes
3567388877,  SergioLegram, 1, 1, 0, yes
805693511366545408,  Vanessa81935131, 1, 1, 0, yes
223382695,  calipette, 1, 1, 0, yes
1659759625,  amelia62109801, 1, 1, 0, yes
829834464,  gianbattistama, 2, 2, 0, yes
805694881058488320,  boi_ricci, 1, 1, 0, yes
778995733953441793,  LuzaCoD, 1, 1, 0, yes
1736726556,  2jeka2, 1, 1, 0, yes
4877232592,  silvia95077047, 1, 1, 0, yes
349584061,  LUNArestaurant, 1, 1, 0, yes
869685432,  euvaras, 1, 1, 0, yes
499834334,  ArabrabMuraca, 1, 1, 0, yes
3175723277,  pidepas, 2, 2, 0, yes
209547335,  SilviaRMideas, 1, 1, 0, yes
169935318,  Ahmcolak, 1, 1, 0, yes
16543583,  LuigiDiIasio, 3, 2, 1, yes
417213341,  SerenaAbrate, 1, 1, 0, yes
2343762240,  BenessereEssere, 1, 1, 0, yes
630961303,  UrloDellaRete, 1, 1, 0, yes
4713636089,  NivrykChiara, 1, 1, 0, yes
254239188,  frodo2507, 2, 2, 0, yes
278467584,  mathematiko83, 1, 1, 0, yes
421053911,  tersilvio, 1, 1, 0, yes
309673616,  d_s_dario, 1, 1, 0, yes
1446141966,  spano81, 1, 1, 0, yes
2902464045,  LaPungiTopa, 1, 1, 0, yes
23664242,  zunocera, 1, 1, 0, yes
1842759236,  MPratelli, 1, 1, 0, yes
476761508,  LuigiDebiasi, 1, 1, 0, yes
805690729536352257,  Angelocorsaro85, 1, 1, 0, yes
2217956377,  _aug_10th, 2, 2, 0, yes
2427150499,  superfoco1984, 2, 2, 0, yes
548641254,  BonanniBibi, 1, 1, 0, yes
998351023,  luigigia1, 1, 1, 0, yes
801028194702946304,  prodo66, 2, 2, 0, yes
481952930,  MariaElisaMart, 1, 1, 0, yes
2251966754,  maurizio_albert, 1, 1, 0, yes
369441295,  andylanza24, 1, 1, 0, yes
4867401563,  yolemax2002, 1, 1, 0, yes
53039843,  SelfMadeMan80, 1, 1, 0, yes
2743366841,  gio_lazzarin, 2, 2, 0, yes
140502808,  frabba69, 1, 1, 0, yes
2929566400,  NordKapp2015, 3, 3, 0, yes
1420539098,  MyriamManca, 1, 1, 0, yes
937173019,  Giampoldigno, 1, 1, 0, yes
381178264,  CiscardiDanilo, 1, 1, 0, yes
22627429,  beachwaves82, 1, 1, 0, yes
43138213,  simone_arduini, 2, 1, 1, neutral
2408481885,  JaciluCinzia, 4, 3, 1, yes
337096642,  GianniMusso, 1, 1, 0, yes
539962117,  MariuzzoAndrea, 1, 1, 0, yes
1018593020,  Arcj22, 3, 3, 0, yes
2431562331,  DeborahPiperno, 2, 2, 0, yes
378487475,  GiacomoClick, 1, 1, 0, yes
2556580015,  Tomlinformica, 2, 2, 0, yes
112791383,  melissima80, 1, 1, 0, yes
2900489815,  ClementiClaudio, 2, 2, 0, yes
732852871,  shardana50, 1, 1, 0, yes
1928484866,  LJLucifero, 2, 1, 1, neutral
3390859047,  ciclistaimpert, 1, 1, 0, yes
269030798,  NancyAiello, 2, 2, 0, yes
319402384,  fuatbozyel, 1, 1, 0, yes
407662837,  RamseteRa, 2, 2, 0, yes
1131217512,  Nikla710, 1, 1, 0, yes
4697563004,  BlackSheep985, 1, 1, 0, yes
23511854,  gianc, 1, 1, 0, yes
2636978444,  mikemar1967, 1, 1, 0, yes
233959454,  LoliLopesino, 1, 1, 0, yes
2465674479,  grilli5293, 2, 1, 1, neutral
100791669,  carlo_75, 1, 1, 0, yes
394190697,  StefaniaStesa, 1, 1, 0, yes
3007456234,  rikiard2, 8, 6, 2, yes
1087020968,  luca_comba, 2, 2, 0, yes
376323771,  EnzoPiazza, 1, 1, 0, yes
2497125043,  Advolotwit, 1, 1, 0, yes
536174298,  marper6620, 2, 2, 0, yes
3424153757,  CarmelaDandrea1, 1, 1, 0, yes
799874546862014465,  KronicaM5S, 3, 1, 2, no
583839098,  AnnaDrovandi, 1, 1, 0, yes
2393782689,  luca_gabban, 1, 1, 0, yes
749236548193910784,  _ZappaTeo_, 1, 1, 0, yes
588338882,  La_brus, 2, 2, 0, yes
59578389,  78neferti, 1, 1, 0, yes
3381467363,  Siempre_PSOE, 1, 1, 0, yes
180257310,  capinoSvu, 1, 1, 0, yes
2401627012,  SNasole, 1, 1, 0, yes
395221007,  Melkydst, 1, 1, 0, yes
2839992429,  Heidegger_PL, 1, 1, 0, yes
353132840,  NotTheRealDem, 1, 1, 0, yes
221904358,  profdantte, 2, 2, 0, yes
804348246,  sfaccimmone, 1, 1, 0, yes
474115794,  cristianduriatt, 1, 1, 0, yes
2569758357,  MarcoMarcovale5, 1, 1, 0, yes
425811911,  CarolinaVarchi, 1, 1, 0, yes
131629662,  tirathbadyal, 1, 1, 0, yes
453341205,  savinocarbone, 1, 1, 0, yes
2164698989,  ultrablackwhite, 2, 2, 0, yes
551136040,  KasdaglisC, 1, 1, 0, yes
381128944,  fabbrifa65, 6, 5, 1, yes
2338918677,  wlavitaole, 1, 1, 0, yes
434789539,  simosimo2787, 1, 1, 0, yes
448055201,  mattebrigno, 2, 2, 0, yes
432823713,  elydiegotechila, 1, 1, 0, yes
83586556,  Assia_H, 1, 1, 0, yes
409490012,  JorgeParis1, 1, 1, 0, yes
416932896,  Tom_Amato, 1, 1, 0, yes
805549843812913152,  j3cko86, 1, 1, 0, yes
701747047,  sechovoglia, 1, 1, 0, yes
345524427,  mvitorodrigues, 2, 2, 0, yes
1702149679,  giovannafarina4, 1, 1, 0, yes
138579666,  AlvarezdePereaA, 1, 1, 0, yes
772519734592040961,  umeglio90, 2, 2, 0, yes
274629573,  P_NenaNena, 1, 1, 0, yes
744984726080004096,  estremo_sud, 3, 2, 1, yes
3347205568,  0a9cebf8ca1a418, 4, 4, 0, yes
490839491,  Dany_B_89, 1, 1, 0, yes
2281160869,  AntonBarbieri67, 2, 2, 0, yes
1151175614,  Javiermartin1e, 1, 1, 0, yes
505768512,  ballerina6200, 1, 1, 0, yes
426529599,  ENRICOALOISI, 2, 2, 0, yes
560192507,  PabloLoRuiz97, 1, 1, 0, yes
17752816,  jujikucz, 1, 1, 0, yes
579238142,  Francesconeri9, 1, 1, 0, yes
721313553832087552,  manupaolo06, 1, 1, 0, yes
2780607506,  lollorosi_, 1, 1, 0, yes
499999748,  CarmedisDi, 2, 2, 0, yes
29161261,  domenico40, 1, 1, 0, yes
195350704,  ConUdeUnico_, 1, 1, 0, yes
117341231,  josecdiez, 1, 1, 0, yes
546997419,  eziosala, 1, 1, 0, yes
297681812,  saraddsara, 1, 1, 0, yes
1007301842,  interno32, 1, 1, 0, yes
2762130903,  LordT0c, 1, 1, 0, yes
803557391501557763,  oOZombieOo1, 1, 1, 0, yes
2381955902,  joemeta1, 1, 1, 0, yes
707666511398305792,  _Mavrogialouros, 1, 1, 0, yes
1351645158,  AntonioGuerri19, 1, 1, 0, yes
133678381,  Fra_pamuk, 2, 2, 0, yes
754788445,  Luckersartori, 1, 1, 0, yes
195350635,  Madhubhaii, 1, 1, 0, yes
2805929187,  pizzamaker8, 1, 1, 0, yes
362450056,  DomenicoFusco, 2, 2, 0, yes
405719917,  Fravert, 5, 4, 1, yes
2465155140,  laucarpineta, 1, 1, 0, yes
730884156,  GCaldone, 2, 2, 0, yes
169388854,  free_spirit_80, 1, 1, 0, yes
4483109657,  Ange90Gaglio, 1, 1, 0, yes
1406253950,  anonimiromani, 3, 3, 0, yes
108331784,  Endorphineee, 1, 1, 0, yes
1295034331,  fran_lag, 2, 2, 0, yes
262649213,  carubina8978, 1, 1, 0, yes
520313622,  VivodaRe, 1, 1, 0, yes
780772735668457472,  Sasyfede1926, 4, 4, 0, yes
500988322,  NICOELIESPOSITO, 2, 1, 1, neutral
2752524750,  nicolas_palas, 1, 1, 0, yes
4142600495,  e445f12f9e1c4ff, 1, 1, 0, yes
2411316883,  Botstral, 1, 1, 0, yes
420557096,  LaGinger, 3, 3, 0, yes
84103652,  maledetto1976, 1, 1, 0, yes
206330048,  romulusaugustul, 1, 1, 0, yes
1949944004,  claudiapausini8, 1, 1, 0, yes
49287577,  mattia82, 1, 1, 0, yes
2751538930,  StranoMirko, 4, 4, 0, yes
390850424,  18_mansi, 1, 1, 0, yes
2329430310,  MAX77ALE2007, 1, 1, 0, yes
242283797,  mariakatsme, 1, 1, 0, yes
4764008248,  franco56939151, 5, 3, 2, yes
114427344,  Bruno_G79, 1, 1, 0, yes
416214216,  NICOLABOVOLI, 2, 2, 0, yes
847870729,  Chris6601946, 1, 1, 0, yes
518316251,  AndreaRaffael_e, 3, 3, 0, yes
805550059890896896,  antonioflo83, 3, 3, 0, yes
306368937,  TheCyrus1, 2, 2, 0, yes
1638877123,  ArchieHenry2, 1, 1, 0, yes
4030998676,  pdebekelar, 1, 1, 0, yes
13436192,  Delphine_D, 1, 1, 0, yes
762291301857497088,  AncestralTie19, 3, 3, 0, yes
445834480,  OkabeKyoumi, 1, 1, 0, yes
1672433401,  19Gianni26, 5, 5, 0, yes
1540434367,  Joxyn_, 1, 1, 0, yes
80281184,  frazaccaria, 1, 1, 0, yes
805550003896860672,  Ruben123neb, 1, 1, 0, yes
434787647,  alonso_aparicio, 1, 1, 0, yes
463047107,  labonvii, 1, 1, 0, yes
151581782,  matteojordan, 3, 3, 0, yes
855206654,  DipporRaffaele, 1, 1, 0, yes
143909649,  Jorxrubio, 1, 1, 0, yes
503158841,  Trotta63Trotta, 1, 1, 0, yes
189283013,  MarcoDelTorchio, 1, 1, 0, yes
301374440,  frvalles, 1, 1, 0, yes
4578908063,  laxSity, 1, 1, 0, yes
878443586,  TifoCami, 1, 1, 0, yes
258856826,  ChiaraDiGianvit, 1, 1, 0, yes
451362493,  bagavita, 1, 1, 0, yes
33244356,  QuirkySquark, 1, 1, 0, yes
2373978739,  AValentino85, 1, 1, 0, yes
804793309952667648,  Dani_ninis, 1, 1, 0, yes
34492262,  DJFunkyGrrL, 1, 1, 0, yes
1204377332,  gizmodarmody, 3, 2, 1, yes
754017028034400256,  DuffiziRoberto, 2, 2, 0, yes
339698448,  benedettacosmi, 2, 2, 0, yes
492467731,  StefanoBlencio, 1, 1, 0, yes
347089179,  g_evgenidis, 1, 1, 0, yes
22610431,  ImBoxoFranz, 1, 1, 0, yes
2845307079,  io_tiziana, 3, 3, 0, yes
505545995,  RosbelDuran, 1, 1, 0, yes
2973098399,  Alessandrocim15, 2, 2, 0, yes
2243394263,  MaurizioMgrungo, 1, 1, 0, yes
1274934110,  CeciliaCecylom, 3, 3, 0, yes
2297529444,  polmeus, 1, 1, 0, yes
390942917,  StephenRainbird, 1, 1, 0, yes
805551209541238784,  BenettiMattia, 1, 1, 0, yes
49035872,  ajcaleca, 1, 1, 0, yes
483102030,  marcoprocs, 3, 2, 1, yes
472840802,  DucaBruno, 1, 1, 0, yes
1002182030,  aleparoni, 2, 2, 0, yes
86197337,  drsilenzi, 1, 1, 0, yes
564176805,  Legionauro, 1, 1, 0, yes
2150009969,  HoneyeyesA, 1, 1, 0, yes
1247071002,  Calem_grande, 9, 4, 5, no
498031195,  NRiglietti, 3, 1, 2, no
3294446985,  MonteCr62530872, 1, 1, 0, yes
905921612,  DahliaGM, 1, 1, 0, yes
3235542892,  danbag72, 1, 1, 0, yes
568178551,  maryCChanel, 2, 2, 0, yes
33840320,  Zaktweet, 2, 2, 0, yes
355988550,  StefanoCapacci, 2, 2, 0, yes
285239924,  CoralieDelaume, 1, 1, 0, yes
569202613,  Musnu17Lautieri, 1, 1, 0, yes
591629546,  MarzioCosta, 1, 1, 0, yes
805550383540146176,  alemini3, 1, 1, 0, yes
2340306893,  longo2610, 1, 1, 0, yes
2763632387,  bizzobeltran13, 2, 2, 0, yes
1329007374,  MkyJFrrll, 1, 1, 0, yes
927435889,  dgennaioli, 1, 1, 0, yes
128482552,  JohnNepkins, 1, 1, 0, yes
370270425,  barbaramasulli, 1, 1, 0, yes
766472826,  antoniomorrone5, 3, 3, 0, yes
4701382877,  jammie1959, 2, 2, 0, yes
793814835666518017,  marrusso01, 2, 2, 0, yes
517321466,  SandroSEDRAN, 2, 2, 0, yes
96348337,  thenaar, 3, 2, 1, yes
365065812,  Laura_Kinder, 1, 1, 0, yes
985142917,  GiulsBigs, 1, 1, 0, yes
779757600783081476,  Dac21gaga, 1, 1, 0, yes
559372170,  IkaFiordiliso, 1, 1, 0, yes
2254187747,  CupiIlir, 3, 3, 0, yes
552941521,  Fabbris97, 8, 1, 7, no
2989755616,  inomniaparatus5, 1, 1, 0, yes
1209059904,  LorenzoBon_, 1, 1, 0, yes
481123900,  Azambo98, 2, 2, 0, yes
227372839,  monicanassisi, 1, 1, 0, yes
411420322,  RapinoLorenzo, 2, 2, 0, yes
116712481,  nestorponguta, 1, 1, 0, yes
2318924155,  pinolapermalosa, 1, 1, 0, yes
471891488,  rob_marinucci, 1, 1, 0, yes
920435114,  LuigiGallo15, 4, 1, 3, no
2574632838,  StefanoPPK, 1, 1, 0, yes
3085173041,  toffee82305, 7, 7, 0, yes
979856821,  mdenaro63, 1, 1, 0, yes
398903741,  MarioLoca46, 1, 1, 0, yes
58240006,  marilena3, 1, 1, 0, yes
47091549,  mathieugallard, 1, 1, 0, yes
155012648,  _ShelovesGaGa, 4, 4, 0, yes
784163003218427904,  TerceraRepublca, 1, 1, 0, yes
1117232047,  Boson_S, 1, 1, 0, yes
184957203,  HaruhiBlack, 1, 1, 0, yes
805550763770605570,  pandz_i, 1, 1, 0, yes
89216551,  living_73, 4, 3, 1, yes
253956103,  Luigipanzeri, 1, 1, 0, yes
534619476,  fransidecandia, 2, 2, 0, yes
322870736,  signorDamy, 1, 1, 0, yes
2813881335,  marco171292, 1, 1, 0, yes
582232217,  costantinomarc2, 1, 1, 0, yes
299579897,  Anne3ca, 1, 1, 0, yes
113688866,  StefaniaGatta, 1, 1, 0, yes
121163427,  Luciaritrovato, 3, 3, 0, yes
3807368123,  JoKer33817736, 2, 1, 1, neutral
197020105,  SteelMan1984, 1, 1, 0, yes
750231912,  AlbertiClemente, 1, 1, 0, yes
475245988,  matteo_pz, 2, 2, 0, yes
2348228122,  manuelagreco29, 2, 1, 1, neutral
588359135,  FPiccinni, 2, 2, 0, yes
805550284743311361,  Andrea070498, 1, 1, 0, yes
72614507,  Romana40, 1, 1, 0, yes
235171152,  Mottavia, 3, 1, 2, no
792137050451509248,  _amorsi, 2, 2, 0, yes
470325173,  vincenzodipi, 1, 1, 0, yes
3436101647,  lwwr1976, 1, 1, 0, yes
827900887,  borsao2, 2, 2, 0, yes
3861596193,  alessan220, 1, 1, 0, yes
456114750,  CarolCarla50, 1, 1, 0, yes
402302077,  Nayaer14, 1, 1, 0, yes
4786466487,  ElenaBulgarell3, 5, 5, 0, yes
2842597865,  giovanni_zucchi, 4, 4, 0, yes
132171317,  fep75, 1, 1, 0, yes
774533134138404864,  tinapica88, 1, 1, 0, yes
153302498,  gildorock, 2, 2, 0, yes
403633565,  guidissimo83, 1, 1, 0, yes
1479745272,  OttoliS91, 1, 1, 0, yes
4152140421,  Monica57407888, 2, 2, 0, yes
259217277,  PeppeMaugeri, 1, 1, 0, yes
1110551,  JamesBruni, 2, 2, 0, yes
435887882,  SalvoGiovenco, 2, 1, 1, neutral
386743800,  tote_alkor, 1, 1, 0, yes
433538171,  giannipizza1982, 3, 1, 2, no
1632539378,  sweetnicolemary, 1, 1, 0, yes
965081233,  _flamp, 2, 2, 0, yes
458685264,  EmanueleDottori, 2, 2, 0, yes
545513304,  Sofiri1, 4, 4, 0, yes
2286561585,  79amala, 2, 2, 0, yes
1562837839,  kikobarna1, 1, 1, 0, yes
552912638,  alvarito9797, 1, 1, 0, yes
512567549,  MatteoCioni2, 1, 1, 0, yes
3207190859,  sipietrantonio, 2, 2, 0, yes
431907075,  federicovicini, 1, 1, 0, yes
4097471361,  eris23elda, 1, 1, 0, yes
320327200,  AriannaLouiseB, 1, 1, 0, yes
68524942,  NenaMancio, 3, 2, 1, yes
4691697265,  lillo716, 1, 1, 0, yes
438376256,  pep8real, 1, 1, 0, yes
1392552084,  MaioloDaniele, 2, 2, 0, yes
423541963,  FilGramegna, 2, 2, 0, yes
2493169664,  laudan62, 1, 1, 0, yes
418730549,  unsole_, 1, 1, 0, yes
370064768,  JZerucelli, 1, 1, 0, yes
740877901,  Riviera_Santana, 3, 2, 1, yes
2472967664,  FaustodeCelis, 1, 1, 0, yes
399705092,  Micciullo_Anton, 4, 4, 0, yes
2353264339,  SalvatoreP1960, 1, 1, 0, yes
449098933,  Simona_Semeraro, 3, 2, 1, yes
162893574,  metoz88, 2, 2, 0, yes
976979232,  GiuseppeTalone, 2, 2, 0, yes
1165684578,  ScarpaGabriele, 3, 1, 2, no
8821252,  perealvaro, 1, 1, 0, yes
3010643573,  lucadel08, 1, 1, 0, yes
1019395273,  ybarresi, 3, 3, 0, yes
353593077,  diegodagiau, 1, 1, 0, yes
1266717968,  sciullen, 1, 1, 0, yes
2584588979,  AuroreItalie, 1, 1, 0, yes
55803731,  pierps, 1, 1, 0, yes
223200527,  BadPaskua, 4, 2, 2, neutral
72519775,  philbird2, 1, 1, 0, yes
710490321545728001,  amacord17, 1, 1, 0, yes
833012514,  dipietro_angelo, 1, 1, 0, yes
373049625,  EnzoQuareEQ7, 1, 1, 0, yes
1592051311,  harry_riddle_, 1, 1, 0, yes
557584682,  _MsSlytherin, 3, 2, 1, yes
83682870,  boxster70, 1, 1, 0, yes
3951163695,  TrumpSelfFunds, 1, 1, 0, yes
818250565,  fpmeuron, 1, 1, 0, yes
586783065,  Soniatalero_, 1, 1, 0, yes
805549972427051008,  Rocco00958096, 3, 3, 0, yes
2892012311,  boi_io, 1, 1, 0, yes
48049530,  accasette, 1, 1, 0, yes
533079643,  MarcusWells_, 1, 1, 0, yes
450923629,  luisapietropaol, 1, 1, 0, yes
542331851,  RobertoCannizz2, 1, 1, 0, yes
4887635579,  mircosirco, 2, 2, 0, yes
2331999371,  zeragaber, 3, 3, 0, yes
351164494,  lucios71, 1, 1, 0, yes
476298310,  Jared_Mango, 1, 1, 0, yes
299740451,  FedericoDiRenzo, 1, 1, 0, yes
1217720851,  Il_sivos, 1, 1, 0, yes
836268638,  BernardiniEnza, 1, 1, 0, yes
778885537,  AntonioPanni, 1, 1, 0, yes
20715638,  PhilDeCarolis, 1, 1, 0, yes
576361872,  tommasotetro, 2, 2, 0, yes
911117598,  gbasfi, 1, 1, 0, yes
586480391,  AgneseConti, 1, 1, 0, yes
70534086,  LostInMemo, 2, 2, 0, yes
2921901945,  EsperanzaMorada, 1, 1, 0, yes
70468529,  ivanstammelluti, 1, 1, 0, yes
493981655,  5t_pOl, 1, 1, 0, yes
141862552,  cmaurizio, 1, 1, 0, yes
514303941,  chicmixjohn, 1, 1, 0, yes
117486038,  ElenaGriff, 2, 2, 0, yes
221287397,  MitchellU1, 1, 1, 0, yes
796062217925959681,  mario1ferlito, 1, 1, 0, yes
431557500,  giuseppegmazza, 1, 1, 0, yes
470505674,  pereceron, 2, 2, 0, yes
555412866,  davidedl83, 1, 1, 0, yes
1357722025,  fabygandolfi, 1, 1, 0, yes
561489422,  FathallahEssam, 2, 2, 0, yes
1037817270,  valentinabendi, 1, 1, 0, yes
410327691,  giorgia_ponti, 1, 1, 0, yes
68025994,  chazzpm, 1, 1, 0, yes
149876100,  SandroCosi, 1, 1, 0, yes
156000994,  adamferguson182, 1, 1, 0, yes
31458684,  pimmfox, 2, 2, 0, yes
473786130,  maurocrisari, 1, 1, 0, yes
4106950157,  carlotak64, 2, 2, 0, yes
40446304,  sivabeh, 1, 1, 0, yes
1696305182,  PatetePatete, 1, 1, 0, yes
1590994513,  Laura_20s, 2, 2, 0, yes
398004123,  aleroma1982, 1, 1, 0, yes
805549628485734400,  zoombiercbk, 1, 1, 0, yes
395381127,  FabrizioGianuss, 1, 1, 0, yes
430943425,  lanza_oreste, 1, 1, 0, yes
71262814,  ianssmart, 1, 1, 0, yes
2855391653,  seimioni, 2, 2, 0, yes
223515625,  MatteoVillaYB, 2, 2, 0, yes
457394700,  chancelnadjou, 1, 1, 0, yes
266847594,  jordilacambra, 1, 1, 0, yes
355523213,  raul230280, 1, 1, 0, yes
220874196,  EnrikeLino, 1, 1, 0, yes
299795045,  calamitweet, 1, 1, 0, yes
2499978518,  hu_lviv, 1, 1, 0, yes
3007800886,  gianroma49, 2, 2, 0, yes
9946882,  GiacomoRz, 1, 1, 0, yes
358903765,  vesuvio1977, 3, 2, 1, yes
25661727,  Caraps, 1, 1, 0, yes
2477158421,  john_milton69, 1, 1, 0, yes
23049519,  OlandeseRoma, 2, 2, 0, yes
1329974636,  luanaalsini58, 1, 1, 0, yes
3295812385,  JrAgostino, 1, 1, 0, yes
490674569,  RitaBoffi, 1, 1, 0, yes
1324763318,  dammilaclava, 1, 1, 0, yes
1238729318,  GpLiber, 1, 1, 0, yes
2789154285,  gbartolini1966, 2, 2, 0, yes
1390409390,  MarcoCaiazzo82, 1, 1, 0, yes
2322120176,  corne_luca, 1, 1, 0, yes
3393904492,  lorenzavescovi, 1, 1, 0, yes
707725315,  Ciabaferra94, 1, 1, 0, yes
2460745596,  salvopilot, 1, 1, 0, yes
462831159,  archumby55, 1, 1, 0, yes
53628146,  OlivierDiGianni, 3, 3, 0, yes
16613227,  nunovargas, 1, 1, 0, yes
3697294275,  valecaimi, 2, 2, 0, yes
608298224,  Mariothebestxse, 1, 1, 0, yes
313457842,  cripatch, 1, 1, 0, yes
4834997097,  info73069771, 1, 1, 0, yes
2723907512,  ChessVertigo, 1, 1, 0, yes
2580752990,  UvyMordicante, 1, 1, 0, yes
1065927258,  carlo_rov, 1, 1, 0, yes
2969776185,  InCrisi, 1, 1, 0, yes
2377047123,  kaic84, 1, 1, 0, yes
1052279604,  cesareruggeri, 1, 1, 0, yes
480218550,  VeliaSetti, 1, 1, 0, yes
778252890511118336,  tamirrencris, 4, 4, 0, yes
277933820,  ppaleandri, 1, 1, 0, yes
455082785,  chrmilici, 1, 1, 0, yes
598011658,  capoceraso, 1, 1, 0, yes
2373806545,  tomedomat, 2, 1, 1, neutral
133764909,  Valentina_27_, 3, 3, 0, yes
2768108356,  ElectricEmy, 1, 1, 0, yes
779097093730426880,  kiara100fanti, 2, 2, 0, yes
441273511,  alessarno, 3, 1, 2, no
464124265,  Twit_NIS, 1, 1, 0, yes
718254192,  MirekVoice07, 2, 2, 0, yes
453083980,  whitemos3s, 1, 1, 0, yes
300361611,  RobertaDiorio, 1, 1, 0, yes
730370780677193728,  patriziapiccol7, 2, 2, 0, yes
56624454,  agnettabruno, 1, 1, 0, yes
389253630,  antoniomanzo3, 1, 1, 0, yes
999315278,  AnelloPaola, 1, 1, 0, yes
4126172775,  Safaehadri1, 1, 1, 0, yes
3252476633,  VittorioFelli, 1, 1, 0, yes
242718237,  jjn_vonk, 1, 1, 0, yes
346187275,  VLetsios, 1, 1, 0, yes
472301391,  gaia796, 6, 1, 5, no
303754150,  FerrarisR, 1, 1, 0, yes
434001132,  tubiolo, 1, 1, 0, yes
760553148507385856,  Giordan33531435, 1, 1, 0, yes
249125525,  ugojazz, 6, 6, 0, yes
2397150845,  FabiolaMariott1, 1, 1, 0, yes
3878967316,  GrainDeSable_, 1, 1, 0, yes
98616163,  iroshi9, 1, 1, 0, yes
2853118781,  Antonella220473, 1, 1, 0, yes
1209045662,  tititablu, 1, 1, 0, yes
243110037,  marix_me, 1, 1, 0, yes
2725556453,  Mer_Tomlinson, 2, 2, 0, yes
800430403584540672,  eneas2203, 2, 2, 0, yes
172249828,  akillerf, 2, 2, 0, yes
387519649,  antoniaronga, 1, 1, 0, yes
1077753097,  Silverjohn67, 1, 1, 0, yes
474932878,  RikusMellet, 1, 1, 0, yes
973639880,  rosba76, 1, 1, 0, yes
416866144,  LucaKat1, 1, 1, 0, yes
316960515,  MFerraraF, 1, 1, 0, yes
767584309,  Finny___, 2, 2, 0, yes
446937751,  mass_march, 1, 1, 0, yes
38692931,  nicovergani, 1, 1, 0, yes
3366083633,  soulmatouis, 3, 2, 1, yes
591651740,  simonescovazzo, 1, 1, 0, yes
437764779,  robymazza70, 1, 1, 0, yes
2974259825,  VitoRubino0, 1, 1, 0, yes
61419304,  maurosays, 6, 1, 5, no
183166373,  strategicpolicy, 1, 1, 0, yes
725284451211722753,  luca_chit, 1, 1, 0, yes
701912987,  PieroRais, 2, 2, 0, yes
3296143359,  baldassarerume1, 5, 5, 0, yes
525035078,  fabr_ferretti, 1, 1, 0, yes
417349910,  lozio98, 1, 1, 0, yes
1381973646,  NDaniela3, 1, 1, 0, yes
3588383897,  soulfoodtogoes, 1, 1, 0, yes
480330301,  MarioSaviello, 1, 1, 0, yes
4905484317,  giacobbebartol1, 3, 3, 0, yes
3027566599,  SteriRosy, 2, 2, 0, yes
4842523900,  brizz1963, 7, 2, 5, no
727094070137503746,  doaa_102, 1, 1, 0, yes
2386573579,  ESAQPD, 1, 1, 0, yes
741083478,  linda_bianchin, 1, 1, 0, yes
904459598,  StefanoBriotti, 1, 1, 0, yes
1883273952,  cinzia44818258, 1, 1, 0, yes
564571580,  GGStefanel, 1, 1, 0, yes
1563965450,  marcolsteinberg, 1, 1, 0, yes
1916498976,  barbarabenfatto, 1, 1, 0, yes
154049996,  Domenico065, 2, 2, 0, yes
1054921585,  GabrieleCandid2, 1, 1, 0, yes
367647153,  GioTropeano, 1, 1, 0, yes
794035311395373056,  mehmetenesbeser, 1, 1, 0, yes
211129641,  paoletto11, 1, 1, 0, yes
46093827,  WodehouseRock, 3, 3, 0, yes
164814907,  _Carle_, 1, 1, 0, yes
4830513129,  Oksana78395400, 1, 1, 0, yes
4044305427,  fabiovale1929, 2, 2, 0, yes
695658573871841280,  dincecco_s, 1, 1, 0, yes
2206179700,  MerliValeria, 1, 1, 0, yes
1209806856,  madeinzena, 3, 3, 0, yes
2341927981,  SigAubry, 1, 1, 0, yes
3298553405,  marco220m, 2, 2, 0, yes
485969641,  Giadashallala, 2, 1, 1, neutral
3305744660,  yume_fx, 1, 1, 0, yes
199615190,  beneuss67, 1, 1, 0, yes
805551718599716864,  Edo_ard_o, 1, 1, 0, yes
516777271,  Ilfefy, 1, 1, 0, yes
714194821792079873,  francy79i, 1, 1, 0, yes
368248258,  littlflo, 2, 1, 1, neutral
403681365,  sicutnox, 2, 2, 0, yes
903918764,  sdgiorgi, 2, 2, 0, yes
126353721,  SuperRox01, 4, 4, 0, yes
702880137335930882,  nicojsessa, 1, 1, 0, yes
712230625604968448,  PatriziaMussoni, 1, 1, 0, yes
447513121,  paolettimichele, 1, 1, 0, yes
63528313,  MrMalky, 1, 1, 0, yes
988677408,  AlbiGaviraghi, 5, 3, 2, yes
2362752282,  balice1977, 1, 1, 0, yes
44959884,  JimKerr1973, 1, 1, 0, yes
1917265746,  mishkaa123, 2, 2, 0, yes
253258092,  Noiangeliblu, 1, 1, 0, yes
517721087,  l_direnzo, 8, 2, 6, no
56123652,  antonelli_a, 1, 1, 0, yes
506280984,  VanHvdh, 1, 1, 0, yes
410383506,  DejaLaNuit, 11, 10, 1, yes
3110440967,  angesorrenti, 2, 2, 0, yes
2713265133,  SalvoCN, 2, 2, 0, yes
602301057,  LeonardoZanna, 2, 1, 1, neutral
2982394731,  ViteDiArchimede, 3, 3, 0, yes
2426354279,  crocket197, 2, 2, 0, yes
554528990,  DanGambard, 12, 11, 1, yes
2820022258,  escribanonavas, 1, 1, 0, yes
398854831,  InfoEttore, 2, 2, 0, yes
121879035,  natalinove, 1, 1, 0, yes
1004562450,  mattiagenova, 1, 1, 0, yes
612704414,  juvefinoalfine, 1, 1, 0, yes
16011628,  SteveatGoodLife, 1, 1, 0, yes
102362597,  msforza, 3, 3, 0, yes
1291339302,  jlvllop, 1, 1, 0, yes
734318324,  rivluc, 2, 2, 0, yes
451022432,  Erry94, 1, 1, 0, yes
539451505,  biglhist, 1, 1, 0, yes
103049510,  ProfessorCurtis, 1, 1, 0, yes
191992974,  fcolacchi, 1, 1, 0, yes
442265323,  martona127, 1, 1, 0, yes
2448221374,  GCiox, 1, 1, 0, yes
2893861557,  Daglaia, 1, 1, 0, yes
3645615275,  MartinaSancamil, 2, 2, 0, yes
371700082,  Elibuzz, 1, 1, 0, yes
1284677702,  messerschmitt22, 2, 2, 0, yes
802861177659359232,  martylomaglio, 1, 1, 0, yes
456896279,  19Freddie85, 1, 1, 0, yes
50809580,  p4trizia, 1, 1, 0, yes
795440879649640448,  CharlotteNathou, 1, 1, 0, yes
476150797,  AmmanGiovanni, 2, 2, 0, yes
751886636942786560,  Piero46878801, 1, 1, 0, yes
300009475,  KatiaDelNegro, 1, 1, 0, yes
587688477,  AndreMongeRosso, 10, 10, 0, yes
19936511,  luigiseverini, 1, 1, 0, yes
128517243,  CarlevaleG, 1, 1, 0, yes
771424048349847552,  Ilaria77715870, 1, 1, 0, yes
899545674,  CVezz82, 1, 1, 0, yes
1101689220,  OSpinazz, 1, 1, 0, yes
174978076,  _Xscape_, 1, 1, 0, yes
2474131813,  VeneziaLuisa, 2, 1, 1, neutral
447506261,  deivxx_, 1, 1, 0, yes
1371577058,  ladymacita, 3, 2, 1, yes
545326818,  supermariotwitt, 2, 2, 0, yes
897132368,  ilmalfo, 2, 1, 1, neutral
168081541,  Kesha_MySmile, 1, 1, 0, yes
16273285,  lukejr, 1, 1, 0, yes
2640536307,  fra_dipippo, 2, 2, 0, yes
805551534775959553,  gmeccas1, 2, 2, 0, yes
224589954,  pfgstyle, 2, 2, 0, yes
534740292,  76Sciopero, 2, 2, 0, yes
242876469,  mocadele, 1, 1, 0, yes
343931635,  mmontagnana, 1, 1, 0, yes
292229906,  lsantagadap, 1, 1, 0, yes
2964705309,  barlumi_orazio, 1, 1, 0, yes
1376975449,  GregoryElly, 1, 1, 0, yes
448228141,  fragolelau, 4, 4, 0, yes
2412540813,  ridhakadiri72, 1, 1, 0, yes
435055434,  shamrock1807, 2, 2, 0, yes
1731060602,  wr_jon, 1, 1, 0, yes
4910760543,  Makkporcaro, 2, 2, 0, yes
16953120,  barbarasgarzi, 2, 2, 0, yes
1511213078,  redzed1981, 2, 2, 0, yes
515288892,  borgesegiovanni, 1, 1, 0, yes
778485818960871424,  cameo_mp, 4, 4, 0, yes
22975175,  lionese, 1, 1, 0, yes
130982265,  giodiamanti, 1, 1, 0, yes
4816805133,  giuSZi1992, 1, 1, 0, yes
2453011479,  fbaldas, 1, 1, 0, yes
7254152,  vitocola, 3, 3, 0, yes
4819585125,  CesarePullano, 1, 1, 0, yes
483181674,  simointerista, 1, 1, 0, yes
1369945826,  ncorrasco, 1, 1, 0, yes
1857317233,  katste_, 2, 2, 0, yes
212950064,  Falce73, 1, 1, 0, yes
713728115730739200,  MarceloCortese2, 1, 1, 0, yes
332324962,  AaronScorsa, 4, 4, 0, yes
95503242,  fedescutari, 1, 1, 0, yes
799361848147660800,  Blogdellavoro, 3, 2, 1, yes
2339368666,  federico_pangra, 1, 1, 0, yes
104854729,  kesause, 1, 1, 0, yes
1316339143,  Aga_e_Gabri, 1, 1, 0, yes
19140613,  ziesmannmedia, 2, 2, 0, yes
4895528873,  giadaf64, 1, 1, 0, yes
289859824,  ClaGonnelli, 8, 7, 1, yes
884309888,  steph_demonte, 1, 1, 0, yes
553459273,  _francograsso, 1, 1, 0, yes
1052460212,  CiccioNovelli, 2, 2, 0, yes
710807087,  CarrollAndrewT, 1, 1, 0, yes
43849635,  raffiore, 1, 1, 0, yes
82606137,  andrealogiudice, 5, 5, 0, yes
434160311,  FaridehG, 2, 2, 0, yes
979788474,  crivelli_andrea, 1, 1, 0, yes
2181828381,  ferraridebora05, 1, 1, 0, yes
60286749,  spottinterista, 3, 3, 0, yes
473788635,  pino877, 1, 1, 0, yes
48766283,  samy_antha, 1, 1, 0, yes
1310267400,  AndreaGiovanel4, 2, 2, 0, yes
1357684502,  AnonimoQuadraro, 1, 1, 0, yes
1095170077,  jimkordogiannis, 1, 1, 0, yes
912342114,  Minaa_1806, 12, 7, 5, yes
282517436,  ucar_andrea, 2, 2, 0, yes
445277553,  Kakazuchi, 2, 1, 1, neutral
165880433,  bblanchine, 2, 2, 0, yes
913379646,  DPinazza, 2, 2, 0, yes
2358664694,  eilagio, 2, 2, 0, yes
2239935042,  boisIter, 1, 1, 0, yes
198884971,  Bimbodoro22, 2, 1, 1, neutral
1228579849,  FMONAGHEDDU, 1, 1, 0, yes
2410128701,  Alagooon, 1, 1, 0, yes
562634375,  FabioAlario, 1, 1, 0, yes
737201584057286656,  EnzoMv70, 3, 1, 2, no
2345558831,  lucamonde, 2, 2, 0, yes
1460866802,  Miche18076, 1, 1, 0, yes
769531022430105600,  La_Via_Pangea, 2, 2, 0, yes
3816387683,  CrimsonWolfVII, 1, 1, 0, yes
10824232,  MelaRomanelli, 1, 1, 0, yes
252516822,  Bioeconet, 1, 1, 0, yes
368893989,  WalterNicoletti, 4, 4, 0, yes
102963984,  maninomax, 1, 1, 0, yes
624456136,  __valfoy, 1, 1, 0, yes
455614216,  Squall_Chief, 1, 1, 0, yes
239428854,  Roby_Valentini, 2, 2, 0, yes
2214051027,  antonioStramagl, 1, 1, 0, yes
760538241040785409,  unattimoeterno, 3, 3, 0, yes
787774580,  ChrisBrey1, 1, 1, 0, yes
3053233209,  platania63, 2, 2, 0, yes
121612157,  milanonoko, 3, 1, 2, no
592844349,  rc_schneider, 1, 1, 0, yes
805551327208148994,  Nunzio42969709, 2, 2, 0, yes
867063409,  magnitudo_7, 1, 1, 0, yes
2875178981,  dottore1989, 1, 1, 0, yes
526702733,  MarkErcolani, 4, 4, 0, yes
89713453,  barbara_b85, 3, 3, 0, yes
800842564802871296,  EscrementoC, 1, 1, 0, yes
306210060,  GiulioCerrato, 1, 1, 0, yes
3578410289,  toniofortebra, 1, 1, 0, yes
1622742043,  vivilavita10, 1, 1, 0, yes
100574264,  andreacampana82, 2, 2, 0, yes
12356422,  marcof, 1, 1, 0, yes
4332141514,  susasialove, 1, 1, 0, yes
2729352926,  PaolaOPed, 1, 1, 0, yes
774350149883686913,  stefy_nicolaci, 1, 1, 0, yes
2259659595,  bonanno_fabio, 2, 2, 0, yes
407001525,  coki1410, 5, 5, 0, yes
58857572,  giulub, 1, 1, 0, yes
4906830658,  GianlucaFriger1, 1, 1, 0, yes
1035424027,  sabina_mauro, 4, 4, 0, yes
770776788096147456,  Martigol10, 1, 1, 0, yes
193406718,  AzmodanEU, 1, 1, 0, yes
525746632,  jerofdez73, 2, 2, 0, yes
754893,  signorponza, 2, 2, 0, yes
2439844345,  AleStellare, 1, 1, 0, yes
399730949,  fabrifrancioni, 1, 1, 0, yes
1111061437,  jackpr83, 1, 1, 0, yes
1578962060,  DemocraticaBet, 1, 1, 0, yes
402259472,  Mike_Prosdocimi, 2, 2, 0, yes
1361729262,  damiant1988, 1, 1, 0, yes
255384728,  loscornetteros, 5, 3, 2, yes
90548758,  dandhicks, 4, 1, 3, no
540045818,  signos_lucas, 2, 2, 0, yes
386897100,  AlesCClock, 1, 1, 0, yes
155013379,  IvanMarrocco, 2, 2, 0, yes
4842804531,  FigliedelaServa, 2, 2, 0, yes
2398040662,  samulam1977, 5, 5, 0, yes
775562909548027904,  PPTFinance, 1, 1, 0, yes
1085908087,  itsbice, 3, 3, 0, yes
2400472947,  franci_desogus, 3, 3, 0, yes
32904859,  WhatTheMessy, 3, 3, 0, yes
225880396,  CarloAshRondi, 1, 1, 0, yes
787732270832640004,  amadeusmdf, 2, 2, 0, yes
495194006,  MannarinoLaura, 1, 1, 0, yes
373453321,  davidedioni, 1, 1, 0, yes
1274823746,  matepan, 2, 2, 0, yes
3151000540,  AlleracNicola, 1, 1, 0, yes
1310956855,  ClaudioBlasi2, 2, 2, 0, yes
4106023397,  mgdelvecchio74, 1, 1, 0, yes
3166928747,  Vittori38715898, 1, 1, 0, yes
1633438908,  adam_lamk, 1, 1, 0, yes
805683079109033984,  Monica64016732, 1, 1, 0, yes
433253863,  DavideVolpi2, 1, 1, 0, yes
2934163013,  NegriElio1, 2, 2, 0, yes
410244065,  AmaruDavid, 1, 1, 0, yes
1057968492,  robirouge62, 1, 1, 0, yes
4576911856,  Disquilibrio, 5, 3, 2, yes
426032312,  AleAleDe, 1, 1, 0, yes
2318588162,  Felix66Latini, 1, 1, 0, yes
240354973,  nakkiviola, 1, 1, 0, yes
522507515,  NegroLuciana, 1, 1, 0, yes
3104565904,  tonypalm75, 1, 1, 0, yes
3303436377,  ginasammarc, 1, 1, 0, yes
2739398945,  _ashtonsdimples, 1, 1, 0, yes
426649501,  DBettoli, 1, 1, 0, yes
880008648,  silremi, 1, 1, 0, yes
225407938,  profsen, 1, 1, 0, yes
2993817359,  vanesalvat, 2, 2, 0, yes
501183558,  domenicocarissi, 1, 1, 0, yes
445553436,  wylmadisalvo, 2, 2, 0, yes
136801143,  vinkie76, 3, 3, 0, yes
476006502,  filomenaguidi, 1, 1, 0, yes
1280441702,  GmaPeppe, 2, 2, 0, yes
4839936285,  PhoneyBa, 1, 1, 0, yes
275635768,  pratolandia, 1, 1, 0, yes
390172879,  GIOweek, 1, 1, 0, yes
2253891068,  MartinaP1087, 2, 1, 1, neutral
1964779298,  marcoramognino, 1, 1, 0, yes
244882651,  dhnored, 2, 2, 0, yes
1021681327,  pmarchetti60, 1, 1, 0, yes
468893263,  fernandesmvm, 1, 1, 0, yes
430912043,  jaina77, 1, 1, 0, yes
2966888020,  saraschivazappa, 1, 1, 0, yes
428423692,  TivoliFrancesco, 1, 1, 0, yes
2777009091,  ItaliaansGoed, 1, 1, 0, yes
540835197,  polmaxim, 1, 1, 0, yes
1098304628,  Cesarebamonte, 1, 1, 0, yes
262225947,  iomarmar, 1, 1, 0, yes
2964109143,  PeppemorBlogger, 5, 4, 1, yes
3288289414,  ceciliafalsone, 1, 1, 0, yes
972859016,  fedesacchetti89, 1, 1, 0, yes
805700470597709824,  Chiara24018085, 1, 1, 0, yes
768521039819210752,  FabriziMarta2, 1, 1, 0, yes
337649843,  fish76rm, 6, 6, 0, yes
377605858,  MarciG1, 1, 1, 0, yes
753499324915519488,  fabrizio1322, 5, 1, 4, no
3104122829,  AleLaCost, 2, 2, 0, yes
305219296,  EnnioMassimo, 1, 1, 0, yes
792028057133539328,  LorisFogliaro, 1, 1, 0, yes
433589446,  lorettaperin1, 2, 2, 0, yes
2283434864,  bocio85, 1, 1, 0, yes
2967129508,  M_D_B_14, 1, 1, 0, yes
182160038,  NickStevenson63, 1, 1, 0, yes
863477084,  RobertoBiava, 1, 1, 0, yes
404951630,  MattiaIerardi80, 1, 1, 0, yes
2322625439,  azana70, 6, 4, 2, yes
552997601,  Assolone, 2, 2, 0, yes
2944825618,  RistVelaMarone, 1, 1, 0, yes
393091272,  MorenoMarchioro, 1, 1, 0, yes
417565977,  TommasoAccordi, 1, 1, 0, yes
103879100,  plastictraffic, 2, 2, 0, yes
555191689,  GiEmmeCorse, 1, 1, 0, yes
227484914,  luisanathalier, 3, 3, 0, yes
1917854600,  cristina7013, 1, 1, 0, yes
2340842151,  albarello2, 3, 3, 0, yes
1215481783,  SMolinarolo, 1, 1, 0, yes
99553769,  nobu_td, 1, 1, 0, yes
466534751,  delsolegiuseppe, 1, 1, 0, yes
1101895994,  stralui7, 1, 1, 0, yes
167549682,  matteotav95, 1, 1, 0, yes
61052962,  clockworgaranch, 1, 1, 0, yes
113590850,  Thomas_Lefroy, 2, 2, 0, yes
301584137,  JeslRiddle, 1, 1, 0, yes
1671298290,  fvic1975, 1, 1, 0, yes
1103828582,  napolis_1980, 1, 1, 0, yes
2806440011,  crackenomics, 1, 1, 0, yes
715168417955913728,  gabi_rothschild, 1, 1, 0, yes
4578440908,  MateoHerGeo, 1, 1, 0, yes
483100467,  _wonderwall21_, 1, 1, 0, yes
260723239,  JamesDoorley, 1, 1, 0, yes
334672187,  Andre79fid, 1, 1, 0, yes
278713558,  trinacria1946, 2, 2, 0, yes
146958182,  katevrny, 3, 3, 0, yes
487403092,  giorgiachetti, 4, 1, 3, no
4218775445,  federicoursitti, 6, 2, 4, no
2234725935,  seya_rox, 1, 1, 0, yes
415862122,  antonioranzani, 2, 2, 0, yes
805549987610460160,  Sebiana131, 1, 1, 0, yes
146464195,  Diuans, 1, 1, 0, yes
40081799,  cacauCB_, 1, 1, 0, yes
14482175,  tfsalomon, 1, 1, 0, yes
3336552407,  MaxQuint753, 2, 2, 0, yes
380463181,  EdoardoGrassi, 1, 1, 0, yes
1849557564,  09olinad, 2, 2, 0, yes
421013034,  BarbaraRicciSW, 1, 1, 0, yes
1935709369,  AlexLaky, 3, 3, 0, yes
253182274,  lavestru, 1, 1, 0, yes
703787381,  _Hellebore, 1, 1, 0, yes
486624050,  CristianaDeLia, 2, 2, 0, yes
411424173,  MorMattia, 1, 1, 0, yes
1373176176,  f_castelnuovo, 1, 1, 0, yes
210874424,  Sus7Inter, 2, 2, 0, yes
22613140,  Volto71, 2, 2, 0, yes
2848655032,  sophia_medea, 1, 1, 0, yes
1638784202,  kaniomartinelli, 1, 1, 0, yes
805553934727282688,  MyladyAtrebor, 2, 2, 0, yes
786879303883644928,  Marcell38142633, 1, 1, 0, yes
53377952,  yoris00, 1, 1, 0, yes
499214987,  fabiocaninoreal, 3, 3, 0, yes
2572955058,  tevito_, 1, 1, 0, yes
710503452443615232,  croceluna, 4, 3, 1, yes
132525185,  CristianoPivato, 2, 1, 1, neutral
83367663,  Giu_Di_Piazza, 1, 1, 0, yes
528329786,  alexnewyorker, 1, 1, 0, yes
975974822,  MoniaMat, 2, 2, 0, yes
733555300465139712,  homervimo, 1, 1, 0, yes
798347430,  BB_Vasto, 2, 2, 0, yes
3047946251,  FraCer10, 1, 1, 0, yes
566385114,  AryMancinelli, 1, 1, 0, yes
4755144017,  mauro_perucca, 1, 1, 0, yes
889896296,  bixer92, 4, 3, 1, yes
312766995,  vincepricolo, 3, 3, 0, yes
389122971,  franzic76, 1, 1, 0, yes
1685654310,  lapoferri, 1, 1, 0, yes
29188865,  pompeotorchia, 2, 2, 0, yes
361260603,  iHackSecurity, 1, 1, 0, yes
50018721,  vincenzogaldi, 3, 3, 0, yes
234151861,  mourinhostyle, 2, 2, 0, yes
804789986251960323,  caldart_17, 1, 1, 0, yes
3010913217,  brigidaalagna1, 1, 1, 0, yes
83619584,  Angie_Bliss, 1, 1, 0, yes
150331093,  jjohncarl, 1, 1, 0, yes
15392102,  adrianoattus, 2, 2, 0, yes
139698657,  pie_cri, 2, 2, 0, yes
1556382019,  PTreggi, 1, 1, 0, yes
1039566296,  fiorezenna, 3, 3, 0, yes
138018852,  minimALessandro, 2, 2, 0, yes
303883152,  boysarco, 2, 2, 0, yes
35702935,  carrarars, 3, 3, 0, yes
89411566,  Il_Centro, 1, 1, 0, yes
1969736210,  gipetox, 3, 3, 0, yes
30059108,  Keroppo, 4, 3, 1, yes
783616187703984128,  caronenicola93, 3, 2, 1, yes
2397909328,  francesco7002, 2, 2, 0, yes
187527575,  AndreaGuolo, 1, 1, 0, yes
429845450,  Bazzo_Arena051, 1, 1, 0, yes
4221257325,  eleonoradit, 4, 3, 1, yes
343362870,  p_dura, 2, 2, 0, yes
361359994,  ManuIade, 1, 1, 0, yes
409103399,  mimmo_tweet, 4, 2, 2, neutral
186144800,  f_montresor, 1, 1, 0, yes
456096225,  Galatouch, 1, 1, 0, yes
2244886947,  andreadurbano, 2, 2, 0, yes
423787736,  Sydshines, 6, 3, 3, neutral
145815793,  FrankDjOfficial, 5, 5, 0, yes
161227746,  BeaufilsBen, 1, 1, 0, yes
223781624,  artifix, 2, 2, 0, yes
516869344,  Enry216, 1, 1, 0, yes
13725552,  darioberna, 10, 2, 8, no
34591654,  KSG80, 1, 1, 0, yes
42242586,  milafiordalisi, 2, 1, 1, neutral
52352156,  gurubook, 1, 1, 0, yes
434157466,  OresteSorace, 2, 2, 0, yes
434886039,  BirinniSal, 2, 2, 0, yes
392959803,  PrestaLucio, 2, 2, 0, yes
2850258019,  riccardo_mene, 2, 2, 0, yes
1908753355,  Luca_Cilli, 2, 2, 0, yes
2803090973,  cagliosa, 1, 1, 0, yes
98751918,  Migui_O1, 1, 1, 0, yes
94163890,  atados, 5, 5, 0, yes
2202176339,  polasalva, 3, 2, 1, yes
4395516197,  MiniSardinaVR, 1, 1, 0, yes
1495780560,  gattovergiallo, 1, 1, 0, yes
80018042,  graziebieber, 1, 1, 0, yes
1527967826,  leleborin, 1, 1, 0, yes
4820704132,  GFr33D, 1, 1, 0, yes
425806885,  ValeMagliaro, 3, 3, 0, yes
417227638,  francoaletti1, 5, 5, 0, yes
490642581,  JonPerezGarcia, 1, 1, 0, yes
17342019,  cristianaraffa, 4, 4, 0, yes
3293088431,  MatteoDAquila, 1, 1, 0, yes
283610058,  simonafersini, 1, 1, 0, yes
805549264755654657,  Mauro99116883, 1, 1, 0, yes
1648789638,  rorenzorilla, 1, 1, 0, yes
705087469776203776,  massipado, 2, 2, 0, yes
176079265,  Francesco_cipi, 1, 1, 0, yes
465687374,  CassanoLucrezia, 1, 1, 0, yes
559918640,  Elvis_lovely, 1, 1, 0, yes
2467466788,  AvvAPavone, 3, 2, 1, yes
433730823,  isalorins, 1, 1, 0, yes
248209343,  Fabushka, 1, 1, 0, yes
2322664484,  mbertolaso, 2, 2, 0, yes
1389724333,  colyfra, 1, 1, 0, yes
111378994,  AdamJones1995, 1, 1, 0, yes
389636218,  LorenzoSavini46, 1, 1, 0, yes
65869236,  liv_77, 3, 2, 1, yes
83353586,  sybil117, 1, 1, 0, yes
525806784,  palliniale, 1, 1, 0, yes
268801715,  pasmadferit, 1, 1, 0, yes
306202078,  thraex87, 2, 2, 0, yes
3868501575,  netw3rat, 1, 1, 0, yes
2401587824,  ale_ambruosi, 1, 1, 0, yes
214689221,  aparbury, 1, 1, 0, yes
2316130596,  Onda_Calabra, 1, 1, 0, yes
24573827,  Marcotti, 1, 1, 0, yes
2761580044,  angelaserra95, 2, 2, 0, yes
106670676,  Alecru1975, 1, 1, 0, yes
509046323,  FiorenzaPoletto, 1, 1, 0, yes
558722038,  GiovanniBuffo, 2, 1, 1, neutral
606158137,  aramantic, 2, 2, 0, yes
2843540919,  Maria24972La, 1, 1, 0, yes
938638687,  GiuseppeCervi, 1, 1, 0, yes
511656186,  GioeleAnni, 3, 3, 0, yes
407040793,  elisamanieri, 1, 1, 0, yes
460992656,  Denny_kr, 1, 1, 0, yes
437036700,  LaFDellaBanda, 4, 4, 0, yes
1066463137,  FscoGreco, 1, 1, 0, yes
630076580,  LucaDelponte1, 1, 1, 0, yes
589441533,  gioleali, 1, 1, 0, yes
248610688,  mace861, 2, 2, 0, yes
14970701,  fdigennaro, 1, 1, 0, yes
237798341,  mattiabrita, 1, 1, 0, yes
235922684,  giacomo_concina, 1, 1, 0, yes
341696320,  a_rava, 1, 1, 0, yes
858154196,  cinzia_renzi, 2, 2, 0, yes
50270346,  chiaramucchi, 4, 3, 1, yes
711355100854415360,  alessandroa1002, 5, 5, 0, yes
1001942749,  FrancescoPotera, 2, 2, 0, yes
331059455,  memeburziosan, 2, 2, 0, yes
972520579,  ma_ma58, 3, 3, 0, yes
747875100947513349,  lamangiatrice, 1, 1, 0, yes
2469424856,  almerindadibene, 1, 1, 0, yes
209645711,  drceparano, 1, 1, 0, yes
2278956151,  ItsChiaGue, 1, 1, 0, yes
400771915,  1962EisRialto, 1, 1, 0, yes
192637995,  CriCor9, 1, 1, 0, yes
2844195529,  pipponovels, 1, 1, 0, yes
716198154,  MPapets, 5, 5, 0, yes
259280431,  DTNewsdeskLee, 1, 1, 0, yes
129081358,  stefanoisde, 4, 3, 1, yes
244591197,  CaCaAlTh, 1, 1, 0, yes
1076875243,  pamela_msg, 1, 1, 0, yes
4462664181,  acoro11, 6, 1, 5, no
68933888,  DanieleCamaioni, 1, 1, 0, yes
1082027130,  donacuo, 1, 1, 0, yes
3039088450,  FabioSgura, 2, 2, 0, yes
1176848460,  pisa6595, 2, 2, 0, yes
2791872850,  zannapinerolo, 1, 1, 0, yes
2365416906,  goterosse, 4, 2, 2, neutral
386055960,  stefanobolzon, 1, 1, 0, yes
2346503615,  Sandro_Bo_, 4, 3, 1, yes
380373007,  Francesc0Meleca, 1, 1, 0, yes
46650696,  Muzzi1969, 5, 5, 0, yes
2557135143,  melogenovese95, 1, 1, 0, yes
1186275745,  rossidiego95, 1, 1, 0, yes
115686442,  matwg, 1, 1, 0, yes
4227017272,  London_Silvia, 1, 1, 0, yes
499768893,  vincib71, 1, 1, 0, yes
52391502,  BOCIUME, 1, 1, 0, yes
14966017,  andrea_boscaro, 5, 3, 2, yes
3135221989,  JulienChristler, 1, 1, 0, yes
26027914,  Jose_PSvBS, 1, 1, 0, yes
420271389,  inter_unica, 1, 1, 0, yes
2463645967,  marina_emme, 1, 1, 0, yes
2791555302,  DonAldrigo, 1, 1, 0, yes
128642289,  MichPotenza, 1, 1, 0, yes
2183769826,  Salaris_Roberto, 3, 3, 0, yes
755065595217997825,  GBACLB, 2, 2, 0, yes
465494967,  GrossiMaugros, 1, 1, 0, yes
770289525000142848,  xMoscons, 1, 1, 0, yes
858153835,  machecaxxo, 3, 1, 2, no
39591437,  barbybo, 3, 3, 0, yes
234011417,  Meu84, 2, 2, 0, yes
763274784969031680,  MariaKasolo, 1, 1, 0, yes
406941651,  AntonioCarpita, 1, 1, 0, yes
4092492821,  Anna68062386, 2, 2, 0, yes
1035806958,  Robertocomiz, 1, 1, 0, yes
528982970,  theTuri65, 1, 1, 0, yes
751795933415956480,  adrianademarco5, 1, 1, 0, yes
519587717,  amoscaroli, 7, 5, 2, yes
838697137,  itamarfa, 1, 1, 0, yes
2731876079,  LuciaRizzari, 5, 2, 3, no
3136892145,  VincenzoVinc51, 3, 1, 2, no
1449282289,  enriglori, 1, 1, 0, yes
3012675754,  DanieleFarolfi, 1, 1, 0, yes
1030541976,  NolaRamerini, 1, 1, 0, yes
493561516,  ilaboccafogli, 1, 1, 0, yes
325195067,  abdullah_abdulk, 1, 1, 0, yes
1723154648,  FedericaPoli007, 1, 1, 0, yes
1709547350,  falconiofr, 4, 3, 1, yes
3019858185,  carmedali, 1, 1, 0, yes
133778334,  FFacondini, 1, 1, 0, yes
506546919,  Incantatore_, 1, 1, 0, yes
456069316,  rnasti1962, 1, 1, 0, yes
752424540458844164,  laionel1941, 1, 1, 0, yes
1728835788,  sere17paolo, 3, 3, 0, yes
334057477,  polanusadvocaat, 1, 1, 0, yes
792029121308160000,  Stella090160, 1, 1, 0, yes
166484578,  AliasKalias, 2, 2, 0, yes
4898428150,  InfernoGlorioso, 2, 2, 0, yes
711230323267346433,  francesco291215, 1, 1, 0, yes
231773982,  maryangelross, 2, 2, 0, yes
418081562,  fdellalu, 1, 1, 0, yes
418111334,  bijean, 1, 1, 0, yes
264589182,  VoncelleVolte, 1, 1, 0, yes
323918999,  mulhollandre, 1, 1, 0, yes
40952231,  renatoamato, 1, 1, 0, yes
260940801,  annamariafilm, 2, 2, 0, yes
1162367792,  mondo_migliore, 8, 4, 4, neutral
386742630,  magian, 2, 2, 0, yes
47963209,  koix, 1, 1, 0, yes
1568726336,  GasbarroCecilia, 2, 1, 1, neutral
733336927,  captainloodoo, 1, 1, 0, yes
73198927,  MinsLiz, 4, 4, 0, yes
164826151,  _avvocato, 1, 1, 0, yes
4089064751,  LuciaScarinci, 2, 2, 0, yes
1436540138,  patrizia2601, 1, 1, 0, yes
464792665,  PLSDE, 5, 3, 2, yes
432556551,  Giada_Effe, 1, 1, 0, yes
213079324,  Lluisdt, 1, 1, 0, yes
64672575,  Erikvt, 1, 1, 0, yes
1252846622,  MilanoFederico, 3, 2, 1, yes
520851710,  RinoRomio, 3, 3, 0, yes
2962803267,  Studiopl80, 1, 1, 0, yes
365770684,  Alfredinooo, 4, 3, 1, yes
805724547169341440,  MartaMaria_N, 1, 1, 0, yes
1106333755,  Sofia_Vinc, 2, 2, 0, yes
389519868,  GiacomoSpazzini, 1, 1, 0, yes
4449306863,  GiuseppeChiofa2, 2, 2, 0, yes
2787939847,  ghy_bg, 1, 1, 0, yes
2689631780,  RobertoBiancoIT, 1, 1, 0, yes
1060755817,  vittoriacisonno, 1, 1, 0, yes
508900391,  GiuseppeRasolo, 1, 1, 0, yes
23046451,  LaBlazette, 2, 2, 0, yes
921996565,  seminademiri, 1, 1, 0, yes
528757687,  pb965, 2, 2, 0, yes
292515117,  FGrammatica, 1, 1, 0, yes
3295724601,  alessandropoz19, 4, 4, 0, yes
185884289,  adorenyaz, 3, 2, 1, yes
3288541107,  CarloRustico, 4, 4, 0, yes
4188045869,  africa4cat, 1, 1, 0, yes
1422775381,  MarinelliMartin, 1, 1, 0, yes
631032177,  sere_ce, 1, 1, 0, yes
565779275,  Yap617, 1, 1, 0, yes
482413612,  Ciru_N, 1, 1, 0, yes
3713931921,  I_need_Justice, 2, 2, 0, yes
500237159,  FilippoBoldrin2, 2, 1, 1, neutral
3346602526,  brinirescueme, 1, 1, 0, yes
292980774,  lorenzo_manunza, 1, 1, 0, yes
826936086,  ValeryZeta, 2, 2, 0, yes
1949105119,  albertemanuelfe, 2, 2, 0, yes
251303476,  laura1162, 1, 1, 0, yes
2487893052,  davies42g, 1, 1, 0, yes
262625428,  beppepicciolo, 2, 2, 0, yes
470485139,  itnasoel, 3, 2, 1, yes
28780220,  bohemienz, 1, 1, 0, yes
397485201,  NatiLoll_, 1, 1, 0, yes
2507600778,  aldonisilvana, 2, 2, 0, yes
470605043,  archistufo, 1, 1, 0, yes
512424640,  rossymood, 3, 3, 0, yes
74105563,  teobone, 4, 2, 2, neutral
1862565644,  giacomoloi2, 1, 1, 0, yes
1029400681,  Clodity, 1, 1, 0, yes
458029422,  jordan_arndt96, 1, 1, 0, yes
719831395594579968,  Fatiha62044222, 1, 1, 0, yes
1227684398,  tardellimichele, 1, 1, 0, yes
484892594,  EnzaSaffioti, 1, 1, 0, yes
407873945,  SabrinaRappoli, 1, 1, 0, yes
17746005,  morotorno, 2, 2, 0, yes
805560778971553792,  stefanomanz70, 2, 2, 0, yes
713014462870065152,  boffelli70, 1, 1, 0, yes
714616792182751232,  CesmelM, 1, 1, 0, yes
796708386,  mamba9977, 1, 1, 0, yes
132253492,  okaka2013, 4, 1, 3, no
421973725,  raffamad81, 2, 2, 0, yes
402134990,  BiancaMascolo, 1, 1, 0, yes
197374715,  gio_prankster, 2, 1, 1, neutral
433181204,  RenzoPolesel, 3, 1, 2, no
2177119627,  Sig_Cumberdale, 1, 1, 0, yes
712393511656677376,  mikyeto, 1, 1, 0, yes
839316019,  alesterpa, 2, 2, 0, yes
443076673,  airgibbo, 1, 1, 0, yes
490218210,  heartsandgold, 2, 2, 0, yes
737955839735123968,  Cuor_di_Cardo, 3, 1, 2, no
3086156721,  gigiaca78, 2, 2, 0, yes
554347347,  EvelinaMassa1, 8, 2, 6, no
46922585,  tixxxtweety, 3, 3, 0, yes
747799087,  1990_enrica, 1, 1, 0, yes
1561186362,  Luca_Arcari88, 7, 6, 1, yes
462212909,  DavideLaMonaca2, 1, 1, 0, yes
540360750,  NovelloAnna, 1, 1, 0, yes
2895074405,  Silviazut, 3, 3, 0, yes
804430844156907520,  paolacarrer11, 1, 1, 0, yes
1602616902,  ALorenzet, 1, 1, 0, yes
259709830,  flowerwatermild, 1, 1, 0, yes
273104548,  bogianen57, 3, 3, 0, yes
4756246485,  FornelloP, 2, 2, 0, yes
223124652,  andrew_dpw, 3, 3, 0, yes
182886082,  DavideElNino, 2, 2, 0, yes
307454902,  AlessioFogliani, 1, 1, 0, yes
721321260307869697,  CristianAiello5, 2, 2, 0, yes
427662029,  GarritCano, 1, 1, 0, yes
2713381906,  viacona50, 1, 1, 0, yes
595519537,  Cecilia_Tibi, 1, 1, 0, yes
394751153,  vivybamby, 1, 1, 0, yes
713837123770716161,  MoretRoby, 1, 1, 0, yes
2943887993,  BORSHI68, 2, 2, 0, yes
2882796737,  PieroCosimo, 2, 2, 0, yes
600977226,  OVicigrado, 5, 3, 2, yes
618530335,  dLgG5891, 1, 1, 0, yes
198054116,  cbprincess5, 1, 1, 0, yes
106773181,  AlessiaCerchia, 1, 1, 0, yes
2203590867,  ilaria_pavoni, 1, 1, 0, yes
313855440,  alessandroemili, 1, 1, 0, yes
95657108,  daitangio, 1, 1, 0, yes
3014514754,  kiwilgrande, 1, 1, 0, yes
379072538,  RRegoli, 1, 1, 0, yes
420223742,  sissikoko, 1, 1, 0, yes
733381098198142976,  M_Bascoulergue, 1, 1, 0, yes
1606516021,  LCavalllini, 1, 1, 0, yes
161308225,  ginopez, 1, 1, 0, yes
366465895,  gl_zn, 3, 3, 0, yes
892953822,  DavideSamperi, 1, 1, 0, yes
550018531,  kekkentre, 2, 2, 0, yes
2604719213,  stellacristal79, 5, 1, 4, no
581884218,  SBouchartM, 1, 1, 0, yes
585584369,  LuciaLolli, 1, 1, 0, yes
419673863,  nikoltsiou, 1, 1, 0, yes
2978608456,  dalianab3, 1, 1, 0, yes
2658990901,  cix210, 1, 1, 0, yes
783050539349184512,  marpo61, 1, 1, 0, yes
486721758,  CarloMaucci, 2, 2, 0, yes
765205884813344768,  casolarof, 1, 1, 0, yes
3297045029,  anna6_b, 2, 2, 0, yes
2196119609,  boxingrita, 2, 2, 0, yes
51780170,  semprescalzo, 1, 1, 0, yes
1320755364,  DamianoDatrev, 1, 1, 0, yes
339850876,  sandronencini, 1, 1, 0, yes
459318215,  vitochieppa, 1, 1, 0, yes
950188562,  masportiece, 1, 1, 0, yes
69641627,  antotwi, 1, 1, 0, yes
3014626840,  rosyelenrrb, 1, 1, 0, yes
355621326,  tommasomorbiato, 1, 1, 0, yes
2193962139,  endea64, 1, 1, 0, yes
3025312887,  mtjannarosa, 1, 1, 0, yes
123981908,  sabiennardi, 1, 1, 0, yes
356718363,  piercethewen, 1, 1, 0, yes
29184998,  paoloparmoli, 1, 1, 0, yes
636433553,  GiaccardiChiara, 1, 1, 0, yes
1183751382,  patriflorence, 2, 2, 0, yes
425774129,  CLAUDIABARONE1, 6, 6, 0, yes
385357774,  MarcoBocca78, 1, 1, 0, yes
742257947582038016,  foolsharing, 5, 5, 0, yes
1062892747,  gabryegel, 1, 1, 0, yes
193363972,  domap72, 2, 1, 1, neutral
375574847,  UmboLacalamita, 1, 1, 0, yes
116487912,  erpoll, 1, 1, 0, yes
2182278972,  maribo59, 1, 1, 0, yes
15418095,  barbaragambini, 1, 1, 0, yes
485512541,  AlessiaMoschini, 1, 1, 0, yes
489565071,  ViciniDesigner, 1, 1, 0, yes
817477074,  BertoldoGeo, 1, 1, 0, yes
835642364,  manuelamelito24, 3, 3, 0, yes
4581780682,  rosy_pasini, 1, 1, 0, yes
3075690245,  happiest110, 1, 1, 0, yes
53401622,  Becmade, 4, 3, 1, yes
160482380,  sideO09, 1, 1, 0, yes
619008629,  thewhobbits, 1, 1, 0, yes
2867343430,  grecal10, 1, 1, 0, yes
482231169,  24_Helene, 1, 1, 0, yes
3017165500,  ferrandonicol, 1, 1, 0, yes
435026595,  OrlandoMappa, 1, 1, 0, yes
802168656645996544,  emigliorati1, 1, 1, 0, yes
3299598124,  GsSimoncini, 2, 2, 0, yes
132690245,  Ezio_1559, 2, 1, 1, neutral
388435692,  alexgnzprz, 1, 1, 0, yes
3417420076,  Eny_Depa, 2, 2, 0, yes
1409874932,  LibriLoris, 1, 1, 0, yes
2345272376,  I_Spezzati, 1, 1, 0, yes
533589700,  raffaellamanzo3, 2, 2, 0, yes
805483232980504576,  Frances90755419, 2, 2, 0, yes
20556900,  peterlafrance, 1, 1, 0, yes
2265822070,  PMazzardo, 1, 1, 0, yes
3023040047,  giorgio_tav, 1, 1, 0, yes
884651706,  tatka150, 1, 1, 0, yes
124816478,  patrixia97, 2, 2, 0, yes
793111703353454592,  marzia_bernardi, 1, 1, 0, yes
1255311673,  deliabiagio, 1, 1, 0, yes
3298930011,  DarthNewsSide, 3, 3, 0, yes
1662762486,  SabrinaConcone, 3, 3, 0, yes
1194513426,  CaronteT, 1, 1, 0, yes
2924806749,  francelinho89, 1, 1, 0, yes
476190413,  danilomiccoli, 1, 1, 0, yes
3004255601,  NinaBolzano, 1, 1, 0, yes
801351695796240384,  martina_dc88, 1, 1, 0, yes
538975251,  DaniloilGobbo, 2, 2, 0, yes
266872025,  michelesuman, 1, 1, 0, yes
123871319,  rrojatti, 1, 1, 0, yes
1407406962,  LizTiscali, 1, 1, 0, yes
60599585,  edgquin, 1, 1, 0, yes
89734000,  juicerefinery, 1, 1, 0, yes
3242123807,  FiloDacerno, 1, 1, 0, yes
774533984009289728,  CafagnoMichele, 1, 1, 0, yes
247504322,  MonicNYC, 1, 1, 0, yes
805681442026115072,  massara_claudio, 1, 1, 0, yes
805681620334346240,  AerreVi, 1, 1, 0, yes
373049578,  a_tosoni, 3, 2, 1, yes
2736288285,  bini44872208, 1, 1, 0, yes
1040539183,  isabiscaldi, 1, 1, 0, yes
447426845,  Elisabetta_58, 2, 2, 0, yes
178346037,  Electralisa, 1, 1, 0, yes
3050234032,  apicella57, 8, 7, 1, yes
1362517861,  TenutaCanei, 2, 2, 0, yes
764387148288004097,  FinalRender_, 1, 1, 0, yes
422727000,  GiuliaCapuleti1, 1, 1, 0, yes
2732521871,  ciuffreda_t, 1, 1, 0, yes
1690718778,  86DVRAKE, 1, 1, 0, yes
1228299560,  luc62ass, 1, 1, 0, yes
2252001017,  gallonerodoc, 1, 1, 0, yes
944614358,  pedrisusi, 1, 1, 0, yes
1235834708,  BidoMara, 2, 2, 0, yes
2622566038,  MarianinaRGdeB, 1, 1, 0, yes
403676060,  MauraDmm, 1, 1, 0, yes
300686926,  FVenturi, 1, 1, 0, yes
84013223,  GpBernabini, 1, 1, 0, yes
718146971,  Rollienry, 4, 3, 1, yes
2318695169,  fxsperati, 1, 1, 0, yes
3198801491,  enricodecarlo75, 1, 1, 0, yes
3049499745,  ivaferre, 1, 1, 0, yes
805671318653911040,  C_N_E_L, 2, 2, 0, yes
3318809865,  tnamelessperson, 1, 1, 0, yes
401993777,  katry34, 1, 1, 0, yes
737340994375581696,  Iriana23688432, 1, 1, 0, yes
2203910772,  IsmailAmin0, 1, 1, 0, yes
2209075260,  AlessioRonconi7, 1, 1, 0, yes
348979316,  FraDiGiuseppe, 2, 2, 0, yes
2306382945,  gyic_, 1, 1, 0, yes
429749558,  SVillabruna, 1, 1, 0, yes
1941952544,  lelaalb, 1, 1, 0, yes
1076208780,  AlexBossVannini, 1, 1, 0, yes
141638302,  The_Jackal_I, 1, 1, 0, yes
805658888112640000,  PasqualeCortes7, 1, 1, 0, yes
2524890685,  framuratori, 1, 1, 0, yes
331243354,  massimo_fabbro, 2, 2, 0, yes
1146057512,  giubod, 1, 1, 0, yes
449721784,  royston_90, 1, 1, 0, yes
497187562,  FmFrancesco, 1, 1, 0, yes
479363897,  ffvorax, 2, 2, 0, yes
28961303,  sergiocntr, 1, 1, 0, yes
792830488243208192,  PietroP14, 1, 1, 0, yes
37543090,  Kimimaro7Gas, 2, 2, 0, yes
559922878,  federicagarosi, 1, 1, 0, yes
395229959,  krisbi2011, 1, 1, 0, yes
238983197,  Dipasoft, 1, 1, 0, yes
1063802857,  MPellizon, 1, 1, 0, yes
2408007268,  afiore10064, 1, 1, 0, yes
435117353,  tifosaignorante, 1, 1, 0, yes
720132395068952576,  Romanito999, 2, 2, 0, yes
1707645900,  barbara_blu, 1, 1, 0, yes
334637294,  NicolaUghi, 1, 1, 0, yes
428303633,  mauroperciballi, 1, 1, 0, yes
69630108,  Keltbraz, 2, 1, 1, neutral
805658166600093697,  scotti_ciro, 1, 1, 0, yes
723383283732488193,  difesaservizi, 1, 1, 0, yes
805492107137994752,  PierluigiManci5, 1, 1, 0, yes
762667545493172225,  Daniela31207520, 2, 2, 0, yes
107963238,  iPetra_, 1, 1, 0, yes
776215134511374337,  MartinsShaia, 1, 1, 0, yes
2756993560,  AntonioAngela, 1, 1, 0, yes
3386020371,  sicheaud, 1, 1, 0, yes
384846800,  andoli73, 1, 1, 0, yes
3010467274,  RiganteLeonardo, 3, 2, 1, yes
425178744,  AcriAdriano, 2, 2, 0, yes
456022757,  anitabelardi, 1, 1, 0, yes
1163997710,  giuseppeBassol6, 1, 1, 0, yes
796267516603596801,  Klaydia84, 2, 2, 0, yes
495929146,  Bantonella18, 1, 1, 0, yes
3035069429,  LadyMaydanoz, 1, 1, 0, yes
1154444857,  lachicca67, 2, 2, 0, yes
1219319803,  elelausa, 2, 2, 0, yes
452496321,  CillaDoopsi, 1, 1, 0, yes
3054696600,  MollDoll352, 1, 1, 0, yes
1259274158,  Gbaghazi, 2, 1, 1, neutral
336172650,  pietrodipaolo, 4, 4, 0, yes
2278870674,  CinziaDanelli, 1, 1, 0, yes
462483435,  LucaLisi, 1, 1, 0, yes
673203,  stefanoepifani, 5, 4, 1, yes
2532142374,  GiulianaDeP, 1, 1, 0, yes
704306981348188160,  Zio_frenk98, 1, 1, 0, yes
1917552324,  EgloffValerie, 1, 1, 0, yes
2954539733,  CDalessio71, 1, 1, 0, yes
7030092,  simonerizzo, 1, 1, 0, yes
761192509280292864,  Pablopannocchia, 2, 2, 0, yes
416157935,  AntoninoMilioto, 1, 1, 0, yes
25699306,  keroro16, 2, 2, 0, yes
1230535302,  stefyarveda, 1, 1, 0, yes
2232868318,  FTronfi, 2, 2, 0, yes
2477355213,  Ollieoflowa, 1, 1, 0, yes
211776502,  ilanbass, 1, 1, 0, yes
2236760975,  c_tarmo, 1, 1, 0, yes
434780087,  davideb1968, 1, 1, 0, yes
1087074564,  matteoud1, 1, 1, 0, yes
4870391981,  ManuelCappuccio, 1, 1, 0, yes
885207620,  archiviobici, 5, 2, 3, no
1042197266,  AlessandraBerzi, 1, 1, 0, yes
1387613059,  fedelencioni, 1, 1, 0, yes
737240988163448832,  DanieleEngel, 1, 1, 0, yes
2884671258,  GTempestoso, 1, 1, 0, yes
76282614,  domandrea_, 4, 4, 0, yes
90747695,  Andnic60, 1, 1, 0, yes
2988219946,  muratymn35, 4, 4, 0, yes
1356354601,  93Mariarosa, 3, 3, 0, yes
768353746552229889,  edebiyatbira, 4, 4, 0, yes
760789406164934656,  AraDamla2017, 4, 4, 0, yes
4211039495,  BatuhanDemir78, 4, 4, 0, yes
4018122309,  Beyzanrsrk, 4, 4, 0, yes
4267950267,  Serokmiro7, 4, 4, 0, yes
711155949986291712,  UnInvitedRT, 4, 4, 0, yes
2804123838,  anladinnnmi, 4, 4, 0, yes
739004693058228224,  berylescubio, 4, 4, 0, yes
3064617951,  busacchio34, 4, 4, 0, yes
711201162855391232,  manyakamq, 4, 4, 0, yes
760467559376445441,  tekinahmet555, 4, 4, 0, yes
1607513726,  askineseri, 4, 4, 0, yes
765123858970054657,  aslanahmetcux, 4, 4, 0, yes
3423588245,  davarovski2, 4, 4, 0, yes
4148124159,  SuatSuat2016, 4, 4, 0, yes
3552090196,  prettycryy, 4, 4, 0, yes
2737195249,  garibansosyete, 4, 4, 0, yes
2824179354,  ornektepeliii, 4, 4, 0, yes
3347086647,  meftunlar, 4, 4, 0, yes
3073757830,  Sir_lannister, 4, 4, 0, yes
4717259193,  _SenaSanli, 4, 4, 0, yes
718086828864184320,  osmancartt, 4, 4, 0, yes
718090667029868544,  osmancarttt, 4, 4, 0, yes
303088871,  _dgnerdgnn, 4, 4, 0, yes
735235967456555010,  nadyaqwe, 4, 4, 0, yes
706859142011559936,  manyaqlaflar, 4, 4, 0, yes
4155875872,  ZahideCam06, 4, 4, 0, yes
2737149927,  siktirederim, 4, 4, 0, yes
801090093197000704,  Cagritaner0, 4, 4, 0, yes
770735122161238017,  alivelihimo, 4, 4, 0, yes
790690872472002560,  tugceizmirli23, 4, 4, 0, yes
797788217676300288,  mertmanyaslii, 4, 4, 0, yes
801395859032330240,  provateplayers3, 4, 4, 0, yes
3503076137,  aysem14531071, 4, 4, 0, yes
761794760617189376,  haydiiicimbomm, 4, 4, 0, yes
387665949,  veriverinays, 4, 4, 0, yes
2525198089,  merhamet134, 4, 4, 0, yes
777892697487081472,  handecokdeli, 4, 4, 0, yes
2840395203,  karabelaf, 4, 4, 0, yes
716211027143233536,  sinan_388, 4, 4, 0, yes
231779512,  DertOnline, 4, 4, 0, yes
2857466644,  maniacprofil, 4, 4, 0, yes
2287958119,  kenanefsar37, 3, 3, 0, yes
774252111429308416,  zoramart24, 3, 3, 0, yes
802642628059795456,  pandabeyy22, 3, 3, 0, yes
780778783427014656,  RetweetCaptain, 3, 3, 0, yes
780781880413085696,  RetweetcinizJun, 3, 3, 0, yes
774214326819426304,  deryaaksoyx, 3, 3, 0, yes
753844651929415681,  merhabaaaaa12, 3, 3, 0, yes
706126457010049024,  ahmetkoca77654, 3, 3, 0, yes
777951789127794689,  decktr2, 3, 3, 0, yes
4877200108,  a_buyukturp, 3, 3, 0, yes
740583489725140993,  2pacuro, 3, 3, 0, yes
739450814591340546,  alessia_bizet78, 1, 1, 0, yes
784696235882151936,  suleymaniverson, 3, 3, 0, yes
525765095,  SrlBott, 1, 1, 0, yes
790126069848367109,  LimaJSDLC, 1, 1, 0, yes
529650614,  druty1, 1, 1, 0, yes
2659285801,  MONIACAPPARELLI, 1, 1, 0, yes
4149800902,  Christi21833162, 1, 1, 0, yes
3072811918,  LupiMirco, 3, 1, 2, no
553021816,  DaveBlanko, 1, 1, 0, yes
4703277218,  lidiaeffetw1, 1, 1, 0, yes
173516546,  HelenaKabul, 1, 1, 0, yes
242295508,  Plinuz, 4, 3, 1, yes
3309800535,  Sandu4Nicoletta, 1, 1, 0, yes
559469909,  MBottai, 1, 1, 0, yes
237008926,  fra82ncesco, 1, 1, 0, yes
4828257199,  WorldBambino, 16, 1, 15, no
1048443139,  GiuliaTolve, 1, 1, 0, yes
2603657302,  Jannik0705, 1, 1, 0, yes
2496818206,  chiara_busani, 1, 1, 0, yes
621697940,  daniele_sforza, 1, 1, 0, yes
3369428141,  Elenin86642827, 1, 1, 0, yes
4211779384,  IrisPiccam, 4, 1, 3, no
2217667895,  magneticouis, 1, 1, 0, yes
220735596,  Alexanderspie, 1, 1, 0, yes
721321298471821316,  otakusnk, 1, 1, 0, yes
456677700,  mellamonicolas, 5, 1, 4, no
286204600,  zelantemente, 2, 1, 1, neutral
89528661,  eumenesx, 1, 1, 0, yes
718157498,  Mari_Grasso, 2, 2, 0, yes
915473534,  giulianaercoli2, 1, 1, 0, yes
962497801,  ziaci74, 1, 1, 0, yes
830520494,  lapoduccio, 4, 4, 0, yes
1135314306,  info_gherardi, 1, 1, 0, yes
1593474428,  bdlgpp, 1, 1, 0, yes
143903706,  sonia_cerase, 1, 1, 0, yes
240792961,  florianaflo, 1, 1, 0, yes
136587208,  michelepapa, 2, 2, 0, yes
2612248771,  mlhanssen, 1, 1, 0, yes
465830166,  simat97, 1, 1, 0, yes
461369880,  annatortora3, 3, 1, 2, no
170872174,  El_Loco_1987, 1, 1, 0, yes
500751096,  FranzNespoli, 2, 2, 0, yes
344301556,  Andrea_Padovani, 1, 1, 0, yes
1580962698,  FrancySurace, 1, 1, 0, yes
939534836,  MicheleStagno, 1, 1, 0, yes
590754460,  PoserElena, 1, 1, 0, yes
2776880399,  gabriv18, 1, 1, 0, yes
789674486,  swaggie617, 1, 1, 0, yes
565628483,  gcapone74, 2, 1, 1, neutral
720207369645502464,  leonardo7_24, 2, 2, 0, yes
921166327,  CinelliLib, 3, 3, 0, yes
863630202,  Dario95AC, 2, 2, 0, yes
112532465,  MrFrel, 6, 5, 1, yes
494963270,  VitoManghisi, 1, 1, 0, yes
489385282,  chia_piatti, 2, 2, 0, yes
1528310352,  Alatriste2804, 3, 2, 1, yes
2303547566,  TagliaMattia, 1, 1, 0, yes
805759339931848704,  mariaev17250796, 1, 1, 0, yes
985045596,  GiuseppIppolito, 1, 1, 0, yes
415132059,  Akamanu72, 2, 2, 0, yes
269929523,  giovannigostoli, 5, 5, 0, yes
3015203625,  LGionchetta, 1, 1, 0, yes
793817118743691264,  Fabioscarnera82, 1, 1, 0, yes
1288383552,  babsi_it, 2, 2, 0, yes
2157047308,  f4t_ale, 1, 1, 0, yes
1356804163,  ClaudioDore1, 1, 1, 0, yes
490623973,  RafLapo, 2, 2, 0, yes
2329191834,  inlovewithmktg, 1, 1, 0, yes
127530005,  HyMyNameIsPaul, 1, 1, 0, yes
749331366202966016,  bettybet01, 1, 1, 0, yes
362992930,  DannataOfelia, 7, 7, 0, yes
984769788,  bicia20, 5, 5, 0, yes
797554230362066944,  JoaoVictor_AE, 1, 1, 0, yes
471998579,  Mori_alvisillo, 1, 1, 0, yes
3404794852,  enzorosanero1, 1, 1, 0, yes
3389883256,  ciribiri024, 1, 1, 0, yes
805757259070525440,  marina181114, 1, 1, 0, yes
716513342,  ZemraVenusia, 2, 2, 0, yes
4104819773,  mariaterediani, 1, 1, 0, yes
3846535223,  max_neroazzurro, 1, 1, 0, yes
764102469047771136,  loredanamarone1, 4, 4, 0, yes
172790343,  rubentravis, 1, 1, 0, yes
713040163774066689,  KraftOli3112, 2, 2, 0, yes
548471623,  nikmanser, 3, 1, 2, no
2243083691,  italiano705, 5, 5, 0, yes
484327726,  valevivoli, 1, 1, 0, yes
986210352,  lucbri, 1, 1, 0, yes
351514115,  valaus2573, 5, 4, 1, yes
87943906,  letiziaprisco, 11, 11, 0, yes
705073788153679872,  da_ilio, 1, 1, 0, yes
2295049728,  domedisa, 3, 3, 0, yes
2325518630,  PopConsMe, 3, 3, 0, yes
401271865,  CornySergio, 3, 3, 0, yes
785598969007239170,  EsseFerradino, 3, 3, 0, yes
2296008147,  PietriniMarco, 1, 1, 0, yes
962235703,  ale_ruggiero91, 1, 1, 0, yes
2466898426,  GfrClementi, 1, 1, 0, yes
1038418454,  zzikiki, 3, 2, 1, yes
1066206709,  GemmaRampinini, 2, 2, 0, yes
715552913083510784,  stino_4, 1, 1, 0, yes
393336947,  p2pitaly, 1, 1, 0, yes
249390043,  fulviomassa, 1, 1, 0, yes
805728728554864640,  sandro131980709, 2, 2, 0, yes
2872236741,  UnfoldingRoma, 1, 1, 0, yes
2319360938,  AlbertoAlmaci, 1, 1, 0, yes
805729127923847168,  carla6925724677, 1, 1, 0, yes
726913828584325121,  insiemexefrati, 1, 1, 0, yes
501059024,  mikycambie, 1, 1, 0, yes
211638487,  EnricoBergantin, 1, 1, 0, yes
3343040355,  grazia139, 2, 2, 0, yes
1035855230,  Gregory31380, 1, 1, 0, yes
706950930,  leone_diego, 1, 1, 0, yes
3436505303,  deleomichele82, 1, 1, 0, yes
2371652432,  filippoaltieri, 1, 1, 0, yes
784650488432234497,  fernandoflorio1, 1, 1, 0, yes
1142080128,  gisagisella, 1, 1, 0, yes
337048412,  amrerolan, 1, 1, 0, yes
554694393,  OmarACM1899, 1, 1, 0, yes
82076620,  YACHTCLUBROMA, 1, 1, 0, yes
19366011,  yurigu, 1, 1, 0, yes
4010518281,  Lidopi1, 1, 1, 0, yes
300370503,  nopeideapost, 3, 3, 0, yes
90766526,  deboliosi, 1, 1, 0, yes
3608785995,  personaleandrea, 1, 1, 0, yes
107554109,  Dan_Lerner, 2, 2, 0, yes
3533791877,  MattiaCarramusa, 1, 1, 0, yes
422572352,  imostriamano, 1, 1, 0, yes
2328275387,  Gusenza, 1, 1, 0, yes
288649793,  elevassa, 1, 1, 0, yes
415632843,  francescadalbos, 1, 1, 0, yes
3335341414,  CBTini_21, 1, 1, 0, yes
594991158,  sugnubedda, 3, 3, 0, yes
316367823,  edelbrook71, 2, 2, 0, yes
3102763995,  IoleSecondulfo, 2, 2, 0, yes
703147891506872321,  toroscantenato, 1, 1, 0, yes
2468139471,  fedemartabert, 2, 2, 0, yes
777506347730530304,  Giulia384746791, 1, 1, 0, yes
1410528320,  Ersiliaaaaa, 1, 1, 0, yes
4242649756,  FilippoBenach98, 2, 2, 0, yes
412453150,  AlexContiac, 1, 1, 0, yes
3064173617,  MrIylolaAjala, 1, 1, 0, yes
1671034082,  Alesanick, 1, 1, 0, yes
732452198009868288,  haltes_prejuges, 1, 1, 0, yes
564504241,  PaolinoPazzia, 1, 1, 0, yes
1246107769,  PriullaGaetano, 1, 1, 0, yes
792822759516667904,  Iovmargh, 1, 1, 0, yes
364962812,  xdrunkofmyidols, 1, 1, 0, yes
2507009302,  Real_Ljam_Pain, 1, 1, 0, yes
805657360949776385,  domenicoleone70, 1, 1, 0, yes
338457126,  DavidN, 1, 1, 0, yes
590294625,  OrecchioniRita, 1, 1, 0, yes
494420235,  SabrinaPricl, 1, 1, 0, yes
1958960383,  Elena_Coniglio, 1, 1, 0, yes
386182882,  RicSpada, 3, 3, 0, yes
2501520674,  vinci0462, 2, 2, 0, yes
97647079,  sergiodigio, 1, 1, 0, yes
592148376,  IacopoSenatori, 4, 2, 2, neutral
813076315,  annaritalobozzo, 2, 2, 0, yes
479872738,  corbinzolu, 1, 1, 0, yes
1040606826,  TibeBecucci, 1, 1, 0, yes
543535171,  LamazoneBlonde, 1, 1, 0, yes
418549266,  spx610, 2, 2, 0, yes
2539591331,  DirrrtyPaws, 1, 1, 0, yes
29693627,  dilettadaddario, 1, 1, 0, yes
785140258010697728,  MargheLamaffy, 1, 1, 0, yes
1289424396,  Anna_Riri_Pit, 1, 1, 0, yes
3256466692,  loredanaguadag1, 1, 1, 0, yes
2579870255,  homocivilis, 1, 1, 0, yes
423801285,  CarlaOui, 1, 1, 0, yes
213265705,  joecasati, 1, 1, 0, yes
715230401489465344,  GiovanniCaspan1, 6, 6, 0, yes
404675923,  francesco_mi, 1, 1, 0, yes
2170368595,  elisabettabovis, 3, 2, 1, yes
391345698,  RmRobmanc, 1, 1, 0, yes
617221882,  sica_francesco, 1, 1, 0, yes
112600567,  wiltchamp, 3, 2, 1, yes
308745561,  arei1970, 1, 1, 0, yes
282146199,  70DODI, 1, 1, 0, yes
442249763,  ivirt, 1, 1, 0, yes
242357249,  RizeMc, 1, 1, 0, yes
303666577,  Arch_Melandri, 1, 1, 0, yes
1326981517,  nicchiotti, 1, 1, 0, yes
1270693644,  SergioCrapiz, 1, 1, 0, yes
1121935224,  sasag71, 1, 1, 0, yes
905911585,  rcurott, 1, 1, 0, yes
131873848,  shindrake, 1, 1, 0, yes
50257478,  giacomaleoparda, 2, 2, 0, yes
942997670,  SFritegotto, 1, 1, 0, yes
2899699987,  GambSergio, 4, 3, 1, yes
146430258,  justchickie17, 1, 1, 0, yes
783020754883469313,  Gian_Baldin, 1, 1, 0, yes
4885275881,  mercuriomazzei, 1, 1, 0, yes
3136934105,  sollitoca, 1, 1, 0, yes
207157479,  therealomo_, 2, 2, 0, yes
16596809,  MaRobbie, 1, 1, 0, yes
752532461452685312,  GiumaniniD, 2, 2, 0, yes
2434437479,  davidebelott1, 2, 2, 0, yes
107243738,  amaniglia, 1, 1, 0, yes
477970228,  maurimilano78, 2, 1, 1, neutral
377409134,  LauraNigro1, 1, 1, 0, yes
1098878316,  baraninburan, 2, 2, 0, yes
715352174,  pfrankw, 1, 1, 0, yes
241457976,  anto_milan92, 1, 1, 0, yes
805478345043570688,  anna260476, 1, 1, 0, yes
1082119771,  giancsi, 2, 2, 0, yes
453597213,  BusinessNature, 1, 1, 0, yes
1969637089,  eldanobile, 1, 1, 0, yes
2633792739,  SciasciaRocco, 1, 1, 0, yes
568352767,  theskyeboatsong, 1, 1, 0, yes
4616222301,  Emanuel33598873, 1, 1, 0, yes
253654938,  avvia28, 3, 3, 0, yes
333492089,  pierio33, 1, 1, 0, yes
91351915,  mascateo, 1, 1, 0, yes
2751585755,  dani_cipo9, 1, 1, 0, yes
118835795,  __littlesickle, 6, 6, 0, yes
1891280142,  CarolinaECardon, 1, 1, 0, yes
1926671532,  Cris13leo, 1, 1, 0, yes
2174454292,  GrimaldiCicero, 1, 1, 0, yes
500278693,  danieledaversa_, 2, 2, 0, yes
1056411350,  FDondolini, 1, 1, 0, yes
805568514362933248,  FabDann83, 1, 1, 0, yes
295121579,  venturinipietro, 1, 1, 0, yes
3467610743,  PumpkinMan777, 3, 3, 0, yes
111112509,  remoappignanesi, 1, 1, 0, yes
754173774782693377,  giampy39, 1, 1, 0, yes
79004086,  sasnori, 1, 1, 0, yes
293945977,  fuscoantonella, 1, 1, 0, yes
2880121635,  Rosse01Scarlet, 1, 1, 0, yes
390354789,  dodopalma, 1, 1, 0, yes
737326025378570240,  pieriofranatz, 2, 1, 1, neutral
135312755,  Giantrentini78, 1, 1, 0, yes
414471722,  Hannah_Babineau, 1, 1, 0, yes
516092855,  danparkins9, 1, 1, 0, yes
377909557,  ssilvia72, 1, 1, 0, yes
50307133,  fradicioni, 1, 1, 0, yes
50743768,  Elisy2090, 1, 1, 0, yes
367189599,  GianniGamba86, 1, 1, 0, yes
1504506552,  PieroP8, 1, 1, 0, yes
2966055136,  rivolta_pietro, 1, 1, 0, yes
66002522,  brazosdmariposa, 1, 1, 0, yes
426143302,  Giuzioanto, 1, 1, 0, yes
1468226568,  _Spettinata, 1, 1, 0, yes
805740252862287872,  andrea_fulli, 1, 1, 0, yes
557102394,  accivghine, 1, 1, 0, yes
1570207747,  DailyValente57, 5, 5, 0, yes
504799287,  davideserusi, 1, 1, 0, yes
2481675126,  Ettore55543456, 1, 1, 0, yes
163871004,  An_Zl, 4, 2, 2, neutral
1084205072,  biancush85, 1, 1, 0, yes
2274864163,  Marco_RV94, 1, 1, 0, yes
2644491873,  Eles1997, 1, 1, 0, yes
1068137514,  mario5812, 2, 2, 0, yes
1277398291,  VittorioMarsico, 1, 1, 0, yes
1117449596,  morenoalessio14, 1, 1, 0, yes
565199427,  Giampaola_I, 1, 1, 0, yes
4115465765,  erricorosa1995, 1, 1, 0, yes
506200939,  claudio_biagini, 3, 3, 0, yes
768558101477875714,  BaruttaFederico, 1, 1, 0, yes
418089296,  giannarubinelli, 1, 1, 0, yes
987504266,  cappelli68, 3, 3, 0, yes
352807355,  matteo_rosin, 1, 1, 0, yes
773988715903549441,  daninchains87, 1, 1, 0, yes
2622315235,  angiulis, 2, 1, 1, neutral
74463498,  MimmoFontana, 1, 1, 0, yes
230803926,  volo99, 2, 2, 0, yes
1680349770,  g_mix1, 1, 1, 0, yes
254952656,  TeddyNello, 1, 1, 0, yes
793934219831611392,  antoniolicini, 1, 1, 0, yes
158688770,  effediracing, 1, 1, 0, yes
253105483,  MarcoSlavazza, 1, 1, 0, yes
598818174,  PierluigiGabrie, 1, 1, 0, yes
525353224,  danydan92028121, 3, 3, 0, yes
92865874,  emilianomolly, 1, 1, 0, yes
402230222,  DennisCalosso, 7, 7, 0, yes
231414880,  Cvetin, 1, 1, 0, yes
355571709,  lamialeie1926, 6, 5, 1, yes
94773688,  pinu_mi, 3, 3, 0, yes
1390121978,  davide_ciervo, 2, 2, 0, yes
431597021,  AlessandroPetr4, 1, 1, 0, yes
97984412,  AmazzoneFuriosa, 4, 4, 0, yes
2354732305,  GagliardoneS, 1, 1, 0, yes
3317188575,  nico97368607, 1, 1, 0, yes
1584906638,  ilc3sko, 1, 1, 0, yes
391657307,  PRettiwit, 1, 1, 0, yes
846139560,  marenauta, 2, 1, 1, neutral
727795893374730240,  Pierpaolo1678, 1, 1, 0, yes
2355155079,  Gice89, 2, 2, 0, yes
1633033735,  DiFrancy6, 1, 1, 0, yes
833097246,  OliceHatman, 1, 1, 0, yes
257308016,  laSilli, 5, 3, 2, yes
1145973943,  corrado_g69, 1, 1, 0, yes
1658698728,  VincenzoMulia, 1, 1, 0, yes
2385607692,  effegi68, 1, 1, 0, yes
3650627895,  giovanniamalfi2, 1, 1, 0, yes
1266611112,  marballerini, 1, 1, 0, yes
3000722393,  c45dca2154814b7, 1, 1, 0, yes
2928182608,  cam2308, 1, 1, 0, yes
1260617916,  LaTiger1, 4, 3, 1, yes
4754556873,  eur_83, 7, 4, 3, yes
181480719,  traxxdeep, 2, 2, 0, yes
2549252170,  annj1955, 1, 1, 0, yes
90466924,  idril_earfalas, 1, 1, 0, yes
1464689852,  dadec95, 4, 4, 0, yes
3226485597,  ElenaZiba, 1, 1, 0, yes
75751731,  looubear, 1, 1, 0, yes
564141057,  DeRdeluca, 1, 1, 0, yes
539388826,  p333dr0, 1, 1, 0, yes
805690089036726272,  LorenzoRavaioli, 1, 1, 0, yes
453810735,  sabrinamancini1, 1, 1, 0, yes
1103641160,  puntalunga50, 2, 2, 0, yes
415130455,  CLLB69, 1, 1, 0, yes
439913147,  CarmenGranato, 1, 1, 0, yes
904679816,  ilaria_murgo, 1, 1, 0, yes
2872801499,  3176eba3432c440, 3, 2, 1, yes
193775609,  PiccoloDomenico, 1, 1, 0, yes
707530111147495424,  enzo_sr81, 1, 1, 0, yes
578094658,  MarcoTognoli1, 1, 1, 0, yes
108990971,  foggio, 1, 1, 0, yes
1024162483,  alspinella, 1, 1, 0, yes
1562485622,  CiscoColombo, 1, 1, 0, yes
3126922474,  SilvanaRiccobo4, 1, 1, 0, yes
751312610168102912,  Antonel58821130, 1, 1, 0, yes
2396546196,  geppicv, 2, 1, 1, neutral
1001843059,  beatricefumarol, 1, 1, 0, yes
293464241,  ilbafioa, 1, 1, 0, yes
1241025565,  G_Gaetano86, 3, 3, 0, yes
3326961875,  testadirapanell, 1, 1, 0, yes
44677659,  MadArtur, 1, 1, 0, yes
805689525678772225,  Elide350300, 1, 1, 0, yes
458254308,  GiorgioMancio, 1, 1, 0, yes
486011347,  MartaLeo95, 1, 1, 0, yes
1197796561,  PietroCh04, 3, 3, 0, yes
488276617,  CampoleseNicola, 1, 1, 0, yes
72808908,  incantamostri, 1, 1, 0, yes
45664080,  Muraghe, 1, 1, 0, yes
3844232848,  chiara_pelizza, 1, 1, 0, yes
792496932,  AliTalluri, 1, 1, 0, yes
598603007,  RosaSelina, 1, 1, 0, yes
2363399704,  AndreaTozzi, 1, 1, 0, yes
1058644093,  antonycilli, 2, 2, 0, yes
915258906,  tomtom25200, 1, 1, 0, yes
705368759838580739,  MauroDIsa2, 1, 1, 0, yes
813452102,  LauraSenna3, 1, 1, 0, yes
489689781,  DorianoSaracino, 1, 1, 0, yes
3267022391,  NunziaReca, 1, 1, 0, yes
1425106950,  ArrafaineARAIA, 1, 1, 0, yes
610543495,  wasimeon, 1, 1, 0, yes
286665260,  LaDianoia, 1, 1, 0, yes
805653100765872129,  Lorenaferraro5, 3, 3, 0, yes
450555112,  AlChiari, 8, 6, 2, yes
356829372,  AlyDonati, 2, 2, 0, yes
1964464562,  giuliacallini, 1, 1, 0, yes
78085964,  giannicostanzi, 1, 1, 0, yes
108936591,  benedictafaber, 3, 2, 1, yes
380458425,  BorjaGarciaPol, 1, 1, 0, yes
1447143823,  BeniFotografo, 8, 8, 0, yes
1099767710,  ericavagl, 4, 4, 0, yes
454145106,  Dottroki83, 1, 1, 0, yes
1583850908,  stravin81_ssl, 1, 1, 0, yes
43082114,  SardegnaNews, 1, 1, 0, yes
4755912257,  sassandpanache, 1, 1, 0, yes
3346519665,  888paoletta, 4, 3, 1, yes
47367554,  M_I_C_H_E_L_E, 1, 1, 0, yes
520761690,  maribarbi72, 1, 1, 0, yes
75858298,  CornelioMunoz, 1, 1, 0, yes
103444619,  ElettroBerta, 4, 4, 0, yes
394921985,  StefanoParadiso, 1, 1, 0, yes
507214602,  richard_ginori, 3, 3, 0, yes
1332326611,  Antonio_lore_, 1, 1, 0, yes
3002376390,  InkStrawberry, 2, 2, 0, yes
802199098984120320,  becchicristian2, 1, 1, 0, yes
524564763,  dinaruggiero8, 1, 1, 0, yes
367904175,  AntoCec, 1, 1, 0, yes
502006918,  MobyDick1951, 1, 1, 0, yes
164359373,  PitFranco_Is, 1, 1, 0, yes
594370025,  lisa_r78, 1, 1, 0, yes
2482274467,  fabiusrusso, 2, 1, 1, neutral
102422828,  Heldna, 1, 1, 0, yes
701731753,  manubou96, 1, 1, 0, yes
245808318,  71valentina, 2, 2, 0, yes
3008083671,  barbara_marenco, 2, 2, 0, yes
580829299,  betty_colombo, 1, 1, 0, yes
805713732416454656,  AndreanoClaudio, 1, 1, 0, yes
112127119,  Silmaess, 1, 1, 0, yes
2243332343,  kaptrest1, 3, 2, 1, yes
2865861602,  ViDiPaola, 3, 3, 0, yes
439081205,  VeronicaSalva74, 2, 2, 0, yes
133468753,  cdifusco, 1, 1, 0, yes
606096596,  DBISCONTI, 1, 1, 0, yes
366660837,  _fiorucci, 7, 7, 0, yes
2747743036,  AgrxxArmando, 1, 1, 0, yes
762353938452586498,  1965edo, 1, 1, 0, yes
131773411,  jacopocavanna, 2, 1, 1, neutral
1222920510,  roblabar, 1, 1, 0, yes
2856745493,  calugigio, 1, 1, 0, yes
805704917197451265,  Raffa_Pavia, 3, 3, 0, yes
718898270727180288,  TizianaSilva65, 1, 1, 0, yes
3078054789,  cristinari1, 1, 1, 0, yes
1707571398,  manuelf1310, 1, 1, 0, yes
2233177214,  marziobuiani, 1, 1, 0, yes
28398786,  Comincini, 6, 6, 0, yes
177605019,  gpminelli, 1, 1, 0, yes
1166261436,  SLiprino, 8, 6, 2, yes
2245729059,  potifrancesco, 1, 1, 0, yes
1007512112,  ChrisMannolini, 1, 1, 0, yes
71215080,  tomtir, 1, 1, 0, yes
799967775842254849,  Volonta3Volonta, 3, 3, 0, yes
248420188,  FerRojas_ok, 1, 1, 0, yes
122910086,  rossalz, 1, 1, 0, yes
484257364,  lnik69, 1, 1, 0, yes
632299570,  MBernardo983, 1, 1, 0, yes
798626317914767361,  dyocle, 2, 1, 1, neutral
441569368,  corradodic, 1, 1, 0, yes
787436305298796544,  beconcini_paolo, 2, 1, 1, neutral
864820532,  jumaca2012, 1, 1, 0, yes
414218653,  CRiccomagno, 1, 1, 0, yes
1002456354,  DavideGiuglian2, 1, 1, 0, yes
551776586,  Mirko_Santini12, 3, 3, 0, yes
96983913,  rosariodeluca83, 2, 1, 1, neutral
2798904417,  Anaelle_Fltr, 1, 1, 0, yes
222531088,  Kh_Elnaru, 2, 2, 0, yes
790548585343582208,  crisjustwrites, 1, 1, 0, yes
1224349800,  antonellacesar2, 1, 1, 0, yes
151082729,  cirodonnarumma2, 1, 1, 0, yes
302251801,  LizArrigoni, 1, 1, 0, yes
524701038,  enzo2664, 1, 1, 0, yes
973621860,  UbaldoConcilio, 1, 1, 0, yes
3342921646,  PinoSantoropino, 1, 1, 0, yes
3970849215,  tinto1976, 2, 2, 0, yes
502178280,  losalumiere, 2, 1, 1, neutral
241885333,  hi_im_tumnus, 1, 1, 0, yes
591364423,  pierozack, 2, 1, 1, neutral
298002994,  superga_rotte, 1, 1, 0, yes
459239187,  APrascina, 2, 2, 0, yes
1325336683,  EleKoptes, 2, 2, 0, yes
2948707558,  deanpe60, 5, 5, 0, yes
385904680,  andreabocca1975, 5, 3, 2, yes
217497747,  egidioCA, 1, 1, 0, yes
400958781,  LaPam73, 2, 2, 0, yes
2814763981,  AicoPortails, 3, 2, 1, yes
794722844,  lamaragura, 1, 1, 0, yes
2404577488,  CosimoEttorre, 1, 1, 0, yes
253717329,  maurozappa1, 1, 1, 0, yes
314485218,  carmineorsini, 1, 1, 0, yes
371263878,  MMFonzie, 1, 1, 0, yes
49355881,  EnzoMichele, 1, 1, 0, yes
4213064554,  mattarello_, 2, 1, 1, neutral
1153862612,  Voglio_la_luna, 1, 1, 0, yes
769904121436659712,  alice17126996, 1, 1, 0, yes
2915881749,  leonardo121070, 1, 1, 0, yes
2419740634,  PetraArmato, 1, 1, 0, yes
3293894566,  LauraLcolombo, 1, 1, 0, yes
2835240843,  Marcello0170, 4, 3, 1, yes
805687588866637824,  marcscal, 1, 1, 0, yes
634663442,  PjeretaK, 1, 1, 0, yes
2356058000,  luciaristori61, 1, 1, 0, yes
970767908,  lmammin, 1, 1, 0, yes
195309414,  GiovannaMurmure, 1, 1, 0, yes
771364683609702400,  Giovann95552689, 1, 1, 0, yes
709874646305402881,  AngelisaAG, 4, 2, 2, neutral
491516594,  LaFranty, 1, 1, 0, yes
805707992800915456,  salvocoppola55, 1, 1, 0, yes
1107358112,  Teresa85821534, 1, 1, 0, yes
1915341866,  GrPierfrancesco, 1, 1, 0, yes
4230212914,  costansguerrins, 3, 3, 0, yes
484050014,  Giuseppe1204, 1, 1, 0, yes
725803612857835520,  MoAnn14, 1, 1, 0, yes
988959134,  MarcoGiamp, 1, 1, 0, yes
2261379506,  MarchaSuJan, 1, 1, 0, yes
927403472,  marcogiorgi79, 1, 1, 0, yes
487002028,  GIANMARCO_GIAC, 1, 1, 0, yes
122750266,  ossuroirevas, 2, 2, 0, yes
805703498604118016,  Tamara492591171, 2, 2, 0, yes
618879461,  VittoriaMassa, 1, 1, 0, yes
21588231,  paolodale, 1, 1, 0, yes
2973444760,  SBellaari, 1, 1, 0, yes
260191236,  viruschh, 1, 1, 0, yes
1872285091,  MariateresaFaie, 1, 1, 0, yes
2995773975,  Mizzio52Mizzio, 3, 3, 0, yes
572917630,  LauradandreaV, 1, 1, 0, yes
1609889239,  pira_michele, 1, 1, 0, yes
1090178647,  ferrari_bravo, 1, 1, 0, yes
2604049343,  andreottoli, 1, 1, 0, yes
113607307,  davecaio, 1, 1, 0, yes
3169533665,  TeamEstinzione, 5, 4, 1, yes
199016943,  illatopositivo, 2, 2, 0, yes
492732698,  carcontreit, 3, 3, 0, yes
489261100,  RobiArcar, 2, 2, 0, yes
37539436,  Audrey985, 2, 2, 0, yes
476310083,  michele_ul, 1, 1, 0, yes
2499061952,  pipista1952, 2, 2, 0, yes
45348536,  Ducabiancon, 1, 1, 0, yes
2813737941,  afortunato4, 1, 1, 0, yes
360772090,  salvatorelaga8, 1, 1, 0, yes
1310353159,  EuranetplusR24, 2, 2, 0, yes
87397977,  DanieleTempera, 3, 3, 0, yes
1898470351,  MonicaMaiocchiM, 1, 1, 0, yes
408512882,  MaxGalimi, 1, 1, 0, yes
3239461619,  giada_vish, 1, 1, 0, yes
2183847653,  DNiosi, 1, 1, 0, yes
613280098,  gianfaustoF, 1, 1, 0, yes
780796072595566592,  marietto1409, 1, 1, 0, yes
705700063113322496,  ClementinaSper1, 1, 1, 0, yes
2277812585,  Nappi_G, 2, 2, 0, yes
3255450621,  ADaria56, 3, 3, 0, yes
970731259,  Niemehrs, 3, 2, 1, yes
4893108669,  andreorsonuti, 1, 1, 0, yes
805557435788300288,  Sonia31970389, 1, 1, 0, yes
724265005059809280,  Brusmilano, 1, 1, 0, yes
712098311625445376,  zafar55u, 2, 2, 0, yes
494945213,  misia7sept, 2, 2, 0, yes
349742068,  crisbynight, 1, 1, 0, yes
82653082,  fabio7272, 3, 3, 0, yes
905870113,  Mozzamotti, 1, 1, 0, yes
2367119188,  AntonioTrvg, 1, 1, 0, yes
569166210,  lorenzog1973, 1, 1, 0, yes
1225842175,  FabrizioLila, 1, 1, 0, yes
2273050215,  mariber56, 1, 1, 0, yes
194458998,  Carl0sCabrera, 4, 4, 0, yes
1945195087,  FFeVW, 2, 2, 0, yes
12804692,  moradisera, 1, 1, 0, yes
764937020972171264,  Kuke58, 1, 1, 0, yes
2330537679,  Zp224, 1, 1, 0, yes
562208673,  fpliuzzi, 2, 2, 0, yes
4838231290,  FR_Rocchi, 2, 2, 0, yes
41240592,  minyoung_sohn, 2, 2, 0, yes
92944167,  0TonyMontana, 1, 1, 0, yes
436712919,  SuperSchwabby, 1, 1, 0, yes
331357329,  OcMatteo, 1, 1, 0, yes
1288206984,  JustMadreTeresa, 2, 2, 0, yes
1322426976,  FrancaBiondelli, 1, 1, 0, yes
280449174,  PR_DiCarlo, 1, 1, 0, yes
415707422,  aleboater, 1, 1, 0, yes
2230480019,  MassimoVenture4, 1, 1, 0, yes
785313665234767873,  ilduca1983, 1, 1, 0, yes
4695542959,  checco2193, 1, 1, 0, yes
191948138,  brendbarbos, 1, 1, 0, yes
3021325811,  metaphisicv, 1, 1, 0, yes
3397464315,  GrazianoGrazie, 1, 1, 0, yes
798991701096407040,  GonzaGallardo80, 2, 1, 1, neutral
2701398830,  pagliu88, 2, 2, 0, yes
2452912347,  acnecis_, 2, 2, 0, yes
3244826380,  Joel_E_Harris, 1, 1, 0, yes
805558746504200193,  FrancyNoe30, 1, 1, 0, yes
4836748084,  glaucopide77, 2, 2, 0, yes
286095232,  iltulipanorosa, 1, 1, 0, yes
499638009,  ninopellg, 1, 1, 0, yes
156778195,  Lulifra, 1, 1, 0, yes
872452627,  Luciagencarelli, 1, 1, 0, yes
148845301,  a_ortus, 5, 4, 1, yes
304603983,  seb1509, 1, 1, 0, yes
138767334,  Spenku, 1, 1, 0, yes
706553180352614400,  am27_miloge, 1, 1, 0, yes
2516855608,  valentuccia, 3, 3, 0, yes
97691041,  hutterdesign, 1, 1, 0, yes
1855562869,  GiorgioDiMisa, 2, 2, 0, yes
1871503172,  dariosanto95, 1, 1, 0, yes
800297782212820992,  maria_marsilii, 1, 1, 0, yes
805558474696495104,  Rosa41656152, 1, 1, 0, yes
15483186,  finlwiz, 1, 1, 0, yes
553427774,  ClaudioCabrio, 1, 1, 0, yes
223352656,  misaelmendez_fr, 1, 1, 0, yes
2290026228,  demy_____, 1, 1, 0, yes
952226456,  saitta_salvo, 2, 2, 0, yes
558038204,  FedeCast1982, 13, 1, 12, no
1194917474,  GAddezi, 1, 1, 0, yes
94065877,  YOUventino, 1, 1, 0, yes
989202396,  GSaraco, 3, 3, 0, yes
196328511,  gandolfifurio, 1, 1, 0, yes
342805351,  GrantDCostello, 1, 1, 0, yes
1099615236,  palectric, 1, 1, 0, yes
193894322,  fulviuus, 2, 2, 0, yes
774631928834191360,  statutos, 5, 5, 0, yes
557827508,  guarini_maria, 2, 2, 0, yes
574057197,  MARGHERITACAST2, 2, 2, 0, yes
507983708,  CScandola, 1, 1, 0, yes
515949774,  daninovaro, 1, 1, 0, yes
338695167,  PietroPiga, 1, 1, 0, yes
4828121039,  fab_bios, 2, 2, 0, yes
3612418763,  sebatin1201, 1, 1, 0, yes
995779290,  MarcoEmanueleCr, 1, 1, 0, yes
240315894,  camposaurus1, 1, 1, 0, yes
1178582916,  giadabulls, 2, 2, 0, yes
2935641575,  marinuccitizia2, 3, 1, 2, no
357668469,  MiloBagno, 2, 2, 0, yes
3609913042,  attmenbag, 1, 1, 0, yes
462810292,  CkiCmoi, 1, 1, 0, yes
17676551,  nathalieniel, 1, 1, 0, yes
1219498273,  formalex77, 1, 1, 0, yes
1227970662,  angmic78, 1, 1, 0, yes
226262430,  annapaola86, 2, 2, 0, yes
414029088,  danielacorghi, 2, 1, 1, neutral
701489686091587586,  PlanBEuskadi, 1, 1, 0, yes
53429265,  pepecarrubba, 1, 1, 0, yes
75295841,  praduzza, 1, 1, 0, yes
416503019,  t_albe, 2, 2, 0, yes
2349348009,  Giopigli, 23, 2, 21, no
389718209,  e_susini, 1, 1, 0, yes
617559084,  saraborghini1, 1, 1, 0, yes
2320457162,  A_Bolzani, 1, 1, 0, yes
437481836,  RikiBaraldi, 2, 2, 0, yes
758964448396664832,  Koapitano, 1, 1, 0, yes
4882950298,  ildeathnote, 1, 1, 0, yes
216288769,  Oscar_Balth, 2, 2, 0, yes
397507338,  Max_Bellisario, 1, 1, 0, yes
271640662,  mercantori, 1, 1, 0, yes
214913753,  ChristianFloris, 1, 1, 0, yes
74162855,  glongoni, 1, 1, 0, yes
617532920,  AndreaGiabardo, 1, 1, 0, yes
481311680,  matteosalvioni, 1, 1, 0, yes
2389485197,  FrancescaIrc, 1, 1, 0, yes
731828210174988288,  PelagieEdo, 1, 1, 0, yes
539612779,  zanon_enrico, 2, 2, 0, yes
572589821,  LauraZannetti, 3, 3, 0, yes
766576798863876096,  FrankAngolo, 1, 1, 0, yes
764944730476146688,  gandreetta10, 1, 1, 0, yes
537417974,  GonCarpintero, 1, 1, 0, yes
2513043779,  OronzoOrpavone, 1, 1, 0, yes
2841012808,  LadyPozzallo, 1, 1, 0, yes
252525256,  martascazzola, 2, 2, 0, yes
804324498602426369,  ifmondodiEmily, 2, 2, 0, yes
337722268,  andredaddu, 1, 1, 0, yes
45103887,  gibfra, 2, 2, 0, yes
470560279,  marcellogiovann, 1, 1, 0, yes
2228521903,  CanYouSiiMe, 1, 1, 0, yes
479673475,  NicoSarrini, 1, 1, 0, yes
976174765,  claudiolazzaron, 1, 1, 0, yes
4343782161,  Princes69050601, 4, 4, 0, yes
4090278971,  emyemucio, 1, 1, 0, yes
735937390896918530,  Rinaldo70026475, 1, 1, 0, yes
475710449,  VadimPie, 1, 1, 0, yes
805591675,  PaolaBenigni3, 1, 1, 0, yes
1174500937,  lupi16giugno, 1, 1, 0, yes
3006390701,  cinziadani_68, 2, 2, 0, yes
2986297931,  Polidoro67, 2, 2, 0, yes
1614516199,  l_danieladardia, 2, 2, 0, yes
1338957062,  Lucamichelotto, 1, 1, 0, yes
739473181312978944,  giusieva, 1, 1, 0, yes
784681934047805440,  MiguelR35645589, 1, 1, 0, yes
2302065724,  KarstenMatteo, 1, 1, 0, yes
3000713540,  Giampa9972, 1, 1, 0, yes
821208756,  pensamemucho, 1, 1, 0, yes
492723072,  QDR_DRG_TURISMO, 4, 4, 0, yes
104169660,  LeVignediAlice, 2, 2, 0, yes
73701694,  andlauri, 1, 1, 0, yes
2745167359,  simosaba10, 1, 1, 0, yes
3332861871,  90a0f1b570e24e5, 2, 2, 0, yes
2864948588,  TiganoMaria, 1, 1, 0, yes
3334714841,  Andre_Borioli, 1, 1, 0, yes
273402819,  silviadip, 1, 1, 0, yes
712712005287813122,  CamilloTarocci, 20, 5, 15, no
2383543380,  albertonegro64, 1, 1, 0, yes
50343031,  LolloNicolao, 7, 6, 1, yes
738412973564297216,  itss_alice, 1, 1, 0, yes
769526013474791424,  Egidio053, 2, 2, 0, yes
800390197133225984,  MariaTurri1, 1, 1, 0, yes
102754809,  Pipino1975, 2, 2, 0, yes
2938230449,  ForgioneCosimo, 1, 1, 0, yes
633676211,  ab_z11, 1, 1, 0, yes
2984636699,  mario_carideo, 1, 1, 0, yes
2233468543,  luporoberto2, 1, 1, 0, yes
53154047,  giornalettismo, 1, 1, 0, yes
462136618,  Gallik111, 1, 1, 0, yes
326171954,  Giovanni_Zurlo, 1, 1, 0, yes
2371919544,  CademartoriMari, 2, 2, 0, yes
435015293,  rossi_maurizio, 2, 1, 1, neutral
380250466,  ermespagani, 2, 2, 0, yes
157738396,  pascalone69, 1, 1, 0, yes
767399388385841152,  bito972, 3, 3, 0, yes
970770866,  RoAr427, 2, 2, 0, yes
2498813462,  GrecoRed, 2, 2, 0, yes
827470574,  redaarmadillo, 2, 2, 0, yes
1609978124,  GQuinzan, 1, 1, 0, yes
385463823,  giovanniterrano, 1, 1, 0, yes
701050184856424448,  beny1953, 1, 1, 0, yes
17214689,  lforlin, 1, 1, 0, yes
714193116899704832,  mardiso20, 1, 1, 0, yes
446652453,  fabiomoratti, 3, 2, 1, yes
2313659803,  Carlotta_LoDico, 1, 1, 0, yes
148292473,  dansalim, 1, 1, 0, yes
2282231465,  PaoloCianchino, 1, 1, 0, yes
211028135,  maksdj, 1, 1, 0, yes
254726886,  leonenemeo, 2, 2, 0, yes
560128591,  rosamariaauriem, 1, 1, 0, yes
754275727877505024,  Sultan_Amini, 1, 1, 0, yes
2876394988,  r_melt, 2, 2, 0, yes
805670522025611264,  fulviaferrarini, 1, 1, 0, yes
1216311296,  m_elenella, 1, 1, 0, yes
59506412,  caitlin_hughes, 1, 1, 0, yes
1430390438,  DolceDonlad, 1, 1, 0, yes
75304107,  mirkop90, 1, 1, 0, yes
742406724854894593,  bettercalsaullo, 1, 1, 0, yes
310379722,  BebaPorcaro, 1, 1, 0, yes
1037035632,  MatildeOliboni, 1, 1, 0, yes
4172130610,  chiaraguidots1, 1, 1, 0, yes
448890890,  NikoCavallo, 1, 1, 0, yes
804592286600495104,  michigan_low, 1, 1, 0, yes
1476910753,  KriegerPa, 1, 1, 0, yes
804355320,  estherbattaglia, 1, 1, 0, yes
2525016102,  SandrocaboniSc, 1, 1, 0, yes
2356127598,  Diplomacy140, 3, 3, 0, yes
1454326411,  vviolethill, 1, 1, 0, yes
410738333,  enzacolatutto, 3, 1, 2, no
3665160975,  LaraMeals, 1, 1, 0, yes
306923201,  AlbyArdy, 4, 4, 0, yes
3720941236,  AaronMeneghin77, 1, 1, 0, yes
817710350,  AmbrogioQ, 1, 1, 0, yes
890639928,  RRCapitale, 6, 1, 5, no
1011755568,  mariaes38465461, 3, 2, 1, yes
2359330276,  DAmbruosoRosa, 2, 2, 0, yes
504413569,  MariCippa, 1, 1, 0, yes
38176782,  giuseppe_stecca, 1, 1, 0, yes
264982328,  sarainskywith, 2, 2, 0, yes
908088338,  ILoveAlexDP10, 5, 5, 0, yes
805682461292326912,  Caterin63089048, 2, 2, 0, yes
805682578992857088,  LauraGhisalber2, 1, 1, 0, yes
88618860,  massimin74, 3, 3, 0, yes
196099112,  alcassandro, 1, 1, 0, yes
4869177970,  Giusepp52672925, 1, 1, 0, yes
4485777502,  AttilioMariaSL, 2, 2, 0, yes
784287170,  Antonella_Cuter, 1, 1, 0, yes
805683765397880832,  FranVergine, 1, 1, 0, yes
410122048,  GenerosoAndria, 1, 1, 0, yes
1274737250,  magririzzi, 5, 4, 1, yes
792852318463070212,  Auri_scuderi, 1, 1, 0, yes
727459695330492416,  Politecnico87, 2, 1, 1, neutral
1227495222,  pmwolf52, 1, 1, 0, yes
429911425,  marinellagalli, 2, 2, 0, yes
537949757,  RossanaContino, 1, 1, 0, yes
131198482,  Erprof, 1, 1, 0, yes
191204810,  AlessandraDust, 4, 3, 1, yes
1013658150,  GiorgiaaLeo, 1, 1, 0, yes
3082215623,  soloprato1908, 1, 1, 0, yes
1011786374,  PamperoPam, 1, 1, 0, yes
420301474,  GioiaBotteghi, 1, 1, 0, yes
74966403,  lucio_scarpa, 1, 1, 0, yes
263139292,  FerratiF, 6, 6, 0, yes
2812961,  gloquenzi, 5, 4, 1, yes
2868560572,  agnelloda, 1, 1, 0, yes
512105666,  ninacenacchi, 2, 2, 0, yes
15333188,  Real_Dr_Roy, 1, 1, 0, yes
557270152,  ClarissaSpada, 1, 1, 0, yes
2647609637,  giannileone721, 1, 1, 0, yes
2848306257,  sweetnanie861, 1, 1, 0, yes
1260348024,  Martystoryline, 1, 1, 0, yes
2508685276,  ErneMontanaro, 2, 2, 0, yes
336239499,  vincrnzobasset, 1, 1, 0, yes
4208879843,  chinasqui, 1, 1, 0, yes
493133620,  egalloperozzi, 1, 1, 0, yes
805557482731032576,  sofragwen, 1, 1, 0, yes
805549812212989954,  ciappi_giuliano, 1, 1, 0, yes
1915496282,  OrofinoDaniela, 1, 1, 0, yes
982773516,  Rayo2009, 2, 2, 0, yes
83882096,  Lucas_Cefas, 3, 2, 1, yes
3023901389,  ColangeloKatia, 6, 2, 4, no
2997635012,  jpodnos, 1, 1, 0, yes
2754489201,  BosiTamara, 1, 1, 0, yes
398236563,  Yaia23, 1, 1, 0, yes
109818597,  Giampobruno, 1, 1, 0, yes
838319900,  FraMandaro, 5, 3, 2, yes
713041857798934529,  mauro_rz1, 1, 1, 0, yes
2473397637,  lellobrazza, 1, 1, 0, yes
3133358394,  MartinoPigato89, 13, 9, 4, yes
3070507502,  jemeo7, 1, 1, 0, yes
539117306,  In_Coscienza, 1, 1, 0, yes
25523882,  angepasi, 1, 1, 0, yes
751863980176605184,  MasseriaNinni, 2, 2, 0, yes
1452990714,  danj472, 2, 2, 0, yes
520607267,  SissiR97, 4, 4, 0, yes
142249812,  skyfox5, 1, 1, 0, yes
119687388,  Ago_73, 1, 1, 0, yes
483399386,  Dany_Borgo, 1, 1, 0, yes
1612704416,  nicohatschi, 1, 1, 0, yes
1574792534,  myfabs23, 2, 1, 1, neutral
1148943278,  paoloballadelli, 1, 1, 0, yes
787759553395978240,  lo_tarantino, 1, 1, 0, yes
1120460647,  teoloria, 1, 1, 0, yes
761338637455851520,  Italy1986carov, 1, 1, 0, yes
515927319,  Alex_Manni, 2, 2, 0, yes
446742193,  Cosmic_Gaze, 1, 1, 0, yes
1259526745,  MelyMelaMelissa, 1, 1, 0, yes
127879288,  John_Doe_Snow, 1, 1, 0, yes
1009474698,  Tom_Cannon_88, 1, 1, 0, yes
619392718,  TaunlSanborn, 1, 1, 0, yes
2259199508,  candelabarro, 1, 1, 0, yes
98088844,  RafBigCat, 3, 3, 0, yes
411370110,  UmbertoMorosini, 5, 3, 2, yes
441227606,  DavidMazzerelli, 1, 1, 0, yes
759401210801692672,  enza_negrin, 2, 2, 0, yes
1079806063,  Dacapani51, 3, 2, 1, yes
515979525,  Gliago89, 4, 3, 1, yes
511805317,  IvanPerriera, 1, 1, 0, yes
1316245117,  guidobodrato, 8, 6, 2, yes
785767683325394944,  altrautista, 2, 2, 0, yes
2891246387,  davidetarsi77, 2, 2, 0, yes
4178858601,  Aberrantissimo, 15, 13, 2, yes
445562103,  oct2610, 2, 2, 0, yes
416492793,  alessio1279, 2, 1, 1, neutral
593615857,  belleiluca, 1, 1, 0, yes
426470235,  LisaMarinaro1, 4, 4, 0, yes
4817730435,  karol_bojnansky, 1, 1, 0, yes
399356077,  francescobei, 2, 1, 1, neutral
2765608372,  rita_corrado, 2, 2, 0, yes
216043741,  Alex_Raggi, 1, 1, 0, yes
2780443681,  FlaShBloGWorld, 3, 2, 1, yes
232364004,  roccoroi, 1, 1, 0, yes
579832920,  ivangranito, 2, 2, 0, yes
1420089103,  PomaraSeiton, 1, 1, 0, yes
594885941,  MarcoPariscenti, 1, 1, 0, yes
2411079502,  lucia_lunghi, 1, 1, 0, yes
471272450,  gionoce, 1, 1, 0, yes
927227653,  SilvanaLibera2, 1, 1, 0, yes
2420979852,  claserenity, 1, 1, 0, yes
805128837650673664,  kishoriradha1, 1, 1, 0, yes
17946926,  mattiamagrassi, 2, 2, 0, yes
1569038504,  campamassimo, 1, 1, 0, yes
20271943,  NeuroVirtu, 3, 2, 1, yes
505865419,  davideacuto, 1, 1, 0, yes
378197352,  NovareseVolante, 2, 2, 0, yes
380834354,  ilFr33, 1, 1, 0, yes
84918135,  giullaregiallo, 1, 1, 0, yes
805442124036669441,  BennyBoomFrozen, 1, 1, 0, yes
4259747315,  _lucapec_, 1, 1, 0, yes
408382868,  Ingesicurezza, 3, 1, 2, no
111875060,  riccardofiorito, 5, 5, 0, yes
1272454735,  checkerhd, 2, 2, 0, yes
2728248539,  alessiatesoro16, 6, 6, 0, yes
751854340399325185,  giobrunori54, 1, 1, 0, yes
1331720245,  LadyWolverine81, 1, 1, 0, yes
803495902430294016,  EmidioBurlotti, 1, 1, 0, yes
767870049579364352,  vito51582589, 3, 3, 0, yes
331841581,  gius_arrighetti, 2, 2, 0, yes
2294741330,  DarioENxx, 1, 1, 0, yes
766248051937832960,  andreau271, 3, 3, 0, yes
117187684,  AldoDeFilippis, 2, 2, 0, yes
894067897,  emmaserra90, 1, 1, 0, yes
299336244,  Maguinavil, 1, 1, 0, yes
1288590109,  marco3281, 1, 1, 0, yes
3351771173,  M4rco79, 1, 1, 0, yes
504326435,  andreamurru23, 2, 2, 0, yes
468345152,  adryvivace, 1, 1, 0, yes
2957219068,  Masc_Anna, 3, 3, 0, yes
91977894,  fcalderan, 1, 1, 0, yes
2232286277,  2ganz4u, 2, 2, 0, yes
4636463057,  AleJackD1, 1, 1, 0, yes
769885684538703872,  maw00000, 5, 4, 1, yes
407699712,  angelo_senaldi, 1, 1, 0, yes
263059517,  AdrianoFrinchi, 7, 7, 0, yes
228775264,  acisotto, 2, 2, 0, yes
256479795,  iuforn, 1, 1, 0, yes
1367713591,  ITraveler111, 1, 1, 0, yes
625864606,  ErmannoClaypoo1, 2, 2, 0, yes
748243726661730304,  passioneonde, 1, 1, 0, yes
876659624,  camillegaltier, 1, 1, 0, yes
587155302,  NASCHartInc, 1, 1, 0, yes
1522729784,  VictorPesare, 1, 1, 0, yes
2475542112,  manowar_acdc, 1, 1, 0, yes
479864573,  tielllle, 1, 1, 0, yes
3121490165,  sere0406, 3, 3, 0, yes
544598710,  vincenzofederi1, 1, 1, 0, yes
227978852,  annadetto, 2, 2, 0, yes
294651995,  Giancatura, 1, 1, 0, yes
2487602595,  tpd0novan, 1, 1, 0, yes
772391535371583488,  Giusepp87176131, 1, 1, 0, yes
884824484,  patriz1a, 2, 2, 0, yes
203670990,  ilgian76, 2, 2, 0, yes
2187389893,  myryaloi, 1, 1, 0, yes
592675895,  ciccone_andrea, 1, 1, 0, yes
281410874,  lunacolferai, 2, 2, 0, yes
2257916805,  MaryJSgro, 1, 1, 0, yes
243120841,  ilsitodifirenze, 1, 1, 0, yes
805557145110532096,  Mario40316778, 1, 1, 0, yes
805258084989943809,  federicomes85, 2, 1, 1, neutral
366622715,  FraHammers, 1, 1, 0, yes
768424440812171268,  ClaudioBaposi2, 1, 1, 0, yes
793867015073267712,  Informa_re, 1, 1, 0, yes
2835916408,  LuigiaIerace, 1, 1, 0, yes
45390665,  mauromele, 1, 1, 0, yes
102803468,  iw0der, 1, 1, 0, yes
456079744,  CarCavaliere, 1, 1, 0, yes
558018502,  SanTMarco16, 1, 1, 0, yes
1570591454,  MRondella, 1, 1, 0, yes
1119822385,  PBisinella, 2, 2, 0, yes
4828921685,  _carlotta49, 3, 3, 0, yes
614273712,  GiulianoPalma21, 1, 1, 0, yes
351167436,  tenniscorner, 1, 1, 0, yes
747385404450553856,  fedebandi, 3, 3, 0, yes
399018954,  JacopoBiasi, 1, 1, 0, yes
1367062297,  Gaetanogati, 1, 1, 0, yes
36158425,  OrchidNYC, 1, 1, 0, yes
3372660087,  lombardo8470, 1, 1, 0, yes
2207550695,  MoneVincenzo, 1, 1, 0, yes
397084851,  Alex_Chiapetto, 7, 1, 6, no
52036241,  DavidPuente, 1, 1, 0, yes
2790647018,  vaniabasilici, 1, 1, 0, yes
418222515,  nickanals, 1, 1, 0, yes
503665830,  bAdXam, 2, 2, 0, yes
805558840976703488,  leoelefante1, 1, 1, 0, yes
3439237132,  nikaangel132, 1, 1, 0, yes
565551081,  ventuhh, 1, 1, 0, yes
155062488,  KerryKennedyRFK, 1, 1, 0, yes
4838093175,  tarchino1080, 1, 1, 0, yes
162718540,  Tommy9211, 1, 1, 0, yes
42850001,  noemimatteucci, 1, 1, 0, yes
111254062,  eurocommunism, 1, 1, 0, yes
804816242427199488,  marcomeloni1974, 2, 2, 0, yes
90805279,  paul_aguilar, 1, 1, 0, yes
467517878,  IsabellaInsolia, 2, 2, 0, yes
159995198,  Boscardin, 1, 1, 0, yes
908597576,  giovann45657288, 1, 1, 0, yes
80435193,  filipporant, 1, 1, 0, yes
1660873634,  SimoneNemesis, 1, 1, 0, yes
788767771572183040,  Fuxmar1, 1, 1, 0, yes
2464181316,  BenSharmaTO, 1, 1, 0, yes
802978298770890752,  montillo_rosa, 2, 2, 0, yes
66238489,  MYounique, 1, 1, 0, yes
983351833,  PaolaMicali, 4, 4, 0, yes
794014662232834048,  ezio_gatti, 1, 1, 0, yes
635445777,  the_dragos, 1, 1, 0, yes
249052178,  angelocovino90, 1, 1, 0, yes
365919630,  seleneblu, 1, 1, 0, yes
802995357827338240,  Nik44301398, 1, 1, 0, yes
39716074,  angelolari, 1, 1, 0, yes
1490276376,  LucaGiamba, 1, 1, 0, yes
325217371,  Vylkeer, 1, 1, 0, yes
3019962549,  CristallinaLr, 1, 1, 0, yes
1251759408,  NuntioVobis, 3, 3, 0, yes
805559750494683136,  Christi95914831, 1, 1, 0, yes
30675309,  vinicioborsi, 1, 1, 0, yes
499778382,  DezenC, 5, 4, 1, yes
466914653,  MMamaches, 1, 1, 0, yes
760396285,  kisacamy, 1, 1, 0, yes
444042573,  domagio1, 1, 1, 0, yes
2380788234,  iLuk10_, 2, 1, 1, neutral
23823353,  stefanosoro, 1, 1, 0, yes
2331616316,  A_Landro, 1, 1, 0, yes
231902290,  Cartabellotta, 3, 3, 0, yes
2338387671,  charlesagorika, 1, 1, 0, yes
24842995,  Orgetorix, 1, 1, 0, yes
2572973244,  mirkogazzetta, 3, 3, 0, yes
1068333732,  LUSATERE, 4, 4, 0, yes
871769438,  LukeRays, 1, 1, 0, yes
525350179,  3L_D13G0, 3, 3, 0, yes
539888174,  kingdano86, 1, 1, 0, yes
143644268,  faboys, 3, 2, 1, yes
148359926,  elen46, 1, 1, 0, yes
74752676,  davidsonra, 1, 1, 0, yes
1249671865,  alecocchi78, 1, 1, 0, yes
270139584,  Mandonnetj, 1, 1, 0, yes
1592101442,  BartoGeo, 1, 1, 0, yes
747177225422790656,  gabrielbowenza, 1, 1, 0, yes
454658035,  CHANTALLE63, 4, 4, 0, yes
780984548553269249,  fuorionda, 1, 1, 0, yes
3091817705,  unamaneradever1, 1, 1, 0, yes
715495167659081728,  ILDaniILDani, 1, 1, 0, yes
3204068644,  GiovannaRest, 2, 2, 0, yes
288749258,  zaradenutella, 1, 1, 0, yes
1668633392,  ErcanUysal2, 1, 1, 0, yes
2863629983,  veronicabattis3, 1, 1, 0, yes
4835005347,  mayorov1985, 1, 1, 0, yes
3390715713,  rusco06, 1, 1, 0, yes
521561869,  borghi17, 1, 1, 0, yes
1715662364,  MarziaAffatato, 2, 2, 0, yes
791976286839275520,  GiusyPellegri16, 2, 2, 0, yes
2862021752,  MRotesi, 1, 1, 0, yes
754527682734526464,  IampxvczTW, 1, 1, 0, yes
799985067066085380,  Targaryan2, 1, 1, 0, yes
1609856436,  lisadi68, 1, 1, 0, yes
1219272870,  lorelaylorella, 3, 2, 1, yes
421145081,  EnricoTurletti, 1, 1, 0, yes
1484857849,  A_Trimaille, 1, 1, 0, yes
2743797029,  PriscoTina, 1, 1, 0, yes
706898978797973504,  FedericoAghito, 1, 1, 0, yes
441219391,  LivAchilli, 1, 1, 0, yes
741283761875243008,  PaoloMuzzin, 1, 1, 0, yes
1725937591,  Ale_Lussana, 1, 1, 0, yes
2254155718,  sixmog, 1, 1, 0, yes
60540719,  POL1975, 1, 1, 0, yes
2968411493,  marinellap62, 1, 1, 0, yes
730476038497701888,  PapiBruno2, 1, 1, 0, yes
2315417601,  TotesNotCreepy, 1, 1, 0, yes
1286298164,  ale16dicosta, 2, 2, 0, yes
199272650,  ManuelaMacario, 1, 1, 0, yes
732590077205958656,  stefycava, 1, 1, 0, yes
509244219,  LauraMiccio, 1, 1, 0, yes
366653707,  emanueleBrenna, 1, 1, 0, yes
218821068,  EugenioStucchi, 1, 1, 0, yes
803685247707738112,  Roberta181010, 2, 2, 0, yes
1058570330,  antoniotucci60, 8, 6, 2, yes
440692702,  TizianaCalanna, 1, 1, 0, yes
784802723346669568,  Cristys1971, 1, 1, 0, yes
2364461868,  lalla24022014, 1, 1, 0, yes
58511784,  _beps, 2, 2, 0, yes
1190527639,  VerganiCarlo4, 1, 1, 0, yes
1920745218,  Dottorina1, 10, 7, 3, yes
2358531166,  nsergio58, 1, 1, 0, yes
3370499337,  stenicar, 3, 3, 0, yes
770351047646777349,  TrendTopic_news, 1, 1, 0, yes
773633250,  ccasseri, 1, 1, 0, yes
986782213,  danielalampis1, 2, 2, 0, yes
323057310,  galimbertilucio, 1, 1, 0, yes
294187618,  toni_mesfosc, 1, 1, 0, yes
3224902024,  Silvia76460957, 1, 1, 0, yes
485937556,  LTLukT, 1, 1, 0, yes
84800149,  79mimmo, 1, 1, 0, yes
512524630,  Secco_Jones, 1, 1, 0, yes
1062514339,  1510Roberto, 2, 2, 0, yes
397526244,  andreacocco4, 1, 1, 0, yes
497899308,  Atrebor78, 2, 2, 0, yes
3105590987,  derossi90, 1, 1, 0, yes
2348648162,  OPhilDelo, 1, 1, 0, yes
3371322767,  AlbertiIaura, 1, 1, 0, yes
174204377,  The_Teuz, 1, 1, 0, yes
179059177,  Marco_Bonini, 1, 1, 0, yes
284558556,  skvrr, 1, 1, 0, yes
864790298,  ChiodoITA, 1, 1, 0, yes
207946407,  ipasticcidiluna, 1, 1, 0, yes
460295351,  Blanche012, 1, 1, 0, yes
44105930,  Jump1967, 2, 2, 0, yes
726839713504571394,  andreapat98, 1, 1, 0, yes
919660430,  cdelmos, 1, 1, 0, yes
500578766,  antoniobonasser, 1, 1, 0, yes
1244280918,  robertamazzei28, 1, 1, 0, yes
805664383451938816,  rgmoscatello1, 1, 1, 0, yes
2906429338,  IngBuono, 1, 1, 0, yes
2160538024,  Orgukt, 1, 1, 0, yes
2875667218,  Amaranth1902, 6, 2, 4, no
1275664376,  ErodeAscalonita, 1, 1, 0, yes
342883786,  SimoneSterbini, 1, 1, 0, yes
4651300527,  salmorvir, 1, 1, 0, yes
254698326,  Giannone, 1, 1, 0, yes
771051101344890880,  MichelottiIlia, 1, 1, 0, yes
546666636,  fabioparretti, 1, 1, 0, yes
4859716631,  riddik333, 4, 3, 1, yes
2254987077,  LorenzoRody, 1, 1, 0, yes
115419968,  votamerola, 3, 3, 0, yes
1325300101,  ChiaraEsse1, 2, 2, 0, yes
804754879646486528,  Gaetano92898881, 1, 1, 0, yes
1712747618,  EliseoLuka, 1, 1, 0, yes
3067655176,  rosariabaffa, 1, 1, 0, yes
770021973342715904,  MatteoCosta_94, 2, 2, 0, yes
799931833475547136,  ilmichimelis, 1, 1, 0, yes
192150791,  tdilonardo, 1, 1, 0, yes
780763287872901120,  ColornoSi, 3, 3, 0, yes
756794645355659264,  RicadiAntonio, 1, 1, 0, yes
913326068,  DavideCracco, 2, 2, 0, yes
513481122,  FatosShehu, 14, 1, 13, no
16629945,  Claudiogiua, 2, 2, 0, yes
1014910104,  JulianaBandiova, 1, 1, 0, yes
140351552,  cmisdead, 2, 2, 0, yes
429194064,  annaliziacapurs, 3, 3, 0, yes
735109884417585152,  mnl3006, 2, 2, 0, yes
11813882,  xtomas, 1, 1, 0, yes
758605186919268352,  carlo_collesi, 1, 1, 0, yes
1555974456,  gdcesena, 1, 1, 0, yes
2435370944,  PMGarredamenti, 3, 3, 0, yes
765219085042982913,  stefi_ci, 1, 1, 0, yes
432857950,  antoninonoto90, 1, 1, 0, yes
765871344076619776,  110_392, 2, 2, 0, yes
1149043339,  evaldojack, 1, 1, 0, yes
3177211792,  framsit, 4, 4, 0, yes
4474420155,  VitoDiocesano, 1, 1, 0, yes
4180219161,  PaoloJlaceli, 1, 1, 0, yes
1155129516,  piercoram, 2, 2, 0, yes
40705890,  enricogualandi, 1, 1, 0, yes
4306216179,  idee_in_circolo, 1, 1, 0, yes
4474392677,  fabioingoio1, 1, 1, 0, yes
607629011,  vincenzoderiso1, 3, 3, 0, yes
3095395041,  prinzio57, 2, 1, 1, neutral
202974263,  mirkomalcangi, 2, 1, 1, neutral
2458031228,  gustavodecicco, 1, 1, 0, yes
557059629,  rnarzisi, 1, 1, 0, yes
721961988147015680,  Aneudis07725573, 2, 2, 0, yes
1901732377,  Napolivana, 1, 1, 0, yes
73208581,  silviobergna, 2, 2, 0, yes
859072500,  s_viceversa, 2, 2, 0, yes
882790081,  elygualtieri, 2, 2, 0, yes
785135125143162880,  pauloanselmo12, 2, 2, 0, yes
4549851317,  GovanGhirlllll, 1, 1, 0, yes
272822756,  GiacomoGuerrini, 4, 4, 0, yes
426919020,  KatiaMar1n0, 2, 2, 0, yes
492603988,  AndreaSantoboni, 1, 1, 0, yes
3105871258,  polato74, 1, 1, 0, yes
580053031,  marcomele12, 1, 1, 0, yes
2243608365,  tanygaetano, 1, 1, 0, yes
2477243514,  Barbara70641413, 2, 1, 1, neutral
3801670049,  Corrado453, 1, 1, 0, yes
471061460,  Fbenotti, 1, 1, 0, yes
447816724,  NatalinoCanale, 1, 1, 0, yes
4817551755,  Renata_Maione, 1, 1, 0, yes
2382248403,  mantegazza_luca, 1, 1, 0, yes
557887612,  pellizza1, 1, 1, 0, yes
361319690,  giancarlofalco1, 1, 1, 0, yes
802843485774745600,  Aaroneleo, 1, 1, 0, yes
153328525,  massimofurlan, 1, 1, 0, yes
770125575893684224,  albatect, 1, 1, 0, yes
3182694317,  WEWECRI, 3, 3, 0, yes
451419267,  stefano_bonelli, 1, 1, 0, yes
793347918690447360,  damianox85, 1, 1, 0, yes
4194649347,  paolotestaverd2, 3, 1, 2, no
105409681,  paolodifalco, 1, 1, 0, yes
366578619,  CiArLy_DEA, 2, 2, 0, yes
849861090,  GioLeuri, 2, 1, 1, neutral
2361471923,  stefaniacattan1, 4, 4, 0, yes
787987095763779584,  Diana87858934, 1, 1, 0, yes
330865662,  LykanLA, 3, 2, 1, yes
382012011,  amverra, 6, 5, 1, yes
2883005427,  AntonellaNinu, 1, 1, 0, yes
729626196577759232,  lucasacccomandi, 1, 1, 0, yes
401208512,  giu_greco, 1, 1, 0, yes
224759311,  AngeloPignolo, 1, 1, 0, yes
561995743,  AnniPodimata, 2, 2, 0, yes
772522039638908930,  YendriKenny, 1, 1, 0, yes
1536207708,  LMrtnvc, 1, 1, 0, yes
2892315400,  teatroatelier1, 1, 1, 0, yes
213013841,  PEPITOSAworld, 5, 3, 2, yes
78007839,  giancarlo_terzi, 1, 1, 0, yes
748888907199152128,  177d8a8f2d974ba, 1, 1, 0, yes
407662065,  FrancaTenore, 1, 1, 0, yes
1477145846,  danielnet77, 1, 1, 0, yes
910823766,  dcmateraz, 1, 1, 0, yes
225563748,  alessioconte28, 1, 1, 0, yes
331483630,  AndcoSeve, 3, 3, 0, yes
783222186622455808,  StudAssocMilano, 1, 1, 0, yes
720048936,  FrancescaFredia, 4, 2, 2, neutral
1022053550,  FBrasi, 2, 2, 0, yes
755044307111931906,  manuelaMcGarten, 1, 1, 0, yes
2396858321,  toroscatenato62, 1, 1, 0, yes
722437795,  elianazannone, 4, 1, 3, no
2541684684,  oscar76504469, 1, 1, 0, yes
803288617422647301,  FrancoCalifano5, 2, 1, 1, neutral
783735608325836800,  giovannipinoli, 4, 4, 0, yes
701779311183974400,  Dario_DallAva, 1, 1, 0, yes
1893926106,  Cintia82C, 1, 1, 0, yes
438735213,  moretti_giada, 1, 1, 0, yes
1913153286,  RecinoDiego, 2, 2, 0, yes
3331635153,  3dde42a122c74f1, 1, 1, 0, yes
45314925,  prisencoli, 1, 1, 0, yes
802153545239851013,  belota3, 1, 1, 0, yes
725764802111483904,  magnogiuman, 1, 1, 0, yes
385587470,  MissoLucio, 1, 1, 0, yes
419108716,  SusannaHpHp, 1, 1, 0, yes
1373828755,  MatitaVoci, 1, 1, 0, yes
778364863630508032,  MirkoGrassia, 1, 1, 0, yes
2948903153,  arturomadrid996, 1, 1, 0, yes
791015549123883008,  GiampyNew, 1, 1, 0, yes
61154684,  dariofrance, 2, 2, 0, yes
2171004471,  megghinicoletti, 1, 1, 0, yes
744941794807414784,  andrea_ballare, 4, 4, 0, yes
1143781171,  umbertoraja, 1, 1, 0, yes
217611528,  Minguzzi72, 1, 1, 0, yes
107820528,  maxrossello, 2, 2, 0, yes
2876249524,  alessandro1846, 2, 2, 0, yes
1009171508,  Vitbaglio, 5, 5, 0, yes
2984614877,  icp3_zero, 1, 1, 0, yes
3175647400,  simona_fal, 1, 1, 0, yes
186027945,  michelecampi64, 3, 3, 0, yes
1612428607,  CiaodaVirginia, 1, 1, 0, yes
565738572,  DiarioDiDario, 1, 1, 0, yes
989502775,  giobrunetti61, 1, 1, 0, yes
132624844,  Marco_Espo, 1, 1, 0, yes
2971201883,  mimmosardi, 1, 1, 0, yes
383206305,  annaadella, 1, 1, 0, yes
392152009,  DavideBrutti, 1, 1, 0, yes
2522836091,  Marymuser1123, 1, 1, 0, yes
28064801,  BilderbergGroup, 1, 1, 0, yes
67882453,  BertoliniGio, 1, 1, 0, yes
4523697141,  carmold2, 1, 1, 0, yes
2320030462,  GiGraziano, 2, 1, 1, neutral
149561648,  lucadinnocenzo, 2, 2, 0, yes
4705974935,  Fit_Girl34, 2, 2, 0, yes
390565306,  sweetlola86, 3, 3, 0, yes
431143908,  marcovalerio4, 1, 1, 0, yes
51457032,  lucalombardo, 2, 2, 0, yes
3424517146,  EMANUELEBARBAR6, 1, 1, 0, yes
780493585,  MauroBarindelli, 1, 1, 0, yes
3027220066,  DanieleBagno, 2, 2, 0, yes
3237045227,  simplymois, 1, 1, 0, yes
2363694009,  lgraz59, 2, 2, 0, yes
613298142,  PAOLOLILLI, 1, 1, 0, yes
345521560,  ValentinaVadi72, 4, 3, 1, yes
274591337,  nuli74, 2, 2, 0, yes
3997584435,  muuuuu02, 1, 1, 0, yes
2904421816,  harrysolver, 1, 1, 0, yes
331899482,  GlaucoMala2, 2, 2, 0, yes
1243979124,  IgnazioAZ, 1, 1, 0, yes
2344865535,  atelierpiermau, 1, 1, 0, yes
548010759,  higheyeofheaven, 1, 1, 0, yes
739432651065577472,  domenic69016451, 1, 1, 0, yes
1958062022,  ugofusco, 1, 1, 0, yes
703783792,  MatteoPontin, 1, 1, 0, yes
425310939,  CarloCoratelli, 3, 1, 2, no
117158470,  MarrazzoRosario, 1, 1, 0, yes
479023397,  stefykiddo, 1, 1, 0, yes
843936690,  Roberta_Fazio10, 5, 5, 0, yes
1127665760,  DLipretti, 1, 1, 0, yes
785647159,  kocis60, 4, 4, 0, yes
751388046306766848,  nicgiuly, 1, 1, 0, yes
3128595119,  Nancy75124, 3, 3, 0, yes
1710567074,  annita_brindani, 1, 1, 0, yes
47803723,  LuigiGaudenzi, 2, 2, 0, yes
750122795913338881,  klaus2196, 2, 1, 1, neutral
4824739947,  Lorenzo_reports, 1, 1, 0, yes
3729198442,  Vaudeville94, 1, 1, 0, yes
1150562089,  eedlop, 1, 1, 0, yes
3638160616,  GlobalTimes_eu, 7, 6, 1, yes
482428376,  cvlbcn, 1, 1, 0, yes
744532594067390465,  FrancescoV344, 2, 2, 0, yes
496208669,  sissa_d, 1, 1, 0, yes
1715836404,  smowke, 1, 1, 0, yes
3433414642,  NapettS, 2, 2, 0, yes
22189370,  fedeposti, 1, 1, 0, yes
499739550,  AndreaGianesini, 1, 1, 0, yes
312553561,  EnricoFop, 2, 1, 1, neutral
4151740097,  AAgnelli92, 2, 2, 0, yes
2597977564,  Daria1Dsavedme, 1, 1, 0, yes
1164281046,  luipanfilibreda, 1, 1, 0, yes
4901828439,  evi20161, 1, 1, 0, yes
982515475,  PaolaTurato, 1, 1, 0, yes
757855565368274944,  PaoloSecchieri, 2, 2, 0, yes
1011196998,  virgiscorner, 2, 1, 1, neutral
388182126,  ChiaraLiati, 1, 1, 0, yes
939432270,  nicofrattura, 1, 1, 0, yes
563172729,  rosaAnnarosa, 1, 1, 0, yes
352204244,  andrealanigra, 1, 1, 0, yes
801487210826625024,  JackPescia, 1, 1, 0, yes
1550965124,  bendeey, 1, 1, 0, yes
3501641477,  venanerazzurra, 1, 1, 0, yes
3073409573,  andreamass67, 3, 3, 0, yes
421380054,  paolociuffa, 1, 1, 0, yes
335871173,  italianadimondo, 2, 2, 0, yes
143745231,  tHeJoKeR_78, 4, 2, 2, neutral
572200239,  SimoCava97, 1, 1, 0, yes
3039804694,  valenzia27, 1, 1, 0, yes
464156077,  Greyslover_95, 1, 1, 0, yes
140382700,  c_delvecchio, 1, 1, 0, yes
2912621278,  agnello_massimo, 1, 1, 0, yes
796670191648337920,  Fabio80793385, 2, 2, 0, yes
380348802,  anndec73, 1, 1, 0, yes
865991736,  MonicaP38209382, 1, 1, 0, yes
632021747,  CristinaSparvie, 1, 1, 0, yes
3058545379,  NandoPollice, 1, 1, 0, yes
3435537363,  marillalo72, 1, 1, 0, yes
2974945617,  TuttoEsaurito_, 1, 1, 0, yes
707187085657174016,  lestoriedimad, 6, 5, 1, yes
2257828493,  ManuelaLaFerla, 1, 1, 0, yes
2303218766,  SeguiBalleri, 3, 2, 1, yes
743174163922358272,  chri_1979, 1, 1, 0, yes
2663751512,  valesangio, 2, 2, 0, yes
563820182,  attipensa, 2, 1, 1, neutral
2576450173,  SimoneBoia99, 1, 1, 0, yes
2880372066,  riccardo_trona, 1, 1, 0, yes
42910444,  MarcoKistner, 1, 1, 0, yes
783659134256353280,  DanielaRoma14, 2, 2, 0, yes
399346572,  AlexCalzerano, 2, 2, 0, yes
3271819566,  GiorgioSegurin1, 1, 1, 0, yes
420561214,  michelesartor, 1, 1, 0, yes
328031487,  tiamq, 1, 1, 0, yes
2797730621,  AlshtagX7, 1, 1, 0, yes
860221824,  ManziTommaso, 1, 1, 0, yes
1667657082,  michelagr72, 1, 1, 0, yes
1477808606,  nocgennaro, 1, 1, 0, yes
2212177779,  studio_magliano, 2, 2, 0, yes
2496397927,  annazambelli60, 1, 1, 0, yes
311465404,  Riccardo237, 1, 1, 0, yes
361231307,  PaoloZippoSpizz, 1, 1, 0, yes
3311837223,  Mirko00660176, 1, 1, 0, yes
1108486045,  AntoPuglieseOff, 1, 1, 0, yes
712592618459369472,  Malintenzionat1, 2, 2, 0, yes
2967752795,  ppaolomauri, 1, 1, 0, yes
2930058027,  nami22265, 1, 1, 0, yes
797837298406658048,  Elisabe92307899, 2, 2, 0, yes
742992676157554689,  ALESSIOGIANITES, 1, 1, 0, yes
89382446,  GabrieleBrocani, 1, 1, 0, yes
418762739,  CiroSct, 1, 1, 0, yes
1640547025,  FutsalRefChri, 2, 1, 1, neutral
720946355905175552,  Francesco23468, 1, 1, 0, yes
22053399,  alvisefranz, 6, 4, 2, yes
3367448165,  losapio93, 3, 2, 1, yes
2993992618,  AleScrittore, 1, 1, 0, yes
34993413,  zionicky, 2, 2, 0, yes
1369876783,  MARIONAPOLI10, 1, 1, 0, yes
721993269568225280,  landau_janina, 3, 1, 2, no
2322690628,  50mm__, 1, 1, 0, yes
177086902,  pietrolisi, 2, 2, 0, yes
96218677,  GraziaFox, 1, 1, 0, yes
173579759,  mic_75, 6, 6, 0, yes
1004832751,  SabrinaMariuz, 2, 2, 0, yes
2540868082,  _alessiart19, 1, 1, 0, yes
3036417395,  hegedex, 1, 1, 0, yes
2611062325,  avvpizzimenti, 2, 2, 0, yes
450738991,  Patrizia0758, 2, 2, 0, yes
745591691403493376,  DanieleScatassi, 2, 2, 0, yes
2360724117,  migni_elio, 1, 1, 0, yes
805670255007793152,  chiamello, 1, 1, 0, yes
2981614197,  BisEnza, 1, 1, 0, yes
174162415,  SONIAC66, 1, 1, 0, yes
910560739,  giusycilia, 2, 2, 0, yes
45340239,  Marco_Cacciotto, 1, 1, 0, yes
2532595073,  DrWriter18, 1, 1, 0, yes
447097837,  CriBri13, 3, 3, 0, yes
980481373,  FulviaDallAcqua, 1, 1, 0, yes
994685858,  tkd_flavia, 1, 1, 0, yes
722071954014998528,  MartaPalumbo3, 2, 2, 0, yes
749338057309057025,  TittiTiziana940, 2, 2, 0, yes
1475875892,  becemac, 1, 1, 0, yes
481390533,  flavioweb2000, 1, 1, 0, yes
2862250054,  Jumping110, 1, 1, 0, yes
805401231179051008,  anto_nella49, 3, 3, 0, yes
3240590409,  ClaudioPetrosi2, 2, 2, 0, yes
2429564733,  franckcountry, 1, 1, 0, yes
543261945,  teddus17, 1, 1, 0, yes
4590906221,  guardini_marco, 4, 4, 0, yes
580138448,  DiaconoToni, 2, 1, 1, neutral
3499638315,  vaden_ada, 2, 2, 0, yes
81129947,  sandrabardotti, 1, 1, 0, yes
517701142,  toton81giangi, 3, 3, 0, yes
245782659,  mauriziogoitre, 1, 1, 0, yes
1206027301,  CarliniMarianna, 2, 2, 0, yes
2777781964,  FornaroCri, 1, 1, 0, yes
347436426,  MorenoRomanato, 1, 1, 0, yes
552856526,  torinorosita, 1, 1, 0, yes
873225552,  VittorioBlasi, 1, 1, 0, yes
514466072,  CleliaMangione, 1, 1, 0, yes
498401005,  RiciDie, 1, 1, 0, yes
631436852,  fgr62, 3, 2, 1, yes
3229041533,  Cira06164758, 1, 1, 0, yes
332370006,  teo_lightyear_3, 2, 2, 0, yes
3054053033,  vincefaraci15, 1, 1, 0, yes
3118959695,  giornale_isola, 1, 1, 0, yes
3330771076,  cesarepietrobon, 1, 1, 0, yes
218474628,  Ccharlott, 2, 2, 0, yes
1240919455,  fatecicapire, 3, 3, 0, yes
471031651,  SerenaPitotti, 1, 1, 0, yes
2839439607,  FioriGualberto, 3, 2, 1, yes
4857755519,  gabrielejuve1, 1, 1, 0, yes
186372018,  Milanonicola, 3, 1, 2, no
3374626023,  GlamirBlog, 1, 1, 0, yes
786921929353654272,  roberto15011955, 2, 1, 1, neutral
197595692,  DanieleCermelli, 1, 1, 0, yes
539829669,  Yodailmaestro, 1, 1, 0, yes
1129215229,  Zuzzurro78, 1, 1, 0, yes
477795938,  SoniaMendola, 1, 1, 0, yes
3377119619,  WikiBoy89, 1, 1, 0, yes
2973065585,  luigicapuano21, 1, 1, 0, yes
789370898,  JMoscianese, 1, 1, 0, yes
786109595051778048,  ninovassallo59, 1, 1, 0, yes
1007051372,  FrancoVenini, 2, 2, 0, yes
376206994,  francesca__86__, 1, 1, 0, yes
410652892,  FrattaleAvverso, 1, 1, 0, yes
952334328,  longostefano1, 1, 1, 0, yes
554376845,  AquilinoValeria, 3, 3, 0, yes
792804255690260480,  alessiasemini, 1, 1, 0, yes
841551709,  CeciliaTinacci, 1, 1, 0, yes
203544524,  crociedelizie, 1, 1, 0, yes
761579872531673088,  AntonioCir1969, 1, 1, 0, yes
3327903855,  LaviniaMaffia, 1, 1, 0, yes
99925189,  pasqualevidetta, 5, 4, 1, yes
906488575,  ggian80, 1, 1, 0, yes
1511831448,  liberodire, 2, 2, 0, yes
632829102,  stefygiu06, 1, 1, 0, yes
757145669664636928,  colaut1, 1, 1, 0, yes
4514669243,  gluca61, 1, 1, 0, yes
495751046,  LBERTULETTI, 2, 2, 0, yes
372255525,  anomys_, 1, 1, 0, yes
1178565433,  MissDilettaP, 3, 3, 0, yes
1017786078,  mariopippo5, 4, 1, 3, no
745600405,  EvaDavoli, 2, 2, 0, yes
364155111,  IsaBeretta1, 1, 1, 0, yes
428956525,  fgloreti, 2, 2, 0, yes
759860804166389760,  laSarita___, 1, 1, 0, yes
518950408,  ContiMericuccu, 2, 2, 0, yes
2865838734,  _00Style00_, 3, 2, 1, yes
473403560,  liberaitaliapsy, 1, 1, 0, yes
3048104911,  a4b91efea39a420, 1, 1, 0, yes
531520956,  IsabellaMerlo, 1, 1, 0, yes
932911370,  BukuriecukaCuka, 1, 1, 0, yes
800347640,  __aniraM__, 1, 1, 0, yes
4178674281,  saraeudizi, 2, 2, 0, yes
471456126,  robebalzano, 1, 1, 0, yes
321914716,  brunolovecchio, 4, 3, 1, yes
469615054,  jaxbrunello, 1, 1, 0, yes
474755454,  AngelaGianotti, 1, 1, 0, yes
4180500279,  pasquinorom, 1, 1, 0, yes
50305974,  gabrielecatania, 1, 1, 0, yes
422784893,  nicksp78, 4, 4, 0, yes
61610187,  sunnybailey8, 1, 1, 0, yes
571198374,  GiusyCapoluongo, 1, 1, 0, yes
82628159,  Nicola_150677, 1, 1, 0, yes
514631537,  nino_lopresti, 5, 5, 0, yes
1257640188,  Kenniedm, 1, 1, 0, yes
90280824,  Suma4720, 1, 1, 0, yes
3144557331,  federicaeee, 4, 3, 1, yes
196097736,  MassiGiribaldi, 1, 1, 0, yes
408682445,  MariaTeresaFon3, 1, 1, 0, yes
525817895,  _ValentinaJA23, 1, 1, 0, yes
702252129994547200,  Hajerty83, 1, 1, 0, yes
498886059,  r_barattini, 1, 1, 0, yes
249348861,  Sercrip, 1, 1, 0, yes
142066251,  stefanies_STYLE, 2, 2, 0, yes
406361052,  EnricoBonni, 1, 1, 0, yes
1601831028,  emanuelefusco4, 1, 1, 0, yes
103393344,  PapaMassi, 1, 1, 0, yes
4861223555,  mirky_10, 1, 1, 0, yes
189493282,  itsupernatural, 1, 1, 0, yes
417437781,  sh06000, 1, 1, 0, yes
731846195484758017,  VincenzoBlaugr1, 1, 1, 0, yes
55589026,  peachfra, 1, 1, 0, yes
34014081,  nitroxx92, 1, 1, 0, yes
1431147332,  saverio_caito, 1, 1, 0, yes
231584009,  BeurkMan, 1, 1, 0, yes
2984621433,  angelorizzi17, 4, 3, 1, yes
475946353,  JulSau, 1, 1, 0, yes
315645972,  Bisaureo, 1, 1, 0, yes
2194662943,  melann_mlps, 1, 1, 0, yes
46898720,  AdrianoClemense, 1, 1, 0, yes
1465718767,  annabepo, 1, 1, 0, yes
528623663,  francescodbossi, 1, 1, 0, yes
1157366478,  dan_gis, 2, 2, 0, yes
535538076,  prince89ferreri, 1, 1, 0, yes
1271029094,  GuerrinoVolta, 2, 2, 0, yes
805555512658038784,  Loredana290153, 1, 1, 0, yes
496038655,  GioRebuscini, 5, 2, 3, no
412869426,  fillysanfilippo, 3, 3, 0, yes
299919677,  NewFranci, 3, 3, 0, yes
3366465557,  RavettiMr14, 1, 1, 0, yes
577439964,  annadavey_, 1, 1, 0, yes
54909945,  LLACAL, 2, 2, 0, yes
485713565,  RomagnoloS, 1, 1, 0, yes
3413481177,  bottiglia69, 2, 1, 1, neutral
409277032,  MaxBrm, 1, 1, 0, yes
455625053,  carydonvidah, 1, 1, 0, yes
136550063,  ateotini, 1, 1, 0, yes
11874352,  massirulez, 1, 1, 0, yes
836419656,  muraca4, 1, 1, 0, yes
2593769192,  Signo8411, 4, 4, 0, yes
2220014681,  CirriLaura, 1, 1, 0, yes
1104393314,  LorenzoBoati, 1, 1, 0, yes
497095286,  baraschini, 1, 1, 0, yes
1390600514,  IAllevato, 2, 2, 0, yes
228903734,  toni8019, 1, 1, 0, yes
213793579,  simotringali, 1, 1, 0, yes
2822253153,  SoriaAngelo, 1, 1, 0, yes
1238682920,  magister_ed, 4, 4, 0, yes
363501186,  danielela3, 1, 1, 0, yes
14384413,  mikkysixx, 1, 1, 0, yes
563790346,  giuliobigbang, 1, 1, 0, yes
1112921833,  amati_anna, 4, 4, 0, yes
2355393590,  marcotini, 1, 1, 0, yes
2217783801,  tvio65, 1, 1, 0, yes
713044897645924352,  MaruscaChelotti, 1, 1, 0, yes
779727934705762304,  Sabrinarizzi72_, 1, 1, 0, yes
2739179513,  PaoloPazko, 1, 1, 0, yes
408653039,  DanieleLaielli, 1, 1, 0, yes
546255957,  FedeIsu, 3, 1, 2, no
1530966212,  giofed24, 2, 2, 0, yes
20498231,  sdmoss, 1, 1, 0, yes
256598095,  404_errore, 2, 2, 0, yes
2762656697,  FrauDonatella, 1, 1, 0, yes
749486426543288320,  milfomane, 9, 6, 3, yes
93297244,  claretfox, 2, 2, 0, yes
132091143,  MichaelForni, 8, 8, 0, yes
70210474,  Andreadakota92, 1, 1, 0, yes
706215774,  matrixunodinoi, 1, 1, 0, yes
1458974892,  alessiogallaro, 2, 2, 0, yes
45862370,  krotkaja, 1, 1, 0, yes
2418308517,  Vallynasole, 1, 1, 0, yes
1920013039,  MatteoMalangone, 1, 1, 0, yes
540851564,  meloni_daniele, 1, 1, 0, yes
428936288,  GTorrigiani, 1, 1, 0, yes
15922115,  KiraOConnor, 1, 1, 0, yes
804312855680000000,  andrea_farnelli, 1, 1, 0, yes
360144930,  RTerentyev, 2, 2, 0, yes
34013432,  sgmacor, 2, 2, 0, yes
950219371,  Francescocili, 1, 1, 0, yes
382292797,  giudittasborgi, 1, 1, 0, yes
1009309458,  alilanza79, 1, 1, 0, yes
3166180059,  LuisCarpentieri, 1, 1, 0, yes
1298019775,  dirittosulpunto, 1, 1, 0, yes
3370727595,  VincyXD97, 1, 1, 0, yes
2849700958,  sebastianogaeta, 3, 3, 0, yes
237735815,  ihcrob, 3, 3, 0, yes
2412655144,  Curatolo_Andrea, 2, 2, 0, yes
163238102,  topedobis, 1, 1, 0, yes
4774982363,  FalcoG2016, 1, 1, 0, yes
2659458731,  milenagallazzi, 1, 1, 0, yes
750121800,  DaniMaBe93, 1, 1, 0, yes
420475251,  gsemprunmdg, 1, 1, 0, yes
2991872159,  Lucio77001623, 13, 5, 8, no
596215691,  morenocorio, 1, 1, 0, yes
2600368942,  moni68jane, 2, 2, 0, yes
747372193,  amalachiti, 1, 1, 0, yes
805558841110908928,  Annaagostini6, 1, 1, 0, yes
56359194,  elisysh, 2, 2, 0, yes
319885906,  sirmikius, 1, 1, 0, yes
773210101700231170,  ZioLunys, 1, 1, 0, yes
2873752325,  NATASHAAAroy, 4, 4, 0, yes
553906356,  codicezeta, 1, 1, 0, yes
1035798212,  Mentulacanis, 1, 1, 0, yes
53492718,  UNonnu, 1, 1, 0, yes
2255666750,  nicolosi59, 2, 2, 0, yes
2216202108,  vgennaro_, 3, 2, 1, yes
3382982877,  kraffa61, 1, 1, 0, yes
2438058023,  DBallaera, 2, 2, 0, yes
391286612,  salvifilippo, 1, 1, 0, yes
261663837,  piodantini, 1, 1, 0, yes
607611228,  chiarantini, 1, 1, 0, yes
1082224789,  fotografaxamor, 1, 1, 0, yes
416259454,  jummo74, 3, 3, 0, yes
418786597,  alice_561, 4, 3, 1, yes
1187918924,  proiettilaura25, 1, 1, 0, yes
582156011,  MarioTrid, 9, 7, 2, yes
482216326,  marcozonca1, 1, 1, 0, yes
33024957,  bonanniluca, 5, 2, 3, no
3243357513,  dipamaury, 1, 1, 0, yes
169081342,  catellaweb, 1, 1, 0, yes
3021601385,  iacopo_righetti, 1, 1, 0, yes
2390438606,  ippolito57, 1, 1, 0, yes
566544109,  ProcopioPaolo, 1, 1, 0, yes
798206763661193216,  stefy89234, 1, 1, 0, yes
1238542698,  CelegonCristina, 1, 1, 0, yes
1690507970,  VERONICASCUOTTO, 1, 1, 0, yes
1388884027,  lafrisa, 2, 2, 0, yes
401370333,  AlessandroRaim2, 1, 1, 0, yes
798909691829043200,  SilvioGarofalo8, 1, 1, 0, yes
3881260575,  ornequa, 1, 1, 0, yes
2802940594,  thebenesway, 1, 1, 0, yes
409605782,  federicassanti, 2, 1, 1, neutral
615125363,  FrancaClick, 1, 1, 0, yes
120496158,  damiendelmotte, 1, 1, 0, yes
596775918,  jlopezbooty, 2, 2, 0, yes
712644163276312576,  settebellez2, 1, 1, 0, yes
45224390,  delplavi, 2, 2, 0, yes
757163501727154176,  ensiale1, 1, 1, 0, yes
706206888686460929,  Alarbus_Alpha, 1, 1, 0, yes
2899472752,  Gabrielelaspins, 2, 2, 0, yes
131841202,  Intetyst, 1, 1, 0, yes
404670518,  VladimirP73, 1, 1, 0, yes
53342962,  stefanomazzotti, 2, 2, 0, yes
2569160611,  TamaniSandro60, 1, 1, 0, yes
407938599,  VincenzoPioPosa, 1, 1, 0, yes
460878875,  EnzoResasco, 2, 2, 0, yes
447076020,  archigino, 1, 1, 0, yes
281760945,  michelegentili, 1, 1, 0, yes
33179713,  vincenzo42, 1, 1, 0, yes
4178618813,  gabryleo2002, 1, 1, 0, yes
724891280,  AlbertoTiezzi, 1, 1, 0, yes
796677773909696513,  pietropanormus, 2, 2, 0, yes
721792099952304129,  AntonioMonti_SS, 1, 1, 0, yes
1875359702,  silvermvs, 1, 1, 0, yes
790997282317537281,  francescagiuls, 2, 1, 1, neutral
720638502514376704,  Salvato52833581, 1, 1, 0, yes
956214918,  ERuzzoli, 2, 2, 0, yes
701008668,  Pluigi74, 1, 1, 0, yes
294736362,  gathoune_b, 1, 1, 0, yes
520935514,  GioDeFilippo, 1, 1, 0, yes
805731065096794112,  odidomenico1971, 1, 1, 0, yes
3613388177,  Roberto200268, 1, 1, 0, yes
2664821018,  polinas30410324, 1, 1, 0, yes
411707121,  87sueellen, 2, 2, 0, yes
11170692,  jimmomo, 5, 3, 2, yes
193829578,  dr_loid, 1, 1, 0, yes
316723668,  GabriDrummer, 1, 1, 0, yes
3297779873,  TouchOfClassIma, 1, 1, 0, yes
1709728165,  brescia_mimmo, 8, 7, 1, yes
998866694,  ALBYwouldGO, 1, 1, 0, yes
365075309,  KingGazze, 2, 2, 0, yes
782006448695963648,  AntonellaNellyB, 4, 4, 0, yes
1265233874,  morellfrancesco, 2, 2, 0, yes
123367754,  matteo_ilbello, 1, 1, 0, yes
407964480,  franci_des, 1, 1, 0, yes
476801479,  FrankSismos, 1, 1, 0, yes
96385220,  oasisiano, 1, 1, 0, yes
611172636,  giobianchi92, 1, 1, 0, yes
181331996,  stefanocri, 2, 2, 0, yes
2386403602,  SecondoTi, 2, 1, 1, neutral
458369885,  federicopisanti, 1, 1, 0, yes
4463901972,  crowbar1942, 1, 1, 0, yes
543525443,  MartinaBattis10, 1, 1, 0, yes
1084257722,  reartuc, 2, 2, 0, yes
447833104,  raimondima, 1, 1, 0, yes
631916066,  lillo_elena, 1, 1, 0, yes
15491386,  kikachan87, 3, 3, 0, yes
527113233,  SULTANO_91, 1, 1, 0, yes
582310657,  Alfredancer1201, 4, 4, 0, yes
2666750846,  LADY_FEMME, 1, 1, 0, yes
627351730,  lucaolandese, 7, 1, 6, no
805556531831906304,  nikiparodi1, 11, 8, 3, yes
3248281632,  deerpiueluo01, 1, 1, 0, yes
426148270,  pietrotripodo, 1, 1, 0, yes
4450964679,  cescajb, 1, 1, 0, yes
247394895,  Alexandraelorza, 2, 2, 0, yes
204436132,  DeeperInside96, 1, 1, 0, yes
277030721,  nadi1913, 1, 1, 0, yes
317417535,  LucaParisi80, 1, 1, 0, yes
1609032570,  SilvanoClerici, 2, 2, 0, yes
364237197,  NinoPazz, 2, 2, 0, yes
969834709,  StefanoMartell9, 1, 1, 0, yes
82064760,  andreatardioli, 1, 1, 0, yes
951582764,  MartaEmilia2, 1, 1, 0, yes
385648915,  haetanpeter, 1, 1, 0, yes
2340725881,  mstarnoni, 1, 1, 0, yes
798731810259816448,  VendettaVidame, 1, 1, 0, yes
317947987,  Berneyes, 1, 1, 0, yes
2373808544,  FrancescoRagane, 1, 1, 0, yes
3052476338,  alvigini45, 4, 4, 0, yes
1889541391,  rivaillen, 1, 1, 0, yes
801145688591568896,  M_Pisellonio, 1, 1, 0, yes
3392650834,  ciciripi, 1, 1, 0, yes
511797511,  caterinacittadi, 2, 2, 0, yes
1408591765,  Mazzalewicz, 1, 1, 0, yes
2306303684,  LuigiaReboa, 1, 1, 0, yes
181959714,  MassimoOddo, 1, 1, 0, yes
255225189,  carmine_marino, 1, 1, 0, yes
4762833076,  gigi_sementa, 1, 1, 0, yes
472223118,  LaurAssunta, 1, 1, 0, yes
4512296141,  blakmamba14, 2, 2, 0, yes
2277393583,  LeonardoScalfi, 1, 1, 0, yes
1686546336,  Cosima68, 1, 1, 0, yes
293401251,  marcorizzo1986, 1, 1, 0, yes
4609954173,  mangiamatte1302, 1, 1, 0, yes
722327438223663104,  MirkoCampana, 2, 2, 0, yes
1219441736,  UCanterino, 1, 1, 0, yes
2174497175,  danjafav, 1, 1, 0, yes
2962566419,  8661ec1c69544c7, 1, 1, 0, yes
2360568861,  Robfar7Farri, 2, 2, 0, yes
1065164258,  squirry, 3, 3, 0, yes
3247238885,  estlm1951, 1, 1, 0, yes
3307887622,  OrnellaIanniel1, 1, 1, 0, yes
788258205155594240,  nohanto85, 1, 1, 0, yes
1271617472,  Davdlight, 1, 1, 0, yes
274082878,  tommaso_v, 3, 3, 0, yes
8015972,  axa1981, 1, 1, 0, yes
923410116,  PeppeSimonett, 1, 1, 0, yes
1520493128,  RitaSignorelli4, 2, 2, 0, yes
2375760301,  BarbaraPand, 1, 1, 0, yes
2801683877,  isavalbranca, 2, 2, 0, yes
3187488789,  giuseppecolaci5, 1, 1, 0, yes
4517800287,  HalHalamek, 1, 1, 0, yes
742054284464918531,  Dina74938546, 1, 1, 0, yes
8226422,  ferrazza, 1, 1, 0, yes
46470688,  DinoRavasi, 1, 1, 0, yes
1628017280,  angela_samm, 1, 1, 0, yes
541166427,  paologaetano, 1, 1, 0, yes
1329407648,  conti_gio, 1, 1, 0, yes
4056328582,  sarafil29, 1, 1, 0, yes
504376617,  littleflower72, 1, 1, 0, yes
421028150,  inge_mg, 1, 1, 0, yes
412566698,  Filippo_Casini, 6, 4, 2, yes
2816446415,  RivieccioGianni, 1, 1, 0, yes
368561716,  ZotDario, 1, 1, 0, yes
37907599,  AdoroCazzo, 1, 1, 0, yes
1258831921,  ManuelaPiersimo, 4, 4, 0, yes
401648409,  lania69, 1, 1, 0, yes
985371360,  Alegalloni, 1, 1, 0, yes
597308370,  ElenaBasileIT, 3, 3, 0, yes
294231932,  SimonAlbertelli, 2, 2, 0, yes
2243165614,  GMoretti85, 2, 2, 0, yes
482492177,  raffaelegambar2, 1, 1, 0, yes
706458199457722368,  SassyKuty, 1, 1, 0, yes
2149474138,  5e5curioso1965, 1, 1, 0, yes
805664953369788416,  Flavio35813519, 1, 1, 0, yes
2878074604,  schughi87, 1, 1, 0, yes
253251657,  _Paspi_, 1, 1, 0, yes
2574291743,  paolograssi16, 1, 1, 0, yes
2942310340,  BrembatiChiara, 1, 1, 0, yes
1222387176,  BottaleMirella, 2, 1, 1, neutral
268837798,  slaytanijk, 1, 1, 0, yes
4859340755,  carlapatrignan1, 3, 2, 1, yes
2906479803,  WIGM_, 1, 1, 0, yes
464720261,  CardinaliSimone, 1, 1, 0, yes
2863212489,  carlosibila, 2, 1, 1, neutral
33942010,  xstefantinox, 1, 1, 0, yes
359450814,  FrancRaiola80, 4, 4, 0, yes
1475463739,  only_rippaah, 4, 4, 0, yes
1731287791,  lucailenia04, 3, 3, 0, yes
92978896,  TheJackSparrow, 3, 2, 1, yes
19560878,  danigamez, 1, 1, 0, yes
2202672330,  secolotrentino, 1, 1, 0, yes
483878513,  danypippi, 1, 1, 0, yes
38669647,  lbianchetti, 6, 5, 1, yes
3704995755,  CSR_Lucia, 1, 1, 0, yes
2725672037,  alesigio, 1, 1, 0, yes
535553704,  fabiolerario, 1, 1, 0, yes
481174138,  roccomessineo1, 1, 1, 0, yes
124626743,  _yoghiboy_, 1, 1, 0, yes
2762851180,  ChiaraT928, 1, 1, 0, yes
180028069,  AlessandraOurs, 2, 2, 0, yes
242461972,  Ainetag, 1, 1, 0, yes
272015261,  cielostellato66, 1, 1, 0, yes
244555888,  graphica18, 1, 1, 0, yes
2814172805,  PolitoEnrico, 9, 1, 8, no
452887985,  alexisthree, 1, 1, 0, yes
424406705,  emanuelepilato, 1, 1, 0, yes
552088748,  UgoFerruzzi, 2, 2, 0, yes
2247558914,  Strada_Nico, 2, 2, 0, yes
715895010059808768,  fede_mar, 2, 2, 0, yes
1734433760,  TonyOstu, 1, 1, 0, yes
2901394836,  FI_giovaniFvg, 4, 1, 3, no
48056231,  melanievecchio, 1, 1, 0, yes
604844463,  belliaarianna, 2, 1, 1, neutral
1222991586,  SandraSansolino, 1, 1, 0, yes
1226095586,  RussoTruss, 1, 1, 0, yes
2603533216,  Swiftrash_, 1, 1, 0, yes
55939572,  dasalvi, 2, 2, 0, yes
28523923,  stegianna, 1, 1, 0, yes
318599082,  alessandrabenci, 3, 3, 0, yes
2863873709,  matteo_zaccaria, 3, 1, 2, no
781219593285173248,  de_prades, 1, 1, 0, yes
735065246390484992,  andreag12502812, 4, 4, 0, yes
145850842,  marcoferri8, 2, 2, 0, yes
1371435558,  matteo_panella, 2, 2, 0, yes
560423967,  colombo_francy, 1, 1, 0, yes
169238582,  peppedima, 1, 1, 0, yes
436751195,  MarkAGiarrusso, 1, 1, 0, yes
774198276367220738,  CalogeroCont, 1, 1, 0, yes
756558809850580992,  AlessandroVell9, 2, 2, 0, yes
41637173,  maali5, 1, 1, 0, yes
454312090,  paolo_man, 1, 1, 0, yes
3050131617,  TodosnelMundo, 1, 1, 0, yes
2163878428,  PrendiPetrit, 1, 1, 0, yes
1442441162,  DeVivoFa, 1, 1, 0, yes
612076857,  RobertoFioreFN, 3, 3, 0, yes
164505562,  AlessandrOrlati, 2, 2, 0, yes
323750618,  lellina131, 1, 1, 0, yes
736342482552795136,  OopsTryagain12, 1, 1, 0, yes
14691891,  alexsaez, 1, 1, 0, yes
1050289063,  Silvietta_3, 1, 1, 0, yes
1303582856,  SoBeItGi, 1, 1, 0, yes
192722154,  kuripazos, 1, 1, 0, yes
726756593728114689,  Marghegigli, 2, 2, 0, yes
3070118717,  maxdiamante46, 1, 1, 0, yes
1361891508,  sono_io_70, 1, 1, 0, yes
123222116,  giovannidepalma, 1, 1, 0, yes
2335198850,  LyneAs1, 1, 1, 0, yes
242380602,  febfontana, 1, 1, 0, yes
373861127,  davide_sandoni, 1, 1, 0, yes
374486045,  FrancescoCalo82, 1, 1, 0, yes
2776121268,  light87ue, 2, 2, 0, yes
98986124,  Bernardo_Fabio, 1, 1, 0, yes
459586635,  RiccardoCurtosi, 4, 2, 2, neutral
2290250712,  elendel85, 1, 1, 0, yes
3082674579,  mattesini_david, 1, 1, 0, yes
285564951,  Vaxgelli, 5, 4, 1, yes
489869245,  72Sly, 2, 2, 0, yes
3053718856,  marteo97, 1, 1, 0, yes
1333609105,  Evan_Wambugu, 1, 1, 0, yes
714239635,  SixxiS73, 2, 2, 0, yes
804306182076829696,  webgine76, 1, 1, 0, yes
454945171,  gulayelik, 1, 1, 0, yes
433405645,  p_olivieri, 2, 1, 1, neutral
726393678,  Penny_Lane_96, 1, 1, 0, yes
331686344,  Veru_MJ, 2, 2, 0, yes
328777065,  ablardenada, 2, 1, 1, neutral
1331692908,  FabioBiocchetti, 1, 1, 0, yes
788119871657836544,  seconDChiesa, 1, 1, 0, yes
525559038,  Linamoon_l, 1, 1, 0, yes
2608163807,  AldoRatta, 1, 1, 0, yes
2727348367,  susyquatro64, 5, 3, 2, yes
438700919,  CesareLoizzo, 4, 4, 0, yes
372226511,  CarloArioli, 2, 2, 0, yes
1726024213,  freddanros, 1, 1, 0, yes
2349920076,  susannabassano, 1, 1, 0, yes
827392352,  Barbarina1893, 1, 1, 0, yes
504837067,  Gabriimp, 1, 1, 0, yes
415446181,  NelloBologna, 3, 3, 0, yes
22118960,  Nottambulo, 1, 1, 0, yes
381053228,  CloLorenzetti, 1, 1, 0, yes
1197019362,  Naturopatica1, 1, 1, 0, yes
745367882905882624,  Acinom711, 1, 1, 0, yes
971752730,  mangetsumisha, 1, 1, 0, yes
2850695375,  con20gianluca, 1, 1, 0, yes
335832794,  dnmarchi, 1, 1, 0, yes
73447161,  Katiapamp, 1, 1, 0, yes
505792878,  paloma_rsp, 1, 1, 0, yes
1275058411,  AndreaCerri36, 1, 1, 0, yes
2724358043,  leo_ragona, 1, 1, 0, yes
389673491,  ElenaVaccarella, 2, 2, 0, yes
125396798,  SpamRoss, 1, 1, 0, yes
193009291,  lavaneradi, 1, 1, 0, yes
1127612394,  vinciot82, 2, 1, 1, neutral
532380495,  PatrickPenzo, 1, 1, 0, yes
1102413804,  MPetosa92, 1, 1, 0, yes
2274458602,  nswe2001, 1, 1, 0, yes
52719361,  leireis, 1, 1, 0, yes
827604452,  coIfriss, 1, 1, 0, yes
4905761794,  OnorioFerraro, 5, 4, 1, yes
483714446,  MirkoScar80, 1, 1, 0, yes
2222056062,  AndreaNata3, 1, 1, 0, yes
565270924,  loreombra, 4, 3, 1, yes
202956127,  debenedictism, 2, 2, 0, yes
1568013704,  giuseppinapicci, 2, 2, 0, yes
165399394,  dpompignoli, 2, 2, 0, yes
2876995911,  LaRosaService1, 1, 1, 0, yes
727127896914059264,  GiovanniDotta, 1, 1, 0, yes
312037371,  javi8lourdes, 1, 1, 0, yes
437309303,  FGuarnier, 4, 1, 3, no
1145939563,  EPanchetti, 3, 3, 0, yes
22147816,  AriadnesThread_, 2, 2, 0, yes
619150517,  graziabaracchi, 2, 2, 0, yes
2482739826,  agostin21078831, 1, 1, 0, yes
48198475,  Neoantos, 1, 1, 0, yes
839428088,  TessRousseau, 1, 1, 0, yes
133305957,  carlomeroni, 1, 1, 0, yes
490523669,  94Corrado, 2, 1, 1, neutral
553634154,  palmieriangelo1, 1, 1, 0, yes
311099307,  nicolaboscar06, 2, 2, 0, yes
2974429487,  79472cbcbe6b4df, 4, 3, 1, yes
35451192,  masciagiannetti, 1, 1, 0, yes
778371426432811009,  Fabiovanacore84, 2, 2, 0, yes
4782088235,  EfeYigiTR, 1, 1, 0, yes
2594624621,  yourlovelyvoice, 1, 1, 0, yes
289351339,  Phoenix_IT, 1, 1, 0, yes
1073850764,  sim_dic, 1, 1, 0, yes
3300224823,  LS_Soave, 1, 1, 0, yes
443891296,  AngelaEsposit46, 1, 1, 0, yes
949421256,  pbriziobello, 3, 3, 0, yes
2194814713,  rdgnet, 1, 1, 0, yes
162672208,  AntonioLupia, 1, 1, 0, yes
499838140,  LuisaFGallo, 1, 1, 0, yes
3888409876,  solegomis, 1, 1, 0, yes
127817514,  ter_mine, 2, 2, 0, yes
15909019,  emataroca, 1, 1, 0, yes
2373188513,  gualandi_luca, 3, 3, 0, yes
503470886,  nereagil_, 1, 1, 0, yes
571095260,  MologniL, 1, 1, 0, yes
70218552,  Nemanja89R, 1, 1, 0, yes
2230541908,  diegoarma66, 2, 2, 0, yes
462743013,  RoccoSantoro_, 1, 1, 0, yes
373901649,  fabiofer84, 2, 1, 1, neutral
76276851,  Foxsel, 1, 1, 0, yes
252142948,  dmilan96, 1, 1, 0, yes
75035725,  alegallo_IT, 1, 1, 0, yes
630354085,  AndreeFrasheri, 2, 2, 0, yes
868010378,  vincioemme, 4, 2, 2, neutral
94015693,  new_BO777, 1, 1, 0, yes
2882719697,  bocognanir, 2, 2, 0, yes
22379109,  totestean, 1, 1, 0, yes
35790914,  condellos, 1, 1, 0, yes
3889931159,  LucaRossonero1, 1, 1, 0, yes
2308726693,  camurriusa, 4, 3, 1, yes
406367008,  GabryBieber98, 1, 1, 0, yes
443216445,  davidegrassi_, 1, 1, 0, yes
4192442327,  MarcoSanna93, 1, 1, 0, yes
805549289166487552,  brilli91, 1, 1, 0, yes
718705208654749696,  irejdoc1897, 2, 2, 0, yes
2916565786,  Davide1Official, 3, 3, 0, yes
331223843,  favste2, 1, 1, 0, yes
950469349,  gbbosco98, 2, 2, 0, yes
2355245877,  matte_bia, 1, 1, 0, yes
1442406685,  maraludovici, 3, 3, 0, yes
287067120,  rkozlowski13, 1, 1, 0, yes
52529529,  kiscian, 1, 1, 0, yes
264900493,  eroicifurori, 1, 1, 0, yes
100290102,  kevnid, 1, 1, 0, yes
436141825,  JackFida, 2, 2, 0, yes
91367070,  andrejaa87, 1, 1, 0, yes
340597784,  CFCerezales, 1, 1, 0, yes
481264111,  Lorebasse90, 1, 1, 0, yes
709504572721594368,  iannsilvia, 2, 1, 1, neutral
1305889465,  DarioPelusi84, 1, 1, 0, yes
469317745,  GiacomoFrigo, 1, 1, 0, yes
9358332,  ilbuffer, 1, 1, 0, yes
505908972,  LucasAkaTWD, 2, 2, 0, yes
2845270359,  oneraf1, 1, 1, 0, yes
277419134,  Davide_Severino, 1, 1, 0, yes
21492030,  LucianoAlvarez, 1, 1, 0, yes
4894650910,  hidalgolaura94, 1, 1, 0, yes
3326924265,  stellasassi, 3, 3, 0, yes
4351712421,  RosannaSapienz2, 1, 1, 0, yes
402944227,  nicolapisu, 1, 1, 0, yes
81835192,  angelagennaro, 2, 2, 0, yes
498132218,  fgargiulo76, 1, 1, 0, yes
546993683,  VdM_78, 1, 1, 0, yes
759489163913785344,  ClaraGnocca, 1, 1, 0, yes
435718928,  Carlovaghi71, 1, 1, 0, yes
2760677068,  ag_ghu, 2, 2, 0, yes
1465341757,  EmanueleFulco, 2, 2, 0, yes
971083940,  drewraymon, 1, 1, 0, yes
303192176,  skagoosi, 1, 1, 0, yes
525715402,  GiuliaBrio, 1, 1, 0, yes
819934578,  kikevillacorta, 2, 2, 0, yes
705521823513972736,  __waffle___, 1, 1, 0, yes
465196470,  mp_c1, 1, 1, 0, yes
159830191,  cuoredaliante, 1, 1, 0, yes
2163139580,  Padretern, 3, 2, 1, yes
621889121,  silvia_alarcon1, 1, 1, 0, yes
1142774480,  Claud1_One, 1, 1, 0, yes
400735671,  gianluigib92, 1, 1, 0, yes
3029234086,  DanyMody, 3, 3, 0, yes
2919935643,  ypsilonpi, 2, 2, 0, yes
2538053700,  ElaineG16, 1, 1, 0, yes
2957247448,  stedanieli, 1, 1, 0, yes
481468299,  DavideZagni, 2, 2, 0, yes
811625310,  AlessioSaracco, 1, 1, 0, yes
2813665753,  leowl__, 1, 1, 0, yes
523749158,  robyugos, 1, 1, 0, yes
443336950,  FedericoPelayo, 1, 1, 0, yes
439984123,  Xuthar, 2, 2, 0, yes
446647836,  GotoGaspare, 1, 1, 0, yes
251674638,  mgarciasachetti, 1, 1, 0, yes
431799411,  delionardella, 1, 1, 0, yes
15723554,  seawanderer, 1, 1, 0, yes
1196642498,  _Death_Shroud_, 4, 4, 0, yes
105222799,  Ruoss69, 1, 1, 0, yes
447423647,  Mastuzza, 2, 2, 0, yes
474864694,  Giorgione81, 1, 1, 0, yes
3003338585,  IgnacioAneiros, 1, 1, 0, yes
3436664482,  marti_cri, 1, 1, 0, yes
799619172951031808,  getmyadsteam, 1, 1, 0, yes
3774442047,  Teefoox, 1, 1, 0, yes
754674027705360384,  VerdeLuna7, 3, 3, 0, yes
277642944,  Escoleira, 1, 1, 0, yes
4714859655,  HybrisJoshua, 1, 1, 0, yes
805551220396060672,  bepppeseg96, 1, 1, 0, yes
391310549,  Giuly_LOL, 6, 5, 1, yes
2757148516,  brunogiuseppe11, 1, 1, 0, yes
3290963938,  pasqualelau, 2, 2, 0, yes
151832926,  RobertoForte81, 1, 1, 0, yes
101469657,  alessiodesiena, 4, 2, 2, neutral
790360261697925120,  akakapa70, 1, 1, 0, yes
788097047698214912,  serena_stooges, 1, 1, 0, yes
237674306,  lb93, 1, 1, 0, yes
16576326,  klrmnn, 1, 1, 0, yes
4071148942,  Enzo_Vara, 1, 1, 0, yes
437561974,  SamyBer, 2, 2, 0, yes
468272277,  Sarocrifo, 1, 1, 0, yes
435372041,  MauroMaXLO, 1, 1, 0, yes
3003561682,  andymeneg, 1, 1, 0, yes
429765708,  AngBur79, 1, 1, 0, yes
381507883,  antonellazirot1, 1, 1, 0, yes
2393365967,  RescignoSergio, 1, 1, 0, yes
778910095493259264,  endless_europe, 1, 1, 0, yes
397601369,  PierDei, 5, 2, 3, no
1425132966,  FlaviaNovelli1, 2, 2, 0, yes
224297700,  19valerosa86, 1, 1, 0, yes
2359624143,  anedda_marco, 1, 1, 0, yes
771441425934319616,  mirosky70, 1, 1, 0, yes
351703594,  arjanagrandecat, 1, 1, 0, yes
2446493174,  Agd6Nas, 1, 1, 0, yes
760620025585819648,  Peter07246724, 2, 1, 1, neutral
801938960079585280,  Petit_Venere, 4, 4, 0, yes
805523904391512069,  giulia_degan, 1, 1, 0, yes
720192180753735681,  lightcreative_, 2, 2, 0, yes
4383590596,  nicodebartolo, 1, 1, 0, yes
320998801,  rajasanda31, 3, 3, 0, yes
2231736969,  ItsMoiseee, 1, 1, 0, yes
409559913,  JumboPaola, 1, 1, 0, yes
1165958852,  mirellamartin13, 3, 3, 0, yes
1556397048,  copapalmieri, 1, 1, 0, yes
3104110990,  edspow, 1, 1, 0, yes
2541875110,  BrunoRossobr1, 1, 1, 0, yes
447454911,  rosacaccavale1, 1, 1, 0, yes
429402556,  javierHazan, 1, 1, 0, yes
1391936778,  nguercio46, 1, 1, 0, yes
459177856,  enzomatto1976, 1, 1, 0, yes
238537485,  OnirAnelli, 1, 1, 0, yes
2484583737,  CatamartMc, 3, 3, 0, yes
266635887,  anna01061976, 1, 1, 0, yes
506178827,  angelocapuana, 1, 1, 0, yes
405340380,  FelicePica, 1, 1, 0, yes
769210336968904704,  marioro99488259, 1, 1, 0, yes
295942386,  TheRealGiannino, 2, 2, 0, yes
352464479,  MatteoLaruffa, 3, 3, 0, yes
360792694,  FRAPELLICANO3, 1, 1, 0, yes
286294555,  robmurray11, 1, 1, 0, yes
227196659,  anjai02, 1, 1, 0, yes
1630455818,  _odisseus, 2, 2, 0, yes
457743921,  ferraramrosaria, 1, 1, 0, yes
140222976,  connellyandrew, 1, 1, 0, yes
2365697120,  canzio08, 3, 3, 0, yes
778889178276847617,  malite56, 2, 2, 0, yes
557244467,  marcopepe95, 1, 1, 0, yes
611585332,  Bonn1eGreer, 1, 1, 0, yes
157408316,  marlaila, 1, 1, 0, yes
1040571721,  rudisubbuteo, 1, 1, 0, yes
413372546,  anchelamosca, 2, 1, 1, neutral
47981515,  Guidogiorgio, 1, 1, 0, yes
1063174573,  Youeconomy, 1, 1, 0, yes
1543965572,  vittoinox, 3, 3, 0, yes
1693346198,  Alfman17, 1, 1, 0, yes
244085448,  Pask9311, 1, 1, 0, yes
16286115,  paula_rotaru, 1, 1, 0, yes
17452196,  Sundip, 1, 1, 0, yes
66006068,  Anto_Gele, 5, 4, 1, yes
106817362,  AlePasquinucci, 6, 3, 3, neutral
3153633274,  af0c195ea28d4d8, 1, 1, 0, yes
2609766510,  Mirkov80, 3, 2, 1, yes
804195751,  MartinaCignoli, 2, 2, 0, yes
194186140,  robertabombelli, 1, 1, 0, yes
1641062670,  TheProtestBoard, 1, 1, 0, yes
306426339,  Omannaya, 1, 1, 0, yes
805550618475634688,  barbaraleone777, 1, 1, 0, yes
700900146,  fleurdumal74, 1, 1, 0, yes
2953880392,  muscasc61, 1, 1, 0, yes
721959078,  egonzalez314, 1, 1, 0, yes
270970665,  flightdeck1140, 1, 1, 0, yes
391896348,  supermaxtwentyt, 2, 2, 0, yes
785509346,  logansltd, 1, 1, 0, yes
2982387466,  myancorniall, 4, 4, 0, yes
444160541,  DeSantanto, 2, 2, 0, yes
315974726,  AChiatti, 1, 1, 0, yes
54242236,  Marivir, 1, 1, 0, yes
453822989,  nataledamico, 1, 1, 0, yes
494287037,  cristinatdd, 3, 2, 1, yes
946810658,  ClaudioCasadei2, 3, 3, 0, yes
2986203719,  RitaRitapaolad, 1, 1, 0, yes
328778670,  GaetanoSalvo1, 1, 1, 0, yes
1066465742,  valponti77, 2, 2, 0, yes
2993386048,  talktojodi, 1, 1, 0, yes
2613522973,  Silvana651, 2, 2, 0, yes
25376111,  noelkucich, 1, 1, 0, yes
793095709495062528,  news24hsu24, 2, 2, 0, yes
394938407,  neymar933, 1, 1, 0, yes
223899265,  EugCipolla, 2, 2, 0, yes
2809023844,  2phoenicians, 1, 1, 0, yes
3325032107,  partenopeo1973, 2, 2, 0, yes
43851953,  pengenton, 1, 1, 0, yes
339882890,  Suffragio, 1, 1, 0, yes
199444195,  NikolayArnaudov, 1, 1, 0, yes
109657350,  katuketi, 2, 1, 1, neutral
492580283,  GiuseppePiazza9, 6, 1, 5, no
952604887,  martamdom, 1, 1, 0, yes
1614610327,  bozenagawal, 1, 1, 0, yes
1686836852,  ButsuSarracino, 2, 2, 0, yes
3172173897,  SimoneEmc2, 1, 1, 0, yes
37897811,  dzchristofer, 1, 1, 0, yes
423523075,  margotten78, 2, 2, 0, yes
1722434732,  daisy_ciop, 1, 1, 0, yes
47904134,  davidmarchese, 1, 1, 0, yes
340914071,  92marwann, 2, 2, 0, yes
605721060,  leonardoaudino, 1, 1, 0, yes
2187473325,  giosole13, 1, 1, 0, yes
262724358,  shiku101, 1, 1, 0, yes
63685718,  Agustin_Martin, 1, 1, 0, yes
569821321,  Agesileao, 1, 1, 0, yes
4397597477,  davidebonzio, 2, 1, 1, neutral
4365297623,  pierolubiani1, 3, 3, 0, yes
29229053,  bolvi, 1, 1, 0, yes
3305437325,  boems8884, 1, 1, 0, yes
2249430114,  vecchie_maniere, 1, 1, 0, yes
3593537897,  melmarabetixo, 1, 1, 0, yes
108670521,  PaolaNat, 1, 1, 0, yes
96126664,  SuzMichela, 1, 1, 0, yes
1255248433,  IlGustoDiRidere, 1, 1, 0, yes
4248766065,  albadebern, 1, 1, 0, yes
4898355431,  Teodorinarci, 3, 2, 1, yes
1664682282,  ra_lori, 1, 1, 0, yes
769857784393375745,  Lumi28521385, 1, 1, 0, yes
445838803,  VITTI1897, 1, 1, 0, yes
470121895,  MarcoPoletti81, 1, 1, 0, yes
3618226335,  ManueleCelano, 1, 1, 0, yes
4577660553,  pccardTT, 1, 1, 0, yes
421911547,  VTaurisani, 1, 1, 0, yes
1186473829,  EnzoplrEnzo, 1, 1, 0, yes
201732490,  cioppol, 1, 1, 0, yes
256936864,  Annav49, 1, 1, 0, yes
785450965390467074,  radule_ludi, 1, 1, 0, yes
2720607815,  251730Alemika, 1, 1, 0, yes
906762372,  AMaravigli, 2, 2, 0, yes
401252318,  giuseppeconti3, 1, 1, 0, yes
3414568475,  brevi_news, 1, 1, 0, yes
502000933,  Gabriel17246092, 2, 2, 0, yes
744130567621517312,  OusmaneBara4, 1, 1, 0, yes
805710378768461825,  RRRossi1, 1, 1, 0, yes
3041706941,  moscarello_pina, 1, 1, 0, yes
2323593059,  aduabiagioli, 2, 2, 0, yes
252606816,  laframineo, 1, 1, 0, yes
109970315,  Ema_Sabatino, 1, 1, 0, yes
1103820174,  Alexmogavero82, 2, 2, 0, yes
849747361,  MESuccetti, 1, 1, 0, yes
1883320610,  alaimosalvo, 1, 1, 0, yes
784297014,  domenicofusco94, 1, 1, 0, yes
2482706624,  FrancescoRidi1, 1, 1, 0, yes
28780525,  LaCarrarini, 4, 4, 0, yes
2404129330,  marcodeblasi3, 1, 1, 0, yes
4137440049,  xbesideselena, 1, 1, 0, yes
2762417410,  PolizziArmando, 1, 1, 0, yes
379354501,  talamay, 1, 1, 0, yes
2182502256,  fasulo_antonio, 9, 3, 6, no
287624163,  VediCara, 1, 1, 0, yes
65384380,  CarmelaRios, 1, 1, 0, yes
2651188471,  EvaKant2248, 3, 3, 0, yes
286738383,  agronslips, 5, 4, 1, yes
514881953,  StefanoFerretts, 1, 1, 0, yes
635490690,  Cla_Car, 6, 2, 4, no
199201127,  TyarCiangola, 1, 1, 0, yes
3493788261,  Giovann91745928, 1, 1, 0, yes
40655821,  jcloleary, 1, 1, 0, yes
68014404,  AdeDragotta, 4, 4, 0, yes
417071371,  AleBito86, 1, 1, 0, yes
3547216575,  sofiatwisty, 2, 2, 0, yes
749369737080176640,  MassimilianoF75, 18, 6, 12, no
251337714,  Korokoro_Pollon, 1, 1, 0, yes
1036579602,  EnzoGasparrelli, 1, 1, 0, yes
397185422,  46Valex, 1, 1, 0, yes
4008029355,  geofpyatt, 1, 1, 0, yes
991511000,  Peca1994, 2, 2, 0, yes
2154040684,  pietro_didio, 3, 1, 2, no
479008440,  GorettiGianluca, 1, 1, 0, yes
323185910,  GiAdUzZoLa90, 2, 2, 0, yes
3244053461,  LivioBaz, 3, 2, 1, yes
2727641338,  0dc18b3215db45c, 1, 1, 0, yes
1250020285,  GfveGianfra, 4, 2, 2, neutral
3459171815,  china09464968, 2, 2, 0, yes
2402816795,  ItKekk, 2, 2, 0, yes
2882697507,  arciteo, 1, 1, 0, yes
428486609,  FabrizioBonetto, 1, 1, 0, yes
349536978,  EmanueleGambuzz, 1, 1, 0, yes
2230287932,  GGal_Mattt, 3, 2, 1, yes
634408874,  PDesantis5, 2, 2, 0, yes
19930236,  nutri_lad, 1, 1, 0, yes
117058883,  JustLemonsong, 1, 1, 0, yes
2737916605,  journalistmgv, 1, 1, 0, yes
2582610247,  Superfly_Video, 1, 1, 0, yes
3243086151,  CosimoMalpede, 1, 1, 0, yes
4122615069,  Elena54714240, 4, 4, 0, yes
1374752149,  annatrezzano, 2, 2, 0, yes
635507004,  19Paolo47, 1, 1, 0, yes
770237165284491265,  jo_bessone, 1, 1, 0, yes
2894677677,  RobertaSalento, 2, 2, 0, yes
344641675,  RosalindaMiglio, 3, 3, 0, yes
475821617,  Edoardo_Iorio, 1, 1, 0, yes
628491531,  stefanosperiani, 1, 1, 0, yes
51393096,  Daxest, 4, 2, 2, neutral
596682292,  mpedro07, 1, 1, 0, yes
989635268,  RagnarWeilandt, 1, 1, 0, yes
3092614427,  KatKatrinaNeves, 1, 1, 0, yes
137387355,  yeahsmokepot, 1, 1, 0, yes
207674579,  sadiocaracas, 1, 1, 0, yes
636307984,  FraGalli8, 1, 1, 0, yes
49396947,  superdrumm, 4, 4, 0, yes
367838720,  PaoloFusco2, 1, 1, 0, yes
1173090662,  FrancescoNepa, 1, 1, 0, yes
221854363,  jmchen88, 1, 1, 0, yes
3241784075,  suraroby, 1, 1, 0, yes
169568486,  Danielino28, 1, 1, 0, yes
745335380447203328,  Crazyas86623997, 2, 2, 0, yes
170874240,  alephill74, 1, 1, 0, yes
1064168010,  ConigeCP, 1, 1, 0, yes
116003920,  sdammy, 1, 1, 0, yes
123829403,  svenicej, 1, 1, 0, yes
171081802,  MarcelloSoragni, 2, 2, 0, yes
776858225350152192,  Chiaraversa, 1, 1, 0, yes
2881766657,  AlePetrucci_, 1, 1, 0, yes
712038610363670529,  andresavo95, 1, 1, 0, yes
442768176,  AndreaGaraffa1, 1, 1, 0, yes
36819984,  pupofabio, 1, 1, 0, yes
3495215663,  roby2177, 3, 3, 0, yes
769848270478802944,  MontiLorenza, 3, 3, 0, yes
1876847533,  PadreOLugo, 1, 1, 0, yes
368953794,  gartigasp, 1, 1, 0, yes
461096515,  regina_rossini, 2, 2, 0, yes
970657538,  Cd36Roberto, 1, 1, 0, yes
30011100,  yarotrof, 1, 1, 0, yes
3264510455,  GattiRomeo, 7, 7, 0, yes
779424974880772096,  antonio_cannino, 1, 1, 0, yes
2901558661,  torre_giulio, 2, 1, 1, neutral
453931362,  PaoloNurra, 1, 1, 0, yes
168273926,  davidedm_91, 2, 1, 1, neutral
805501812375687169,  an75874088, 1, 1, 0, yes
255667704,  amantomatimou, 1, 1, 0, yes
3070646573,  antoniosenneca, 2, 2, 0, yes
96614148,  michelottina, 5, 4, 1, yes
787927354588946432,  Gabriel98492832, 3, 3, 0, yes
51314216,  emilynun, 1, 1, 0, yes
8252912,  Iguano, 4, 4, 0, yes
524884014,  GaldiNicola, 1, 1, 0, yes
800035244950900736,  Stefani13079878, 1, 1, 0, yes
444068106,  gragra2368, 2, 2, 0, yes
295918388,  gago_mario, 1, 1, 0, yes
423304991,  sacri26, 4, 4, 0, yes
343288175,  Hyndrax, 1, 1, 0, yes
969728082,  OnZeLeft, 1, 1, 0, yes
515537312,  MatteoSportelli, 1, 1, 0, yes
2180073286,  embecerto, 10, 3, 7, no
367597661,  albertomoramarc, 1, 1, 0, yes
35541410,  _minderaser_, 1, 1, 0, yes
364991831,  IdaDiGrazia, 1, 1, 0, yes
804650913759690752,  frances46475884, 2, 2, 0, yes
790304982004277254,  AmeliMiele, 1, 1, 0, yes
242611604,  NicoZoso, 1, 1, 0, yes
207315546,  cecicamba, 1, 1, 0, yes
1130202086,  RobertoSambuco, 1, 1, 0, yes
303172080,  VinsMarques, 5, 2, 3, no
744602879080693764,  carmineital, 2, 2, 0, yes
461332960,  LorenzoRagonesi, 1, 1, 0, yes
4216626711,  fernandoincitti, 2, 2, 0, yes
1204066471,  CerasoliLuca, 1, 1, 0, yes
332951041,  bluraissa, 2, 2, 0, yes
784522182919618561,  mtbilla18, 2, 2, 0, yes
240651648,  ocraMDo, 1, 1, 0, yes
144996486,  GogetaSsj87, 1, 1, 0, yes
2857687949,  BurgioAntonella, 5, 5, 0, yes
2270043874,  A_C_Pacilli, 2, 2, 0, yes
228843710,  CiroPrince7, 1, 1, 0, yes
38183286,  caterinabiti, 1, 1, 0, yes
3020258541,  CarmelaRossi4, 1, 1, 0, yes
3070356232,  toniorizzo1, 1, 1, 0, yes
452085394,  OpunziaEspinosa, 1, 1, 0, yes
748855075485999105,  PGubiangubiani, 2, 1, 1, neutral
360618573,  Benjwestwood, 1, 1, 0, yes
768524456646086656,  romyfemia, 1, 1, 0, yes
1897485804,  annabonvicini12, 1, 1, 0, yes
272008185,  GILLESDELERIS, 1, 1, 0, yes
470091459,  Ale_Arcara, 1, 1, 0, yes
547260202,  GriffinLahre, 1, 1, 0, yes
1015932840,  gmacciocu, 1, 1, 0, yes
260681740,  CharlesBronzy4u, 2, 1, 1, neutral
1905411920,  AgostiniMea, 1, 1, 0, yes
256082093,  davidearpa, 1, 1, 0, yes
424905555,  AntoBonolis, 4, 4, 0, yes
565306828,  WolfLorenz, 1, 1, 0, yes
115095483,  inesgcaballo, 1, 1, 0, yes
801918950,  RiccardoGangale, 1, 1, 0, yes
124797094,  mancini_282, 1, 1, 0, yes
367232658,  hemslark, 2, 2, 0, yes
1432474196,  Ant_Karaxalios, 1, 1, 0, yes
356667067,  Fabry_85, 1, 1, 0, yes
3051451097,  Dani95pa, 1, 1, 0, yes
402754730,  franza79, 1, 1, 0, yes
1653290557,  vincesalmeri, 1, 1, 0, yes
1684063170,  DarioMenghini, 1, 1, 0, yes
712948986223730689,  d8efe3b5e0194f2, 16, 10, 6, yes
264199189,  irenerussopiano, 1, 1, 0, yes
3111928911,  V279Nic, 1, 1, 0, yes
417137870,  Coppen2Enrico, 1, 1, 0, yes
2743394769,  robijuancarlos, 1, 1, 0, yes
783090147583782912,  lenaechicca, 1, 1, 0, yes
3381762699,  rump_sven, 1, 1, 0, yes
1534970456,  katerina_kokka, 1, 1, 0, yes
2384097810,  fiorenicolabari, 1, 1, 0, yes
4074728769,  RolandoWLF, 2, 2, 0, yes
379686861,  MarioChiavola, 1, 1, 0, yes
334921185,  1989Bert, 1, 1, 0, yes
329894545,  EmanueleCerqua, 1, 1, 0, yes
765273049516089344,  bulmafree, 1, 1, 0, yes
757361610222624768,  Massimo105431, 6, 2, 4, no
209632990,  matidima, 1, 1, 0, yes
727188574639153152,  nihalcioncoloni, 2, 2, 0, yes
1317314684,  MikeleS9, 1, 1, 0, yes
1724823667,  kainzrognerud, 1, 1, 0, yes
385551667,  HafedhBalhag, 1, 1, 0, yes
248400223,  MarcoDagna, 1, 1, 0, yes
523370083,  cristianagamba, 1, 1, 0, yes
69608788,  tomawoke72, 3, 3, 0, yes
82560721,  LadisIndoItalia, 1, 1, 0, yes
3438529882,  avvmacellaro, 4, 2, 2, neutral
440911380,  ivoavido20, 1, 1, 0, yes
817183783,  CassandroEnrico, 1, 1, 0, yes
714424673,  alessandracellu, 1, 1, 0, yes
626549912,  hereiskev, 1, 1, 0, yes
2494373125,  anarcomico, 4, 4, 0, yes
2330256328,  cristinaultras, 2, 2, 0, yes
3554364023,  kris_chadi, 1, 1, 0, yes
485795874,  Enrico_Toschi, 2, 2, 0, yes
541882699,  Andst7, 1, 1, 0, yes
2474072946,  fulvia69265588, 1, 1, 0, yes
724310822,  makisstasinos, 1, 1, 0, yes
144501610,  LeleSuperstar, 1, 1, 0, yes
1259376295,  Annaf66Ferrero, 1, 1, 0, yes
4768179358,  MonacoMico, 2, 2, 0, yes
54600782,  carlayo, 4, 2, 2, neutral
29188599,  VeniceLaura, 1, 1, 0, yes
2247181336,  DmcLibero, 2, 2, 0, yes
949425925,  IamBerry29, 9, 2, 7, no
1656196699,  AndreMensi, 1, 1, 0, yes
163988077,  bratislagirl, 1, 1, 0, yes
634740757,  ColonelEmi, 1, 1, 0, yes
325043884,  fedevenni, 3, 2, 1, yes
229659619,  GiammyMcMario_, 2, 1, 1, neutral
708028408949768195,  luigi_forte00, 1, 1, 0, yes
499080223,  MattiaMir, 1, 1, 0, yes
397403788,  MemueroporPeter, 1, 1, 0, yes
584087349,  dicovanvliet, 1, 1, 0, yes
120427808,  Carmine1960, 4, 4, 0, yes
439622452,  Myla731, 5, 1, 4, no
457508940,  ALetkiewicz, 1, 1, 0, yes
2897879980,  cavanna_giacomo, 1, 1, 0, yes
51033515,  a_cegna, 3, 3, 0, yes
193008680,  C_Pugliese1996, 1, 1, 0, yes
752108230160023552,  passerimarcofi, 3, 3, 0, yes
149374739,  maisels, 1, 1, 0, yes
925408752,  LasarteJavier, 1, 1, 0, yes
714054026724253696,  MatleyfaQualcos, 2, 2, 0, yes
510410157,  Afrau91, 1, 1, 0, yes
911965489,  alexpicconatore, 2, 2, 0, yes
720704772,  DD65724315, 1, 1, 0, yes
453382162,  ombra2282, 3, 3, 0, yes
525647632,  VDidencu, 2, 2, 0, yes
370416519,  AF_1994, 3, 2, 1, yes
1245841746,  AlessiaLautone, 1, 1, 0, yes
2767704125,  francoservodid1, 1, 1, 0, yes
92133758,  OncleMilton, 1, 1, 0, yes
121460228,  piccolacri76, 2, 2, 0, yes
784028706247442436,  erfanaskar, 1, 1, 0, yes
2343639954,  LiberoPens, 8, 2, 6, no
1858525380,  EglantineNyssen, 1, 1, 0, yes
93647760,  DanLens, 1, 1, 0, yes
191023343,  leonardzilla, 1, 1, 0, yes
38415663,  Zetakon, 1, 1, 0, yes
3432072459,  andy_mart_, 1, 1, 0, yes
396883113,  Zmaj64, 1, 1, 0, yes
1215785438,  rainoce76, 1, 1, 0, yes
716977007523930119,  egemylanmatteo, 1, 1, 0, yes
2969608983,  leomodonnet, 1, 1, 0, yes
4287274457,  gigicarta68, 1, 1, 0, yes
2725835234,  Piero_De_Luca, 1, 1, 0, yes
25522485,  abarandun, 1, 1, 0, yes
455283451,  VIRGINIOCESCON, 1, 1, 0, yes
3170325538,  infoscensura, 3, 1, 2, no
206605239,  JulioTejedorB, 1, 1, 0, yes
872383772,  yarifor_se, 3, 3, 0, yes
1548322466,  aleditommy, 1, 1, 0, yes
1242238854,  pirriconswag, 1, 1, 0, yes
2344219808,  toniodipace, 1, 1, 0, yes
2480721025,  TwKia, 3, 2, 1, yes
715038742,  lisabeppi, 1, 1, 0, yes
771339159353057285,  giacomopinna3, 1, 1, 0, yes
749701057,  BittABC, 1, 1, 0, yes
529307081,  natasa_jokic, 1, 1, 0, yes
833441077,  RhesusNegatif, 1, 1, 0, yes
2895259742,  CarlosAburtoC, 1, 1, 0, yes
516507672,  kyozer0, 3, 3, 0, yes
3058354738,  massimoalbore, 4, 2, 2, neutral
42644445,  _nyc_trades, 1, 1, 0, yes
420408213,  Paola_Gennaro, 1, 1, 0, yes
2350766887,  pappeox, 5, 4, 1, yes
920591754,  FioralbaF, 3, 3, 0, yes
2496192462,  FranceschiniAA, 1, 1, 0, yes
780445281351524352,  Raysa29682895, 2, 2, 0, yes
3055890411,  ballabee57, 2, 2, 0, yes
161859449,  GioiaGhezzi, 1, 1, 0, yes
4824583720,  nik_skevofylax, 2, 2, 0, yes
3705553635,  MartinaMarti95, 1, 1, 0, yes
2558721480,  aerdnAittennaiG, 1, 1, 0, yes
554443560,  AndreDeMedici, 1, 1, 0, yes
105283010,  bernardeschi, 2, 2, 0, yes
264479566,  emefeuve, 1, 1, 0, yes
2525321257,  Ebetix, 1, 1, 0, yes
502908681,  marthasydenham, 1, 1, 0, yes
341552326,  templare66, 1, 1, 0, yes
17549414,  juancarreno, 1, 1, 0, yes
128554994,  Paio83, 1, 1, 0, yes
796376814012825601,  flamandreas, 1, 1, 0, yes
772025330617966592,  MarcoG05827630, 1, 1, 0, yes
1410312216,  Alessio_Cass, 1, 1, 0, yes
2740167057,  volpe56, 2, 2, 0, yes
44900096,  PattyTesauro, 2, 2, 0, yes
4405270528,  interno3beer, 2, 2, 0, yes
350795096,  CarloAngrisano, 1, 1, 0, yes
221472860,  Chrisbad87, 1, 1, 0, yes
246525616,  mikyanna089, 2, 2, 0, yes
157663655,  poisS182, 1, 1, 0, yes
181224913,  theradiolover, 1, 1, 0, yes
473275820,  PietroRubertone, 1, 1, 0, yes
2866489733,  thedronequeen, 1, 1, 0, yes
326679309,  fabiolagranier, 3, 3, 0, yes
2418970080,  yannbisiou, 1, 1, 0, yes
3635615296,  RobertoFerret10, 1, 1, 0, yes
3251405422,  ferrara_cinzia, 1, 1, 0, yes
2861248095,  baba_menghini, 1, 1, 0, yes
1622965465,  irefly77, 2, 1, 1, neutral
3978576677,  xharryhug_, 2, 2, 0, yes
1694143957,  idnbh, 3, 1, 2, no
4174266335,  lidiadegiglina, 2, 2, 0, yes
406462894,  AprileVittorio, 1, 1, 0, yes
25788082,  Angelo1997, 5, 2, 3, no
2413172561,  Antonel34340103, 1, 1, 0, yes
14488923,  yannigg, 1, 1, 0, yes
2151535697,  NetPoz, 2, 2, 0, yes
767383186993254400,  mariano81ita, 2, 2, 0, yes
19455967,  kateandclaudius, 1, 1, 0, yes
3000792817,  vimonf82, 3, 3, 0, yes
581858737,  paulin_spa, 5, 4, 1, yes
232191167,  seraphine2011, 1, 1, 0, yes
452845621,  Mayouuuuuuu, 1, 1, 0, yes
542903719,  Giulia_Barca_fe, 1, 1, 0, yes
4538104696,  MAUROPAOL, 1, 1, 0, yes
1142170956,  NanniScavo, 1, 1, 0, yes
716674840539881472,  BaruchSpinoza80, 1, 1, 0, yes
1062812520,  ParasEnrico, 1, 1, 0, yes
467901984,  Davideballerino, 1, 1, 0, yes
375202376,  GestionemosLA, 2, 2, 0, yes
96292882,  27west, 1, 1, 0, yes
557292057,  GBonConti, 4, 4, 0, yes
3288316067,  agodibari, 1, 1, 0, yes
48461963,  epiclove_, 5, 2, 3, no
406944831,  Ermi_Fr, 1, 1, 0, yes
90476932,  MariaPLaya, 1, 1, 0, yes
2336248313,  ppe60, 1, 1, 0, yes
448762990,  tancredinazario, 2, 2, 0, yes
804706258578194433,  bestbikesardin1, 1, 1, 0, yes
2218356125,  SerisSerena, 2, 2, 0, yes
170276347,  robertoyantari, 1, 1, 0, yes
397270457,  arena_marco, 1, 1, 0, yes
707113868754096128,  WWENewsIT, 1, 1, 0, yes
34896699,  JoseGAlcazar, 1, 1, 0, yes
1389635384,  AngeloZingale, 1, 1, 0, yes
2917649163,  sarafab87, 1, 1, 0, yes
1139589385,  Momo87Zar, 1, 1, 0, yes
3358681043,  NatzeSupernatrl, 1, 1, 0, yes
2458599733,  PononoUomo, 1, 1, 0, yes
204254603,  comunicattivo, 1, 1, 0, yes
887475566,  ClemenoBruno, 1, 1, 0, yes
402052627,  teddyr73, 1, 1, 0, yes
2811309575,  neymarco98, 3, 3, 0, yes
1339879026,  giucarg, 2, 2, 0, yes
890880662,  alexia_mail, 1, 1, 0, yes
706506401330372608,  spindoctorsbe, 3, 3, 0, yes
1293820314,  robymyrteza, 2, 2, 0, yes
29452472,  vassiouti, 1, 1, 0, yes
787298520046927874,  xincox2, 1, 1, 0, yes
480498834,  salvo_ruta, 2, 2, 0, yes
1405915656,  lorypari, 1, 1, 0, yes
481266808,  ClaudiaDelVecc1, 1, 1, 0, yes
735627229619736576,  porcodivo1, 4, 4, 0, yes
760097368859705344,  RELIGIONS2DUPES, 3, 2, 1, yes
214604553,  skirchy, 1, 1, 0, yes
19772429,  DrApocalypse, 1, 1, 0, yes
59416453,  markheart80, 3, 1, 2, no
2984310675,  mv_verona, 1, 1, 0, yes
136333649,  gonlomo, 1, 1, 0, yes
32432130,  tzcastillo, 1, 1, 0, yes
104542314,  synoguer, 1, 1, 0, yes
1498892858,  Thomas_99_, 1, 1, 0, yes
3033156627,  alexfred65, 1, 1, 0, yes
2871911706,  kimiraiko62, 2, 2, 0, yes
1599301920,  Dani_De_Be, 1, 1, 0, yes
266249609,  piero_fr, 7, 5, 2, yes
221777674,  ja_lujan, 1, 1, 0, yes
3586601835,  RivielloFN, 2, 1, 1, neutral
428657205,  AImmediato, 1, 1, 0, yes
2211030362,  Eugenio_Dragoni, 1, 1, 0, yes
4794071,  Mehdi_Tra, 1, 1, 0, yes
239949783,  YuriMaker, 2, 2, 0, yes
83565816,  gabrielegigli, 1, 1, 0, yes
214200271,  AnnanasAllen, 1, 1, 0, yes
4228643473,  MassyBacca79, 1, 1, 0, yes
1327034432,  NMGI2, 1, 1, 0, yes
261814634,  ariannafuzio, 1, 1, 0, yes
421138611,  claudiacamastro, 1, 1, 0, yes
2459304163,  garrus12, 1, 1, 0, yes
912154068,  MathildeSagaire, 1, 1, 0, yes
293474091,  CKotanko, 1, 1, 0, yes
427341335,  MarianoWeltgeis, 1, 1, 0, yes
550088517,  libringioco, 2, 2, 0, yes
205198685,  marmylady, 1, 1, 0, yes
389768787,  ukipwebmaster, 4, 1, 3, no
794089087082893312,  robertopau83, 2, 2, 0, yes
27948514,  sara___bi, 1, 1, 0, yes
782677592159641600,  inesplaricart, 1, 1, 0, yes
68684787,  Goosebyron, 1, 1, 0, yes
703018443,  tommymiana, 1, 1, 0, yes
2539754609,  alessiocorsini1, 2, 2, 0, yes
767954635,  berno96, 1, 1, 0, yes
74458003,  NellyOranje, 1, 1, 0, yes
754041202501124096,  danieli_leo, 1, 1, 0, yes
1407691932,  cartocopyservic, 1, 1, 0, yes
14834281,  MakeMKTG, 1, 1, 0, yes
406244237,  DaniaR812, 1, 1, 0, yes
95119630,  estrellacometa, 4, 3, 1, yes
1317347384,  JoseLuisHS_, 1, 1, 0, yes
256738811,  paslico, 1, 1, 0, yes
2871900780,  Mat_TeoManna, 1, 1, 0, yes
1036605871,  paulciax, 2, 2, 0, yes
126567475,  darienlevani, 1, 1, 0, yes
1278931370,  edoardorocc, 1, 1, 0, yes
1089968412,  FedeRossi1991, 1, 1, 0, yes
474734009,  severinoanna, 1, 1, 0, yes
48435472,  destefanix, 1, 1, 0, yes
181259074,  silvia_grazioli, 1, 1, 0, yes
993578214,  MatteoRamelli, 1, 1, 0, yes
3050120599,  8fbd8ecdd429439, 1, 1, 0, yes
246524534,  tamistars, 1, 1, 0, yes
194626440,  violaric, 1, 1, 0, yes
915597902,  SALVOFIN, 1, 1, 0, yes
1082367421,  CVincenz, 1, 1, 0, yes
474076624,  Dani84N, 1, 1, 0, yes
328715454,  AlexiusAsr, 11, 2, 9, no
85877613,  alenatale, 1, 1, 0, yes
1933788787,  dalmasso_simone, 1, 1, 0, yes
415519285,  thepaci, 1, 1, 0, yes
2772346300,  CCoscos, 1, 1, 0, yes
80514727,  giolist, 1, 1, 0, yes
3348910421,  LauraEilVolo, 1, 1, 0, yes
1352534808,  GComincini, 1, 1, 0, yes
479806516,  barbaracafferat, 1, 1, 0, yes
471471979,  massiminik, 1, 1, 0, yes
78085739,  renesari, 1, 1, 0, yes
194514278,  annalisapro, 1, 1, 0, yes
476784892,  rubyc94, 1, 1, 0, yes
3014410691,  bucciconi, 1, 1, 0, yes
306925261,  caroline_madrid, 2, 2, 0, yes
805549455936208896,  tatareddu27, 1, 1, 0, yes
1020866462,  VivianaSanvito, 4, 3, 1, yes
2252338855,  BA47766932, 1, 1, 0, yes
2797738390,  CatalaniCivitaC, 1, 1, 0, yes
504295812,  maurizio_forte, 1, 1, 0, yes
591911848,  Den93R, 1, 1, 0, yes
2474866188,  Sirency, 1, 1, 0, yes
2155591379,  FranzFronsac, 1, 1, 0, yes
2992086947,  chihorin007, 1, 1, 0, yes
476031469,  MarrasStefano, 2, 2, 0, yes
315113818,  RicardoRetamalO, 1, 1, 0, yes
157559613,  8fede7, 1, 1, 0, yes
51171890,  _fruxo_, 1, 1, 0, yes
754275980538150912,  Valentina_t93, 1, 1, 0, yes
260316106,  AlexAlt31, 1, 1, 0, yes
582625937,  SoniaCampagnani, 1, 1, 0, yes
394247123,  VermeylenS, 1, 1, 0, yes
430201335,  nidraNocirnE, 1, 1, 0, yes
2376041347,  gabrielioan100, 1, 1, 0, yes
1701969248,  Angelmartgar, 1, 1, 0, yes
1462795766,  MB__Cicero, 1, 1, 0, yes
805549988864557056,  fravitto96, 1, 1, 0, yes
1181256696,  ashes38034160, 1, 1, 0, yes
2898349810,  franca47zedda, 1, 1, 0, yes
805550156091445248,  Valemattei83, 1, 1, 0, yes
830895108,  AlfyDP, 1, 1, 0, yes
2494294426,  Mirianikekiki, 2, 1, 1, neutral
2535846747,  _95dima, 1, 1, 0, yes
708209089273266176,  fabioti87, 3, 3, 0, yes
68961429,  davideguariento, 1, 1, 0, yes
201680143,  Benjamin5Reilly, 11, 2, 9, no
144601535,  FRAYCELSO, 1, 1, 0, yes
463644675,  pioggia_sereno, 1, 1, 0, yes
1259664565,  begafab, 3, 3, 0, yes
3374631371,  AlexiaSarris4, 1, 1, 0, yes
397534931,  LeoBianchi91, 1, 1, 0, yes
3595989797,  Noddie091, 1, 1, 0, yes
802268538253746176,  Greya84, 1, 1, 0, yes
563549787,  gorinotsukudani, 1, 1, 0, yes
790258583405494272,  Titta_2016, 1, 1, 0, yes
732208228600295424,  Dissident1379, 1, 1, 0, yes
3299057343,  DinoSab1, 2, 2, 0, yes
1087726656,  ashavit23film, 1, 1, 0, yes
988335655,  GMasseria, 1, 1, 0, yes
703663384437325824,  DanielePampalo1, 1, 1, 0, yes
338642240,  eduribbas, 1, 1, 0, yes
8308222,  anshelsag, 1, 1, 0, yes
415127523,  SchepisTony, 1, 1, 0, yes
442815439,  masinatti, 1, 1, 0, yes
1077850658,  PrivateCapBlog, 1, 1, 0, yes
127025272,  anemoneblu, 1, 1, 0, yes
284742079,  RobertHBlazquez, 1, 1, 0, yes
2528428111,  lucioarguello00, 1, 1, 0, yes
576973641,  RenatoAlbergo, 1, 1, 0, yes
3044031919,  cesare270973, 1, 1, 0, yes
54040754,  cap_ovbio, 1, 1, 0, yes
4851259343,  peppeg05, 2, 2, 0, yes
2557442732,  Carmine433, 1, 1, 0, yes
43248814,  lamblock, 1, 1, 0, yes
760208791,  zephiro1, 2, 1, 1, neutral
466409637,  MTavola, 1, 1, 0, yes
2739485532,  Ricky_Ita, 1, 1, 0, yes
774630574623428609,  Toni03767418, 1, 1, 0, yes
165000104,  Lampo83, 1, 1, 0, yes
1368932658,  RaKalckreuth, 1, 1, 0, yes
772043263205318656,  leonardoarcang3, 1, 1, 0, yes
2702322286,  d_altafini, 1, 1, 0, yes
715911688898404352,  paduanomaria01, 1, 1, 0, yes
488855604,  Notorious_PMC, 1, 1, 0, yes
466732772,  lucioamato, 1, 1, 0, yes
436756604,  LiciaRibolla, 1, 1, 0, yes
2882667118,  italian_selfie, 1, 1, 0, yes
201488335,  TONODECOLES, 1, 1, 0, yes
993771385,  ElioBecchis, 2, 2, 0, yes
851610090,  IlMichetti, 1, 1, 0, yes
82884417,  Riccarda12, 1, 1, 0, yes
543541105,  Spoby__, 5, 5, 0, yes
2765797166,  RiccardoGamb, 1, 1, 0, yes
4416823163,  DanyBluFenix97, 1, 1, 0, yes
419030431,  FinanzaNoStop, 1, 1, 0, yes
632248070,  fabioclem00, 1, 1, 0, yes
93220976,  lucatermine, 4, 3, 1, yes
805550517426552833,  daniele_valt, 1, 1, 0, yes
561191770,  JackSintini, 1, 1, 0, yes
732525287326507008,  themidnightmag, 1, 1, 0, yes
230026390,  francobcd, 1, 1, 0, yes
1435908997,  AlbunioGig, 2, 1, 1, neutral
434216695,  chiaracosta87, 1, 1, 0, yes
1020842490,  ColonelShotover, 1, 1, 0, yes
39863200,  MOREMIO, 1, 1, 0, yes
342011546,  Ant1Adam, 1, 1, 0, yes
768097527048577025,  desaturazione, 2, 1, 1, neutral
586388013,  VincenziVanessa, 1, 1, 0, yes
51674563,  lucasocionovo, 1, 1, 0, yes
401688638,  vincenzolopres1, 11, 8, 3, yes
22077586,  PaoloGilardini, 1, 1, 0, yes
2753029129,  SandersonRach, 3, 2, 1, yes
516039451,  ClementeZard, 1, 1, 0, yes
494378859,  franchi_paola, 1, 1, 0, yes
40493610,  AntonioBarbone, 3, 3, 0, yes
44846660,  gigio_muffin, 1, 1, 0, yes
22015299,  BREAKINGSWEEP, 1, 1, 0, yes
54691321,  aleniandrea, 2, 2, 0, yes
499968365,  robzip7, 2, 1, 1, neutral
462379461,  vero__berry, 1, 1, 0, yes
97193723,  piddienne, 1, 1, 0, yes
384948399,  OsservatorioLor, 5, 3, 2, yes
4090258552,  robertobellli, 2, 2, 0, yes
477545175,  gecarot, 1, 1, 0, yes
424907383,  FabioTraversa, 3, 2, 1, yes
306367790,  FilippoGhirardi, 4, 3, 1, yes
199781484,  mino_7th, 1, 1, 0, yes
18168213,  Malabrocca, 1, 1, 0, yes
500983691,  vivereliquido, 1, 1, 0, yes
482479828,  MauroMandrioli, 1, 1, 0, yes
796126854411382784,  pietrostiglitz, 4, 4, 0, yes
763017573843755008,  Ultimo_metro, 1, 1, 0, yes
25979970,  fedesene, 1, 1, 0, yes
752609732536496129,  Milena1675, 1, 1, 0, yes
96515004,  matteo105, 2, 2, 0, yes
7587412,  starise, 1, 1, 0, yes
494494145,  carlorugge, 1, 1, 0, yes
2322407453,  Nikoalb90, 1, 1, 0, yes
728056298,  psiko, 4, 1, 3, no
712325808698859520,  antofra2001, 1, 1, 0, yes
2196739383,  frabrizio83, 1, 1, 0, yes
314086992,  mariventro, 1, 1, 0, yes
771689574615638016,  Roberto33566465, 1, 1, 0, yes
477022508,  andrame93, 4, 4, 0, yes
363846098,  albertone_ricci, 1, 1, 0, yes
331702255,  mnpl10, 6, 4, 2, yes
215971922,  quotidianonet, 1, 1, 0, yes
396743588,  SilvanoMatranga, 5, 2, 3, no
561467949,  gianfrfumarola, 1, 1, 0, yes
2844842721,  opinionimask, 3, 3, 0, yes
2466239785,  BobRaoul1, 1, 1, 0, yes
236567015,  agendarockcuneo, 3, 3, 0, yes
476083170,  pierloreto, 1, 1, 0, yes
82105576,  JackDaniele, 1, 1, 0, yes
784687667325857792,  itsluca__, 1, 1, 0, yes
163022873,  Unconscious_8, 1, 1, 0, yes
2767062390,  MagicCou, 1, 1, 0, yes
211625701,  carmencen, 2, 2, 0, yes
246804467,  serecelli, 2, 2, 0, yes
350411440,  niallsbeat, 2, 2, 0, yes
459429980,  giorgiamecca, 1, 1, 0, yes
1384806966,  Arturo_Governa, 2, 2, 0, yes
823269025,  AlfanoToni, 2, 2, 0, yes
354988692,  AFerrandi, 1, 1, 0, yes
4498013608,  friodormorrison, 1, 1, 0, yes
850997250,  fabriziosbardel, 1, 1, 0, yes
105132897,  Borghetti73, 3, 3, 0, yes
156584886,  andmas01, 2, 2, 0, yes
491675077,  Frix_92, 1, 1, 0, yes
568141830,  EmaGuanciale, 2, 2, 0, yes
418666005,  MonjaCN, 1, 1, 0, yes
1234781281,  TEbhardt, 1, 1, 0, yes
1281672427,  andrebon93, 1, 1, 0, yes
49954018,  ilfoglio_it, 4, 2, 2, neutral
200065134,  simonavet, 1, 1, 0, yes
623813859,  ProveFromGnidel, 4, 4, 0, yes
230450346,  BojanDjuric78, 1, 1, 0, yes
1459575834,  ValliCamilla, 1, 1, 0, yes
2147850901,  cladav2, 1, 1, 0, yes
781950189871521793,  fabiopeirasso, 1, 1, 0, yes
86553252,  sabrinica, 1, 1, 0, yes
3217933624,  EspMarcop10, 1, 1, 0, yes
2882717339,  andreabranca94, 2, 2, 0, yes
161843603,  lorenzopia, 1, 1, 0, yes
107430047,  Giuliadedi, 2, 1, 1, neutral
489497171,  Stefania_Bo, 1, 1, 0, yes
482091026,  therealgrassi, 2, 2, 0, yes
19759015,  giduso, 1, 1, 0, yes
1019776338,  DUNDARKESAPLI, 1, 1, 0, yes
398542727,  claudia_raggi, 1, 1, 0, yes
2486652485,  CavaggioniMario, 1, 1, 0, yes
459073997,  JohnnyCerrans92, 2, 2, 0, yes
53021813,  francisparacino, 2, 2, 0, yes
424950362,  eli_grandi, 6, 5, 1, yes
32399184,  tittisanta, 1, 1, 0, yes
3136372012,  FrancoisLeLamer, 1, 1, 0, yes
3257064955,  rik912, 1, 1, 0, yes
2269189779,  Carlo_f2, 1, 1, 0, yes
454016323,  peggy979, 3, 2, 1, yes
31093722,  fulviocentoz, 2, 2, 0, yes
777953137,  Francesco_Berty, 1, 1, 0, yes
1897681980,  CerboneDario, 1, 1, 0, yes
239747389,  marcobeneduce, 1, 1, 0, yes
978797348,  EmanueleVizzini, 1, 1, 0, yes
550361069,  rinosardo, 1, 1, 0, yes
466684889,  ECapomazza, 2, 2, 0, yes
1814131,  salvio, 1, 1, 0, yes
374053052,  RicciardoloRich, 3, 3, 0, yes
418597947,  BRicciuti, 1, 1, 0, yes
116260078,  MarcoDiMaro, 1, 1, 0, yes
701852222926225408,  Patrizio1010, 2, 2, 0, yes
301875051,  INDROGHIGNO, 1, 1, 0, yes
366245194,  robertbiern, 1, 1, 0, yes
519383710,  Albe3110, 1, 1, 0, yes
501014441,  AlexandraChatz, 1, 1, 0, yes
144696100,  clairebizarre, 1, 1, 0, yes
386239262,  ales_nardone, 1, 1, 0, yes
402099995,  Dar3ios, 1, 1, 0, yes
263566567,  patrizio957, 1, 1, 0, yes
2878456721,  missvalyfox, 2, 2, 0, yes
125570941,  Muschelschloss, 2, 1, 1, neutral
236454159,  Josh_RaymondUK, 1, 1, 0, yes
766564938,  MattiaLiVigni, 1, 1, 0, yes
25321373,  GabriellaDoneda, 2, 2, 0, yes
1133758207,  PaulAurelienB, 1, 1, 0, yes
67313839,  Ettoremar, 4, 4, 0, yes
446532729,  EdoardoBuffoni, 2, 2, 0, yes
2841167885,  RichMelis, 1, 1, 0, yes
2353451501,  diego_giacoboni, 5, 5, 0, yes
72398403,  RiccardoCicconi, 1, 1, 0, yes
25529201,  Francesco_Con, 5, 5, 0, yes
707509963,  LucaKx, 1, 1, 0, yes
2679070518,  IsabellaHisa, 2, 2, 0, yes
105487204,  federiconegrini, 1, 1, 0, yes
419710006,  GFratti, 1, 1, 0, yes
3006676132,  donellabaronti, 1, 1, 0, yes
50262676,  tommasomello, 10, 10, 0, yes
37027634,  martahhh, 1, 1, 0, yes
920724872,  SaltoBz, 1, 1, 0, yes
781135576187670529,  Bengoa_Marta, 2, 2, 0, yes
4867818599,  franz_perez1989, 1, 1, 0, yes
23318055,  paultang, 1, 1, 0, yes
631843453,  DeMaConnie, 2, 1, 1, neutral
20200760,  cri900, 1, 1, 0, yes
3326788066,  FaragalliZ, 1, 1, 0, yes
2783687350,  giusmara, 2, 2, 0, yes
1589822768,  eosjuliet, 2, 2, 0, yes
1189249206,  Teresa_smaldone, 6, 6, 0, yes
402659507,  Aldo_Benassi, 1, 1, 0, yes
1262175068,  Matthews10R, 1, 1, 0, yes
56384857,  fabripav, 1, 1, 0, yes
731562331348582400,  bennygo99, 1, 1, 0, yes
366290744,  alan_cittone, 4, 4, 0, yes
2843633925,  ChristianIacon1, 1, 1, 0, yes
270461603,  yiury, 5, 4, 1, yes
2964582089,  lorenzozerbi, 1, 1, 0, yes
196623028,  alonsay, 1, 1, 0, yes
494095659,  geofedesevi, 1, 1, 0, yes
313535823,  boostap, 3, 2, 1, yes
86726713,  robertopinotti, 2, 2, 0, yes
3797229502,  Silvia78unavita, 2, 2, 0, yes
1729065984,  PeterMcC66, 1, 1, 0, yes
718126630670098432,  matcastellani, 3, 2, 1, yes
1058862104,  C_Graziana, 5, 5, 0, yes
78262716,  Pinella_, 3, 2, 1, yes
550341744,  Chicca62Provasi, 1, 1, 0, yes
2976694415,  antoninorusso64, 1, 1, 0, yes
1367203884,  BeppeRaineri, 1, 1, 0, yes
146332990,  NahlahAyed, 1, 1, 0, yes
721736617262772224,  gbattistaManna1, 1, 1, 0, yes
760404980763332608,  RaffoSarnataro, 1, 1, 0, yes
198689110,  IsmaMonzon, 3, 1, 2, no
14599507,  SilviaGuedes, 1, 1, 0, yes
376958750,  fra_puliti46, 1, 1, 0, yes
1104345804,  giannisca, 1, 1, 0, yes
625808731,  CasseraShanthi, 1, 1, 0, yes
801793188822450181,  domiult, 1, 1, 0, yes
465947740,  steInterTiamo, 1, 1, 0, yes
1073810917,  ManaiStefano, 2, 2, 0, yes
4830595617,  official_staniz, 1, 1, 0, yes
352976180,  FabioFedele1, 1, 1, 0, yes
41148765,  matteopoile, 1, 1, 0, yes
185784070,  CapMT, 1, 1, 0, yes
256633869,  riccardo_vetere, 1, 1, 0, yes
475862409,  molumbe, 1, 1, 0, yes
2440654436,  ProfJeffKenner, 1, 1, 0, yes
389641495,  parrantoni, 1, 1, 0, yes
589046682,  RudinaXhunga, 1, 1, 0, yes
442157009,  marco_tani, 1, 1, 0, yes
1025251326,  RosarioManVita, 2, 2, 0, yes
51875903,  w4rr10r_0, 4, 2, 2, neutral
2351417734,  lefamul, 1, 1, 0, yes
760240850567856129,  Luissrossonero, 1, 1, 0, yes
1652903876,  turcato_davide, 2, 2, 0, yes
408394098,  SimoneGrossule, 1, 1, 0, yes
2798965288,  MMvanDitmars, 1, 1, 0, yes
1928285366,  Sophieneveu1964, 1, 1, 0, yes
738878628998582272,  lucianolamb00, 6, 4, 2, yes
82581141,  egodeimi, 1, 1, 0, yes
3739985477,  QQuirica, 4, 4, 0, yes
182438498,  notayesmansecon, 1, 1, 0, yes
367161949,  BigMonty96, 6, 4, 2, yes
986347999,  PippoFr79590522, 2, 2, 0, yes
228868445,  mirkoube, 2, 2, 0, yes
83811813,  michelgelly, 1, 1, 0, yes
529375100,  An_Bion, 2, 2, 0, yes
159960846,  ilikethedreams, 1, 1, 0, yes
2285007224,  nikolaussuck, 6, 5, 1, yes
1454417300,  AlyssaFree33, 1, 1, 0, yes
471835353,  Alexios1201, 1, 1, 0, yes
1034461074,  RemoGilli, 1, 1, 0, yes
2979746110,  roseg_68, 1, 1, 0, yes
4882196008,  pallottaomar, 3, 1, 2, no
8452402,  flaviabrevi, 1, 1, 0, yes
198536391,  barbieridavidee, 1, 1, 0, yes
2450034750,  Ciu_Si, 1, 1, 0, yes
384791263,  yerard_fa, 1, 1, 0, yes
1212419094,  SarahCaste, 1, 1, 0, yes
67981255,  mark_Bg, 1, 1, 0, yes
443157122,  RedMax79, 1, 1, 0, yes
2744556341,  rododentro61, 1, 1, 0, yes
4784314430,  gRoms7, 1, 1, 0, yes
419039654,  TalpaClanFaenza, 1, 1, 0, yes
256880349,  _stellaprudente, 1, 1, 0, yes
429694228,  stefanciao, 1, 1, 0, yes
15822470,  pietrodn, 3, 2, 1, yes
282172253,  nicolaconti, 1, 1, 0, yes
440125957,  Sera__182, 1, 1, 0, yes
477504130,  JonasMarti_, 1, 1, 0, yes
494887596,  davidetaddia23, 2, 1, 1, neutral
265930433,  xavibermudez, 3, 3, 0, yes
2396880104,  Dome_Salerno, 1, 1, 0, yes
490185703,  PakoCarlucci, 1, 1, 0, yes
98103225,  elenapapad, 2, 2, 0, yes
27078217,  FrApfel, 1, 1, 0, yes
465402622,  PamelaPinna1, 2, 2, 0, yes
1433374316,  TonyLor7, 2, 2, 0, yes
785568083389845504,  Martimacol1992, 1, 1, 0, yes
363862747,  eli_mariani, 1, 1, 0, yes
2259901114,  Si81MoN, 1, 1, 0, yes
83946991,  PausaCaffe, 1, 1, 0, yes
209043150,  stefanogiorgi, 1, 1, 0, yes
1245538746,  ld14971, 1, 1, 0, yes
1371763459,  kafra89, 3, 2, 1, yes
193356806,  xlikeskyscraper, 1, 1, 0, yes
2420870084,  seekinsdeanimus, 8, 7, 1, yes
17705666,  scar0b, 1, 1, 0, yes
432571128,  TeoNumberOne, 1, 1, 0, yes
186387855,  gazzettamodena, 2, 2, 0, yes
324805752,  Catecome, 2, 1, 1, neutral
561319005,  bplimmobiliare, 3, 3, 0, yes
460497344,  MTmarcotaroni, 1, 1, 0, yes
180707741,  moontony, 2, 1, 1, neutral
431832423,  Luca_Pedota, 1, 1, 0, yes
169958761,  natyy483, 4, 3, 1, yes
45569671,  cyberzita, 1, 1, 0, yes
2881438581,  AmedeoMazzocchi, 2, 2, 0, yes
430671067,  Gabrymondy, 1, 1, 0, yes
302595470,  Chem4Nsic, 2, 1, 1, neutral
2661108945,  akracki, 1, 1, 0, yes
126023344,  Polydamas, 1, 1, 0, yes
354876240,  FiGlody, 1, 1, 0, yes
3396221,  composizioni, 1, 1, 0, yes
783796455987351552,  rebecca_aaaaa, 2, 2, 0, yes
361897749,  AnnaIlaria, 1, 1, 0, yes
4502381,  Tinny, 4, 3, 1, yes
384237636,  MMassimiliani, 1, 1, 0, yes
799888220787974144,  MontuoriAntoni1, 1, 1, 0, yes
291189250,  SimonaGrieco, 1, 1, 0, yes
390109567,  Samumassit, 1, 1, 0, yes
369400792,  Donatocerullo93, 2, 2, 0, yes
875403187,  TobiasBtow, 1, 1, 0, yes
969956425,  EStefanutto, 2, 2, 0, yes
537369250,  VitoLongo4, 2, 1, 1, neutral
2922007389,  ChrisODonnellSA, 1, 1, 0, yes
66958904,  lenyyoann, 1, 1, 0, yes
121158213,  AlertTrade, 1, 1, 0, yes
229895531,  ArjunKVGole, 1, 1, 0, yes
1000549238,  AndreaDMancuso, 4, 3, 1, yes
372488770,  chiaramanna, 5, 3, 2, yes
46967220,  TheChatminoute, 1, 1, 0, yes
292823459,  lucerax1, 2, 2, 0, yes
114435001,  luizreka, 2, 2, 0, yes
1105926824,  piergiorgio_pet, 1, 1, 0, yes
1425949100,  fantaccini81, 1, 1, 0, yes
389648746,  CarloIncoronato, 3, 3, 0, yes
624615294,  antonioventuri2, 1, 1, 0, yes
572927953,  BardazziMarta, 1, 1, 0, yes
506087820,  elisachillu, 1, 1, 0, yes
336050325,  loreilo79, 1, 1, 0, yes
84650559,  C_Zervos, 2, 2, 0, yes
2841801923,  shtrafnoy, 1, 1, 0, yes
425908846,  IsabellaCusano, 3, 3, 0, yes
413074101,  nicopiccaluga, 1, 1, 0, yes
248645037,  confusiongrows, 1, 1, 0, yes
205494348,  fabiomorellini, 2, 2, 0, yes
921115417,  EnricoMestieri1, 1, 1, 0, yes
25734478,  StGeoursSophie, 1, 1, 0, yes
278635327,  frollinainaina, 1, 1, 0, yes
490687455,  JGiusi, 1, 1, 0, yes
444820775,  stivenvox88, 3, 3, 0, yes
375094291,  Giuscarlomagno, 1, 1, 0, yes
482329336,  fedevilla24, 1, 1, 0, yes
2262684225,  92Lingua, 1, 1, 0, yes
1966484178,  ottaviomasini, 2, 2, 0, yes
727039431295795200,  mariluce92, 2, 2, 0, yes
4193073802,  Donatel55692998, 1, 1, 0, yes
255123295,  m_albania, 1, 1, 0, yes
202236183,  curvadipenelope, 1, 1, 0, yes
436196466,  Sardiniacolours, 1, 1, 0, yes
302722774,  PhilippeCorbe, 1, 1, 0, yes
467809551,  Danidista21, 1, 1, 0, yes
466003629,  GiorgioCurcio, 1, 1, 0, yes
2279444148,  fiorent96466389, 1, 1, 0, yes
536424984,  chiara_dimarzio, 1, 1, 0, yes
726046612745781248,  Pek76Vincenzo, 3, 2, 1, yes
2785463902,  litio4you, 1, 1, 0, yes
32937766,  La_Pat, 3, 3, 0, yes
14235101,  Blutarsky72, 2, 2, 0, yes
225566841,  maxrodgers_, 1, 1, 0, yes
484179231,  giulialamoratta, 1, 1, 0, yes
426187565,  QuattroAprile, 2, 2, 0, yes
27880740,  ColetteMao, 6, 3, 3, neutral
819922742,  Maria__Luisa_, 3, 2, 1, yes
476485701,  dancrawford85, 1, 1, 0, yes
66193381,  BorisSollazzo, 2, 2, 0, yes
152769774,  canofite, 1, 1, 0, yes
1166069124,  reecewhayes, 1, 1, 0, yes
492968999,  silviamei1, 1, 1, 0, yes
477879405,  giotalamo, 1, 1, 0, yes
1500673885,  A_Volpe995, 1, 1, 0, yes
131450947,  arjuna56, 3, 3, 0, yes
805530522457960448,  paolo_sant, 1, 1, 0, yes
440345487,  DarioGhezzi1, 3, 1, 2, no
393903494,  FrancescoTrudu, 1, 1, 0, yes
203422688,  pavassal, 4, 2, 2, neutral
358383458,  mimmo_perego, 1, 1, 0, yes
805529757647597568,  Alessan28152692, 1, 1, 0, yes
475022643,  Dallolio_Marco, 1, 1, 0, yes
323261818,  AdrianoErnesto1, 1, 1, 0, yes
140265539,  KikaLadesiempre, 2, 1, 1, neutral
453239189,  RiccardoMagni95, 1, 1, 0, yes
50298324,  tongi979, 1, 1, 0, yes
268872309,  Lollo_NY96, 1, 1, 0, yes
422092854,  CerriMatteo, 1, 1, 0, yes
125488839,  JadeWaldorf, 1, 1, 0, yes
1224995306,  alberto_palu, 1, 1, 0, yes
1324418191,  Nico_Vermersch, 1, 1, 0, yes
15977038,  ForexBTC, 1, 1, 0, yes
26275704,  Stone_SkyNews, 1, 1, 0, yes
89470984,  ronaldkoknl, 1, 1, 0, yes
401084802,  cielovaniglia, 2, 2, 0, yes
126781995,  umbertogini, 1, 1, 0, yes
35740848,  Cepernich, 1, 1, 0, yes
3310571,  filicaetano, 1, 1, 0, yes
270370521,  juanludepaolis, 1, 1, 0, yes
407982859,  FedericoNappi, 1, 1, 0, yes
1582613335,  limonareduro, 1, 1, 0, yes
733014956,  MenaFarro, 1, 1, 0, yes
28951869,  Stridic, 1, 1, 0, yes
431812066,  il__marinaio, 1, 1, 0, yes
22022534,  giacchettone, 1, 1, 0, yes
2246362397,  IvaniLaura, 1, 1, 0, yes
489518406,  cola_alessandro, 1, 1, 0, yes
356129121,  marco_ddr, 2, 2, 0, yes
2148776336,  simone_ferrali, 1, 1, 0, yes
566720919,  P_Cotroneo, 1, 1, 0, yes
96238328,  AlexFina87, 1, 1, 0, yes
575835078,  Taleof2Treaties, 1, 1, 0, yes
481512949,  GaloppinoWhite, 2, 1, 1, neutral
3075472505,  maria_mlepri, 2, 2, 0, yes
248176574,  askanews_ita, 2, 2, 0, yes
753359587,  LaraTinca, 1, 1, 0, yes
763430733704753152,  TweetAmico, 1, 1, 0, yes
250364793,  Calum_McN, 1, 1, 0, yes
441282339,  Giovinap, 2, 2, 0, yes
4200749482,  Lulla__J, 7, 4, 3, yes
1395206779,  EnricoFranco9, 1, 1, 0, yes
389530115,  coriolanogiorgi, 1, 1, 0, yes
733960361246875648,  infosubmarine, 1, 1, 0, yes
176199546,  baeknuggets, 1, 1, 0, yes
402164784,  luitelesca, 1, 1, 0, yes
43379546,  DarkWingHero, 1, 1, 0, yes
327250893,  antoniofarigu, 3, 2, 1, yes
98919277,  GraziaaM, 1, 1, 0, yes
1575382976,  Il_Teoldi, 2, 2, 0, yes
557695583,  mdanielamaselli, 1, 1, 0, yes
370057716,  OresteDeFelice, 1, 1, 0, yes
4186292608,  walter_zema, 2, 2, 0, yes
131486969,  isabbah, 5, 2, 3, no
7936692,  estela_goiko, 1, 1, 0, yes
2720917810,  AligDylan, 1, 1, 0, yes
1026453456,  Fry_Fra, 1, 1, 0, yes
407277763,  nero_stirner, 1, 1, 0, yes
236918683,  Maury_mo, 1, 1, 0, yes
739064336858124288,  alesurri, 3, 3, 0, yes
3053117626,  rossimo90, 1, 1, 0, yes
1425113809,  ronflexPD, 3, 2, 1, yes
4859853969,  Stefano63670421, 1, 1, 0, yes
53336226,  francescosanto, 1, 1, 0, yes
1376716286,  OrnellaLuzzi24, 1, 1, 0, yes
1851912031,  marinagola, 1, 1, 0, yes
88223869,  charlierock12, 5, 1, 4, no
2584412440,  craigoneill73, 1, 1, 0, yes
2466245488,  eticiuk, 2, 2, 0, yes
118473257,  gerry30046, 3, 2, 1, yes
929059525,  coconutsplumbeo, 1, 1, 0, yes
2362991535,  Fede_Bonez, 1, 1, 0, yes
989732754,  PeppeSalerno71, 1, 1, 0, yes
407633325,  ChiaraTranQ, 1, 1, 0, yes
171522063,  frabilli, 1, 1, 0, yes
295909458,  alesssandro__, 1, 1, 0, yes
53023752,  franzemanuele, 1, 1, 0, yes
406186281,  AntonioSC78, 1, 1, 0, yes
851258737,  Etuttounpocosi, 2, 2, 0, yes
543213808,  emanuelecontu, 2, 2, 0, yes
4109142693,  estemporaneo__, 1, 1, 0, yes
1190422741,  giumazzichi, 1, 1, 0, yes
73949832,  BoomAlexs, 6, 6, 0, yes
542607381,  NicoleGomena, 1, 1, 0, yes
422107369,  laFrisy_, 3, 3, 0, yes
2511482311,  Lhaudian, 1, 1, 0, yes
99149944,  pinkwoodmac, 3, 3, 0, yes
1075249656,  larnunzio, 2, 2, 0, yes
481316156,  ricsal72, 1, 1, 0, yes
293440037,  f_stevanato, 1, 1, 0, yes
801042058945368064,  ElianaCocca, 1, 1, 0, yes
35564742,  salvosottile, 1, 1, 0, yes
412382577,  nicalbasini, 1, 1, 0, yes
114267176,  lucazingrone, 1, 1, 0, yes
1125700688,  proveppe1, 1, 1, 0, yes
1155283195,  plestival, 1, 1, 0, yes
6720322,  BrunoRuffilli, 1, 1, 0, yes
716371151912615936,  Duplicatodaut, 1, 1, 0, yes
502182693,  PaoloSywaf, 1, 1, 0, yes
475911815,  Sheva77722, 1, 1, 0, yes
53488362,  langeuhr, 1, 1, 0, yes
389672581,  jeegrobot88, 1, 1, 0, yes
3254528956,  PeppPisco, 1, 1, 0, yes
1578444637,  igroooo, 1, 1, 0, yes
2347350496,  Maura_Corr, 8, 5, 3, yes
781538334048940032,  politica_oggi_, 1, 1, 0, yes
50297825,  agriturismo_web, 1, 1, 0, yes
49976341,  Had20, 1, 1, 0, yes
85629903,  pottolina, 1, 1, 0, yes
223413877,  Antetomaso, 1, 1, 0, yes
418889174,  francaebasta86, 1, 1, 0, yes
425935283,  Broadway42nd, 1, 1, 0, yes
436248368,  SARABARE75, 13, 7, 6, yes
2873029109,  antpugl59, 3, 3, 0, yes
359265606,  DjFulvio81, 1, 1, 0, yes
988329955,  PilloniFederico, 1, 1, 0, yes
45786408,  LaRota, 1, 1, 0, yes
430690927,  ChristianFini, 1, 1, 0, yes
397189518,  MirkoGaravaglia, 4, 1, 3, no
3252637672,  d11ed8a855044b3, 1, 1, 0, yes
252201878,  marilenadegiorg, 1, 1, 0, yes
3047887129,  GinoDemi, 1, 1, 0, yes
605697838,  montales1, 4, 2, 2, neutral
9196682,  lugiampieri, 1, 1, 0, yes
634024501,  RuiASousa, 1, 1, 0, yes
417245754,  buercher, 2, 2, 0, yes
3027869254,  McNamara271977, 1, 1, 0, yes
256065286,  eli_marongiu, 2, 2, 0, yes
1069201236,  Maria40884654, 1, 1, 0, yes
344129956,  luisa_siccardi, 1, 1, 0, yes
743175345533255681,  davidebusanello, 1, 1, 0, yes
147237728,  fernandodenitto, 1, 1, 0, yes
435933629,  rosciolianna, 1, 1, 0, yes
413012396,  GianniCaso, 1, 1, 0, yes
372245608,  GentileCarlo, 2, 2, 0, yes
728194800902639617,  MassDei, 1, 1, 0, yes
371935881,  xNaive_, 1, 1, 0, yes
228678661,  flavioarzarello, 3, 3, 0, yes
431753625,  ilariasotis, 2, 2, 0, yes
852583842,  Ja_Wieczorek, 1, 1, 0, yes
48124145,  mdedona, 1, 1, 0, yes
251241835,  marcovalentiaq, 1, 1, 0, yes
1376941658,  VtladybirdR, 1, 1, 0, yes
2946460816,  Benve1312, 1, 1, 0, yes
1069107084,  StudioAmerini, 1, 1, 0, yes
3343287154,  vBohnenblust, 1, 1, 0, yes
12194852,  berlinialberto, 1, 1, 0, yes
3153775982,  Tempe_88, 1, 1, 0, yes
83322742,  Khaisake, 1, 1, 0, yes
10040822,  scuderidomenico, 1, 1, 0, yes
2351629252,  Gmrk76, 1, 1, 0, yes
224985396,  MiniMichi83, 1, 1, 0, yes
2890353405,  AntoceleC, 1, 1, 0, yes
404778182,  ASchiesari, 1, 1, 0, yes
2371064141,  airkingo, 1, 1, 0, yes
33230351,  caterinad, 1, 1, 0, yes
98897455,  ilvisa, 3, 2, 1, yes
416130723,  cristinassi, 2, 2, 0, yes
753324692199632901,  jbstefanini, 1, 1, 0, yes
459582893,  Ricky24795, 1, 1, 0, yes
494395730,  toMMilanello, 2, 2, 0, yes
2647729368,  MarcRenton, 1, 1, 0, yes
2871165084,  frmancusi, 4, 4, 0, yes
283473247,  alemerlo1, 1, 1, 0, yes
2577235811,  Savio_1927, 1, 1, 0, yes
3024770230,  CarloUmbria, 1, 1, 0, yes
418297721,  teozorzoli, 1, 1, 0, yes
431000125,  mauriziobonora, 1, 1, 0, yes
12497362,  joaovillalobos, 1, 1, 0, yes
2227409246,  ex_piero, 1, 1, 0, yes
50263809,  vinclem, 2, 1, 1, neutral
1125613298,  ElianaChessa, 1, 1, 0, yes
794976740011544576,  salvuccio1996, 1, 1, 0, yes
91571343,  IvanZenAttitude, 3, 3, 0, yes
5661312,  antuan, 1, 1, 0, yes
115651058,  flowersexport, 1, 1, 0, yes
448124299,  Umberto_Senpai, 1, 1, 0, yes
714309424,  PanciaSimona, 2, 1, 1, neutral
770389599378087936,  DaCanale1995, 1, 1, 0, yes
90365920,  paolonocchi, 1, 1, 0, yes
433296285,  Phlancton, 1, 1, 0, yes
128961168,  niccolab, 2, 1, 1, neutral
133411105,  andreagam78, 1, 1, 0, yes
2248808823,  grashiof, 2, 1, 1, neutral
157482173,  mredivad, 3, 2, 1, yes
1060584542,  ScardoneAntonio, 1, 1, 0, yes
2390989930,  AndreaOliviers, 1, 1, 0, yes
955965985,  Bio_Ge, 1, 1, 0, yes
64660672,  AstritS, 2, 2, 0, yes
767704192119111680,  disanteandrea, 1, 1, 0, yes
586635337,  italoabelli, 1, 1, 0, yes
436012138,  Rougeforweb, 1, 1, 0, yes
1924398546,  AApache10, 1, 1, 0, yes
2506290296,  UKIPDB, 2, 1, 1, neutral
73372432,  memethegoat, 1, 1, 0, yes
501620391,  Aggiustare, 1, 1, 0, yes
825366348,  _elena_2202, 2, 2, 0, yes
75972647,  carminedefazio, 1, 1, 0, yes
386204288,  RiccaVeltro, 2, 2, 0, yes
2810480374,  claudiabovenzi, 1, 1, 0, yes
1883273444,  _albertobignone, 1, 1, 0, yes
93399856,  azhicaz, 2, 2, 0, yes
2466612532,  wesley_ita, 1, 1, 0, yes
2469792687,  PetrosinoVega, 1, 1, 0, yes
283843715,  meebits, 1, 1, 0, yes
406347157,  alkex95, 2, 2, 0, yes
113132724,  cbuquicchio, 3, 2, 1, yes
2407829022,  kingdom1991, 4, 4, 0, yes
236081351,  elisasileb, 1, 1, 0, yes
239759838,  TommasoManzin, 1, 1, 0, yes
707937831788879872,  IDEEPERILPAESE, 1, 1, 0, yes
89989180,  lupettianna, 1, 1, 0, yes
485177720,  carloterzaroli, 1, 1, 0, yes
4738886235,  SelenaRampi, 4, 1, 3, no
2804324997,  MakoveiTN, 3, 2, 1, yes
279053073,  DanyMan90, 3, 3, 0, yes
410735674,  mattiatarelli1, 3, 2, 1, yes
1165959254,  Siilviadp, 1, 1, 0, yes
500155353,  louis_gaget, 1, 1, 0, yes
1585659486,  Carlotta_Action, 1, 1, 0, yes
807129056,  MarqMarti, 2, 1, 1, neutral
131590170,  LSD976, 1, 1, 0, yes
18975919,  CeciNobili, 2, 2, 0, yes
20009450,  frihetsdottir, 1, 1, 0, yes
469649315,  marcodonatone, 1, 1, 0, yes
1074941221,  max888ant, 1, 1, 0, yes
503159466,  pablito9700, 3, 3, 0, yes
3149383696,  JewyD09, 1, 1, 0, yes
1880884993,  Giampy_fortun, 1, 1, 0, yes
527411904,  marchisano, 2, 2, 0, yes
533560458,  FedoMei, 1, 1, 0, yes
60413758,  VICTORJPC, 1, 1, 0, yes
358826022,  pierovecchiato, 2, 1, 1, neutral
400189987,  alexiskarklins, 1, 1, 0, yes
265921912,  Pippo992, 1, 1, 0, yes
513596528,  silkycalum, 2, 2, 0, yes
199606693,  ziovin, 1, 1, 0, yes
255573592,  Baldrea, 1, 1, 0, yes
58611094,  ChriMacFerretti, 7, 6, 1, yes
2359252857,  fabio_ratini, 1, 1, 0, yes
756843925,  deadxxinsidex, 5, 3, 2, yes
98014190,  jpmontoya1, 1, 1, 0, yes
340341529,  stevencattai, 2, 1, 1, neutral
980574780,  lousweaters, 1, 1, 0, yes
409298312,  _aledipi_, 2, 2, 0, yes
581808446,  E_Gambilonghi, 3, 3, 0, yes
405826534,  silviaslide46, 1, 1, 0, yes
2175498208,  NavarraCarmine, 1, 1, 0, yes
3008535123,  AnnKristin_S_, 1, 1, 0, yes
1372999801,  fflos7, 2, 2, 0, yes
3938233695,  Marcomassamappa, 2, 2, 0, yes
3179570025,  lucal2306, 1, 1, 0, yes
331049501,  frenz92, 2, 2, 0, yes
2958726245,  UgoliniVanessa, 2, 2, 0, yes
3361002119,  elena_gualtieri, 1, 1, 0, yes
527353082,  CamillaBurelli, 1, 1, 0, yes
245700162,  veronica25p, 4, 1, 3, no
1503375152,  PatariniAndrea, 1, 1, 0, yes
461441940,  lorenziniSimone, 1, 1, 0, yes
118411239,  maxleva, 2, 2, 0, yes
4870838625,  GarzonioAlessio, 1, 1, 0, yes
4245829457,  nanni_calabro, 1, 1, 0, yes
555398101,  NaoStern, 1, 1, 0, yes
718695063,  BenedettaMe, 3, 3, 0, yes
356762636,  ceciliaa_14, 1, 1, 0, yes
58914947,  Palombellamiope, 1, 1, 0, yes
122960686,  Ambroise_Mejean, 1, 1, 0, yes
534288003,  Tess_Granato, 2, 1, 1, neutral
179044057,  fraporzio95, 2, 2, 0, yes
1276057015,  giovaz1990, 1, 1, 0, yes
2801440154,  LucaMasre, 1, 1, 0, yes
2892265408,  and88cam, 1, 1, 0, yes
263631029,  aaambra, 1, 1, 0, yes
777537583630909440,  Shelly868148121, 4, 4, 0, yes
833597947,  Boiardo2, 2, 2, 0, yes
578950964,  f_lanciano, 3, 3, 0, yes
763820725,  PpeGius, 1, 1, 0, yes
624731323,  a_famulari, 1, 1, 0, yes
425661276,  saint_arnoulf, 1, 1, 0, yes
484837200,  ItaliadelleIdee, 2, 2, 0, yes
1237020048,  Martina2076, 2, 2, 0, yes
26980751,  kekko71, 1, 1, 0, yes
26444296,  gialupa, 1, 1, 0, yes
436805794,  FabioRinaldi90, 1, 1, 0, yes
351802779,  bennymoro, 1, 1, 0, yes
633588652,  pa0l0maion3, 3, 2, 1, yes
1081062866,  sev144, 1, 1, 0, yes
96413354,  DavideAicardi, 1, 1, 0, yes
480406560,  T_Rabbia, 1, 1, 0, yes
103046908,  sivabbe, 3, 2, 1, yes
35265379,  americanlife_, 1, 1, 0, yes
309241972,  bbelux, 1, 1, 0, yes
128922889,  Balqis_3asal, 4, 4, 0, yes
2334586102,  lou_redH, 2, 2, 0, yes
986569482,  Patrizia_bove, 1, 1, 0, yes
500208900,  EugenioDiquattr, 1, 1, 0, yes
626960986,  nunomigs, 1, 1, 0, yes
428414243,  sacconigabriele, 1, 1, 0, yes
2570299816,  kikimusampa76, 1, 1, 0, yes
961318268,  ABorghetto, 4, 2, 2, neutral
899563880,  scandroglio69, 1, 1, 0, yes
159817933,  Mario_Nikolic, 2, 2, 0, yes
60402872,  gianna_sio, 1, 1, 0, yes
732093992586887168,  GigiSullivan7, 3, 3, 0, yes
801368498186420225,  HenriXhakupi, 1, 1, 0, yes
235566527,  robertotornello, 1, 1, 0, yes
1853733661,  bk_foffy, 1, 1, 0, yes
234036652,  maxmartinez44, 1, 1, 0, yes
485123214,  antonucci_leo, 1, 1, 0, yes
538286720,  Turlupini, 3, 2, 1, yes
510132746,  IaccaFrancesco, 1, 1, 0, yes
2887837811,  Lorenzoarkt, 1, 1, 0, yes
51036508,  francesco1m, 3, 2, 1, yes
342703028,  Robert_Berting, 1, 1, 0, yes
171976569,  TDROLDLADY, 5, 5, 0, yes
2860541782,  andreabo92, 1, 1, 0, yes
2221578131,  leovarago, 1, 1, 0, yes
2808658462,  franzfior, 1, 1, 0, yes
403717469,  Hullabaloo___, 1, 1, 0, yes
521630525,  danineri2511, 1, 1, 0, yes
400683403,  FrancescoGrana, 1, 1, 0, yes
2537661010,  FraRugiero, 1, 1, 0, yes
613725356,  Georgios_Gou, 1, 1, 0, yes
1139421722,  mary76205070, 1, 1, 0, yes
104875219,  Samy_Aloulou, 1, 1, 0, yes
2455570740,  raffamax68, 4, 3, 1, yes
3297233683,  j_lemiech, 1, 1, 0, yes
212616314,  vagabondo81, 1, 1, 0, yes
45057682,  andykinesis, 1, 1, 0, yes
18594951,  AlonsoDamian, 1, 1, 0, yes
345940302,  LaRicciaGuido, 1, 1, 0, yes
2500244129,  AntonioCrisetti, 1, 1, 0, yes
388291888,  giadairis, 1, 1, 0, yes
155598597,  ellirelli, 1, 1, 0, yes
258062486,  Cremaschina, 1, 1, 0, yes
3303589715,  e90085a14a2f4d0, 1, 1, 0, yes
798463710,  M3scalina, 2, 1, 1, neutral
494906863,  lph20, 1, 1, 0, yes
50619721,  aspeciale, 1, 1, 0, yes
173968152,  palpeet, 1, 1, 0, yes
188121556,  LorisBrega, 1, 1, 0, yes
4440535582,  paolicelli96, 1, 1, 0, yes
88224703,  rikymag81, 1, 1, 0, yes
219159765,  Sissetta80, 6, 6, 0, yes
2838324124,  Dreamvectioner, 1, 1, 0, yes
3235673973,  EmiComites, 1, 1, 0, yes
132452104,  FedericoGhidini, 1, 1, 0, yes
89481028,  gabrielecif, 1, 1, 0, yes
386732636,  masonotarianni, 10, 7, 3, yes
2370406796,  federico_sime, 1, 1, 0, yes
285181232,  anDmcLive, 1, 1, 0, yes
1111159670,  EmanuelaCaracci, 1, 1, 0, yes
426423569,  AlessandroEmil2, 2, 2, 0, yes
724699433271758848,  TonyStark300181, 5, 1, 4, no
557806739,  AntonioIppolit3, 1, 1, 0, yes
87255569,  BeatriceParrino, 1, 1, 0, yes
425188592,  GennaroDecri, 2, 2, 0, yes
76385745,  Enrico_Pozzo, 2, 2, 0, yes
14845141,  monossido, 1, 1, 0, yes
720891425769013248,  MarcoBart06, 1, 1, 0, yes
380229739,  Lui_Izzo, 1, 1, 0, yes
3192200055,  dafnevolpe, 1, 1, 0, yes
465901864,  MarinaTosto, 1, 1, 0, yes
377476229,  garofalo_ma, 1, 1, 0, yes
288694726,  benedetta_er, 1, 1, 0, yes
23487072,  famgio, 1, 1, 0, yes
453434150,  CareriPaolo, 1, 1, 0, yes
2296871221,  promisezerozero, 1, 1, 0, yes
421395978,  snafribo, 2, 1, 1, neutral
402707224,  AttilioMalena, 1, 1, 0, yes
2303142972,  MesserRoberto, 2, 2, 0, yes
209066290,  palpatine42, 1, 1, 0, yes
985522832,  francesco111971, 3, 3, 0, yes
434198390,  mariaemiliainfa, 1, 1, 0, yes
364985622,  CiraMarchionne, 1, 1, 0, yes
357392399,  IMalcoMix, 2, 1, 1, neutral
52065987,  G_2_love, 3, 3, 0, yes
449660849,  Tatu_Fi, 1, 1, 0, yes
2424256072,  luciano_sisio57, 1, 1, 0, yes
39313286,  rodrigowaghorn, 1, 1, 0, yes
764038772568784896,  barbara74353678, 1, 1, 0, yes
198073780,  bumbolotto, 3, 3, 0, yes
702938980111798273,  Giorgi6b, 1, 1, 0, yes
866310332,  CapoMir, 1, 1, 0, yes
1186680884,  VallaBomber, 2, 2, 0, yes
1183218548,  Vorvoli, 2, 1, 1, neutral
1927667856,  matteogamalerio, 1, 1, 0, yes
25264929,  AriannaOrazi, 2, 2, 0, yes
2498399355,  gianrollandi, 9, 1, 8, no
1322187091,  LipariIrapil, 1, 1, 0, yes
431887124,  craaash80, 20, 7, 13, no
47276325,  Rbca92, 1, 1, 0, yes
192943412,  afxgroup, 3, 3, 0, yes
150156901,  vicenslozano, 1, 1, 0, yes
2244946799,  maryceccarelli, 1, 1, 0, yes
712321184700997633,  ElenaLauraMunt1, 1, 1, 0, yes
1145995544,  pouceopposable, 1, 1, 0, yes
4189694716,  mcarletti76, 1, 1, 0, yes
29269197,  albertobotton, 1, 1, 0, yes
219071528,  jobarbaste, 1, 1, 0, yes
76786936,  leggoit, 1, 1, 0, yes
2938612463,  WishYouWereV, 1, 1, 0, yes
2472353049,  Cribecc, 1, 1, 0, yes
378642701,  AntoToniAnto, 1, 1, 0, yes
382778607,  twitt_Ego, 4, 3, 1, yes
431449356,  cat_fede, 1, 1, 0, yes
513347811,  Luca1988S, 1, 1, 0, yes
278235012,  javycor, 1, 1, 0, yes
42114536,  valeria_e, 1, 1, 0, yes
328718515,  MarcoQuintano1, 1, 1, 0, yes
4697142235,  studiolegalefp1, 1, 1, 0, yes
108120112,  Tassobarbasso, 2, 2, 0, yes
1006059277,  SBraccagni, 1, 1, 0, yes
2279009125,  mangiapiddini, 4, 3, 1, yes
1149110491,  c_femina, 4, 4, 0, yes
776663796,  DrVdeV, 1, 1, 0, yes
409234460,  moltovintage, 1, 1, 0, yes
122492247,  TweetCarlaTweet, 1, 1, 0, yes
398805513,  VasilisDalianis, 1, 1, 0, yes
381406069,  NewsReputation, 1, 1, 0, yes
991376580,  FraMoreschi, 1, 1, 0, yes
207491270,  Ily984, 1, 1, 0, yes
1924350494,  thealiceromano, 4, 3, 1, yes
218635177,  T_Socialist, 1, 1, 0, yes
390476500,  SguegliaR, 1, 1, 0, yes
175725030,  aleiv77, 1, 1, 0, yes
45634740,  steceroni, 1, 1, 0, yes
255697884,  IlarioSabbadini, 1, 1, 0, yes
74035862,  AliciaCiciliani, 1, 1, 0, yes
333441243,  DanicoGnisci, 14, 3, 11, no
819905174,  moonlightmeb, 1, 1, 0, yes
2883264898,  FabioCaudullo, 1, 1, 0, yes
488298411,  f_giuffrida, 3, 2, 1, yes
1259954168,  v2Dark, 1, 1, 0, yes
3226613787,  giu_rago, 1, 1, 0, yes
2729744770,  dabo76M26, 2, 1, 1, neutral
3097727387,  debym1881, 2, 2, 0, yes
897023148,  FloHuvier, 1, 1, 0, yes
2181916995,  PgPiergiorgio, 1, 1, 0, yes
144288146,  SoyPuri, 2, 2, 0, yes
397176329,  LuisaIannelli, 1, 1, 0, yes
729280198055743488,  Dario48656406, 1, 1, 0, yes
2966565923,  AlessiaScopel, 2, 2, 0, yes
14889282,  pbarbieri, 1, 1, 0, yes
610693948,  ErikaNatze, 1, 1, 0, yes
35224788,  leachline, 1, 1, 0, yes
358461740,  Nc_Pablito, 2, 2, 0, yes
469139479,  JoanMariaDiu, 2, 2, 0, yes
51191573,  AndreaMarinelli, 1, 1, 0, yes
31451735,  PhilBruAFP, 1, 1, 0, yes
415128032,  VincenzoScalett, 1, 1, 0, yes
348355768,  byuunnie, 1, 1, 0, yes
2307151081,  dhanairsara, 1, 1, 0, yes
1148811253,  LorenzoLMP, 1, 1, 0, yes
196584753,  GpCasagni, 1, 1, 0, yes
800788482478116864,  m_cara86, 3, 3, 0, yes
576751668,  RosaliaPurita, 1, 1, 0, yes
269489101,  stoipa, 1, 1, 0, yes
55799367,  undelfino, 1, 1, 0, yes
341142309,  mikyknight, 1, 1, 0, yes
291591372,  HarryLevante, 1, 1, 0, yes
515830018,  Emilianolutteri, 1, 1, 0, yes
484029674,  EricGuesh, 1, 1, 0, yes
403330710,  claudiacanelles, 1, 1, 0, yes
35295467,  DavideRoncaioli, 1, 1, 0, yes
411490873,  Capozza_Franc, 6, 3, 3, neutral
57280878,  HausWitt, 2, 2, 0, yes
39115395,  frankspicc, 1, 1, 0, yes
718002726,  DIRITTOELEGGI, 1, 1, 0, yes
372914329,  TheRealPezzi, 2, 2, 0, yes
318270933,  Parga1967, 1, 1, 0, yes
37761352,  maestroenriwedd, 1, 1, 0, yes
389690683,  raffutz, 1, 1, 0, yes
2944803959,  grandolfo1980, 1, 1, 0, yes
702907203372589057,  HambreVenezuela, 2, 2, 0, yes
188491265,  Wildlife__Photo, 1, 1, 0, yes
4200599823,  frax76_, 1, 1, 0, yes
564813291,  UmbertoFattori, 1, 1, 0, yes
825642738,  A5Antonella, 2, 2, 0, yes
760470886713614336,  dom_barone, 1, 1, 0, yes
632681333,  MarcoGavarini, 1, 1, 0, yes
428277277,  AugustaCaselli, 1, 1, 0, yes
865059738,  CapalboAngelo, 1, 1, 0, yes
161082608,  DarioPulieri, 1, 1, 0, yes
1226225444,  cristian_altair, 1, 1, 0, yes
342141816,  FCaligaris, 4, 4, 0, yes
331273766,  Er_Massiccio, 1, 1, 0, yes
392636497,  VasThomop, 1, 1, 0, yes
69252638,  SergioWyz, 1, 1, 0, yes
420943143,  NeoNicola, 1, 1, 0, yes
1520582076,  bigmike_EK, 1, 1, 0, yes
2353788272,  DaniKnish, 1, 1, 0, yes
208480790,  VincenzoMart, 2, 2, 0, yes
18856867,  zerohedge, 1, 1, 0, yes
258895780,  ArmandoFerrigno, 1, 1, 0, yes
374430468,  gabrieledestef1, 1, 1, 0, yes
1313730139,  GianniLacava, 2, 2, 0, yes
618337953,  gabriellaalfie1, 1, 1, 0, yes
599443587,  stavroulaber, 1, 1, 0, yes
1627826564,  giocalamia, 1, 1, 0, yes
369774424,  rogeRosich, 1, 1, 0, yes
453044594,  Suriciotto, 2, 1, 1, neutral
1365016130,  bruscomassimo, 3, 3, 0, yes
2202295197,  ABisacci, 1, 1, 0, yes
534111119,  FranciTerzaghi, 1, 1, 0, yes
486810047,  whitehugsblack, 1, 1, 0, yes
3094757843,  mauriman88, 1, 1, 0, yes
424177405,  yurimaga87, 1, 1, 0, yes
77961442,  carpato82, 1, 1, 0, yes
10724352,  leblognoteur, 1, 1, 0, yes
2168940672,  mario_citino, 1, 1, 0, yes
349808256,  ABazardi, 1, 1, 0, yes
298704150,  jhallwood, 1, 1, 0, yes
2637150321,  niccolo_fabbri, 1, 1, 0, yes
2270554436,  MarzulloYoussef, 1, 1, 0, yes
712945642532958208,  Marco48756199, 2, 2, 0, yes
495033886,  chiaroline, 1, 1, 0, yes
240822656,  jorisdancot, 1, 1, 0, yes
4840224262,  domenico_21st, 1, 1, 0, yes
2453200885,  MariaSaladinopd, 1, 1, 0, yes
37953750,  BernhardRude, 1, 1, 0, yes
421293572,  MAX_JUMP, 1, 1, 0, yes
50744846,  GiordanoPerico, 1, 1, 0, yes
1372642555,  raider763, 3, 3, 0, yes
2377047721,  LOsservante, 1, 1, 0, yes
236621542,  leonardometalli, 1, 1, 0, yes
431784727,  antonioavino, 2, 2, 0, yes
76884767,  LucaGras, 4, 4, 0, yes
599135419,  CarminePulzella, 1, 1, 0, yes
1242324488,  biancogian77, 6, 6, 0, yes
43163301,  matteoburico, 2, 2, 0, yes
272077852,  atomuan, 6, 3, 3, neutral
797477028161351680,  albertoA2610, 1, 1, 0, yes
479585948,  andrea_alunni, 1, 1, 0, yes
506030733,  JoeySere, 1, 1, 0, yes
182297051,  AldoCerroni, 1, 1, 0, yes
414680231,  ValerioMammone, 1, 1, 0, yes
387169207,  ilgustofilo, 1, 1, 0, yes
1669075927,  FedericaRo, 1, 1, 0, yes
507579268,  fantaspino, 1, 1, 0, yes
517147820,  MaxDorian90, 1, 1, 0, yes
199434768,  robicato, 1, 1, 0, yes
399964269,  mororosso, 5, 1, 4, no
745891141237760000,  SorrentinoMic, 1, 1, 0, yes
326679529,  N1ccolo, 1, 1, 0, yes
537446680,  IvanBergami, 1, 1, 0, yes
268891887,  loreinter, 1, 1, 0, yes
267925085,  _Andrea_Ant, 2, 2, 0, yes
446511103,  DamoreDAmore, 1, 1, 0, yes
96589915,  AndreaPMP, 1, 1, 0, yes
764199430941712384,  robi89222547, 1, 1, 0, yes
735853459103223808,  CarloMilan95, 1, 1, 0, yes
1227965000,  ivanlupo969, 3, 3, 0, yes
132538866,  Biondoravenna, 1, 1, 0, yes
424154220,  turicalabrese, 8, 7, 1, yes
1213735286,  senzapaga, 1, 1, 0, yes
3330240280,  dorismarchetti1, 1, 1, 0, yes
428289775,  Domo_asr, 1, 1, 0, yes
1725012834,  mauromilanista, 1, 1, 0, yes
403515713,  musicslifesoul, 1, 1, 0, yes
454720001,  Claudia_Cervini, 1, 1, 0, yes
2435218631,  zariotwt, 3, 2, 1, yes
47114753,  rozelyn1984, 1, 1, 0, yes
804780499231272960,  thedoc1007, 1, 1, 0, yes
85325283,  Am_Barbara, 2, 2, 0, yes
428510819,  LaraLiotta, 1, 1, 0, yes
3353996691,  mia_diletta, 1, 1, 0, yes
795291600662437899,  estel_edo, 1, 1, 0, yes
291044197,  antoniodag75, 1, 1, 0, yes
616052541,  elib62, 1, 1, 0, yes
3089192073,  edoardo_ceriani, 1, 1, 0, yes
365150406,  Aiko_Natzumi, 1, 1, 0, yes
423777278,  LuFraCi, 1, 1, 0, yes
15593503,  Iridium24, 1, 1, 0, yes
2886214750,  danielmitric, 1, 1, 0, yes
963263815,  antomura1978, 1, 1, 0, yes
303322026,  martamicolf, 1, 1, 0, yes
419823058,  simonettaconti, 1, 1, 0, yes
352430203,  CeneFra, 1, 1, 0, yes
401557941,  GiampaoloGulli, 1, 1, 0, yes
521647232,  stefanocirrinci, 2, 2, 0, yes
434343679,  pepp32, 2, 1, 1, neutral
289347170,  arenik17, 1, 1, 0, yes
445832505,  ciani_michele, 2, 1, 1, neutral
217381810,  tokyo_0, 1, 1, 0, yes
1062886831,  LuigiVillano10, 1, 1, 0, yes
773235943419604993,  franlvt, 1, 1, 0, yes
1175400422,  MarcoBisso, 2, 1, 1, neutral
183988375,  Mario_Colleoni, 1, 1, 0, yes
202113803,  PD_Lombardia, 2, 2, 0, yes
35481847,  rikcristil, 1, 1, 0, yes
263845240,  FrancesNewman3, 1, 1, 0, yes
48460902,  ValeLaTerza, 1, 1, 0, yes
420193880,  GiusPerri, 1, 1, 0, yes
1889137992,  enzoacquisto, 2, 2, 0, yes
28426876,  maribergo, 3, 3, 0, yes
418763256,  trisorio, 1, 1, 0, yes
2407011606,  CorradoAbbondi, 1, 1, 0, yes
72275942,  bertous, 1, 1, 0, yes
390316543,  JacopoDini, 1, 1, 0, yes
3044954049,  hollywoodians, 3, 2, 1, yes
9879172,  fabiocomelli, 1, 1, 0, yes
80079643,  venderbure, 1, 1, 0, yes
586045261,  Efesto70, 1, 1, 0, yes
382351899,  FatigatiV, 1, 1, 0, yes
386214140,  yurizoli, 1, 1, 0, yes
22603913,  _MariaLarosa, 1, 1, 0, yes
2510254619,  bagnatidalsole_, 2, 2, 0, yes
536368250,  simoberny, 1, 1, 0, yes
368405739,  silv10tedesco, 1, 1, 0, yes
2853872685,  unaenirati, 1, 1, 0, yes
2326224523,  SangueBlu73, 1, 1, 0, yes
3112443346,  massimoclerici3, 1, 1, 0, yes
299638032,  Maurizio_Bell, 1, 1, 0, yes
1915168326,  NicDorazio, 1, 1, 0, yes
460598125,  grclsn, 1, 1, 0, yes
824767958,  ceciagg, 1, 1, 0, yes
3438905411,  6e2ffe03521e474, 7, 5, 2, yes
1880755172,  salvad_m, 1, 1, 0, yes
424163949,  WeeMarco, 2, 2, 0, yes
2996880806,  thomas_tonetto, 1, 1, 0, yes
96842824,  Ste_Pinkish, 2, 1, 1, neutral
1016106888,  giamalba, 2, 2, 0, yes
103057495,  yesrema, 1, 1, 0, yes
1261935721,  Davideonline, 1, 1, 0, yes
791378714537889792,  TM8_italia, 2, 2, 0, yes
1231611342,  DanieleDeGu, 1, 1, 0, yes
321425048,  EmidioPierro, 1, 1, 0, yes
2158771718,  puntinosullaG, 2, 2, 0, yes
459275547,  KarenSarlo, 6, 6, 0, yes
137708693,  TomasHerzovich, 1, 1, 0, yes
4142962655,  Mistic_River, 1, 1, 0, yes
1043089045,  Bronzfamily, 1, 1, 0, yes
2969499394,  luigi_turci, 1, 1, 0, yes
2704006331,  BacinBaloo, 2, 1, 1, neutral
1016181973,  fashionboycry, 1, 1, 0, yes
2691158463,  AndreaHighway, 1, 1, 0, yes
366729610,  MartinManfro, 1, 1, 0, yes
28643746,  FerdinandoLM, 1, 1, 0, yes
3534145156,  dylan_mckane, 1, 1, 0, yes
95976253,  gabrielledrew95, 1, 1, 0, yes
138782102,  ilsinidimilano, 1, 1, 0, yes
51152921,  bellonetom, 1, 1, 0, yes
2986089309,  robertalabonia, 2, 2, 0, yes
389942998,  Filippo_C88, 1, 1, 0, yes
4889062487,  Giusyonlyyou, 1, 1, 0, yes
427252412,  MDelRed, 1, 1, 0, yes
2953442253,  francescofarigu, 1, 1, 0, yes
61187948,  fabiogermani, 2, 1, 1, neutral
2506490109,  PesinoPesino, 1, 1, 0, yes
4843877464,  Vissottanta, 1, 1, 0, yes
421106884,  AntonioBiundo1, 1, 1, 0, yes
394362305,  gienjoy, 1, 1, 0, yes
624755362,  Matthieu__P, 1, 1, 0, yes
758663392471187456,  jv_marko, 1, 1, 0, yes
875651755,  CiaoKarol, 1, 1, 0, yes
290810039,  HumbertoHTC, 1, 1, 0, yes
3240511971,  ema9792, 1, 1, 0, yes
27835061,  Tosy73, 1, 1, 0, yes
59842693,  manolomata, 1, 1, 0, yes
2522635730,  peppe_termine, 1, 1, 0, yes
585953833,  umagrini, 1, 1, 0, yes
538272044,  blancanicvar, 1, 1, 0, yes
136368373,  Teresona80, 1, 1, 0, yes
2461714062,  Stefano55317332, 1, 1, 0, yes
103573618,  Da_Macchi, 1, 1, 0, yes
1151252660,  GuillermoGiFu, 1, 1, 0, yes
2937510635,  Daviddesiderio2, 1, 1, 0, yes
206609186,  VitoPalmi, 1, 1, 0, yes
16145458,  DianaMalerba, 1, 1, 0, yes
2196158781,  D_Vannoni, 1, 1, 0, yes
2770027941,  DaldoBike46, 1, 1, 0, yes
3242345475,  berberbiker, 1, 1, 0, yes
1680754122,  N_eoreJ, 2, 1, 1, neutral
773404116399820800,  Chiara63103617, 1, 1, 0, yes
1051228465,  RouxPasquale, 1, 1, 0, yes
14210150,  saponaro, 1, 1, 0, yes
2382734438,  Marinodino2, 2, 2, 0, yes
2539642920,  rpr8395, 1, 1, 0, yes
157167481,  Luis_Huacuja_A, 1, 1, 0, yes
795675927363645441,  DanieleOrfila, 6, 3, 3, neutral
391971112,  LorenzoTomei, 1, 1, 0, yes
1047860948,  DonataBoesso, 1, 1, 0, yes
1723022899,  VassalloLazzaro, 1, 1, 0, yes
714573162,  PaoloZepPicchio, 1, 1, 0, yes
418182287,  MatteoUrru, 1, 1, 0, yes
2607148602,  tnsstan, 1, 1, 0, yes
2843337297,  FVincenzi1986, 1, 1, 0, yes
3209519350,  carlottacepo, 1, 1, 0, yes
955439466,  RidetRidet, 1, 1, 0, yes
67279668,  compolitica, 1, 1, 0, yes
77182524,  liviacirone, 1, 1, 0, yes
130890180,  nickss_, 1, 1, 0, yes
49926262,  elisatron, 4, 3, 1, yes
2481860582,  vitt_iannotta, 1, 1, 0, yes
25367826,  mcinnis_erin, 1, 1, 0, yes
22321740,  joaovale, 1, 1, 0, yes
287845358,  gianni_ventola, 2, 2, 0, yes
52394311,  paolobiondi, 1, 1, 0, yes
427371278,  romanom71, 1, 1, 0, yes
47991037,  guado77, 2, 2, 0, yes
722795666825568256,  cdfangelo, 1, 1, 0, yes
1433974471,  cipuostare, 1, 1, 0, yes
308933620,  MorabitoG, 1, 1, 0, yes
439590391,  RupicI, 1, 1, 0, yes
42783546,  m_ntst, 1, 1, 0, yes
223312494,  ben_shore, 1, 1, 0, yes
309724856,  Fredy_Rotonda, 1, 1, 0, yes
2745252699,  AlfredoGirardi, 1, 1, 0, yes
1124944140,  nympheasroses, 5, 4, 1, yes
361751767,  PeterBirro, 1, 1, 0, yes
191524366,  skillyjazz, 3, 3, 0, yes
26193119,  adewolff, 1, 1, 0, yes
507594598,  albsreale, 1, 1, 0, yes
501007314,  webenets, 1, 1, 0, yes
250608984,  NicolaFiaschi, 1, 1, 0, yes
792748892358053888,  Rossella1203, 1, 1, 0, yes
125780180,  damkup, 1, 1, 0, yes
1286913812,  simonecassin, 1, 1, 0, yes
384822158,  PatrizioVit, 2, 2, 0, yes
394105608,  aleciampini, 1, 1, 0, yes
1640473700,  FabrizioBrocca1, 2, 2, 0, yes
768467383228956672,  DunyaPorrani, 1, 1, 0, yes
16968656,  pedro75, 2, 1, 1, neutral
912051726,  MirkaMartelli, 1, 1, 0, yes
1241455146,  CLuca_Nicoletti, 1, 1, 0, yes
459180066,  belindezena, 12, 12, 0, yes
140074228,  reportmuenchen, 1, 1, 0, yes
178786446,  SusieLJ4113, 1, 1, 0, yes
78036431,  casadelaloca, 1, 1, 0, yes
1243895455,  FrancoPalmieri4, 1, 1, 0, yes
3577167016,  frankat76, 1, 1, 0, yes
485114039,  delf97, 1, 1, 0, yes
24865599,  PaoloMoretti, 1, 1, 0, yes
297521602,  aghisaura, 1, 1, 0, yes
375281956,  stefanofiorillo, 1, 1, 0, yes
447401345,  boninisimone, 1, 1, 0, yes
897445088,  alegiumat, 1, 1, 0, yes
397173604,  MERCEDESPANTA, 1, 1, 0, yes
401308330,  FrancescoGld, 2, 1, 1, neutral
132833078,  donatellissima, 2, 2, 0, yes
280641531,  MotardDu94000, 2, 1, 1, neutral
257066360,  immaaguilar, 1, 1, 0, yes
755466947375013888,  despertos88, 1, 1, 0, yes
381163948,  LucianaMMorgera, 1, 1, 0, yes
593652712,  salvatore_riggi, 1, 1, 0, yes
1411023120,  a_presbitero, 2, 2, 0, yes
386123511,  MaxMinervini, 1, 1, 0, yes
418652809,  ChiccaChimienti, 1, 1, 0, yes
3949687521,  Essad_T, 1, 1, 0, yes
538538805,  francegreco2010, 2, 2, 0, yes
2462278165,  Carlitos_Loba, 1, 1, 0, yes
423185298,  AngeluccioNetti, 1, 1, 0, yes
2973395025,  edocupia, 1, 1, 0, yes
140442781,  chrispergola, 2, 2, 0, yes
621433,  StephZibi, 1, 1, 0, yes
59485731,  navi68, 1, 1, 0, yes
3523056802,  manetti_elena, 1, 1, 0, yes
732353497887178752,  eortizijornet, 1, 1, 0, yes
1384359890,  BiniMavie, 1, 1, 0, yes
261420561,  BLVitela, 1, 1, 0, yes
795015324596895744,  corcostr, 1, 1, 0, yes
1078026440,  LordOfVenice, 1, 1, 0, yes
69074548,  rodbarbieri, 1, 1, 0, yes
2788841721,  fabiolupo_, 1, 1, 0, yes
1373189510,  giovannidorto, 2, 2, 0, yes
1004773549,  ddmp1648, 1, 1, 0, yes
856426165,  DanielaMuradore, 1, 1, 0, yes
229120963,  valuskina, 6, 6, 0, yes
2487102222,  rikishi1996, 3, 2, 1, yes
3478841655,  FedeJo982, 4, 4, 0, yes
132477836,  milagro_twins, 1, 1, 0, yes
746720195922767873,  Kant_Illuminist, 1, 1, 0, yes
802228318871388160,  guia44078251, 1, 1, 0, yes
195454744,  Lauriberto, 1, 1, 0, yes
2778530818,  SrMariaclaudia, 1, 1, 0, yes
611634072,  SamuelGiove, 1, 1, 0, yes
565248340,  fiege_max, 1, 1, 0, yes
4846874405,  BaratheonMirko, 1, 1, 0, yes
2945936519,  chiaracibe, 1, 1, 0, yes
2162679080,  assi_saji, 2, 2, 0, yes
782928424109244416,  bethslaterza, 1, 1, 0, yes
703972216,  BuccoDiego90, 1, 1, 0, yes
110200585,  BarriosTorales, 1, 1, 0, yes
1727129084,  scegob, 2, 2, 0, yes
2848500969,  RickyGary68, 1, 1, 0, yes
28377017,  lorenzodavalos, 1, 1, 0, yes
1959049868,  VirnaDG, 1, 1, 0, yes
740538119125078016,  BakisMurgia, 1, 1, 0, yes
113045622,  MiChiamoPenny, 1, 1, 0, yes
418234589,  MariaritaSisto, 1, 1, 0, yes
738860584821751808,  lorix65, 1, 1, 0, yes
4800423792,  charlytos4u, 1, 1, 0, yes
2834772743,  moscaalex1, 1, 1, 0, yes
355428122,  FranciNiccheri, 2, 2, 0, yes
2850133379,  BdaouiSoufiane, 1, 1, 0, yes
363042332,  ClarCArLO, 1, 1, 0, yes
710148109901426689,  627ca5317ee8407, 1, 1, 0, yes
1845173006,  terzimichele, 1, 1, 0, yes
3435506849,  dino81bras, 3, 1, 2, no
2174471289,  piccolodio, 10, 8, 2, yes
4126934782,  pia_bonola, 1, 1, 0, yes
4893217048,  la_sanza, 1, 1, 0, yes
362069633,  mariolino66, 1, 1, 0, yes
4888351385,  scerra_fra, 2, 2, 0, yes
489493520,  Sandra_primer, 4, 3, 1, yes
214579361,  MariaRosaMare, 1, 1, 0, yes
105531870,  vamba59, 1, 1, 0, yes
791195738785087488,  busviz, 4, 3, 1, yes
2264006410,  alepozzato, 1, 1, 0, yes
2984135811,  fiorenzoborett3, 1, 1, 0, yes
534223695,  bovans01, 3, 1, 2, no
1534128798,  FLPFRZ, 1, 1, 0, yes
295948759,  SilviaNegretto, 1, 1, 0, yes
2239749823,  nuzzi80, 1, 1, 0, yes
2557326428,  BertoliGiacomo, 1, 1, 0, yes
988797656,  balordo3, 2, 2, 0, yes
2586065103,  careddu_gio, 1, 1, 0, yes
4878966425,  rosaria_zerbini, 1, 1, 0, yes
2446911433,  enesyilmazz98, 1, 1, 0, yes
799256731079610368,  Cottignola_A, 1, 1, 0, yes
2482817466,  giampiero661, 1, 1, 0, yes
1226060282,  U_Flora, 1, 1, 0, yes
1670649835,  annalisasongia, 2, 2, 0, yes
355523123,  castiglio87, 1, 1, 0, yes
2659400945,  Fabrizio751, 2, 2, 0, yes
553374200,  stefanodottcomm, 8, 4, 4, neutral
564566016,  AntonelloDeMasi, 1, 1, 0, yes
2289380756,  mario12309060, 2, 1, 1, neutral
872218404,  angelo_ragusa, 1, 1, 0, yes
395574751,  marte_number1, 1, 1, 0, yes
594424911,  minimibotha, 1, 1, 0, yes
2248466202,  romanelli_fede, 1, 1, 0, yes
1102903188,  Geri_Sallitto, 4, 4, 0, yes
16498488,  sgabroz, 1, 1, 0, yes
805096306461069312,  beherenowww, 1, 1, 0, yes
298874408,  bonifazzi200, 1, 1, 0, yes
14473764,  2021, 1, 1, 0, yes
72432108,  totedj, 1, 1, 0, yes
541037607,  PhotoRecal, 1, 1, 0, yes
1332443192,  LesieurAntoine, 1, 1, 0, yes
192938261,  DenisAguirreC, 1, 1, 0, yes
67876581,  ilaria_c, 1, 1, 0, yes
202398659,  __E_m_i, 4, 2, 2, neutral
4484178340,  WalterWalter198, 1, 1, 0, yes
710075387057983489,  DavideSimeoni2, 1, 1, 0, yes
125526196,  pacoconte, 1, 1, 0, yes
186014963,  giovannitaurasi, 1, 1, 0, yes
4718468032,  mile_zh, 2, 2, 0, yes
364842055,  GabrieleRoss, 1, 1, 0, yes
2883146585,  VVoltolin, 1, 1, 0, yes
706745153109794816,  Daniela_Micco, 1, 1, 0, yes
415027449,  emamatturri, 1, 1, 0, yes
2839838987,  arbidani, 1, 1, 0, yes
3034117503,  cyp_hdn, 1, 1, 0, yes
290511795,  lentz_live, 1, 1, 0, yes
700359428122505216,  raffrachieli, 2, 2, 0, yes
743735767604699141,  gaspareezuzzur1, 2, 2, 0, yes
520595162,  FPenati, 1, 1, 0, yes
2218092468,  consuelo2105, 1, 1, 0, yes
240191766,  Mrlore9, 1, 1, 0, yes
748103713995227136,  gmlegnino, 2, 2, 0, yes
780711009883344896,  MyBodyWorkout, 1, 1, 0, yes
356009891,  raffaelepascale, 1, 1, 0, yes
338351183,  daniela_curreli, 1, 1, 0, yes
6245442,  Alexiel85, 1, 1, 0, yes
299824035,  bvd75, 1, 1, 0, yes
761248696197640192,  mauro_tita, 2, 2, 0, yes
1052654228,  frainna, 2, 2, 0, yes
500654851,  lucaalgenii, 1, 1, 0, yes
729952668999942144,  salemi_omar, 1, 1, 0, yes
70949497,  andrew_t80, 1, 1, 0, yes
1249320013,  MariangelaLugl1, 3, 2, 1, yes
154844900,  marcomartis2, 1, 1, 0, yes
168659266,  patriziacarbone, 1, 1, 0, yes
2362319847,  MMennuno, 2, 2, 0, yes
111828008,  rinoooooooooo, 1, 1, 0, yes
1750311,  Shugotenshi, 1, 1, 0, yes
1864406076,  faxfassina, 1, 1, 0, yes
763713794,  andreagoldstei6, 1, 1, 0, yes
203124202,  pepromano, 1, 1, 0, yes
845007600,  Mamo_Piccioli, 1, 1, 0, yes
1254323509,  JensWoelk, 2, 1, 1, neutral
400599578,  Fabiodeciuceis, 3, 3, 0, yes
445595745,  iso24ari, 1, 1, 0, yes
750372158367535104,  mari_alpy, 1, 1, 0, yes
311951978,  leoleoncinofi, 1, 1, 0, yes
1360191522,  pereazzo9, 1, 1, 0, yes
1009410301,  nuvolox71, 1, 1, 0, yes
87449931,  Biz_sebastian, 1, 1, 0, yes
2361499298,  Denis_Donadel, 1, 1, 0, yes
161268878,  AndreCardi, 2, 2, 0, yes
403706239,  fabdeagostini, 7, 7, 0, yes
796852735421403137,  anna_giagheddu, 1, 1, 0, yes
2792341073,  geopetrosino, 1, 1, 0, yes
701825129366552577,  SilvanLuisa, 3, 3, 0, yes
298666055,  gianrebucini, 1, 1, 0, yes
574376779,  valscot7, 1, 1, 0, yes
2971620695,  raffacalore72, 2, 2, 0, yes
2184578097,  vmastra, 1, 1, 0, yes
801729096459964416,  frasilupa, 3, 2, 1, yes
2827362754,  norma_marco_M5S, 6, 4, 2, yes
69280093,  elyraw, 1, 1, 0, yes
707026630,  RomoloCalisi, 1, 1, 0, yes
1135208660,  ivivas117, 1, 1, 0, yes
426920970,  annacci1, 2, 1, 1, neutral
392955088,  PFMinnucci, 2, 2, 0, yes
4919832610,  selfromanticism, 1, 1, 0, yes
301507167,  L_CaronMusto, 1, 1, 0, yes
399894162,  ChristianDoinet, 1, 1, 0, yes
3065734378,  Labarblebelle, 1, 1, 0, yes
373812385,  NteManu, 1, 1, 0, yes
800053105433964545,  holly194622, 1, 1, 0, yes
50239937,  antoputignano, 1, 1, 0, yes
346584828,  Alcarin78, 1, 1, 0, yes
480772557,  annunziata68, 1, 1, 0, yes
2495957832,  margher30817465, 2, 2, 0, yes
805483403101503488,  totonico6356, 4, 4, 0, yes
4857718281,  RobyMagrobius, 2, 2, 0, yes
2348529975,  fioresie, 3, 1, 2, no
1558979455,  andrea91pick, 1, 1, 0, yes
1060007233,  StefanoSteven1, 1, 1, 0, yes
2306190441,  CorsaroEnza, 1, 1, 0, yes
987116222,  bracco960, 1, 1, 0, yes
2778060755,  MusengaSm, 1, 1, 0, yes
2178801373,  jesusph87, 1, 1, 0, yes
484592863,  dayflyer, 1, 1, 0, yes
432858035,  nicola_capone, 1, 1, 0, yes
2196532040,  Giammy_Mores, 1, 1, 0, yes
293393953,  pameladauria, 1, 1, 0, yes
3928701,  Monnolo, 2, 2, 0, yes
727666699,  ArgentinaSoy1, 1, 1, 0, yes
117708359,  centobuste, 2, 2, 0, yes
459606362,  maxminna, 1, 1, 0, yes
196787117,  miromannino, 1, 1, 0, yes
559822492,  FrancescoTrove, 1, 1, 0, yes
230696096,  marinabologna, 1, 1, 0, yes
1620370315,  GhessasKennel, 1, 1, 0, yes
751790735494619137,  gpizmb, 2, 2, 0, yes
191907960,  ettabi93, 1, 1, 0, yes
2583150213,  lvngwaydown, 1, 1, 0, yes
1301069341,  abrizzi79, 1, 1, 0, yes
45887791,  andreinaromano, 1, 1, 0, yes
165052214,  federicatosello, 1, 1, 0, yes
2366982160,  BrigatiEli, 1, 1, 0, yes
593136453,  faffo202, 3, 3, 0, yes
478890597,  Tommaso_Pinter, 1, 1, 0, yes
71488891,  andy_olive, 1, 1, 0, yes
2271919946,  plessaanastasia, 1, 1, 0, yes
87375963,  AlfredoSpagna, 1, 1, 0, yes
255429223,  ieranto, 1, 1, 0, yes
714527714,  GAlbertelli, 2, 1, 1, neutral
572936933,  paolaMilani6, 3, 2, 1, yes
269300422,  Geggio29, 1, 1, 0, yes
3031672075,  GiroMichele, 1, 1, 0, yes
415058338,  MicheleCarletti, 1, 1, 0, yes
546892543,  MassimoLarosa3, 1, 1, 0, yes
1030469935,  MRomanoRC, 2, 2, 0, yes
467434125,  FDElovah, 2, 2, 0, yes
722166011307417600,  RickePaula, 1, 1, 0, yes
2434269917,  dr_antoniorusso, 1, 1, 0, yes
2728015055,  CaveSergio, 1, 1, 0, yes
726047154184265728,  JoeFau2014, 1, 1, 0, yes
1425121099,  stefivecchi, 1, 1, 0, yes
2936019933,  Raffo_Official, 3, 3, 0, yes
390386210,  LucentiNestor, 1, 1, 0, yes
759622517648658433,  tedgab70, 1, 1, 0, yes
128648069,  sibiuan, 2, 2, 0, yes
805765679332855808,  fabrizi_ivano, 1, 1, 0, yes
737927383148285952,  SabrimaScasso, 1, 1, 0, yes
739167266760183808,  Paolaromanord, 1, 1, 0, yes
1340122417,  MauriziSilvia, 1, 1, 0, yes
1063939244,  Lillatro1, 1, 1, 0, yes
576954385,  DucaBonacini, 1, 1, 0, yes
330282851,  PierZaccone, 1, 1, 0, yes
2869253230,  GuidoMLeonardi, 2, 2, 0, yes
514665209,  semicarme, 2, 2, 0, yes
92052564,  megababi, 2, 2, 0, yes
455660676,  adbsdebbus, 1, 1, 0, yes
521681061,  CatebeaCaterina, 1, 1, 0, yes
2484868361,  PellegattaD, 1, 1, 0, yes
847108200,  Meharis60, 2, 2, 0, yes
403697237,  LuigiReviglio, 1, 1, 0, yes
1270438662,  johdima, 3, 3, 0, yes
779608862064246784,  SilvioDiGiovan1, 1, 1, 0, yes
207023275,  wiljamp, 2, 2, 0, yes
1660751173,  fioretebe, 1, 1, 0, yes
440369275,  flavietta_de, 1, 1, 0, yes
188409000,  gasagram, 1, 1, 0, yes
422227339,  AngelaPetrone82, 1, 1, 0, yes
4184261189,  giuliloca_, 3, 3, 0, yes
360045728,  Gonibonibo, 1, 1, 0, yes
2277154035,  daccoltisilvia, 1, 1, 0, yes
2246899150,  ProfM73, 1, 1, 0, yes
1967432390,  salimbenimattia, 1, 1, 0, yes
3207820852,  antosiege, 1, 1, 0, yes
2778247005,  CanutiGabriella, 2, 2, 0, yes
3407280022,  sandro_boscolo, 2, 2, 0, yes
87954672,  birtheskyt, 1, 1, 0, yes
805766429660348416,  mazio61, 1, 1, 0, yes
2377701816,  simone_tironi, 1, 1, 0, yes
750286035733667840,  ManiniEmanuela, 1, 1, 0, yes
2582275394,  MsoeAda, 1, 1, 0, yes
954174110,  safewriter, 1, 1, 0, yes
805744563390447617,  MonPag63, 1, 1, 0, yes
4609789701,  MilardoLucilla, 2, 2, 0, yes
1007097450,  iz8pox_roberto, 1, 1, 0, yes
1336563324,  ShisusReloaded, 1, 1, 0, yes
3015335643,  Elena_342, 2, 2, 0, yes
1885697252,  pba1967, 3, 3, 0, yes
381032878,  angelaico, 1, 1, 0, yes
1353946608,  GiadaRem, 2, 2, 0, yes
2416109272,  squaletto82, 1, 1, 0, yes
2252400478,  PresJuni, 1, 1, 0, yes
602368173,  ElGiMa2, 2, 2, 0, yes
805040856,  pietrocicognan1, 1, 1, 0, yes
1901726623,  toreoliena, 1, 1, 0, yes
1252167206,  AlexCastilletti, 1, 1, 0, yes
2899666713,  matteocapellih1, 1, 1, 0, yes
768831371653554176,  riccardorizzi5, 2, 2, 0, yes
2408108734,  LucaCecconi6, 1, 1, 0, yes
3290871062,  betti_cott, 1, 1, 0, yes
91381777,  do_green, 1, 1, 0, yes
2330553377,  dario94dr, 1, 1, 0, yes
2302794340,  DarioTaddeo, 1, 1, 0, yes
380346533,  PaoloRen_79, 1, 1, 0, yes
3030689795,  magra20141, 1, 1, 0, yes
2182107570,  banfi555, 1, 1, 0, yes
3221128415,  pivacorpifreddi, 1, 1, 0, yes
545261922,  pasqualecerofol, 2, 2, 0, yes
48749311,  RossellaBenatti, 1, 1, 0, yes
2480440491,  __hollydeedee, 1, 1, 0, yes
552813421,  CaterinaSolini, 1, 1, 0, yes
1367290652,  BUmbellici, 1, 1, 0, yes
99964869,  marrus91, 2, 1, 1, neutral
189234594,  DelSorboMaria, 1, 1, 0, yes
384569823,  salvocaputo79, 1, 1, 0, yes
560977621,  AlessioSuriano2, 2, 2, 0, yes
160578815,  Jozannyme, 4, 1, 3, no
1031029266,  annaritacir, 1, 1, 0, yes
802559032733167617,  Marilyvetro, 1, 1, 0, yes
384792569,  GiuliaV5, 2, 2, 0, yes
797437809644732417,  RossGiovagnoli, 1, 1, 0, yes
707616770656436224,  Michele93114291, 2, 2, 0, yes
4777818957,  Laurapastorell4, 1, 1, 0, yes
64373600,  fliesen1, 2, 2, 0, yes
733286484741107713,  tantisaluti, 1, 1, 0, yes
548361139,  RedDarter, 1, 1, 0, yes
769740390,  KilljoyGP, 3, 2, 1, yes
2486449973,  beanfiex, 1, 1, 0, yes
2340064633,  maribioleta, 2, 2, 0, yes
2806979686,  az0068, 3, 3, 0, yes
771435393568899072,  disalvomanfred1, 1, 1, 0, yes
1710060782,  anto_effe, 1, 1, 0, yes
4896156933,  bluhawaii3, 2, 1, 1, neutral
791874462,  croceagnello, 2, 2, 0, yes
2835112095,  HckDonatella, 1, 1, 0, yes
1065627055,  cavrin32, 1, 1, 0, yes
1547773470,  CorradoZucca1, 4, 4, 0, yes
699288457626181633,  ivana53M, 2, 1, 1, neutral
351468435,  Alee___4, 3, 3, 0, yes
162694129,  maccal2011, 1, 1, 0, yes
466890371,  Simone40V, 1, 1, 0, yes
246277707,  famaxi73, 3, 3, 0, yes
13160192,  sa_tomas, 1, 1, 0, yes
796422594,  NICOLETTA_46_, 2, 1, 1, neutral
789206471934214144,  gianlujuve10, 1, 1, 0, yes
1262291346,  PPMZAF, 1, 1, 0, yes
108966770,  LaGazzettaWeb, 5, 3, 2, yes
309249918,  HugoBas, 1, 1, 0, yes
960528517,  powertohobos, 1, 1, 0, yes
325081770,  a_iodi6, 1, 1, 0, yes
482107186,  gabrieleuggeri, 1, 1, 0, yes
3207190541,  CitGabriella, 1, 1, 0, yes
745208961255735296,  PoshAssHole, 1, 1, 0, yes
2691852287,  Francesco2370, 1, 1, 0, yes
1883695837,  Marco813coltro, 1, 1, 0, yes
2239794777,  GualtieriIlaria, 1, 1, 0, yes
182810905,  pablorojasit, 1, 1, 0, yes
720753642597453825,  MarcoPavoneCz, 1, 1, 0, yes
233672808,  _LaNanda, 1, 1, 0, yes
801874250621558784,  mevrouwalexis, 1, 1, 0, yes
2743185794,  VitoCisternino9, 1, 1, 0, yes
1342563883,  NyMataguilera, 1, 1, 0, yes
2769402819,  sugarsoul_, 1, 1, 0, yes
19491723,  Pappydude, 1, 1, 0, yes
775008264572571648,  matpellegrino, 1, 1, 0, yes
393348679,  daniele_maccio, 1, 1, 0, yes
416147718,  franco7402, 1, 1, 0, yes
2838223366,  dangdaide, 4, 1, 3, no
312150744,  blunotte17, 1, 1, 0, yes
3196463729,  SSer778, 3, 3, 0, yes
777639123226165248,  frefrancesca81, 1, 1, 0, yes
2865730870,  met_valpo, 1, 1, 0, yes
318506183,  RossellaStamati, 1, 1, 0, yes
805573689202839552,  michele31928092, 1, 1, 0, yes
149102823,  lullabyfatale, 2, 2, 0, yes
3869536593,  CA_Streaming, 4, 2, 2, neutral
295075775,  CarloKioCiocca, 1, 1, 0, yes
1223057479,  DR_ietti, 1, 1, 0, yes
376603768,  barcalofia, 1, 1, 0, yes
713136440088129539,  etrusco1957, 3, 3, 0, yes
195953303,  Lou1S89, 1, 1, 0, yes
257055724,  fadipas, 1, 1, 0, yes
16463311,  geppy52, 1, 1, 0, yes
755661374785724416,  DonLuciano10, 1, 1, 0, yes
742611407867412480,  mschloee, 1, 1, 0, yes
435564122,  carlillis78, 1, 1, 0, yes
5988932,  aliceavallone, 1, 1, 0, yes
476243412,  marcepa49, 1, 1, 0, yes
412968604,  dutchsandwich, 1, 1, 0, yes
2784749050,  BLopes_BL, 1, 1, 0, yes
3108558635,  Simo_Tweet, 1, 1, 0, yes
740289354225094656,  gerrynadilevv, 1, 1, 0, yes
2569249636,  MauroSanfelici, 4, 1, 3, no
1155080588,  Mymanucan, 1, 1, 0, yes
416632865,  cislyV, 1, 1, 0, yes
486621384,  GiovanniSaliani, 1, 1, 0, yes
609159320,  GiovannaFrene, 3, 3, 0, yes
567052799,  gavinedda, 2, 2, 0, yes
2864655377,  giulyscisci, 2, 1, 1, neutral
14139772,  kronn, 1, 1, 0, yes
107020880,  slivermetal, 3, 3, 0, yes
2898087731,  Frameroni, 1, 1, 0, yes
460854604,  NicolaCavalier2, 1, 1, 0, yes
4622374936,  simo_lions, 2, 1, 1, neutral
2395092806,  stefani2170, 1, 1, 0, yes
431009968,  AntonioGermano0, 1, 1, 0, yes
1249938181,  Sorcina67, 1, 1, 0, yes
186024392,  questo_immenso, 1, 1, 0, yes
1350411,  jlazaro, 9, 1, 8, no
587671882,  chiara_destefan, 4, 4, 0, yes
3399983187,  Claudio61372742, 1, 1, 0, yes
3246272185,  guido_fellini, 1, 1, 0, yes
485689510,  213Gruppuso, 1, 1, 0, yes
163904433,  GianlucaOdinson, 1, 1, 0, yes
1726637498,  EnterEsc, 1, 1, 0, yes
3221517904,  AnnaSapone_MD, 1, 1, 0, yes
554553427,  Filus_, 4, 2, 2, neutral
314425165,  Bigtimefans_, 1, 1, 0, yes
528833509,  IvanPistillo, 1, 1, 0, yes
577460723,  clapt1861, 1, 1, 0, yes
784921032,  antonionpltn, 3, 3, 0, yes
3243346745,  depinto_nicola, 1, 1, 0, yes
659973,  keeper1h, 1, 1, 0, yes
2676639177,  FrancMarra125, 1, 1, 0, yes
322216956,  Tittyshadhy, 1, 1, 0, yes
303347593,  MCresc, 9, 8, 1, yes
728748190724444160,  cyberego1, 1, 1, 0, yes
456050432,  NGourd, 1, 1, 0, yes
1030669428,  franzdemu, 1, 1, 0, yes
799237502,  TinoMichele, 3, 3, 0, yes
382734543,  EPovoledo, 1, 1, 0, yes
68236888,  co_G_ito, 1, 1, 0, yes
763704163373084672,  TaloniStefano, 4, 4, 0, yes
44081167,  AruVale77, 3, 2, 1, yes
2377463946,  avanzidicervell, 2, 2, 0, yes
251105503,  DanielePradetto, 2, 2, 0, yes
168457009,  cavoIina, 2, 1, 1, neutral
4910587203,  Giacomocoppol10, 1, 1, 0, yes
854401782,  essturmtruppen, 3, 3, 0, yes
756628625009569792,  anelenia31, 2, 2, 0, yes
1335364904,  antonio_viola83, 1, 1, 0, yes
453328441,  titty6561, 2, 2, 0, yes
400310928,  visconti69, 1, 1, 0, yes
740613442609000449,  PerilloMarcella, 1, 1, 0, yes
4166439586,  IreneFerri_, 1, 1, 0, yes
1262256306,  schirinzi_f, 1, 1, 0, yes
774917243222237184,  BisantiFilippo, 1, 1, 0, yes
731411565363232768,  gazza_alex, 2, 2, 0, yes
3656382388,  lallameoila, 1, 1, 0, yes
163080729,  gualactarus, 2, 2, 0, yes
10141482,  earriagada, 1, 1, 0, yes
104477588,  simona2101, 1, 1, 0, yes
330356688,  silviabernasco1, 2, 2, 0, yes
2324571745,  Andrea7Fracca, 1, 1, 0, yes
435687294,  rober1900, 1, 1, 0, yes
277375540,  lucariello76, 1, 1, 0, yes
2581052953,  SilviaLoForte, 2, 2, 0, yes
387193714,  mariellacardel, 1, 1, 0, yes
2976241827,  Gimar95, 1, 1, 0, yes
3111436635,  ff63336cf814404, 1, 1, 0, yes
2945845168,  LolloBerna95, 1, 1, 0, yes
153503737,  nktpnd, 1, 1, 0, yes
173890386,  DaniAmblasta, 1, 1, 0, yes
133364771,  salmez, 1, 1, 0, yes
1384363724,  LorellaAllerol, 1, 1, 0, yes
296738874,  djloiralinda, 1, 1, 0, yes
96630920,  sonjazap, 1, 1, 0, yes
114876546,  KarinaCopelloOK, 1, 1, 0, yes
1028105353,  laMariaRita, 1, 1, 0, yes
1362878707,  DomenicoDeRosa7, 3, 3, 0, yes
1324672099,  francescocozz12, 1, 1, 0, yes
701646025,  LuigiLoglisci, 2, 2, 0, yes
1106249214,  AndreaArcuri89, 1, 1, 0, yes
2161569822,  AleMarMatti, 1, 1, 0, yes
455222543,  angelolanza62, 1, 1, 0, yes
738802756878733312,  marilyferrari, 2, 2, 0, yes
139706562,  il_letterino, 1, 1, 0, yes
37445271,  13_Odin, 1, 1, 0, yes
130274802,  SpectrumNLD, 1, 1, 0, yes
24194827,  _stefanSia, 1, 1, 0, yes
195744292,  gidino, 1, 1, 0, yes
82765476,  italian_cat, 1, 1, 0, yes
108602344,  ulrichetcetera, 1, 1, 0, yes
745980918,  cris7313, 1, 1, 0, yes
534594234,  gianlucafagna, 1, 1, 0, yes
435162877,  marcodecade, 2, 2, 0, yes
429360621,  grassi_anna, 1, 1, 0, yes
44126374,  annapolentona, 1, 1, 0, yes
409484947,  martinaliotta, 2, 2, 0, yes
504524011,  cecco1976, 5, 2, 3, no
2364487620,  PATRIZIA953, 4, 4, 0, yes
397829165,  DomenicoDAuria, 1, 1, 0, yes
797286496906645504,  Emilianocatarsi, 1, 1, 0, yes
1575448430,  rocco_galluzzo, 1, 1, 0, yes
47949452,  Paulslettenhaar, 1, 1, 0, yes
54363042,  emmelle_miss, 1, 1, 0, yes
2754427949,  lelloedany46, 1, 1, 0, yes
786164847771840512,  massimo2302, 1, 1, 0, yes
941413034,  JohnsonSuzi, 1, 1, 0, yes
239089980,  tadjerouine, 1, 1, 0, yes
512991064,  NapolitanoCarlo, 2, 2, 0, yes
2745547739,  romainmetro, 1, 1, 0, yes
324500366,  IMDInternet, 1, 1, 0, yes
88468101,  gianni_casella, 1, 1, 0, yes
367112400,  biednone, 2, 2, 0, yes
727392350750801920,  475wildeymagnum, 2, 2, 0, yes
727850228829818880,  e_quintav, 2, 2, 0, yes
386559669,  emechelli, 1, 1, 0, yes
424599509,  GRodriguez__, 1, 1, 0, yes
988284498,  luca66111782, 1, 1, 0, yes
614098709,  ant_ior, 1, 1, 0, yes
301388743,  GLlamazares, 1, 1, 0, yes
50628790,  il_ceru, 1, 1, 0, yes
717263094544777216,  NisilliNicole, 1, 1, 0, yes
497217552,  pino__ricci, 1, 1, 0, yes
476588950,  UGambini, 1, 1, 0, yes
165765384,  pucci_francesca, 1, 1, 0, yes
3404323246,  carminescarano7, 1, 1, 0, yes
413890451,  MontellaAndrea, 3, 2, 1, yes
476777236,  RoccoMuzzi, 1, 1, 0, yes
737926406659842048,  giuliadimassa1, 1, 1, 0, yes
54491474,  honeyorange, 1, 1, 0, yes
734844491660730369,  giangiangi74, 1, 1, 0, yes
381598987,  FrancescoAmato_, 5, 4, 1, yes
1620935340,  TucciRoma, 2, 2, 0, yes
96197609,  givetwit67, 1, 1, 0, yes
464972446,  KiabiCbisi, 3, 2, 1, yes
804512863,  simoAsso210, 5, 1, 4, no
1009645262,  Matt2298, 1, 1, 0, yes
242868922,  paula1764, 1, 1, 0, yes
270035600,  LuigiLiguori, 2, 2, 0, yes
235556102,  luifecachi, 1, 1, 0, yes
719138026593644544,  cefalu_sailing, 1, 1, 0, yes
2512353200,  CredevoPeggio, 2, 2, 0, yes
27668241,  jonahhull, 1, 1, 0, yes
1468048220,  OlivDrot, 1, 1, 0, yes
507768657,  RickyBusky, 2, 1, 1, neutral
84368531,  carlottaquadri, 2, 2, 0, yes
4067950720,  masterace_27, 1, 1, 0, yes
49141541,  RiccardoStinga, 1, 1, 0, yes
1628630449,  apoatti, 1, 1, 0, yes
374354527,  kirycri, 1, 1, 0, yes
969733694,  FrancescaS73, 2, 2, 0, yes
582181251,  MariaFosco, 1, 1, 0, yes
1367747732,  AMagna7, 1, 1, 0, yes
620063798,  LaKazzimma, 2, 1, 1, neutral
840523495,  BattistaRossana, 1, 1, 0, yes
732858049904431104,  simone225cvx, 1, 1, 0, yes
4212344524,  arrigo_rocco, 1, 1, 0, yes
40870308,  Rybitzky, 1, 1, 0, yes
1238292738,  matteomariani13, 1, 1, 0, yes
1013879910,  comedian72, 7, 6, 1, yes
24181248,  p_ceretti, 1, 1, 0, yes
402589095,  alby_lucchini, 1, 1, 0, yes
4034284283,  guacci_gabriele, 3, 2, 1, yes
35224330,  SpilUmberto, 1, 1, 0, yes
50249561,  cladinge, 1, 1, 0, yes
779319008260657154,  Solito_Ignoto, 1, 1, 0, yes
797894838,  millenews, 1, 1, 0, yes
803762956244844545,  Giurdik94, 1, 1, 0, yes
487668041,  PaolaTalladira, 2, 2, 0, yes
3339171231,  ludovico_m03, 3, 3, 0, yes
575268462,  PhilippeVanKems, 1, 1, 0, yes
784568976,  whiskysodandbj, 1, 1, 0, yes
428232929,  AleAccardoP, 1, 1, 0, yes
727964611195056128,  Orsodallaluna, 1, 1, 0, yes
2250337170,  marcocamotti, 1, 1, 0, yes
2898971763,  marpro1977, 1, 1, 0, yes
583773679,  chiaretta_gelli, 1, 1, 0, yes
2823036120,  italianinsider, 1, 1, 0, yes
517533610,  readytorun___, 2, 2, 0, yes
1565868403,  kevindironza, 1, 1, 0, yes
187518687,  Obstacle3_, 1, 1, 0, yes
30772115,  RichFeloni, 1, 1, 0, yes
510541729,  A_B_Evans, 1, 1, 0, yes
779255232496893953,  michael_dejavu, 2, 2, 0, yes
284519305,  DavideGariglio, 2, 2, 0, yes
28091881,  suzanneshine, 1, 1, 0, yes
731589201641275392,  LuiGinopm, 1, 1, 0, yes
553686809,  Gianpaoloooo, 2, 2, 0, yes
2194451647,  paggans, 1, 1, 0, yes
466730231,  MelloBS, 1, 1, 0, yes
124594120,  Faberius, 1, 1, 0, yes
202829231,  chocodonte, 1, 1, 0, yes
435079528,  TeresaCioffi, 1, 1, 0, yes
161549964,  Mickey_Sc, 1, 1, 0, yes
2226920636,  k4artever, 1, 1, 0, yes
433423965,  PierfrancoR, 1, 1, 0, yes
329396578,  jolezakoka, 1, 1, 0, yes
455120411,  RussoForAmerica, 1, 1, 0, yes
439287906,  francescocarpy, 1, 1, 0, yes
118062862,  rosariopolizzi, 1, 1, 0, yes
17573681,  breakingbutter, 1, 1, 0, yes
786721110226264064,  marralucia81, 1, 1, 0, yes
739467944581844992,  danguardz, 1, 1, 0, yes
467322258,  panda_r1, 1, 1, 0, yes
793885942260064256,  294_39, 1, 1, 0, yes
130549887,  BahmanKalbasi, 1, 1, 0, yes
733298006,  robertograzza, 2, 2, 0, yes
377596180,  Sciandi, 2, 1, 1, neutral
899849024,  alexjuv76, 1, 1, 0, yes
384542223,  iaiapic, 1, 1, 0, yes
474994442,  MattiaHudson, 1, 1, 0, yes
353849397,  MicheleGadaleta, 1, 1, 0, yes
183682909,  Marta218, 1, 1, 0, yes
418814122,  rinoscala, 1, 1, 0, yes
717074321102004224,  MicheleGPizzo, 1, 1, 0, yes
418559193,  Conservative_88, 1, 1, 0, yes
2806392479,  tintinreports, 1, 1, 0, yes
228176071,  AlarmBell, 1, 1, 0, yes
3250816754,  LuisRomano9OM, 1, 1, 0, yes
3011673768,  caputmundiHeidi, 3, 3, 0, yes
1488233845,  AlexGen87, 2, 2, 0, yes
290562205,  sgueina, 1, 1, 0, yes
590852220,  totis73, 1, 1, 0, yes
134967469,  AlexMasiPhoto, 2, 2, 0, yes
368373639,  MassimoDufrelli, 1, 1, 0, yes
134025268,  rhidalgott, 1, 1, 0, yes
570298215,  fxfinans, 1, 1, 0, yes
804436049225220096,  thehappygoat68, 4, 3, 1, yes
847177051,  Casewithaboy, 1, 1, 0, yes
312778814,  Catespa, 1, 1, 0, yes
403072086,  Emidio_Cnt, 1, 1, 0, yes
427411233,  ColonnaAntonio, 1, 1, 0, yes
3083819007,  Antonio111978, 1, 1, 0, yes
562286679,  slevin8685, 2, 2, 0, yes
125317787,  lapopi87, 1, 1, 0, yes
408417863,  elenaloewenthal, 1, 1, 0, yes
1117322250,  giovasantarelli, 2, 2, 0, yes
1356872376,  Alicenonce, 6, 2, 4, no
2277302946,  m_apice, 1, 1, 0, yes
1091706535,  AdaLeNoci, 1, 1, 0, yes
1048154215,  parahorizons, 1, 1, 0, yes
1904781277,  andrea_licata, 5, 5, 0, yes
269349017,  lib4no, 1, 1, 0, yes
211178508,  Giuseppe978, 1, 1, 0, yes
3001232244,  streetspoetry, 1, 1, 0, yes
803709462431367168,  t196700, 1, 1, 0, yes
610101483,  AlbertoSchepis1, 3, 1, 2, no
225764028,  giannilabbate, 1, 1, 0, yes
22345552,  evalt_emarketer, 1, 1, 0, yes
2744371765,  andreaasole, 1, 1, 0, yes
407358055,  alfo_ramos, 2, 2, 0, yes
493915898,  joachimvoss, 1, 1, 0, yes
256510818,  anablzk, 1, 1, 0, yes
2741547820,  mwolinskariedi, 1, 1, 0, yes
707557070128685056,  pablosnapoli, 1, 1, 0, yes
1123520378,  zagaria_andrea, 1, 1, 0, yes
2916095633,  MDobici, 3, 2, 1, yes
168261427,  TheJackers_1994, 1, 1, 0, yes
26639510,  MatteoBenedetto, 1, 1, 0, yes
2340529119,  BattaglioFelice, 3, 1, 2, no
42424530,  MarielaBejar, 1, 1, 0, yes
331261972,  Giacomoilgallo, 1, 1, 0, yes
51055146,  AntonioSemeraro, 1, 1, 0, yes
13118042,  roquentin, 1, 1, 0, yes
738850244390162433,  Manuel__Fantoni, 3, 3, 0, yes
803298250837082112,  Giovix1987, 1, 1, 0, yes
368805345,  francogarna, 1, 1, 0, yes
379892878,  risparmiocasa, 1, 1, 0, yes
2867492272,  pasconte1, 1, 1, 0, yes
335560833,  gimmeHutchence, 1, 1, 0, yes
361505392,  MatteoNovelli1, 1, 1, 0, yes
82926718,  campaninimarco, 3, 2, 1, yes
345945147,  ValerioPeracchi, 1, 1, 0, yes
44991921,  francilubrano, 2, 1, 1, neutral
226275157,  dhbaldo, 1, 1, 0, yes
519861994,  gdigiannantonio, 1, 1, 0, yes
266073674,  PabloTortajada, 1, 1, 0, yes
1379016079,  AlbertoDott, 1, 1, 0, yes
45427678,  marcosardi, 1, 1, 0, yes
3426629872,  CannizzoPino, 1, 1, 0, yes
499256389,  MarisaVidilla_, 1, 1, 0, yes
270635783,  PayetJeremy, 1, 1, 0, yes
822080779,  silvantonio71, 1, 1, 0, yes
164252719,  Merypaul, 1, 1, 0, yes
4775770107,  CristinaFNPavia, 1, 1, 0, yes
166913642,  Odontogix, 1, 1, 0, yes
525616016,  ClaudiaDandy, 1, 1, 0, yes
3165230877,  MarcoAntei, 2, 2, 0, yes
368441334,  MartinaGiuliano, 1, 1, 0, yes
1395720890,  mafumi50, 4, 3, 1, yes
207259950,  walterdicori, 2, 2, 0, yes
1606675206,  ciberviper, 2, 1, 1, neutral
200215691,  Eleda13, 1, 1, 0, yes
202320781,  Dodo_24, 3, 3, 0, yes
796662482534334464,  leonardomicch, 1, 1, 0, yes
1074655345,  nonnolibero66, 1, 1, 0, yes
391470200,  enzobuonocore79, 1, 1, 0, yes
589882817,  AnonOps_IAG, 1, 1, 0, yes
886431990,  bob_digilio, 1, 1, 0, yes
791696156279599105,  Matteo_Frigeri, 1, 1, 0, yes
626402118,  OremeIannarelli, 1, 1, 0, yes
3317941535,  laura_steven84, 1, 1, 0, yes
392012740,  caranomr, 1, 1, 0, yes
841561104,  BiasioCaterina, 1, 1, 0, yes
330196261,  GMitakides, 2, 2, 0, yes
2270760339,  GmMostardini, 1, 1, 0, yes
3300882646,  Maria14127287, 2, 2, 0, yes
2565601384,  BibiBibina, 1, 1, 0, yes
735022891583016960,  macgio1964, 5, 1, 4, no
114762279,  templare3000, 1, 1, 0, yes
1133913854,  LucaLucch, 1, 1, 0, yes
3660379880,  bornraisedidiot, 1, 1, 0, yes
3090617688,  frank_rm_, 1, 1, 0, yes
101304929,  ollieblog, 1, 1, 0, yes
803534213978976256,  Marcoeml, 2, 2, 0, yes
476945131,  peppe_p_94, 1, 1, 0, yes
386129306,  nichmitchell, 1, 1, 0, yes
2981800653,  saggiante_ivano, 1, 1, 0, yes
369429049,  RobertaEspos, 2, 2, 0, yes
1701809443,  MICE_FACTORY, 1, 1, 0, yes
275131941,  cambaranci, 1, 1, 0, yes
146033408,  StefanoRiffaldi, 2, 2, 0, yes
41939008,  jed1984, 2, 2, 0, yes
864457176,  capoccione2, 13, 1, 12, no
473470649,  myrnadelorenzo, 1, 1, 0, yes
4386912273,  4moni6, 1, 1, 0, yes
919638002,  _D_StaRk, 1, 1, 0, yes
50598193,  skipperfra, 1, 1, 0, yes
788916621981036544,  DeplorablePeopl, 3, 2, 1, yes
104949284,  djbatista86, 1, 1, 0, yes
764771394,  HerbertKilpin84, 1, 1, 0, yes
399510285,  AdrianMilky, 1, 1, 0, yes
153506617,  silvinamarq, 1, 1, 0, yes
53767650,  DollyKola, 1, 1, 0, yes
836717850,  peppeusai, 1, 1, 0, yes
458495032,  Gatti__Nicola, 3, 1, 2, no
952477016,  FabioFois79, 1, 1, 0, yes
577604259,  pellegrino_rosa, 1, 1, 0, yes
969889141,  f_capodiferro, 1, 1, 0, yes
955446296,  KolRemx, 1, 1, 0, yes
243866693,  ghellersahlgren, 1, 1, 0, yes
541147672,  SilviaSalute, 1, 1, 0, yes
392334927,  Aki80Achille, 1, 1, 0, yes
19898593,  Mariellena, 1, 1, 0, yes
251388963,  malascala, 2, 2, 0, yes
213798805,  Andreaccolla, 2, 2, 0, yes
3108843358,  speranza_62, 1, 1, 0, yes
379916499,  TerranovaPietro, 1, 1, 0, yes
287338255,  giampiniz, 1, 1, 0, yes
760944558704324608,  luposolitariofi, 2, 2, 0, yes
2996395480,  giosy978nosw, 1, 1, 0, yes
783031450266468353,  ElisaPan3, 6, 6, 0, yes
2411466618,  madariaga_goiri, 1, 1, 0, yes
2451506257,  stagnaro5, 1, 1, 0, yes
430637562,  BertagnoliPaolo, 1, 1, 0, yes
143024355,  gilgiunc, 1, 1, 0, yes
2964874570,  MilaneseLorenzo, 1, 1, 0, yes
3296303218,  marcellodandre7, 1, 1, 0, yes
2523192985,  blacKKBULL7, 1, 1, 0, yes
191405693,  giupiniello, 1, 1, 0, yes
2397659219,  Freccia_verde, 1, 1, 0, yes
587341963,  sbleo77, 1, 1, 0, yes
489369926,  Salvatore_Uva, 1, 1, 0, yes
249457691,  yebosfaye, 1, 1, 0, yes
526265139,  MPettinati, 1, 1, 0, yes
526813633,  DivusConsul, 1, 1, 0, yes
22912065,  zeromarcy, 1, 1, 0, yes
2949130360,  filippopasqui, 1, 1, 0, yes
3549420682,  ChiaraAlcherigi, 1, 1, 0, yes
1471141681,  Joseph_milan96, 1, 1, 0, yes
1658260076,  ebellazzi, 1, 1, 0, yes
3049865121,  gianfrymaggio, 2, 2, 0, yes
768096406020259840,  FemmyLover99, 1, 1, 0, yes
263775129,  Lena1717, 1, 1, 0, yes
2228425848,  GioSer1998, 1, 1, 0, yes
2860448789,  MondoEspe, 1, 1, 0, yes
3904339243,  teo1705_m, 2, 2, 0, yes
1216196035,  giumo860, 1, 1, 0, yes
120606871,  dccSalvo, 1, 1, 0, yes
134168061,  Maire_OD, 1, 1, 0, yes
3574146735,  Norbihms, 1, 1, 0, yes
14217906,  flix1, 1, 1, 0, yes
358828356,  Gretaputignano, 1, 1, 0, yes
2359509852,  DamnHarley, 1, 1, 0, yes
3124517781,  CapitanioFabio, 1, 1, 0, yes
141572754,  finanzasmania, 1, 1, 0, yes
637048635,  riccardogorlani, 1, 1, 0, yes
368954495,  MonicaManiero, 1, 1, 0, yes
540178941,  andrea33485417, 1, 1, 0, yes
420562068,  marco_bon, 1, 1, 0, yes
1352818926,  FBaraccca, 1, 1, 0, yes
1379733312,  IsoleGrecheCom, 2, 2, 0, yes
3295174841,  MngPiero, 1, 1, 0, yes
364411731,  Robertinohornet, 1, 1, 0, yes
281689745,  AntiEUAntiEuro, 4, 3, 1, yes
2238661575,  albmanfredonia, 1, 1, 0, yes
997948202,  Rosario_Biafora, 1, 1, 0, yes
96565372,  il_libertario, 3, 2, 1, yes
972289507,  mardydrum, 1, 1, 0, yes
411350139,  SoloBerlusconi, 1, 1, 0, yes
541996235,  FrankAddam, 1, 1, 0, yes
418816920,  BrontoloeBasta, 2, 2, 0, yes
339559937,  DucaSimakiku, 3, 1, 2, no
1165554492,  domasibarita, 3, 3, 0, yes
209062585,  SteveCobretti, 2, 2, 0, yes
2357037111,  AlbertoFrizalbe, 1, 1, 0, yes
1074115178,  MartinaSnape, 1, 1, 0, yes
62802523,  strano86, 1, 1, 0, yes
1013334853,  oryblu, 5, 2, 3, no
283130838,  AngeloGenca, 1, 1, 0, yes
3329141957,  tomtomzuli, 1, 1, 0, yes
173213739,  icon_ic, 2, 2, 0, yes
1003495832,  v_dotty, 1, 1, 0, yes
523674841,  federicatodaro_, 1, 1, 0, yes
526530582,  tg2rai, 2, 2, 0, yes
3030988839,  carisimolider, 1, 1, 0, yes
2813234751,  Panf57, 1, 1, 0, yes
53091721,  redsquirrel87, 1, 1, 0, yes
2277558351,  elisabettacecc, 1, 1, 0, yes
428954003,  NewsNovara, 1, 1, 0, yes
109216266,  lallaenmadrid, 1, 1, 0, yes
864990590,  godot_gio, 1, 1, 0, yes
494086612,  imdiegopq, 1, 1, 0, yes
725958598514221058,  Orazio1971, 2, 1, 1, neutral
150600839,  GianfrancoGi, 1, 1, 0, yes
550235677,  CristianGuzzi, 1, 1, 0, yes
3001405264,  ResidenceMarino, 1, 1, 0, yes
3054196775,  5cc4386e4e96494, 1, 1, 0, yes
26382263,  filjander, 1, 1, 0, yes
247908768,  andrewsgeoff, 1, 1, 0, yes
1648281926,  Salvatore0199, 1, 1, 0, yes
3404346244,  FNMAGENTA2015, 1, 1, 0, yes
768544113213992960,  ouzpatos, 1, 1, 0, yes
781491602070044672,  EtipetC, 1, 1, 0, yes
419469812,  lovingsomebands, 1, 1, 0, yes
45439845,  pimpiripette, 3, 1, 2, no
78019039,  fguzzardi, 1, 1, 0, yes
133013373,  SergioLangdon, 1, 1, 0, yes
105247762,  dianakola, 1, 1, 0, yes
356186954,  vittorio_trucco, 1, 1, 0, yes
731170418992812032,  Raffaele_uil, 1, 1, 0, yes
1281918049,  PoliticaAttiva, 3, 2, 1, yes
246313651,  SimonMacauda, 1, 1, 0, yes
56914215,  GraziaButtaci, 1, 1, 0, yes
117566899,  gio_paolino, 1, 1, 0, yes
264684849,  Cibo82, 1, 1, 0, yes
373391085,  DKoureas, 1, 1, 0, yes
199260213,  hurricane_cd, 1, 1, 0, yes
216544535,  OpOpOmOx, 1, 1, 0, yes
2788225609,  PoliticsUKTD, 1, 1, 0, yes
1322570808,  francescosaisi, 1, 1, 0, yes
1063047079,  DAGO89S, 1, 1, 0, yes
3021166336,  mbrollo50, 2, 2, 0, yes
450078638,  DennyMaglie, 1, 1, 0, yes
547092413,  TrentoMaurizio, 1, 1, 0, yes
464604268,  dm_claudio, 1, 1, 0, yes
754719534213464064,  NickBallAmerica, 1, 1, 0, yes
748446842300534784,  GiovanniMesse, 1, 1, 0, yes
167399649,  davidscris, 1, 1, 0, yes
2706906130,  dadial30, 2, 2, 0, yes
66698754,  pabloojer, 1, 1, 0, yes
453046545,  finello76, 1, 1, 0, yes
2842485611,  PasqualeArch, 1, 1, 0, yes
708106344063225856,  maria0900000, 1, 1, 0, yes
756148631997153280,  MirkoRossiVegan, 2, 2, 0, yes
1180254084,  cbaccillieri, 3, 3, 0, yes
574809767,  dicarlodani, 1, 1, 0, yes
242752764,  babucicu, 1, 1, 0, yes
2364248823,  pirozzi_andrea, 1, 1, 0, yes
153924469,  budget_tourist, 1, 1, 0, yes
484585978,  wanna1382, 2, 1, 1, neutral
750676098002874368,  joannemills8101, 1, 1, 0, yes
3010096407,  luciano76189084, 1, 1, 0, yes
457682537,  zannidiaprile, 1, 1, 0, yes
709502718965059584,  RosellaPalesti1, 1, 1, 0, yes
2157082588,  PaulFaivre22, 1, 1, 0, yes
35145147,  beaudonnet, 1, 1, 0, yes
3959385917,  papinavitamia, 1, 1, 0, yes
1372315189,  AlessioCatania1, 1, 1, 0, yes
92378984,  MyNameIsArianna, 1, 1, 0, yes
3975756309,  OskWars, 1, 1, 0, yes
377189761,  giangi1169, 1, 1, 0, yes
40259082,  maxpiccinno, 1, 1, 0, yes
205627167,  palmarocchim, 6, 1, 5, no
472255137,  RitaCuboni, 1, 1, 0, yes
42667528,  pjn_1989, 1, 1, 0, yes
460405767,  stefano_limone, 1, 1, 0, yes
221394018,  MarcoPecchia, 1, 1, 0, yes
789008288608387072,  TomTav00, 2, 2, 0, yes
165029116,  JosemaStendhal, 4, 3, 1, yes
311085868,  OvveroMe, 8, 6, 2, yes
26220509,  gin_dallolmo, 1, 1, 0, yes
1899723308,  A_Magdalena92, 4, 2, 2, neutral
3000908489,  gianfrancazorz1, 1, 1, 0, yes
412428195,  EmmePan, 1, 1, 0, yes
966419364,  whamzyns, 3, 2, 1, yes
417678424,  ovvio76, 1, 1, 0, yes
376832875,  lo_ml, 1, 1, 0, yes
152690951,  geniuzzo, 1, 1, 0, yes
206197837,  qs009, 1, 1, 0, yes
117559404,  stefaniabonaldi, 1, 1, 0, yes
403477285,  GinnyTocco, 1, 1, 0, yes
285506719,  filippo_marano, 1, 1, 0, yes
348763721,  Sat_666, 1, 1, 0, yes
855101617,  clubdigitale, 1, 1, 0, yes
246087962,  scotty1389, 1, 1, 0, yes
3297011662,  corbodora, 2, 2, 0, yes
2375897122,  confortia24, 1, 1, 0, yes
709402460666863616,  AuroraRosatiii, 1, 1, 0, yes
985035704,  AnnaMFerraro2, 1, 1, 0, yes
88480395,  MaryAlice_ts, 2, 1, 1, neutral
3290447679,  enricaroma80, 1, 1, 0, yes
879621294,  EmasFanelli, 1, 1, 0, yes
2431647181,  kottovaa, 1, 1, 0, yes
2204963370,  allalarga1, 3, 3, 0, yes
3129250355,  ImagineDaniele, 2, 1, 1, neutral
784263410233987073,  R3IZ_, 1, 1, 0, yes
729937518,  tylerfromtheweb, 1, 1, 0, yes
277993876,  R_Salinski, 1, 1, 0, yes
4688280565,  Mauhdeeb, 5, 2, 3, no
103423616,  nascarone, 1, 1, 0, yes
4252283422,  Dalfranco24, 1, 1, 0, yes
4497735735,  wahinertraveler, 3, 3, 0, yes
387306378,  man_in_bluff, 2, 1, 1, neutral
2154915549,  wonder_ste, 1, 1, 0, yes
3063912075,  Caoscalmo63, 8, 1, 7, no
71310067,  annaritapovia, 1, 1, 0, yes
58930553,  g_gaspari, 1, 1, 0, yes
3631780037,  DomenicoPiroz12, 1, 1, 0, yes
39338497,  capitone71, 1, 1, 0, yes
1829832589,  BOCCHIGIOVANNI, 1, 1, 0, yes
526799237,  dancurcuruto, 4, 4, 0, yes
3118985463,  moneeeeeeee2, 1, 1, 0, yes
122712880,  novellaurora, 1, 1, 0, yes
728511409,  ucoulon, 1, 1, 0, yes
132281409,  worldtripsluca, 1, 1, 0, yes
436680358,  gabriellagenisi, 1, 1, 0, yes
433702678,  BonazziFederico, 17, 2, 15, no
2510151044,  xMediaFaced, 1, 1, 0, yes
3342409671,  RPennese, 2, 2, 0, yes
1037360724,  CarneadeVerona, 1, 1, 0, yes
535312895,  marinaromy, 1, 1, 0, yes
1400642011,  ris_pa, 1, 1, 0, yes
2318856164,  FlavioGallo5, 1, 1, 0, yes
462923059,  VinzuAnzu, 1, 1, 0, yes
2890866940,  nicolevIFG, 1, 1, 0, yes
3303649757,  Gigi68Barbariga, 2, 2, 0, yes
204768059,  negrobarese, 1, 1, 0, yes
885264224,  lu_ka_filippi, 1, 1, 0, yes
3971295089,  nafasaro1, 1, 1, 0, yes
195781393,  gaclege, 1, 1, 0, yes
460496157,  alice_tortelli, 3, 3, 0, yes
90407658,  deandre82, 1, 1, 0, yes
890674015,  ChristophHeer52, 2, 1, 1, neutral
2282351922,  blusewillis, 24, 14, 10, yes
17924100,  jbouhs, 1, 1, 0, yes
1109545314,  claudiolastdanc, 2, 2, 0, yes
89934423,  luchino84, 1, 1, 0, yes
68578389,  federicofedere, 1, 1, 0, yes
364197912,  claudiadaconto, 1, 1, 0, yes
359770444,  SirRyanR, 1, 1, 0, yes
17188766,  pally_q, 1, 1, 0, yes
1007133583,  giadacristian, 1, 1, 0, yes
490485299,  Celoni_Simone, 1, 1, 0, yes
462229483,  Paola8891, 1, 1, 0, yes
987137280,  NCurreli, 1, 1, 0, yes
6788812,  Contz, 1, 1, 0, yes
2906615746,  MonycaMarini, 10, 9, 1, yes
47881452,  dert86, 1, 1, 0, yes
627632609,  gesalquadrato, 1, 1, 0, yes
2454417328,  tantumanita, 1, 1, 0, yes
746031626216423424,  daniele_bada, 4, 3, 1, yes
2457190477,  srescio, 2, 2, 0, yes
313402952,  FabrizioFiorin1, 1, 1, 0, yes
383409103,  Mattia_Geno, 1, 1, 0, yes
1065047300,  LucaMarconero, 1, 1, 0, yes
335516524,  SteveManex, 1, 1, 0, yes
518478920,  CeschiReto, 1, 1, 0, yes
1021795003,  PAGLIARIG, 1, 1, 0, yes
2481502943,  silvia_scardini, 1, 1, 0, yes
125388314,  monicadimonza, 1, 1, 0, yes
195358406,  pertheath, 1, 1, 0, yes
610982400,  SilvioDeCesare, 1, 1, 0, yes
420469077,  fabiokep, 1, 1, 0, yes
1239677354,  GeriGiovanni6, 1, 1, 0, yes
2766360395,  AgenziaAgoa, 2, 1, 1, neutral
128691108,  sandromarchesi, 1, 1, 0, yes
358690565,  NewYvev, 2, 2, 0, yes
492930723,  biyip55, 1, 1, 0, yes
490628734,  NicoliniEdoardo, 1, 1, 0, yes
399027749,  _Peppuzzo, 1, 1, 0, yes
399577911,  FabioAnzalone13, 1, 1, 0, yes
159907040,  JonathanTorino, 1, 1, 0, yes
2337236772,  BoenaSvoabo, 1, 1, 0, yes
196639025,  The_Albizzi, 1, 1, 0, yes
143125572,  vitocascione, 1, 1, 0, yes
1054609442,  errecapello, 1, 1, 0, yes
15271006,  uniwave, 1, 1, 0, yes
3338444177,  GladizPalmeira, 1, 1, 0, yes
1289971742,  GRusso10, 1, 1, 0, yes
495557471,  FedeGhisio, 1, 1, 0, yes
2341518533,  passaricaterina, 1, 1, 0, yes
2626194219,  vivivolp84, 1, 1, 0, yes
271532907,  elitischmos, 1, 1, 0, yes
378091829,  CiroQuisisano, 1, 1, 0, yes
394086202,  marco_zio, 1, 1, 0, yes
553574875,  GiudittaAvilio, 1, 1, 0, yes
606323194,  MicheleCheie, 1, 1, 0, yes
754011298380279809,  AlessandraFed75, 1, 1, 0, yes
3361115747,  Pierg_Nestola, 4, 3, 1, yes
3184910541,  catia_1968, 2, 1, 1, neutral
1073703126,  GGflotta, 1, 1, 0, yes
516305074,  claudelongchamp, 1, 1, 0, yes
1044868694,  ManlioVicini, 1, 1, 0, yes
65078688,  armandopica, 1, 1, 0, yes
2890508061,  Littleffort, 1, 1, 0, yes
342317640,  mauro_pek, 1, 1, 0, yes
2391733929,  carmendmc84, 1, 1, 0, yes
2900383378,  vittoriocorso_, 1, 1, 0, yes
703736845868408832,  Daniela74134481, 2, 2, 0, yes
3056927199,  alexgiannoccari, 2, 1, 1, neutral
762326347565953024,  MarcoDiGerio, 1, 1, 0, yes
1896008953,  cheikhfatma24, 1, 1, 0, yes
805213699,  amargant_olga, 1, 1, 0, yes
471050131,  Little_Hyena, 1, 1, 0, yes
1024535564,  iannotta73, 3, 3, 0, yes
337355818,  aragostablu, 1, 1, 0, yes
340196914,  Naly2581, 1, 1, 0, yes
287948128,  ItoParedes, 1, 1, 0, yes
51699440,  Narses81, 1, 1, 0, yes
2432366232,  fortumarra95, 1, 1, 0, yes
193809517,  EmilianaRagno, 1, 1, 0, yes
1703447346,  Spillo_90, 5, 2, 3, no
3238213307,  valentini_one, 1, 1, 0, yes
352667447,  lucalondini, 1, 1, 0, yes
50342033,  melonimatteo, 1, 1, 0, yes
790254593720614912,  domenico823, 4, 1, 3, no
3715554915,  SimeoneFausto, 1, 1, 0, yes
2949282023,  PvAbc, 1, 1, 0, yes
800045774,  Zubalich, 1, 1, 0, yes
22006895,  alexarmuzzi, 3, 1, 2, no
815662435,  albasidera, 1, 1, 0, yes
2876610999,  Ross18_2_75, 1, 1, 0, yes
444735149,  Nicolas81D, 1, 1, 0, yes
100870895,  craziemile, 1, 1, 0, yes
28317864,  stepas82, 1, 1, 0, yes
259750898,  RikAudereSemper, 2, 2, 0, yes
164324786,  VICTORLEONARDIB, 1, 1, 0, yes
1975956834,  Matteopuffocois, 1, 1, 0, yes
268362575,  Juan_montero4, 1, 1, 0, yes
2285930056,  CarluccioRoby, 1, 1, 0, yes
2359715570,  Emanuel55650469, 1, 1, 0, yes
464939996,  Maffricano, 2, 2, 0, yes
283070184,  chiarabarbagli, 1, 1, 0, yes
1485363008,  elinedany, 1, 1, 0, yes
425067460,  andryburzo, 1, 1, 0, yes
291656846,  SguilleH, 1, 1, 0, yes
397519030,  PBerhouet, 1, 1, 0, yes
2838580227,  elisa_eelisa, 1, 1, 0, yes
711342235,  Tanya2005Tanya, 1, 1, 0, yes
2408667657,  Mark_trevis, 1, 1, 0, yes
791727627404972032,  gdu1197, 3, 2, 1, yes
452920047,  DagoMichele, 1, 1, 0, yes
23830526,  anto475, 1, 1, 0, yes
894209612,  gilbedegaspari, 1, 1, 0, yes
1262817392,  VielNoemi, 1, 1, 0, yes
470112631,  michelemontanar, 1, 1, 0, yes
4870364140,  golneth, 1, 1, 0, yes
1416604285,  CiclistaCielo, 2, 1, 1, neutral
993849391,  FabriMontemagno, 1, 1, 0, yes
2937372461,  passeritina, 4, 2, 2, neutral
860187049,  allegrisilvia, 1, 1, 0, yes
226662801,  andreturchetti, 1, 1, 0, yes
124323758,  alexargeles, 1, 1, 0, yes
350510584,  LALAZIOMIA, 1, 1, 0, yes
2243808423,  renato_tola, 1, 1, 0, yes
182843662,  BEPPEMONOPOLI, 1, 1, 0, yes
781522958158274560,  ilcercalibro059, 1, 1, 0, yes
1609984734,  ThePromisedWLAN, 1, 1, 0, yes
712249866378997760,  Pietro_Bell, 1, 1, 0, yes
716781195502215169,  damianomazzola5, 1, 1, 0, yes
521158819,  BenniVY, 1, 1, 0, yes
1622365038,  DinaMalgieri, 1, 1, 0, yes
751378885888053248,  janesgamm, 1, 1, 0, yes
801378926908030976,  LarsHobma, 1, 1, 0, yes
1030640449,  DavideGhisa, 1, 1, 0, yes
506034684,  Tomala_W, 1, 1, 0, yes
4128883822,  Andrea10Capo, 1, 1, 0, yes
225033013,  carmelolg, 2, 1, 1, neutral
397389160,  ClaudioCortese1, 1, 1, 0, yes
3553054757,  badesse75, 1, 1, 0, yes
490618237,  DaveCapoti, 1, 1, 0, yes
51085679,  paulgalles, 1, 1, 0, yes
802248958949158912,  CdpRicciotti, 1, 1, 0, yes
35332405,  AntoinetteNikol, 1, 1, 0, yes
2338480649,  demovola, 1, 1, 0, yes
15261998,  nickylang, 1, 1, 0, yes
4908692729,  Deborinoavita, 1, 1, 0, yes
1522004376,  LorinQosja, 1, 1, 0, yes
2966423621,  Szymsio, 1, 1, 0, yes
501220324,  PSerretiello, 1, 1, 0, yes
444623589,  ilRoby72, 1, 1, 0, yes
480787660,  giovannirapisa2, 1, 1, 0, yes
3140856317,  EnclaveUS, 1, 1, 0, yes
792663324563480580,  PippoIspica, 1, 1, 0, yes
2465218274,  Giovi209, 1, 1, 0, yes
510810708,  LFabbricini, 1, 1, 0, yes
118114589,  PercyCorrales, 1, 1, 0, yes
629774607,  PBersaglio, 3, 3, 0, yes
4048884801,  transportesmeg1, 1, 1, 0, yes
804757054485360643,  tsimona16, 1, 1, 0, yes
2398423638,  francescasmusic, 1, 1, 0, yes
4866227159,  ercicalone, 1, 1, 0, yes
2981205407,  FunariValerio, 1, 1, 0, yes
3062527144,  giulipau1, 1, 1, 0, yes
2974350279,  luciano_decarlo, 1, 1, 0, yes
361787988,  urlodalsilenzio, 9, 4, 5, no
418039401,  GiacomoCasoni, 1, 1, 0, yes
491403847,  Paolo_Tari, 1, 1, 0, yes
782119497750675457,  Carmen27514300, 1, 1, 0, yes
20615164,  NicolettaTurci, 3, 1, 2, no
310178609,  danyATAC, 1, 1, 0, yes
305858820,  Nitromarisa, 1, 1, 0, yes
3812885476,  koslo69, 3, 3, 0, yes
586060154,  sonyamarchese, 1, 1, 0, yes
485094283,  maxpeyn84, 1, 1, 0, yes
82132412,  Pieracci_Alb, 1, 1, 0, yes
496450737,  attiliobo, 1, 1, 0, yes
108030044,  mr_gIitch, 2, 1, 1, neutral
418216001,  fmastrovito, 1, 1, 0, yes
1063610162,  TaniaMonia, 1, 1, 0, yes
459629387,  peochef, 1, 1, 0, yes
507924020,  AllNewsRealty, 1, 1, 0, yes
700646117193547777,  chiaramontino, 1, 1, 0, yes
897682855,  alicely78, 1, 1, 0, yes
512868247,  elzbiet14039785, 1, 1, 0, yes
736530328995647488,  Federic88217567, 1, 1, 0, yes
562838873,  FabozziC, 1, 1, 0, yes
246906913,  MiddleFingerIta, 1, 1, 0, yes
788367869797105664,  ratschkatzl, 1, 1, 0, yes
387259860,  IsabelValin, 1, 1, 0, yes
55798532,  abvit, 1, 1, 0, yes
420675365,  galt_007, 1, 1, 0, yes
1362967092,  alexmarti80, 1, 1, 0, yes
404413246,  68francina, 1, 1, 0, yes
301555405,  davideos64, 1, 1, 0, yes
1115143405,  ImClod, 1, 1, 0, yes
15016610,  fabpicca, 1, 1, 0, yes
1259828274,  ElenaCecconi1, 5, 5, 0, yes
384228037,  monica_carmeno, 1, 1, 0, yes
565599088,  StefyTerranini, 1, 1, 0, yes
591310560,  sav_gr, 1, 1, 0, yes
415104986,  paoloamicucci, 1, 1, 0, yes
503012219,  TotoC35, 1, 1, 0, yes
400865276,  ariomfirenze, 1, 1, 0, yes
1220815819,  fadesimo, 1, 1, 0, yes
289942669,  AntonyAlbergo, 1, 1, 0, yes
3404352773,  il__Mauro, 14, 5, 9, no
1114410762,  GuidoRomani, 1, 1, 0, yes
431894814,  Faby07fabyMaria, 3, 3, 0, yes
1480687333,  bafius11, 1, 1, 0, yes
1020312552,  DanieleScriva, 1, 1, 0, yes
2284176942,  virantovir, 1, 1, 0, yes
2352704001,  TornuscioloB, 1, 1, 0, yes
1066893133,  kysmichp, 1, 1, 0, yes
193683674,  agiusti, 1, 1, 0, yes
1178520270,  18Zuliani, 2, 2, 0, yes
358723329,  LuigiGranata2, 1, 1, 0, yes
794959084021805057,  Annag37163081, 1, 1, 0, yes
442059926,  OsvaldoScarano, 1, 1, 0, yes
96312573,  Delontearenas, 2, 2, 0, yes
468581456,  Uba_Alb16, 1, 1, 0, yes
700644864,  bfassoni, 2, 1, 1, neutral
477614027,  PierpaoloBarlet, 1, 1, 0, yes
3824147415,  giovannifisich3, 1, 1, 0, yes
227615641,  vincigig, 1, 1, 0, yes
1694886410,  _simona1992, 1, 1, 0, yes
623160336,  KingEric_VII, 4, 2, 2, neutral
1025048880,  denardiriccardo, 6, 6, 0, yes
307144710,  antoniodejoma, 1, 1, 0, yes
354917445,  metroguida, 1, 1, 0, yes
1580376102,  MaxCarbone78, 1, 1, 0, yes
84050169,  bbking72, 1, 1, 0, yes
797127537696579584,  valecomerci, 1, 1, 0, yes
4110808096,  federicacannol1, 3, 3, 0, yes
2640051129,  basketbrutti, 1, 1, 0, yes
805719943367053313,  PierluigiRizzo4, 1, 1, 0, yes
1244648594,  cozzi_alessia, 1, 1, 0, yes
803536150371696640,  GabRizzi1, 11, 1, 10, no
2758409283,  RozziniTony, 1, 1, 0, yes
83356669,  montalbanom, 1, 1, 0, yes
1224123170,  marzi_jacopo, 1, 1, 0, yes
2382986116,  elibalda89, 1, 1, 0, yes
2778813700,  LaZiaSere, 1, 1, 0, yes
1278510602,  andcasu, 3, 3, 0, yes
2537404585,  Antonio250394, 1, 1, 0, yes
2351211413,  Caiafaida, 1, 1, 0, yes
52071233,  romanopaolo, 2, 1, 1, neutral
763884228,  BacinelliNicola, 1, 1, 0, yes
748446257924947970,  The88Chef, 1, 1, 0, yes
462088303,  Fiandolo, 1, 1, 0, yes
2380568686,  marialuisatom, 1, 1, 0, yes
522595824,  Manuelafarina73, 3, 3, 0, yes
104210812,  EBETf, 1, 1, 0, yes
3179265154,  bambibambi753, 3, 3, 0, yes
706053789,  Ginko92_, 1, 1, 0, yes
492336069,  FabianaGiura, 1, 1, 0, yes
340951421,  AlbertoSBlanco, 1, 1, 0, yes
470116777,  rocca_luca, 1, 1, 0, yes
2179727597,  marcoloprinzi, 1, 1, 0, yes
580843452,  MassimoCiccola, 2, 2, 0, yes
386177747,  ElenaMain88, 1, 1, 0, yes
4830695975,  senator_it, 6, 2, 4, no
444549684,  GiulianoPasini, 2, 2, 0, yes
610976694,  parrin66, 1, 1, 0, yes
720324851286859776,  mary_Terry67, 1, 1, 0, yes
789513059979104256,  FabioVitali8, 1, 1, 0, yes
1041933954,  alesdauria, 1, 1, 0, yes
976467152,  McristinaBarbi, 1, 1, 0, yes
1692344714,  ITGuy9401, 1, 1, 0, yes
459450731,  susyromanelli, 1, 1, 0, yes
1327282969,  ProfVanacore, 3, 3, 0, yes
2351310581,  BertoliniClo, 1, 1, 0, yes
1649930347,  DuttoPaolo, 1, 1, 0, yes
4902267070,  lilo_io, 1, 1, 0, yes
1519853935,  maurizio0746, 1, 1, 0, yes
363721784,  Naborr, 1, 1, 0, yes
411841520,  gnnali, 7, 2, 5, no
1386150547,  Cielodeloeste, 2, 2, 0, yes
540924320,  ludus49, 2, 2, 0, yes
485250628,  7BastianH, 1, 1, 0, yes
461851442,  madichicy, 2, 2, 0, yes
109315903,  ipazia66, 4, 3, 1, yes
820278810,  1968Mememe, 1, 1, 0, yes
2201019390,  PietroRizzi85, 1, 1, 0, yes
3002011482,  Fede9619, 1, 1, 0, yes
1357937306,  DaisyTituli, 1, 1, 0, yes
714572830374014978,  pablita7672, 2, 2, 0, yes
2429458070,  miku39pack, 1, 1, 0, yes
1562750084,  MattiaManzati, 1, 1, 0, yes
63225284,  negraoro, 1, 1, 0, yes
154663507,  _marfain, 1, 1, 0, yes
797882532,  Makis_Tr, 1, 1, 0, yes
3400067308,  emineismailaga, 1, 1, 0, yes
1858989858,  _rasr13, 1, 1, 0, yes
375700539,  PASOSPCL1, 1, 1, 0, yes
1267923242,  piergiorgio2S, 1, 1, 0, yes
2525509826,  ErbaSelvatica, 2, 2, 0, yes
255658657,  emanueleraco, 1, 1, 0, yes
116827501,  millersoto, 1, 1, 0, yes
148911684,  orthofede, 7, 4, 3, yes
588946610,  r_raffy94, 1, 1, 0, yes
721497735996813314,  Eduardo66329166, 1, 1, 0, yes
888993078,  AndreaCordobao, 1, 1, 0, yes
126455055,  filipros, 2, 1, 1, neutral
142848230,  ddiiuorio, 1, 1, 0, yes
2624238479,  colonna_studio, 1, 1, 0, yes
401690576,  MauriziaR, 2, 2, 0, yes
805588357522788352,  monica788078, 1, 1, 0, yes
3352686130,  gugkli, 1, 1, 0, yes
2793087868,  burcu__turker, 1, 1, 0, yes
763930340918386694,  hasanahimovic1, 1, 1, 0, yes
795141000939393024,  AhmetKi68338202, 1, 1, 0, yes
803200194254929920,  CanSirkecit, 1, 1, 0, yes
803205500611493888,  Reisci8, 1, 1, 0, yes
791288247280340992,  dolarfiyat_net, 1, 1, 0, yes
596450353,  xdiclegorduk, 1, 1, 0, yes
803328369668538368,  HSenlendir, 1, 1, 0, yes
745004769844989953,  golgeliyormus, 1, 1, 0, yes
2809737264,  sia_41, 1, 1, 0, yes
780140293832249344,  gaye_tomurcuk, 1, 1, 0, yes
769541161115652096,  hllmyq, 1, 1, 0, yes
2981757813,  cihancakar35, 1, 1, 0, yes
779364637666119680,  02Volta, 1, 1, 0, yes
3214543227,  AyazOguZzzz, 1, 1, 0, yes
797413169379557376,  spordiyocom, 1, 1, 0, yes
787271624420626432,  suarezz33, 1, 1, 0, yes
749687296132321280,  batmisiz, 1, 1, 0, yes
788484775761895424,  emirhanyaziyor, 1, 1, 0, yes
1225069214,  kolonisahibi, 1, 1, 0, yes
773957664757977088,  zoramart12, 1, 1, 0, yes
3333320007,  Retweetcirit, 1, 1, 0, yes
69167515,  azyazarozyazarr, 1, 1, 0, yes
804156228389797889,  istanbulescortd, 1, 1, 0, yes
804598179907792896,  Olivier91398499, 1, 1, 0, yes
1641485791,  whyyoudothatbro, 1, 1, 0, yes
721403639307374592,  Sinankahveci05, 1, 1, 0, yes
804646865039949825,  pandabeyy0, 1, 1, 0, yes
2576150098,  KbradmrtsDmrts, 1, 1, 0, yes
1134150512,  GamzeeMaya, 1, 1, 0, yes
804672019874873344,  0cn400, 1, 1, 0, yes
4754375865,  onuuragyureek, 1, 1, 0, yes
3642066137,  HakangrbzHkn, 1, 1, 0, yes
3431637111,  esra_dayi, 1, 1, 0, yes
1905480774,  RaifYavuzYilmaz, 1, 1, 0, yes
500689720,  Kaliite, 1, 1, 0, yes
2929401099,  selambenenees, 1, 1, 0, yes
797040977634623488,  alalanihal, 1, 1, 0, yes
1076761681,  ozgroztrk99, 1, 1, 0, yes
756103721268965377,  edepsizat, 1, 1, 0, yes
1443186511,  ege_erabur, 1, 1, 0, yes
2994797199,  bitavsiyemvars, 1, 1, 0, yes
2397541809,  zamanesozleri, 1, 1, 0, yes
1007270563,  _gibrba, 2, 2, 0, yes
735218341523120131,  mercanqw, 1, 1, 0, yes
709862134126157825,  _ivanbebekk, 1, 1, 0, yes
395926094,  BartucanKamaci, 1, 1, 0, yes
371691154,  van_give, 1, 1, 0, yes
4164293417,  mustafaveselin, 1, 1, 0, yes
804942899133771777,  seaseadweeadsa1, 1, 1, 0, yes
3929077114,  MedyaHalk, 1, 1, 0, yes
4603426582,  ozgurcelik321, 1, 1, 0, yes
4888427439,  cobsteve, 1, 1, 0, yes
727601807845920768,  ToyDimaglar, 1, 1, 0, yes
804982847396335616,  seasewadaweada1, 1, 1, 0, yes
804987889658564609,  seasdweaadweae1, 1, 1, 0, yes
785503075549192192,  vapurvemarti, 1, 1, 0, yes
3056920376,  recepmason61, 1, 1, 0, yes
804781233813209089,  Delikanlitemi, 1, 1, 0, yes
703306493215563776,  uisroot, 1, 1, 0, yes
459420857,  simoneferioli, 2, 2, 0, yes
85421094,  badilaz, 1, 1, 0, yes
532445469,  viciotage, 1, 1, 0, yes
30635733,  Alesampox, 1, 1, 0, yes
490290899,  Barbara_Serra_, 1, 1, 0, yes
331630877,  valedonaggio, 1, 1, 0, yes
4858261319,  Pontigv, 1, 1, 0, yes
302477206,  IRSI1990, 1, 1, 0, yes
446401886,  RiccardoMeregal, 2, 1, 1, neutral
59612916,  ShadowX5452, 1, 1, 0, yes
2543855568,  LuisaSabrina2, 1, 1, 0, yes
519352990,  Ivana71bis, 1, 1, 0, yes
4044502341,  Rochy35451447, 11, 5, 6, no
790653396571258882,  PioLoEspo, 1, 1, 0, yes
1104631111,  FedericaA23, 1, 1, 0, yes
13902852,  trumbitta, 1, 1, 0, yes
441914111,  seccomood, 4, 2, 2, neutral
469238898,  gian_fox, 1, 1, 0, yes
3075980884,  tiziano281078, 1, 1, 0, yes
416318249,  ziomau1956, 1, 1, 0, yes
1087419979,  barca_emanuele, 1, 1, 0, yes
485877476,  kekko78cs, 3, 3, 0, yes
3887606853,  eliaspapoulas, 1, 1, 0, yes
535387004,  DarioGarramone, 1, 1, 0, yes
788434519514832896,  Manuel_Solinas, 1, 1, 0, yes
2377412898,  michelepalillo, 1, 1, 0, yes
994097172,  nicolo_giusti, 2, 2, 0, yes
750333027088302080,  DojeFrittur, 3, 3, 0, yes
1686110437,  vale_vale20, 1, 1, 0, yes
16041745,  elenabonfanti, 1, 1, 0, yes
3295090787,  globulolibero, 1, 1, 0, yes
3189712181,  ef306109574349f, 1, 1, 0, yes
3307392364,  BeJu__st, 1, 1, 0, yes
2442750422,  giraffone1975, 1, 1, 0, yes
1712654598,  aledonnini_8, 2, 2, 0, yes
766981398964084736,  TGombia, 3, 3, 0, yes
2494606407,  SunRacingTeam, 1, 1, 0, yes
567392966,  justmarianna_5, 1, 1, 0, yes
805701944425803776,  Michele95vb, 1, 1, 0, yes
68711354,  Celtar_Advisers, 1, 1, 0, yes
804406801437458432,  grandeggio, 1, 1, 0, yes
311374184,  antonellatacci, 2, 1, 1, neutral
1011308838,  Arinzecom1981, 1, 1, 0, yes
805704816647344128,  SilviaScala4, 1, 1, 0, yes
3077812983,  RTreossi, 2, 1, 1, neutral
473063723,  michelecostigli, 1, 1, 0, yes
1324516416,  gavazzicristina, 1, 1, 0, yes
616554482,  PaoloRussoIT, 1, 1, 0, yes
196234135,  settesere, 1, 1, 0, yes
419444738,  albertomarino6, 1, 1, 0, yes
2771005295,  _hazzasmile_, 1, 1, 0, yes
2478049702,  kopralaplng, 1, 1, 0, yes
3127648403,  StefVanzo, 1, 1, 0, yes
262101027,  CarlosHidalgoS, 1, 1, 0, yes
593583090,  Jonnytizy, 1, 1, 0, yes
435763914,  marcomuscia, 1, 1, 0, yes
599396246,  ClaBotta, 1, 1, 0, yes
966734737,  BonomoMl, 1, 1, 0, yes
765901856,  mfischione, 2, 2, 0, yes
175444192,  ensistavers, 1, 1, 0, yes
421952674,  ssaintpablo, 7, 2, 5, no
706198119441174529,  NoAllaUE, 5, 3, 2, yes
165094166,  giovanni_tont, 1, 1, 0, yes
226641307,  gestoredirete, 1, 1, 0, yes
95111515,  dmerovingio, 1, 1, 0, yes
433707374,  vanymorata, 2, 2, 0, yes
3218048074,  gialloblu1907, 1, 1, 0, yes
792311228609822720,  frenyzzle, 1, 1, 0, yes
1180711645,  CTAMELLINI, 2, 2, 0, yes
356774248,  FPergolese, 2, 1, 1, neutral
257188974,  cavramingo, 4, 2, 2, neutral
2320262368,  hopind_mystic, 1, 1, 0, yes
46706273,  renesolermusic, 2, 2, 0, yes
116828005,  carmenbeat, 1, 1, 0, yes
33831648,  ritagiuliani, 2, 2, 0, yes
797028637333749760,  andrecol87, 2, 1, 1, neutral
1204267536,  Elmosmoccurio, 1, 1, 0, yes
268208354,  CalogeroAquila, 1, 1, 0, yes
366766979,  teoburgs, 1, 1, 0, yes
191094356,  LenaMaturin, 1, 1, 0, yes
1362033247,  mar_paladino, 3, 1, 2, no
489310317,  stefanofacco99, 1, 1, 0, yes
2656206754,  matteucci84, 1, 1, 0, yes
274406790,  miaminiz, 1, 1, 0, yes
2447280450,  FabioND10, 1, 1, 0, yes
2421081508,  nliangeli93, 1, 1, 0, yes
720527794619478016,  Maxwell76M, 1, 1, 0, yes
531400039,  luc314, 1, 1, 0, yes
288375991,  ashleysepia, 1, 1, 0, yes
514407629,  GrethelCartaMan, 1, 1, 0, yes
443015444,  CarlosPalacn, 1, 1, 0, yes
2533163394,  vannijack, 1, 1, 0, yes
23177770,  fdomenella, 7, 7, 0, yes
1037846899,  fava_giuseppe, 9, 4, 5, no
745261482,  LucinaDiMeco, 3, 3, 0, yes
840804259,  MattiaMeirone, 2, 2, 0, yes
45532597,  Justoverthesky, 4, 2, 2, neutral
43452778,  Tom2_0Live, 1, 1, 0, yes
52165227,  sbUdUbU, 2, 2, 0, yes
54554348,  withego, 1, 1, 0, yes
2905530046,  miriamdalfomso, 1, 1, 0, yes
805588085618700288,  FedeValandro, 1, 1, 0, yes
739460203486285824,  federika88, 1, 1, 0, yes
782492444336254976,  working2eventi, 3, 2, 1, yes
393534336,  MartiAbbondanza, 1, 1, 0, yes
2594423644,  Moni4Rome, 2, 2, 0, yes
3194124455,  axenia_rosca, 1, 1, 0, yes
1712603108,  vitotorello, 1, 1, 0, yes
38903873,  ddinno, 2, 2, 0, yes
1174508773,  MiriamPalazzo1, 1, 1, 0, yes
145985649,  AARCarchitetti, 1, 1, 0, yes
738313190887546880,  Gius_1987, 3, 3, 0, yes
57936402,  piscotta82, 1, 1, 0, yes
804319476657389568,  JennywiththeJ, 1, 1, 0, yes
1482983257,  paolamarino64, 2, 2, 0, yes
329928735,  AlessioRavenna, 3, 2, 1, yes
631364970,  SofiaLombardi, 1, 1, 0, yes
4547588854,  placrt22, 1, 1, 0, yes
277465345,  zaesarsoc, 1, 1, 0, yes
801481023393591298,  PeppaM58, 1, 1, 0, yes
805682982891700224,  Alessan63535400, 1, 1, 0, yes
496795333,  KiKiQuaglia, 1, 1, 0, yes
2740292727,  sabinamaccarro1, 1, 1, 0, yes
787736005,  StevenLee290, 1, 1, 0, yes
4499861554,  marina_nervo, 1, 1, 0, yes
1155222637,  rrossidue, 7, 7, 0, yes
24868978,  SaraDeDeo, 2, 2, 0, yes
2939270097,  cenia_sara, 1, 1, 0, yes
347522105,  rotax76, 1, 1, 0, yes
2497356511,  CarnielRossella, 3, 3, 0, yes
491104092,  Lehandro89, 1, 1, 0, yes
546858689,  SBonaccina, 1, 1, 0, yes
79151996,  tito_coluccelli, 1, 1, 0, yes
115014966,  federicomorando, 1, 1, 0, yes
1941405499,  fdonelli, 1, 1, 0, yes
3416542491,  pakos1994, 1, 1, 0, yes
19349569,  arenda, 1, 1, 0, yes
561601842,  gtopjon, 2, 2, 0, yes
1404900818,  MBarroccu, 3, 3, 0, yes
80567096,  zetanove, 1, 1, 0, yes
808587727,  TopRT_IT, 2, 2, 0, yes
805590788600168448,  Davide22888535, 1, 1, 0, yes
2168813293,  cr_colombo, 5, 3, 2, yes
1148239141,  Luciano12199379, 5, 1, 4, no
82071596,  marymiu, 1, 1, 0, yes
265427137,  pdgimmobiliare, 1, 1, 0, yes
428910104,  MariaLazzaroni, 1, 1, 0, yes
2154765489,  Albacha111Bacha, 1, 1, 0, yes
50459310,  DeboraCapalbo, 1, 1, 0, yes
407151003,  laessebi, 1, 1, 0, yes
583907112,  Sicilia882, 3, 3, 0, yes
805561098288201728,  CarloScognamig6, 1, 1, 0, yes
431177356,  Gioia_Palm, 2, 2, 0, yes
184984969,  ValdaCM, 2, 2, 0, yes
805558077013524481,  carlotrocchi11, 1, 1, 0, yes
383266488,  calunajanles, 1, 1, 0, yes
2282801540,  francamato3, 1, 1, 0, yes
69561739,  tuttoscemo, 1, 1, 0, yes
3072516610,  ianna63, 1, 1, 0, yes
2690409655,  giuseppedanese2, 1, 1, 0, yes
3003116697,  mfperezcr, 1, 1, 0, yes
437512892,  diegoferre1, 1, 1, 0, yes
372163834,  casteddu1984, 2, 2, 0, yes
547831170,  Adihajdarhodzic, 1, 1, 0, yes
775312021399232512,  wakaflaka90, 1, 1, 0, yes
109869957,  abcd_ely, 1, 1, 0, yes
723554886651142144,  mbx1900, 7, 1, 6, no
440960994,  javisanchezglez, 1, 1, 0, yes
1275001772,  ellellevercillo, 4, 2, 2, neutral
429469577,  paolabrilli1, 2, 2, 0, yes
14052979,  Monyka, 1, 1, 0, yes
1553748344,  yannlatrik, 1, 1, 0, yes
256734980,  ilSindic, 1, 1, 0, yes
2880215427,  ea83cc0f3622435, 2, 2, 0, yes
2990368215,  7cf797865a654d2, 1, 1, 0, yes
265017059,  paraid82, 1, 1, 0, yes
744645346232500224,  juananprz, 1, 1, 0, yes
3586587142,  GueneyK58, 1, 1, 0, yes
4385308702,  MilioneManuel, 1, 1, 0, yes
40472896,  nady0310, 3, 2, 1, yes
195695463,  AntonioBruno84, 1, 1, 0, yes
416290762,  fioresalvino, 18, 2, 16, no
312550124,  StefanoBertuzzi, 1, 1, 0, yes
396826432,  cardinali_carlo, 9, 1, 8, no
3305457508,  remoremo12323, 2, 2, 0, yes
66505492,  azzurrinha, 1, 1, 0, yes
62577085,  buckybarks, 1, 1, 0, yes
805559903817449473,  VoceMuta, 1, 1, 0, yes
418248432,  gferrax, 1, 1, 0, yes
474908439,  DonatoAbbate, 1, 1, 0, yes
1092794108,  Diana_DeMarchi, 1, 1, 0, yes
333362225,  StellaBi79, 1, 1, 0, yes
323156359,  piescic, 1, 1, 0, yes
101031118,  luca_ruberto, 18, 9, 9, neutral
377598768,  enricomontorsi, 2, 2, 0, yes
3318774389,  UliSpreitzer, 4, 2, 2, neutral
2202004531,  MRalessioserra, 1, 1, 0, yes
711548832312659968,  sarafesposito, 2, 2, 0, yes
1139018790,  mancinigraziano, 3, 1, 2, no
191384333,  clatiro, 3, 2, 1, yes
255566304,  MalikSarajevo, 1, 1, 0, yes
2839768911,  Zanichelli5, 1, 1, 0, yes
805563475581894656,  beabosco97, 2, 1, 1, neutral
793581775817699328,  meg_thedullgirl, 1, 1, 0, yes
2445358395,  LukeysTardis, 1, 1, 0, yes
597293515,  sfaiella, 1, 1, 0, yes
405125113,  PaolaAmbrosino, 1, 1, 0, yes
2921306229,  57Ascari, 1, 1, 0, yes
87051231,  oggionni, 1, 1, 0, yes
180356278,  alfio82it, 1, 1, 0, yes
373352975,  Conneri70, 1, 1, 0, yes
1084646606,  ellamanganelli, 1, 1, 0, yes
805557438669869057,  porcaitalia, 3, 2, 1, yes
2504105605,  anthea_91, 1, 1, 0, yes
139430375,  duemila20, 1, 1, 0, yes
501195196,  rossonera_42, 1, 1, 0, yes
763123177690193921,  andreyvette16, 1, 1, 0, yes
405912134,  AntoninoPolito, 1, 1, 0, yes
2651904048,  raffaele_roll, 1, 1, 0, yes
24149582,  SimoneMoriM, 1, 1, 0, yes
724288978220888064,  Delazzza, 2, 1, 1, neutral
70164099,  ale_palermo, 1, 1, 0, yes
92378926,  laquilaabruzzo, 3, 3, 0, yes
604765988,  rescuemelou, 1, 1, 0, yes
725984888344723456,  TrTreccarichi, 1, 1, 0, yes
2325565789,  blaahsimmi, 3, 2, 1, yes
318930806,  Alberto_Ambrosi, 1, 1, 0, yes
4525547722,  tarozzoredirect, 1, 1, 0, yes
1011908012,  alfaomega012, 1, 1, 0, yes
61732896,  GabrieleBaratto, 1, 1, 0, yes
2462374708,  matte_mariani, 1, 1, 0, yes
1673210132,  Crisine66, 1, 1, 0, yes
1477453526,  ipernapoli, 3, 3, 0, yes
2431849271,  gughygu, 1, 1, 0, yes
235261778,  Real_Mss_Styles, 1, 1, 0, yes
591102065,  asialove22, 1, 1, 0, yes
1019817919,  Alessia273, 1, 1, 0, yes
3318650853,  Mrs_Lar_Hood, 1, 1, 0, yes
426535684,  sandrosabatino, 1, 1, 0, yes
2215819597,  MarcellaGrecu, 1, 1, 0, yes
3433216204,  Scudzeko, 1, 1, 0, yes
30303783,  gb0743, 1, 1, 0, yes
131653616,  fraggletastic, 1, 1, 0, yes
4765403127,  BeraldoRoberta, 1, 1, 0, yes
805563788195954688,  AlessandraRand, 1, 1, 0, yes
157611373,  pierocamera, 2, 1, 1, neutral
363066504,  VincenzoReggina, 1, 1, 0, yes
789870840,  EMILIOPOLVY, 4, 2, 2, neutral
796025388514283520,  viciomanga70, 1, 1, 0, yes
2715411465,  claudiocillari1, 1, 1, 0, yes
624603613,  GiAdIiSsImA89, 9, 9, 0, yes
137982833,  amicodiverte, 3, 2, 1, yes
759921308297605120,  AngelaVidili, 1, 1, 0, yes
805563882253193219,  Eleonor_013, 1, 1, 0, yes
459624509,  UmbeMarengo, 2, 1, 1, neutral
361770326,  _Paghy_, 1, 1, 0, yes
1033020176,  FaberFerrante, 2, 2, 0, yes
239588626,  vannitotaro, 1, 1, 0, yes
431966285,  marmarfar, 1, 1, 0, yes
2436681937,  elecrispino, 1, 1, 0, yes
1855197146,  bralex84, 3, 3, 0, yes
540414141,  P2FiorelloMania, 1, 1, 0, yes
2259385171,  MicheleCrescini, 3, 3, 0, yes
625885536,  AngeloDitria, 1, 1, 0, yes
900625873,  fabio_pallaro, 1, 1, 0, yes
257541444,  luisrueda96, 1, 1, 0, yes
805557888320212992,  Valenti19807063, 2, 2, 0, yes
3081871101,  0Piera, 2, 2, 0, yes
1015397084,  idosudro, 2, 2, 0, yes
1013065578,  enniobianchi1, 2, 2, 0, yes
2728013525,  GBertaglia, 3, 2, 1, yes
728440574,  FinaTolindo, 1, 1, 0, yes
547575470,  RokkoPicerno, 1, 1, 0, yes
349585024,  EdoardoMaestri, 1, 1, 0, yes
723009325,  AndreaMartini80, 1, 1, 0, yes
8724702,  franzcos, 1, 1, 0, yes
515635839,  Snoop_Demo, 1, 1, 0, yes
454152305,  dangerven, 1, 1, 0, yes
3435154781,  hazrecc, 1, 1, 0, yes
525850721,  MicheleDamonte, 2, 1, 1, neutral
1432778851,  musumeci29, 1, 1, 0, yes
99488270,  ffhorizon, 1, 1, 0, yes
593509889,  MilenaPessina1, 2, 2, 0, yes
1375844893,  igeektolive, 1, 1, 0, yes
441879621,  alegiramondo, 1, 1, 0, yes
360188602,  tomrossotti, 1, 1, 0, yes
3005771757,  Stefaniannz, 1, 1, 0, yes
4009313313,  wmassafra1, 2, 1, 1, neutral
189816720,  njuste, 1, 1, 0, yes
3670005443,  cgiannarino, 1, 1, 0, yes
193755396,  MrDicomex, 1, 1, 0, yes
453812597,  lorebenci, 1, 1, 0, yes
235481090,  ildoje, 1, 1, 0, yes
2258046194,  GangemiLohan, 1, 1, 0, yes
488844512,  giordi63, 4, 1, 3, no
2476205996,  theharrycock, 1, 1, 0, yes
405354066,  silasmarcosborn, 1, 1, 0, yes
562401026,  wildjack1, 1, 1, 0, yes
1132339716,  AlBallarini, 1, 1, 0, yes
1315351338,  LidaKuang, 1, 1, 0, yes
1322558791,  gigliogall, 1, 1, 0, yes
3110845047,  tmiccot, 5, 5, 0, yes
4825143837,  sabri73_sabrina, 1, 1, 0, yes
2304892520,  lgcampanile, 1, 1, 0, yes
760965704418033664,  Antpanic96, 1, 1, 0, yes
3312086805,  nonnamoderna60, 1, 1, 0, yes
1604100126,  pakodoni, 2, 2, 0, yes
2799972731,  fedeinlondon, 1, 1, 0, yes
140078240,  lucaddi, 1, 1, 0, yes
417761840,  Davide92es, 3, 2, 1, yes
1405385509,  ilianasissi, 1, 1, 0, yes
3312131968,  kIapollos, 1, 1, 0, yes
795557511734632449,  APpianist, 1, 1, 0, yes
1033426050,  Monets19, 3, 2, 1, yes
804315233011507200,  IlyLuongo, 1, 1, 0, yes
577177928,  francesca_lenty, 1, 1, 0, yes
505838638,  cozzutti, 1, 1, 0, yes
2348792540,  davidpisaneschi, 1, 1, 0, yes
804778322857250817,  MarinaBurnacci1, 2, 2, 0, yes
357639773,  CarlucciniChri, 1, 1, 0, yes
321263996,  andrfiore, 1, 1, 0, yes
709389043,  GS_LAbbate, 10, 1, 9, no
588460132,  benrosky2, 1, 1, 0, yes
2358469433,  tuttok2011, 2, 2, 0, yes
416402124,  xalexfrance, 1, 1, 0, yes
805733258461855745,  scrambler_one, 1, 1, 0, yes
56706947,  paoloalbano, 3, 2, 1, yes
543558776,  a_hsd, 2, 2, 0, yes
3313166170,  ragnetto, 1, 1, 0, yes
107458928,  Leti_wldrf13, 1, 1, 0, yes
2875841338,  77paideia, 2, 1, 1, neutral
216130626,  antooooo85, 1, 1, 0, yes
3438195976,  giovao3, 1, 1, 0, yes
987329048,  PaoloINNOCENTI6, 1, 1, 0, yes
14173157,  maxliccardo, 1, 1, 0, yes
84074331,  alanpalombi, 1, 1, 0, yes
574047334,  PeveriMauro, 3, 1, 2, no
42914452,  marco_cattaneo, 1, 1, 0, yes
220613412,  andreaballero, 1, 1, 0, yes
418736719,  gio65mar, 1, 1, 0, yes
631104764,  mattepow, 1, 1, 0, yes
4703813781,  MimmoCaruso56, 2, 2, 0, yes
156019997,  pablozena66, 1, 1, 0, yes
2458455888,  matvej_s, 3, 3, 0, yes
388420971,  LupoGiuseppe1, 1, 1, 0, yes
515167150,  Poliroma, 40, 36, 4, yes
484708643,  PatriziaTomasi1, 1, 1, 0, yes
996850076,  lau_spo, 3, 2, 1, yes
380253950,  occhidaraba, 1, 1, 0, yes
1076316258,  capitana1965, 1, 1, 0, yes
250693134,  nisumma, 2, 1, 1, neutral
2491061695,  helpfiore, 1, 1, 0, yes
2761835593,  gigidangio, 1, 1, 0, yes
532089309,  dorak51, 1, 1, 0, yes
1036593667,  claudio_nuti, 2, 2, 0, yes
2157694720,  cuncetipetta, 1, 1, 0, yes
55193168,  Amok_PP, 1, 1, 0, yes
461124590,  ccharlotts, 1, 1, 0, yes
4069923435,  marilinalisi4, 1, 1, 0, yes
22907521,  peval27, 1, 1, 0, yes
863596795,  DavideMariga, 3, 2, 1, yes
464898327,  marcopasquini2, 1, 1, 0, yes
802092250066984960,  ritamasi4, 1, 1, 0, yes
1026265896,  lilianasabatino, 1, 1, 0, yes
3435708070,  stevenViotti, 1, 1, 0, yes
196409507,  MatsKBj, 1, 1, 0, yes
3300627109,  FlorianHeiner, 1, 1, 0, yes
4867155778,  Ro020812, 1, 1, 0, yes
4689722174,  The__Quarrymen_, 2, 2, 0, yes
1608331512,  sprea_84, 2, 1, 1, neutral
773260743684788228,  king_enry, 2, 2, 0, yes
2663458522,  gianluca24474, 1, 1, 0, yes
2577663699,  luicome, 1, 1, 0, yes
2954761065,  AnettKirchner, 1, 1, 0, yes
1172000148,  Luly1949, 1, 1, 0, yes
2784080999,  liberodatuttose, 1, 1, 0, yes
1202345928,  barby_fari, 3, 1, 2, no
319521867,  Lxfetto, 1, 1, 0, yes
1063022088,  brusso1234, 1, 1, 0, yes
2268950237,  ABrentassi, 1, 1, 0, yes
29302472,  SGlti, 3, 3, 0, yes
805677711679254528,  Vittoriocovre02, 1, 1, 0, yes
1266793658,  mauroucci, 1, 1, 0, yes
2189467576,  Piazza6Laura, 1, 1, 0, yes
3306991895,  BigongialiLucia, 1, 1, 0, yes
1009453760,  AnnaMCamporeale, 1, 1, 0, yes
2400306869,  m4ssimiliano_86, 2, 1, 1, neutral
2182678656,  JacopoMira7, 1, 1, 0, yes
3891494854,  flavia_baldi79, 1, 1, 0, yes
2462781947,  EnricoVioli, 1, 1, 0, yes
328551488,  vianelik, 2, 2, 0, yes
775074632575705090,  Pisasimo89, 1, 1, 0, yes
2505648783,  ciabattamarza, 1, 1, 0, yes
166328344,  ladyMarion85, 1, 1, 0, yes
432462395,  MarioRefuto, 1, 1, 0, yes
295231631,  OresteMazzi, 1, 1, 0, yes
420351046,  sole24ore, 3, 3, 0, yes
1008683240,  marziacataldi, 1, 1, 0, yes
26968329,  spourvendier, 2, 1, 1, neutral
2254174623,  MartaGallina1, 1, 1, 0, yes
304510359,  LeonorMarBel, 1, 1, 0, yes
410764457,  pierluigiele, 1, 1, 0, yes
3616673775,  Craftergut, 1, 1, 0, yes
1975578234,  remop47, 2, 1, 1, neutral
171505056,  Licettina, 1, 1, 0, yes
2303605488,  DanielaSword, 1, 1, 0, yes
403161544,  Vincenzo_Di_Leo, 1, 1, 0, yes
19028516,  StefanoOlivari, 2, 1, 1, neutral
2325971197,  DiSipioLuigi, 2, 2, 0, yes
1696429746,  sergiangelo, 1, 1, 0, yes
868606758,  AndreaFerrarin4, 2, 2, 0, yes
787588087190781952,  IntrecciArte, 1, 1, 0, yes
786238108631052288,  dana100657, 1, 1, 0, yes
571869122,  luigimig21, 1, 1, 0, yes
3009771069,  MarcoHomerJ, 1, 1, 0, yes
1092938449,  kiacchia83, 1, 1, 0, yes
1114059097,  LauraAlibra, 1, 1, 0, yes
1041550796,  giupeppe_napoli, 2, 2, 0, yes
580787517,  RalloMatteo, 1, 1, 0, yes
798907507695636480,  GloriaLeone4, 1, 1, 0, yes
3431833228,  martinamanca_, 1, 1, 0, yes
805479115310723072,  gargiulote, 2, 2, 0, yes
805030253341065216,  kokonews5, 1, 1, 0, yes
61613898,  RamziNasir, 1, 1, 0, yes
50269456,  macondo68, 1, 1, 0, yes
2981320335,  marcelloliccia3, 2, 2, 0, yes
2770171641,  oibafaccuz, 2, 2, 0, yes
33211808,  andre_peralta, 1, 1, 0, yes
595497169,  ulivig, 1, 1, 0, yes
593729812,  salven52, 1, 1, 0, yes
596405762,  Reteblu, 1, 1, 0, yes
505644756,  RoccoMessina2, 1, 1, 0, yes
379553108,  mario_viola, 2, 1, 1, neutral
407146029,  supertump, 1, 1, 0, yes
805723198469898240,  annasalizzabo, 1, 1, 0, yes
805726563853631488,  LtdFranco, 2, 2, 0, yes
805666594110238720,  Valentina281185, 1, 1, 0, yes
946181442,  gianlucagrb, 1, 1, 0, yes
344623565,  GPugliesi, 1, 1, 0, yes
2660974942,  GV75_FR, 1, 1, 0, yes
377997682,  CeciliaVig, 1, 1, 0, yes
22601789,  GenGen72, 1, 1, 0, yes
977177101,  Lienz46, 2, 2, 0, yes
1952055770,  alswirkoenten, 1, 1, 0, yes
2623744426,  AGrigina, 1, 1, 0, yes
2289750857,  cxlvii18, 1, 1, 0, yes
3749528777,  adele_effe, 1, 1, 0, yes
1037583168,  4magora, 1, 1, 0, yes
805467321389158400,  OlloMoschetti, 2, 1, 1, neutral
816135402,  VolpatoLuciano, 1, 1, 0, yes
3001821422,  LelaPame74, 1, 1, 0, yes
787922960925483008,  davidecontu97, 1, 1, 0, yes
804453673552134144,  NatAle992, 1, 1, 0, yes
2959067991,  SteffyVir, 1, 1, 0, yes
4766770768,  QuilicoUgo, 1, 1, 0, yes
800776975140851713,  GiovannaDavid6, 1, 1, 0, yes
2353760868,  ghigoghigo2, 8, 1, 7, no
2713840689,  oscar236_, 1, 1, 0, yes
780453512803192832,  melindaaaa94, 1, 1, 0, yes
805723413465759745,  AriannaPaoli78, 1, 1, 0, yes
895286318,  KonKiara, 1, 1, 0, yes
2203363914,  Gianlucarizzant, 2, 1, 1, neutral
1402619654,  xndrsbileduct, 1, 1, 0, yes
610175536,  AleRana95, 1, 1, 0, yes
1222986782,  andrewasr6630, 1, 1, 0, yes
96604544,  MarcoDeMartis, 1, 1, 0, yes
773860271282675712,  TommasoFidanzia, 1, 1, 0, yes
365493942,  valeriodorazi, 1, 1, 0, yes
707658874,  DemarchiFra, 1, 1, 0, yes
805720799634145280,  bianca_villy, 1, 1, 0, yes
997759596,  sc0pritore, 2, 1, 1, neutral
53065894,  AlessandroPat, 1, 1, 0, yes
128816487,  treckk, 1, 1, 0, yes
1333750741,  eccio22, 1, 1, 0, yes
737963630218649600,  IdoDallalana, 1, 1, 0, yes
722191243,  MartinaFaldi, 1, 1, 0, yes
1664433936,  pagafacile, 1, 1, 0, yes
717286755699916801,  Rosannadifra, 1, 1, 0, yes
757297568196026373,  Betsabea25, 1, 1, 0, yes
93370094,  Wilmone, 1, 1, 0, yes
4208609711,  I3hvsVittorio, 1, 1, 0, yes
896316086,  LilliIzzo, 2, 2, 0, yes
503194893,  MEnestro_, 1, 1, 0, yes
414675500,  948Dominique, 1, 1, 0, yes
2461728571,  sauro30101961, 1, 1, 0, yes
1077499177,  mm_enzo, 1, 1, 0, yes
396774338,  sannymozzy, 1, 1, 0, yes
515470569,  andrewpasq, 1, 1, 0, yes
390250086,  PPenagoli, 2, 2, 0, yes
773502885502001156,  LIBERO79498223, 1, 1, 0, yes
805660577016217600,  AntonioAruano1, 2, 2, 0, yes
73967991,  belisariusx, 1, 1, 0, yes
4866717149,  revolution_fr, 3, 3, 0, yes
2889506848,  elisabettanali2, 1, 1, 0, yes
778478980370403328,  twelveme, 1, 1, 0, yes
74703347,  caccia74, 2, 2, 0, yes
599261888,  giuseppesassa, 1, 1, 0, yes
130919010,  gabbani72, 1, 1, 0, yes
839407824,  giuliacolombo7, 2, 2, 0, yes
109067974,  bambinadiaz, 1, 1, 0, yes
836007223,  annalisacimatti, 1, 1, 0, yes
332662414,  lbrfrz, 1, 1, 0, yes
45100798,  Slargapel, 1, 1, 0, yes
2196137971,  FedericaDC83, 1, 1, 0, yes
805657117487222785,  Franchinobel, 1, 1, 0, yes
779399291915931648,  serenaedenny, 4, 4, 0, yes
1364703349,  blade_runner68, 2, 2, 0, yes
2363064713,  buotiz, 1, 1, 0, yes
528833475,  massimo1175, 3, 1, 2, no
3233509552,  rosevvoodgirl, 1, 1, 0, yes
474297452,  mi8330, 1, 1, 0, yes
767298055,  PerleDiFollia, 1, 1, 0, yes
1847427919,  x5secofharry, 1, 1, 0, yes
282941464,  queensy79, 1, 1, 0, yes
24905259,  vestaledizeus, 3, 2, 1, yes
491317733,  76theedge76, 1, 1, 0, yes
797043235222855680,  dL3uqhOtLmLK1ea, 1, 1, 0, yes
600186678,  Veroauger_eu, 2, 1, 1, neutral
1892674471,  FRANCESCO1857, 1, 1, 0, yes
606572020,  nicolascaligina, 1, 1, 0, yes
2304429884,  silviocanargiu, 1, 1, 0, yes
72125038,  pesmiz, 1, 1, 0, yes
805316471039623168,  Luca24735964, 3, 3, 0, yes
4185374404,  dilucaSin, 1, 1, 0, yes
251721234,  GianDes, 1, 1, 0, yes
1262115918,  FENERIEMILIO, 1, 1, 0, yes
744167996487307264,  mondini_luisa, 1, 1, 0, yes
420210142,  cekka23, 2, 2, 0, yes
477987677,  bughybughi, 1, 1, 0, yes
630573729,  Magnardis, 1, 1, 0, yes
790939785149939712,  viscontifamily, 1, 1, 0, yes
142386619,  stelutealpine81, 1, 1, 0, yes
780139737755549696,  La_Raffi, 1, 1, 0, yes
2441592352,  danielatognocc1, 1, 1, 0, yes
2231337922,  EliStaim, 1, 1, 0, yes
444640968,  vaniabettucchi, 2, 2, 0, yes
558090385,  AndreaMinini, 1, 1, 0, yes
484118321,  simonpistollato, 1, 1, 0, yes
411630693,  SirCicca, 1, 1, 0, yes
2251811183,  fauilla, 1, 1, 0, yes
702845547078676480,  BPrevtali, 1, 1, 0, yes
114428546,  vincamendola, 1, 1, 0, yes
805688610368475136,  Roberto24514, 2, 2, 0, yes
2181849375,  LSavito, 1, 1, 0, yes
2855733442,  gherozacc, 1, 1, 0, yes
507773595,  FMauro10, 1, 1, 0, yes
1918130443,  australiano27, 1, 1, 0, yes
805712974065397760,  Bau_dolino, 1, 1, 0, yes
805709911426531328,  OrnellaRattini, 1, 1, 0, yes
1143690379,  morvione, 1, 1, 0, yes
955343978,  a_casciaro, 1, 1, 0, yes
1676787925,  laurammandelli, 3, 2, 1, yes
84057783,  MaryCandela, 1, 1, 0, yes
387112928,  Lucagrillanda, 1, 1, 0, yes
747398927759122432,  Sheva_gol, 1, 1, 0, yes
75010284,  polepolebetta, 1, 1, 0, yes
3223861275,  OSVI34, 1, 1, 0, yes
124913558,  Mariomonaco68, 1, 1, 0, yes
1073080100,  TW_SilverSurfer, 8, 2, 6, no
861572696,  Bluessunflowers, 1, 1, 0, yes
4066807079,  futurirubati, 2, 1, 1, neutral
1083633715,  marfe99, 1, 1, 0, yes
3790965321,  la_Gaze, 1, 1, 0, yes
3817502380,  samu2876, 1, 1, 0, yes
744062876512575488,  non_esset, 2, 2, 0, yes
1596340129,  zjmsnormani, 1, 1, 0, yes
372981992,  AleNistico, 2, 2, 0, yes
263578319,  circemaga, 1, 1, 0, yes
3289583757,  Sara_Bullock81, 1, 1, 0, yes
719234997316644864,  fabio33090488, 1, 1, 0, yes
122026959,  Lilsistakaty, 4, 4, 0, yes
390541760,  CesarePolli, 1, 1, 0, yes
2567565267,  DRomei, 1, 1, 0, yes
747735140047130624,  _ThousandN, 1, 1, 0, yes
58291981,  GiorgioSavoldi, 1, 1, 0, yes
2837968374,  alessandrochec3, 1, 1, 0, yes
2966670283,  sara_panzeri, 1, 1, 0, yes
610735566,  RobBrunoit, 1, 1, 0, yes
1869343627,  OggiSonoBravA, 1, 1, 0, yes
2373058468,  ElenaMXP, 1, 1, 0, yes
416674648,  FeliceDArco, 1, 1, 0, yes
1154953621,  annamariarusso1, 1, 1, 0, yes
218069358,  semi50, 1, 1, 0, yes
460145280,  concettavitolo, 1, 1, 0, yes
1135092072,  gianlucamilo78, 2, 2, 0, yes
356073621,  CriG2410, 1, 1, 0, yes
2347471091,  Maria_Rabito, 2, 2, 0, yes
770208197537923072,  michelegalli29, 1, 1, 0, yes
3004221005,  Ella_pois, 1, 1, 0, yes
252197304,  Eliana_Fly, 1, 1, 0, yes
88454221,  diaghilev2, 1, 1, 0, yes
1709901535,  francescofran2, 1, 1, 0, yes
48983716,  JustanHotelier, 1, 1, 0, yes
401568347,  PpPagliaro, 1, 1, 0, yes
173836023,  _stefaniap, 1, 1, 0, yes
444598054,  IlariaTroian, 1, 1, 0, yes
2507914064,  AntoMencacci, 1, 1, 0, yes
126924380,  Miko1377, 1, 1, 0, yes
431881059,  NortidaDardha, 1, 1, 0, yes
42244940,  Longlegtomboy, 1, 1, 0, yes
217815159,  AleRicci90, 2, 2, 0, yes
370182024,  FSchiavariello, 1, 1, 0, yes
760528337966133248,  claudio_menale, 1, 1, 0, yes
2854413556,  isaisa65, 2, 1, 1, neutral
2730169601,  12aprile14, 1, 1, 0, yes
331683916,  AsiaEis, 6, 3, 3, neutral
2482780253,  pitchblack746, 1, 1, 0, yes
499950573,  bartolip70, 1, 1, 0, yes
418182172,  LucaGuzzo1, 1, 1, 0, yes
402048742,  elisacalessi, 5, 3, 2, yes
194701800,  LucaChichiSala, 1, 1, 0, yes
323844319,  lucacuppi, 1, 1, 0, yes
731865708733272065,  FilippaDaniela, 2, 2, 0, yes
771020746109882368,  Teskio87, 1, 1, 0, yes
200869165,  gerardoforliano, 1, 1, 0, yes
1021829911,  urien300, 1, 1, 0, yes
327053541,  rosscaracol, 1, 1, 0, yes
592284060,  danc667, 1, 1, 0, yes
824075305,  Elsa_Elbazis, 1, 1, 0, yes
805565353275301888,  leoscac80, 1, 1, 0, yes
717943272,  FazFabio, 4, 1, 3, no
54688260,  mirkocalemme, 1, 1, 0, yes
454957458,  Giuditta_C, 1, 1, 0, yes
3051223909,  gius03ct, 1, 1, 0, yes
4230255508,  Manumosi1, 1, 1, 0, yes
3084257668,  qudulibri, 1, 1, 0, yes
428464404,  fabioragni92, 2, 2, 0, yes
2963141259,  lovemeanto, 1, 1, 0, yes
147872956,  sistemato5, 1, 1, 0, yes
784465133011599360,  Laneralex833, 1, 1, 0, yes
742012732145336320,  achernar_blast, 1, 1, 0, yes
166778849,  IlCappoVittore, 1, 1, 0, yes
1377361808,  Sara_J27, 16, 12, 4, yes
2977350736,  zanaboni1, 2, 2, 0, yes
4164544401,  lo_smilzo123, 1, 1, 0, yes
4266268887,  SuzanneChamma, 5, 5, 0, yes
445476842,  claudiazeni1, 4, 3, 1, yes
617612841,  ScarpatoLuca, 2, 1, 1, neutral
394905727,  elkios73, 2, 1, 1, neutral
457950946,  FerMirko, 1, 1, 0, yes
464854793,  nicola798, 1, 1, 0, yes
770392112105914372,  igreggiocal, 1, 1, 0, yes
2973547582,  achareal, 1, 1, 0, yes
1615782625,  GuidoAlessio, 1, 1, 0, yes
522146584,  PakiLama, 1, 1, 0, yes
3065264536,  D_Spriggs43, 1, 1, 0, yes
381011797,  RobertoAramini, 1, 1, 0, yes
43931484,  JimBronskill, 1, 1, 0, yes
385522793,  Riccardoriccar1, 1, 1, 0, yes
41400715,  Betta_1992, 1, 1, 0, yes
2829522125,  Lintellan, 1, 1, 0, yes
2359383127,  alessandrocuzz1, 1, 1, 0, yes
3026333837,  EleonoraRovito, 1, 1, 0, yes
524809486,  4gni, 1, 1, 0, yes
782494015,  vescio_orlando, 3, 3, 0, yes
3095619550,  XPEPPE97X, 1, 1, 0, yes
1107391316,  rosmilan, 1, 1, 0, yes
700571530,  BacciLara, 1, 1, 0, yes
4256144895,  pauline_mazin, 1, 1, 0, yes
96637364,  FabioNatalucci, 1, 1, 0, yes
1083824419,  JackHawkins02, 1, 1, 0, yes
16780708,  MeridioNews, 1, 1, 0, yes
4904279621,  DavideT_92, 2, 2, 0, yes
2816544629,  Haejeogg, 1, 1, 0, yes
915516571,  AnthVespa, 1, 1, 0, yes
22016711,  AleFangano, 1, 1, 0, yes
390661901,  ale_sciretti, 1, 1, 0, yes
1099421017,  mmanuela07, 3, 1, 2, no
997507200,  LaSilviaR, 1, 1, 0, yes
469293581,  Dani_Tasso, 1, 1, 0, yes
993790446,  capldi, 1, 1, 0, yes
1909235491,  Alex_camboni, 4, 4, 0, yes
3187080806,  elizabethsangha, 1, 1, 0, yes
4644442289,  NiceShotCafe, 1, 1, 0, yes
744776242604343296,  RobertoSechi555, 1, 1, 0, yes
115821555,  LeverageCuda, 1, 1, 0, yes
764951818111750148,  JuliTheFirst, 1, 1, 0, yes
1295383261,  fatmaulgen, 1, 1, 0, yes
805212972264067072,  lucatambe, 2, 2, 0, yes
635296970,  marcobremb, 1, 1, 0, yes
144504621,  Jatzel09, 1, 1, 0, yes
591021132,  Valentina11Vale, 3, 2, 1, yes
3336877409,  AstoAlessandro, 1, 1, 0, yes
129164948,  valeriobrl, 5, 5, 0, yes
71271080,  kamavisione, 3, 3, 0, yes
400289790,  destinazroma, 4, 1, 3, no
93272727,  liamsnipple, 1, 1, 0, yes
272521304,  GRlFFINDORK, 1, 1, 0, yes
432708990,  gbocchieri, 2, 2, 0, yes
1022062812,  francyfeola, 1, 1, 0, yes
98740095,  grent82, 3, 3, 0, yes
272362666,  Pietros1982, 1, 1, 0, yes
580180263,  NickUbert, 1, 1, 0, yes
4081782863,  mohicani, 1, 1, 0, yes
394086402,  ceccotto74, 5, 2, 3, no
554550902,  Hgomara, 1, 1, 0, yes
549269702,  GiulioAndreoli, 10, 5, 5, neutral
1002564463,  Gianluca_Bongi, 1, 1, 0, yes
1534561381,  Lopeezus, 1, 1, 0, yes
233892110,  wiskyno, 8, 2, 6, no
4203949589,  Nwanky2, 3, 3, 0, yes
15600814,  middleclassbuzz, 1, 1, 0, yes
109812607,  momitodos, 1, 1, 0, yes
263597282,  robertodincau, 1, 1, 0, yes
53034833,  micaelacamaroto, 1, 1, 0, yes
3247733397,  ram10sin, 1, 1, 0, yes
2964296135,  peronello, 1, 1, 0, yes
2608830911,  FereAmiri, 1, 1, 0, yes
4895498483,  alexingra98, 1, 1, 0, yes
1039662980,  Luki6970, 4, 3, 1, yes
770672957614161921,  paolokanta, 2, 1, 1, neutral
107688105,  ErosLabara, 2, 2, 0, yes
2237348108,  juanferrerr, 1, 1, 0, yes
2600762739,  koula84, 1, 1, 0, yes
11667542,  maxturci, 1, 1, 0, yes
459082154,  MarinaCalzoni, 1, 1, 0, yes
451370524,  niconick89, 2, 2, 0, yes
1038129816,  acupofsamy, 1, 1, 0, yes
423578540,  MayaFerretti, 1, 1, 0, yes
82624516,  paolapierotti, 1, 1, 0, yes
230834144,  Alessia_Pinna90, 1, 1, 0, yes
488932813,  Novelanna, 2, 2, 0, yes
2369655635,  marcepisanu, 1, 1, 0, yes
212510232,  sabrykou, 1, 1, 0, yes
2357228716,  giovanniguazza1, 1, 1, 0, yes
2404840057,  AnnaNapoli46, 1, 1, 0, yes
485830194,  SilviaMengiGiur, 7, 7, 0, yes
83821749,  mcmingiacchi, 1, 1, 0, yes
1093335109,  FabriMartorelli, 1, 1, 0, yes
45174445,  trash_italiano, 1, 1, 0, yes
196283080,  marcodecu, 1, 1, 0, yes
288762146,  infusodithe, 2, 1, 1, neutral
1355619217,  MarinellaU, 1, 1, 0, yes
760835836346785793,  p3pp3dicosm5, 1, 1, 0, yes
2876938142,  CapuaWalter, 1, 1, 0, yes
712625176626769921,  immaginare1, 1, 1, 0, yes
84025943,  lingualandjp, 1, 1, 0, yes
2668229027,  Fcinterfans2, 1, 1, 0, yes
142296094,  trovabartender, 1, 1, 0, yes
460371242,  chiarapadu, 2, 2, 0, yes
509126371,  it9aup, 1, 1, 0, yes
4860515429,  seeeeree, 1, 1, 0, yes
512597661,  GianniToro75, 2, 2, 0, yes
489663383,  Maripan2, 1, 1, 0, yes
101079007,  cyberste, 2, 2, 0, yes
281159949,  LaurInter, 1, 1, 0, yes
592734814,  GianlucaGuardo, 2, 2, 0, yes
808763706,  ggblq, 1, 1, 0, yes
105406390,  dominicnanni, 3, 3, 0, yes
53022283,  gaetanofranco, 2, 2, 0, yes
351543541,  AlessioDeLuca1, 1, 1, 0, yes
2867786794,  maria_guerci, 1, 1, 0, yes
1219795716,  Whiplash46, 2, 2, 0, yes
300806300,  GabrieleNet1, 1, 1, 0, yes
194654625,  digimonjjunior, 1, 1, 0, yes
2364024907,  Emilo_S_Torres, 1, 1, 0, yes
66621167,  stefanolamanna, 1, 1, 0, yes
2354983764,  alexgrazzini, 3, 2, 1, yes
361132630,  MaddalenaFaedo, 1, 1, 0, yes
2926782875,  Mustapha1508, 1, 1, 0, yes
707502357,  CarmDigrezia, 1, 1, 0, yes
954071725,  somertastic, 1, 1, 0, yes
2801711627,  vikidesideri, 4, 1, 3, no
3121704701,  carlocekkini, 1, 1, 0, yes
2337532863,  SaraRosGI, 3, 3, 0, yes
451083998,  Ellessephoto, 9, 3, 6, no
1216616684,  fabmilano, 1, 1, 0, yes
3906942560,  fgramellini1, 2, 2, 0, yes
3124581651,  e_caciolo92, 3, 1, 2, no
3049365441,  ftroiano71, 1, 1, 0, yes
167135204,  soconn5, 1, 1, 0, yes
2935511249,  cittadino54, 1, 1, 0, yes
500245740,  AlessandraViero, 1, 1, 0, yes
781217587,  FratoniR, 1, 1, 0, yes
435323569,  Fabiana_xx, 1, 1, 0, yes
4061997435,  _lightblue97, 6, 6, 0, yes
571104142,  luisatonto, 1, 1, 0, yes
379950246,  _Blanche, 1, 1, 0, yes
486040444,  SuperSticchio, 1, 1, 0, yes
104815028,  IANDELLACASA, 1, 1, 0, yes
3325677778,  SpinosoAngelo, 1, 1, 0, yes
4821305896,  annabarbararosa, 1, 1, 0, yes
584131032,  NittoLeone, 1, 1, 0, yes
68482248,  alterquantum, 1, 1, 0, yes
702410174779228161,  loreta_terzini, 1, 1, 0, yes
1564405694,  selfvmade, 2, 2, 0, yes
252108270,  GiuliaCarla, 2, 2, 0, yes
387274847,  Luismi_Soler, 1, 1, 0, yes
426185698,  CesareGal70, 3, 3, 0, yes
335989756,  dabeat25, 2, 2, 0, yes
51836146,  StefanoBoeri, 4, 3, 1, yes
1002511194,  davideori90, 1, 1, 0, yes
66465123,  BlackDukeITA, 1, 1, 0, yes
136173805,  marisandralizzi, 1, 1, 0, yes
69601121,  albet86, 2, 2, 0, yes
417442872,  StefanoNoris, 1, 1, 0, yes
831730153,  PainterDReam, 2, 1, 1, neutral
396485439,  ioamolasardegna, 2, 2, 0, yes
863773182,  GiampieroBiglia, 2, 1, 1, neutral
318306185,  LucaLattanzi, 1, 1, 0, yes
29984815,  massimotiano, 1, 1, 0, yes
2408699625,  MDignani, 1, 1, 0, yes
514722953,  agosta_simone, 1, 1, 0, yes
3240796887,  G_luisOggebro, 1, 1, 0, yes
418259535,  lundici_it, 1, 1, 0, yes
574292336,  PeppinoCasale64, 2, 2, 0, yes
394332805,  HernanN_N, 1, 1, 0, yes
34898180,  GeoRosanna, 1, 1, 0, yes
127107676,  ariellegall21, 1, 1, 0, yes
559633081,  Dani_Gambit, 5, 5, 0, yes
42222355,  arasnigro, 1, 1, 0, yes
430044265,  giosabry, 1, 1, 0, yes
1624835593,  speakeasy_p, 3, 2, 1, yes
201049431,  Feli_small, 1, 1, 0, yes
493866087,  Pacha_kuti, 2, 1, 1, neutral
1614700928,  piccherroll, 2, 2, 0, yes
317214523,  SimonaFoglia, 7, 4, 3, yes
997495124,  teo1951, 2, 1, 1, neutral
301399914,  GianfDeGregorio, 1, 1, 0, yes
391693281,  photostereofree, 1, 1, 0, yes
997511580,  eliser08, 2, 1, 1, neutral
864808656,  massimobarone62, 1, 1, 0, yes
100278455,  niemete, 2, 2, 0, yes
3107012981,  robigalloni1, 2, 2, 0, yes
165737933,  Profferrari, 1, 1, 0, yes
942045698,  DaniaRessi, 1, 1, 0, yes
3290022280,  FlaviaRicevuti, 1, 1, 0, yes
217166151,  tatoalo, 1, 1, 0, yes
720586127,  EluciVeruska, 1, 1, 0, yes
432397706,  NarduzziLuca, 2, 1, 1, neutral
2549802077,  cioccopayno, 4, 3, 1, yes
2492813555,  FCucchiaroni, 1, 1, 0, yes
42981320,  chickenutZ, 1, 1, 0, yes
3026965575,  Gianni05G, 1, 1, 0, yes
2299526755,  Mrs_Coccoway, 1, 1, 0, yes
805712025179586560,  jackal67it, 1, 1, 0, yes
2976505282,  selenagalati, 1, 1, 0, yes
1725054890,  BedMau, 1, 1, 0, yes
55183612,  paulinadamico, 1, 1, 0, yes
2486847947,  ashtonomrical__, 1, 1, 0, yes
2484948226,  ShimmmerMagazln, 1, 1, 0, yes
244500244,  freexpression_, 5, 3, 2, yes
3065857803,  ayeltsalexiss, 1, 1, 0, yes
2482919440,  Qulddita, 1, 1, 0, yes
3065821193,  PatriclaAnnShow, 1, 1, 0, yes
2476498355,  KFahnstr0m, 1, 1, 0, yes
1063118197,  alessandramond4, 1, 1, 0, yes
4908653127,  lauramerlino1, 1, 1, 0, yes
1175897090,  LorenzoDGS, 1, 1, 0, yes
88930347,  claudiourbano, 2, 2, 0, yes
520918011,  LinaCatwoman, 1, 1, 0, yes
2774435558,  ItalianoPJ, 2, 2, 0, yes
780544113233932288,  mathew_ita, 1, 1, 0, yes
1336717021,  VanniniPatrizia, 1, 1, 0, yes
3048905493,  giovabomba, 1, 1, 0, yes
40287835,  xWAx_Templar, 1, 1, 0, yes
438532895,  m4lfuri0n, 2, 2, 0, yes
513538706,  dalesiog, 1, 1, 0, yes
3004511595,  LucaCinos, 2, 2, 0, yes
4195544692,  Edomenegaz, 1, 1, 0, yes
398751342,  Starbury4879, 2, 2, 0, yes
39512728,  jontargetti, 1, 1, 0, yes
456236226,  Cri1897, 1, 1, 0, yes
293992685,  ugotruffelli, 3, 3, 0, yes
2506162815,  sannasimola, 1, 1, 0, yes
2295670251,  martinamrcss, 1, 1, 0, yes
805581596707483648,  Rosyanna59, 2, 2, 0, yes
1921957074,  birretta_80, 1, 1, 0, yes
1454690916,  angelo_martelli, 1, 1, 0, yes
116904633,  ppedroni, 1, 1, 0, yes
460688565,  NaderNabil05, 1, 1, 0, yes
1224746503,  alearzola99, 1, 1, 0, yes
2870407648,  Marifabio15, 1, 1, 0, yes
387686536,  MRomano61, 2, 2, 0, yes
202345873,  amarlett, 1, 1, 0, yes
4846285762,  Anne_gami, 1, 1, 0, yes
312138170,  silvemass1, 1, 1, 0, yes
484992883,  mauropomponi, 2, 2, 0, yes
47727790,  Recher, 1, 1, 0, yes
3096799368,  bruno_loizaga, 1, 1, 0, yes
29747246,  PabloDurissimo, 1, 1, 0, yes
92343472,  kkoci80, 1, 1, 0, yes
523634182,  JacopoBitetti, 1, 1, 0, yes
1232033858,  lisergica_mente, 2, 2, 0, yes
522586399,  barbarataccone1, 1, 1, 0, yes
535066582,  asca56, 1, 1, 0, yes
496989908,  SaraTrif, 3, 2, 1, yes
2890031807,  half640, 1, 1, 0, yes
795045803547127808,  neugber, 1, 1, 0, yes
791352178631991296,  CTucudean, 3, 3, 0, yes
191839572,  samuelesantoni, 3, 3, 0, yes
57725329,  meclus, 1, 1, 0, yes
4179246183,  andrea___9, 4, 4, 0, yes
454230732,  federico_reale, 1, 1, 0, yes
14374811,  GabrielePersi, 3, 3, 0, yes
1307286932,  socialsud, 1, 1, 0, yes
3027235803,  DomAntAntRusso, 2, 2, 0, yes
124192305,  filipposogus, 1, 1, 0, yes
781763084486488064,  Clarisse_desk, 10, 6, 4, yes
480216889,  VincentCorleone, 1, 1, 0, yes
3370007122,  MarcoBernardel2, 4, 4, 0, yes
84916389,  thewisesaru, 1, 1, 0, yes
2401156465,  RJennromao, 1, 1, 0, yes
1667286782,  beingallears, 4, 2, 2, neutral
2907136619,  DChisciotta, 1, 1, 0, yes
70376374,  Rado97, 1, 1, 0, yes
800421706745581568,  Daniela12517159, 1, 1, 0, yes
3411693136,  dimauroalf, 1, 1, 0, yes
3296908558,  valcos60, 3, 3, 0, yes
258330117,  khudoleyolena, 1, 1, 0, yes
609022558,  IneedsyouOned, 1, 1, 0, yes
4558690911,  Leminismo, 3, 2, 1, yes
570699348,  SereJules, 1, 1, 0, yes
805698403938271232,  S_Cedraschi, 3, 3, 0, yes
1205891113,  La_Laurisss, 1, 1, 0, yes
41800657,  davideranaldo, 1, 1, 0, yes
15197537,  giacomo_lagona, 3, 2, 1, yes
779922361,  claudiogliozzo, 1, 1, 0, yes
184149361,  NatSalCas, 1, 1, 0, yes
748847098234302466,  guglielmomaz, 3, 1, 2, no
2807167028,  SteFra7, 2, 2, 0, yes
393872384,  ottopol1, 1, 1, 0, yes
363642894,  martinamallozzi, 1, 1, 0, yes
720742792,  ElisabettaNasta, 2, 2, 0, yes
968479380,  corona_corona1, 1, 1, 0, yes
450026499,  ClaraCapone, 1, 1, 0, yes
2174489653,  BroccaPietro, 1, 1, 0, yes
62082066,  elkunaguero10, 1, 1, 0, yes
2507798559,  gmila76, 1, 1, 0, yes
382235216,  covelliroberto, 1, 1, 0, yes
486759616,  RougeAlessandro, 1, 1, 0, yes
1381849902,  montale60, 1, 1, 0, yes
3033534617,  mauroamato87, 1, 1, 0, yes
1936869948,  gialucagrasso, 1, 1, 0, yes
350210209,  Nandodj59, 1, 1, 0, yes
5556802,  lucascamel, 1, 1, 0, yes
177515277,  HausOfDoris, 1, 1, 0, yes
119894332,  Roberto040759, 1, 1, 0, yes
278716071,  Lord_Inno, 1, 1, 0, yes
478876014,  argyris16, 1, 1, 0, yes
2784391760,  Askyouto_stay, 1, 1, 0, yes
63769123,  segeno1, 1, 1, 0, yes
805753946803421184,  SaltariMauro, 1, 1, 0, yes
805753665218813952,  Mariell61025759, 1, 1, 0, yes
718409653940568064,  br_lightwood, 1, 1, 0, yes
1233775843,  MosSimone, 1, 1, 0, yes
443051637,  LaGioiainCucina, 1, 1, 0, yes
476656924,  Di__Vale, 1, 1, 0, yes
521564494,  gaetanoproietti, 1, 1, 0, yes
2225307018,  PimpiMarco, 1, 1, 0, yes
1449199578,  giampaologiglio, 3, 2, 1, yes
147525315,  FiorellaEFFE, 1, 1, 0, yes
802170996727959552,  sebastianoborzu, 2, 2, 0, yes
3349313541,  FranzTreviso, 1, 1, 0, yes
501912925,  bonicatto, 1, 1, 0, yes
406226381,  eleonorabiffi, 2, 2, 0, yes
709083360157638656,  hichem28583974, 1, 1, 0, yes
2862435837,  MikoMiko03, 1, 1, 0, yes
114409134,  sirena1317, 2, 2, 0, yes
485902520,  Chetti46, 1, 1, 0, yes
789225402963197952,  Vilma65331672, 1, 1, 0, yes
537312357,  drelery, 3, 3, 0, yes
774271784384335872,  Riccardo0141, 1, 1, 0, yes
394036496,  chewebaccazz, 1, 1, 0, yes
2972902120,  CervFranci28, 2, 2, 0, yes
567326208,  chiariish, 1, 1, 0, yes
2199395873,  _gnegna_, 2, 2, 0, yes
484881638,  GiuseppeFrieri, 1, 1, 0, yes
1257539040,  blackhole1972, 1, 1, 0, yes
299637901,  Poemarhiel, 1, 1, 0, yes
2884866819,  lenorysam, 1, 1, 0, yes
586592053,  ROBERTOFIORE8, 2, 2, 0, yes
477859562,  darioeur999, 1, 1, 0, yes
486709068,  Marco_Rove, 1, 1, 0, yes
445455530,  peo60, 1, 1, 0, yes
207094936,  GiuliaMorgane, 2, 2, 0, yes
1902963848,  CCFCattaneo, 3, 2, 1, yes
513135078,  DISOSS, 1, 1, 0, yes
794187962825244672,  annarosselli69, 7, 7, 0, yes
118325134,  portorotondina, 3, 3, 0, yes
238183373,  SCasadei, 8, 4, 4, neutral
805736234828124160,  Flavia97124166, 1, 1, 0, yes
756820042126417920,  MatthewCurlies, 1, 1, 0, yes
495201413,  fifabve, 1, 1, 0, yes
403051086,  Carlitos87_4, 1, 1, 0, yes
805757298324946945,  antoniocitta121, 7, 7, 0, yes
135427585,  danielelepido, 1, 1, 0, yes
48979869,  S_Le_Roux, 1, 1, 0, yes
4248340461,  svevaomg10, 1, 1, 0, yes
3437042872,  philmodena1984, 1, 1, 0, yes
191993933,  C_Scannelli, 3, 3, 0, yes
1911187686,  ilmazza8, 4, 2, 2, neutral
4814255548,  PrensaRomagnoli, 1, 1, 0, yes
37239804,  sdevincenzo, 1, 1, 0, yes
1002335324,  JMSimonChi, 1, 1, 0, yes
719249714592542726,  ten1000favs, 1, 1, 0, yes
75707250,  rgcalvo, 1, 1, 0, yes
288420797,  AurelioLongo, 1, 1, 0, yes
832912356,  SdeRenato, 3, 2, 1, yes
153132339,  xvillalba1, 1, 1, 0, yes
470364842,  PAUROSALBA, 4, 4, 0, yes
3041408584,  GAcciarresi, 3, 2, 1, yes
1304446423,  SoniaGregori1, 1, 1, 0, yes
75881487,  ericamoscatello, 1, 1, 0, yes
2971397853,  mimmo2971, 1, 1, 0, yes
496591832,  ciccone_ang, 1, 1, 0, yes
800501196,  MichaelAngerer1, 1, 1, 0, yes
592975217,  liviominafra, 1, 1, 0, yes
2716690211,  GuerreriStefano, 1, 1, 0, yes
2375221309,  AdrianoMosti, 2, 1, 1, neutral
3082124753,  BenattiLoredana, 1, 1, 0, yes
976979730,  robertosorge1, 1, 1, 0, yes
174259796,  antoniomtrani, 1, 1, 0, yes
1071845365,  enzuccioborri, 1, 1, 0, yes
202195141,  MLuisa83, 1, 1, 0, yes
318974616,  ElenaPancotti, 1, 1, 0, yes
472296413,  GiusiMartorana, 1, 1, 0, yes
3545434095,  MaurizioPodini, 2, 2, 0, yes
312786569,  arty55ago, 1, 1, 0, yes
803958739476824064,  NadaWael_94, 5, 4, 1, yes
3317584444,  pugipet, 1, 1, 0, yes
1140566335,  J_Mazzetto, 1, 1, 0, yes
429734284,  GiuseppeFalcao, 1, 1, 0, yes
856904862,  ChiarettaRiva_V, 1, 1, 0, yes
2719748591,  GiovanniBaccin, 1, 1, 0, yes
2712663316,  IngalaSimona, 1, 1, 0, yes
2180462307,  miceli_miceli1, 2, 2, 0, yes
400630126,  marco_nemecek, 3, 1, 2, no
621728989,  Massy1966, 1, 1, 0, yes
396898731,  matteo_manca15, 2, 1, 1, neutral
391034817,  MvolpiMi, 1, 1, 0, yes
552781573,  giobbe_paziente, 2, 2, 0, yes
1008884305,  pier22861, 2, 2, 0, yes
200061869,  teresabassetti, 1, 1, 0, yes
418174327,  S_Eleonora_S, 1, 1, 0, yes
2848567701,  Armageneiker, 1, 1, 0, yes
779049312265404416,  valehijadelmar, 1, 1, 0, yes
514722148,  Martinned81, 1, 1, 0, yes
3033036850,  blusky750, 1, 1, 0, yes
455871602,  salvocappellano, 1, 1, 0, yes
73649323,  lucabosa, 1, 1, 0, yes
436657216,  federicorossi12, 1, 1, 0, yes
1060264448,  PubAffairsBXL, 1, 1, 0, yes
189796399,  peppesimon, 2, 2, 0, yes
26937364,  rodrigorozelli, 1, 1, 0, yes
2831932554,  arch_maio, 1, 1, 0, yes
1264276956,  freckly94, 1, 1, 0, yes
805566083256217600,  Giuseppe_Firinu, 1, 1, 0, yes
27446946,  valgatugamala, 1, 1, 0, yes
350364717,  mariadeor, 1, 1, 0, yes
1228544545,  Lore_wes, 1, 1, 0, yes
3492470895,  97_Nek_97, 2, 2, 0, yes
498555024,  turgutpehlevan, 1, 1, 0, yes
64192887,  mebewale, 1, 1, 0, yes
709840587864842240,  The_Lenny_Face, 1, 1, 0, yes
1185492008,  Jet_de_Cutano, 1, 1, 0, yes
510269881,  Francesca519, 1, 1, 0, yes
2522862591,  bidimensionale, 2, 1, 1, neutral
738725172576976896,  Mary18370508, 1, 1, 0, yes
337848920,  EvaAProvenzano, 1, 1, 0, yes
68432965,  margheritacarp, 1, 1, 0, yes
180015057,  JaySqueezy_, 1, 1, 0, yes
1131788353,  ElisaMartiNY, 1, 1, 0, yes
529223274,  salvatore_izzo, 2, 1, 1, neutral
703211909,  g_bresciani11, 1, 1, 0, yes
417116121,  Dan_Ko13, 1, 1, 0, yes
747695538221555712,  biosphericman, 1, 1, 0, yes
2564726559,  LubarbierLuca, 1, 1, 0, yes
88475676,  magia2000, 1, 1, 0, yes
802316884494479362,  marcopoesio1, 3, 3, 0, yes
278468889,  ZizzioDaDonnici, 1, 1, 0, yes
476642968,  anna_bianchi94, 1, 1, 0, yes
2977909667,  stefy274, 2, 2, 0, yes
153735142,  5Dome, 1, 1, 0, yes
3047847698,  RoccaMichael, 1, 1, 0, yes
2462125201,  Mar_va, 1, 1, 0, yes
300309295,  MargheritaL, 1, 1, 0, yes
513261091,  mimmosbr, 1, 1, 0, yes
238644962,  stennerello, 1, 1, 0, yes
550371963,  Putaghjone, 1, 1, 0, yes
487835953,  gioressuros, 1, 1, 0, yes
237455060,  luigicaputo71, 1, 1, 0, yes
1383848130,  KenYonWiy, 1, 1, 0, yes
551271704,  lferrari090, 1, 1, 0, yes
2236230630,  Paris97official, 3, 3, 0, yes
1226095015,  IanClark95, 1, 1, 0, yes
2866485621,  acorradini48, 1, 1, 0, yes
1053150162,  ornybott, 1, 1, 0, yes
599091015,  vic_Who24, 1, 1, 0, yes
4881240478,  mirko_locatelli, 1, 1, 0, yes
529710339,  giu_fonta, 1, 1, 0, yes
426755011,  giafea, 1, 1, 0, yes
777272540964290560,  LaFerolaFrances, 1, 1, 0, yes
57369576,  DimitriTinti, 1, 1, 0, yes
2570216668,  prallo1954, 3, 3, 0, yes
1149022190,  IlgGatto, 1, 1, 0, yes
341010958,  Marcella345, 3, 3, 0, yes
4034742658,  michegiu, 1, 1, 0, yes
281485046,  angeloantm, 1, 1, 0, yes
231420700,  Giannandreafior, 1, 1, 0, yes
1145868577,  Danilo9407, 1, 1, 0, yes
247466977,  the_smoker_man, 1, 1, 0, yes
54583487,  LunarossaUK, 1, 1, 0, yes
564597336,  Albe_t, 1, 1, 0, yes
2183269083,  katia15maggio, 1, 1, 0, yes
790234259260862464,  connorrose49, 1, 1, 0, yes
2276745582,  aelle2010, 1, 1, 0, yes
1458144156,  NikitaFesyukov, 2, 2, 0, yes
566393338,  simoo__costa, 1, 1, 0, yes
69633028,  martinapar82, 2, 1, 1, neutral
614962997,  FedericaRinald2, 3, 3, 0, yes
769071966150127618,  mr_menca, 1, 1, 0, yes
486850872,  CleAllegretta, 1, 1, 0, yes
2545781307,  Alessan06227965, 1, 1, 0, yes
465668838,  peccalo, 1, 1, 0, yes
875291742,  antoniotocchi, 1, 1, 0, yes
3095405121,  daniza79, 1, 1, 0, yes
596502176,  dagone66, 4, 4, 0, yes
292520884,  AlexTorroni, 1, 1, 0, yes
447923082,  DinaFrignani, 7, 7, 0, yes
3363209998,  FaAndreina, 1, 1, 0, yes
2714080196,  finallybarbos, 2, 2, 0, yes
99748135,  _mowmo_, 1, 1, 0, yes
3290123038,  vlad694_vlad, 1, 1, 0, yes
232362719,  rosquezexjst, 1, 1, 0, yes
773964344476504064,  granini63, 1, 1, 0, yes
463651488,  VMastropaolo, 1, 1, 0, yes
2179868841,  marcuzespo, 1, 1, 0, yes
419300656,  marco_la_salvia, 1, 1, 0, yes
382579217,  Lau82Fer, 1, 1, 0, yes
32845422,  Eastwood74, 1, 1, 0, yes
1859562668,  gaetanocicorel1, 1, 1, 0, yes
2201464809,  Antonel66villa, 1, 1, 0, yes
38830544,  smoothino, 1, 1, 0, yes
1362953851,  guarguaglini_g, 1, 1, 0, yes
486574767,  SuorCristina, 1, 1, 0, yes
221749393,  biondinobello, 1, 1, 0, yes
2544438851,  CelormaTonio, 2, 1, 1, neutral
970862977,  EnricoStronati, 1, 1, 0, yes
2392820977,  delamancia, 1, 1, 0, yes
4874002353,  Giovann83277291, 1, 1, 0, yes
1225991917,  paslifummo, 1, 1, 0, yes
355527150,  matteo20timpano, 1, 1, 0, yes
433697535,  brurster, 1, 1, 0, yes
784693452822962177,  giuserm67, 1, 1, 0, yes
730111740,  MarianoAvaglian, 1, 1, 0, yes
859876152,  JustFrancesca79, 2, 2, 0, yes
547510198,  occhineroblu, 1, 1, 0, yes
1037187446,  nonnamaria3, 1, 1, 0, yes
3015239325,  MoniaCuter, 3, 3, 0, yes
801564417817268232,  ArcangelaMarti2, 1, 1, 0, yes
334658624,  crpiemonte, 3, 2, 1, yes
62197721,  maxcolla, 1, 1, 0, yes
354866096,  carloaleandro, 1, 1, 0, yes
2432690404,  GiuseppeBartoc1, 1, 1, 0, yes
579066168,  Marti_Bernocchi, 1, 1, 0, yes
2873587564,  debbyoriana, 1, 1, 0, yes
259648969,  AlbertoFoa, 1, 1, 0, yes
150432747,  Visce5, 1, 1, 0, yes
1219652864,  swordfish933, 2, 1, 1, neutral
88632037,  Tatanka1983, 1, 1, 0, yes
586865731,  LinoToma, 1, 1, 0, yes
185229283,  m4gny, 2, 2, 0, yes
337306572,  LuiAie, 1, 1, 0, yes
2225315109,  BallatoreMirko, 2, 2, 0, yes
3314862999,  chiamami411, 3, 1, 2, no
772569713268359169,  asterixderoma, 7, 1, 6, no
805768373913190400,  stefania_next, 1, 1, 0, yes
2230589230,  Buzzurroerudito, 1, 1, 0, yes
2360560600,  fedcarta, 1, 1, 0, yes
223769248,  TribunusPlebis2, 1, 1, 0, yes
2173725232,  CValcavi, 1, 1, 0, yes
1445001552,  exassessore, 1, 1, 0, yes
72110791,  f_carrera, 1, 1, 0, yes
599498290,  JohNiel_, 1, 1, 0, yes
825851462,  SimoPasqui, 1, 1, 0, yes
305039987,  MicheleBuscema, 1, 1, 0, yes
501818176,  morodavide1, 1, 1, 0, yes
393923156,  steronides, 1, 1, 0, yes
1465598504,  Buongod, 1, 1, 0, yes
325090622,  pasqualec4, 1, 1, 0, yes
553873961,  danieladucato, 3, 3, 0, yes
1370916242,  paocart, 1, 1, 0, yes
786681004744445953,  Riccioand80, 1, 1, 0, yes
507651081,  FabioDG1975, 1, 1, 0, yes
3288788129,  aniryllis, 1, 1, 0, yes
3291014069,  CarlaPauselli, 1, 1, 0, yes
2761980937,  ollaandrea74, 1, 1, 0, yes
758323644854599682,  nocentini2, 3, 2, 1, yes
3239826335,  simdangelo1, 1, 1, 0, yes
545340312,  rogernello, 1, 1, 0, yes
233223130,  mammaraffy, 2, 2, 0, yes
354808295,  nicolae_galea, 1, 1, 0, yes
96338067,  smalto10, 1, 1, 0, yes
391642711,  guenevia, 2, 1, 1, neutral
768887920203862016,  AleJuventina92, 1, 1, 0, yes
987217273,  Simone_Rota, 1, 1, 0, yes
389007173,  MarcoMastracca, 1, 1, 0, yes
2202091984,  salvaggio06, 3, 3, 0, yes
794517122,  SimoneGargiulo3, 2, 2, 0, yes
1511561010,  antoxpistoia, 1, 1, 0, yes
457460781,  GiuliaFerrand, 2, 2, 0, yes
1613465552,  ideehawaii, 3, 3, 0, yes
1047184218,  AlessioSpuriS, 1, 1, 0, yes
2738340699,  EziaMossa, 1, 1, 0, yes
1536589740,  Anny_Calboli, 1, 1, 0, yes
118019990,  AndreaFerrazz, 2, 1, 1, neutral
1319065460,  mariarosa10566, 1, 1, 0, yes
747706272435281921,  LisaMiori, 1, 1, 0, yes
784113358089912320,  ritari_maria, 1, 1, 0, yes
1336604798,  achillemaltese, 1, 1, 0, yes
2796322312,  IrisMGC, 1, 1, 0, yes
1563555048,  Fra_Bachis, 1, 1, 0, yes
803922911694360576,  teresa02827679, 1, 1, 0, yes
727113805457690624,  spoltorenotizie, 1, 1, 0, yes
322190361,  davidealfa1, 2, 1, 1, neutral
598383501,  Victor_Albrecht, 1, 1, 0, yes
418674654,  maaaartiiiiiiin, 1, 1, 0, yes
633075838,  Thinkofmenburn, 1, 1, 0, yes
4143440429,  PirovanoMaria, 1, 1, 0, yes
1000183705,  PieroPizzoli1, 1, 1, 0, yes
1027010088,  amapica, 1, 1, 0, yes
1140861840,  StandbyAgain, 1, 1, 0, yes
541168521,  Svenia72, 1, 1, 0, yes
265346620,  Fabiola_Chiara, 1, 1, 0, yes
3708346335,  kiaraBro92, 3, 3, 0, yes
715654834289000448,  casilde153, 1, 1, 0, yes
16222127,  daniabbondanza, 1, 1, 0, yes
2943276957,  Nicola_Sam628, 1, 1, 0, yes
51402085,  fcasadeiturroni, 1, 1, 0, yes
805749408189054976,  LidiaMasini, 1, 1, 0, yes
2678300963,  cinziapiccoli, 1, 1, 0, yes
2893877165,  florianello, 1, 1, 0, yes
4636097626,  cingo1979, 3, 3, 0, yes
2238961512,  gianfrancoguzz2, 1, 1, 0, yes
1500644454,  daniesantangelo, 1, 1, 0, yes
115136982,  sandrofazi, 1, 1, 0, yes
1112487614,  gianlucaansaldi, 1, 1, 0, yes
469436424,  torob19, 1, 1, 0, yes
460328603,  danimona24, 1, 1, 0, yes
4481154521,  VarottiGiovanni, 1, 1, 0, yes
424444347,  EnzoMaulucci, 1, 1, 0, yes
111638359,  franckfelino, 1, 1, 0, yes
1372164266,  OlivottoSimone, 1, 1, 0, yes
508580854,  AnnaVizzari, 2, 2, 0, yes
510549536,  Piumalupo, 3, 2, 1, yes
55015628,  congiata, 1, 1, 0, yes
1830717614,  schesirnature, 4, 1, 3, no
2517209974,  MonikaRizzo, 1, 1, 0, yes
747575245,  GusMarilena, 1, 1, 0, yes
8948672,  mmbjml498, 1, 1, 0, yes
307971714,  ex0n3z, 1, 1, 0, yes
718543214567940096,  Tizy65mc, 1, 1, 0, yes
465947439,  QueensFra, 1, 1, 0, yes
452871662,  BalloccoDavid, 1, 1, 0, yes
438611465,  Ale__dibe, 1, 1, 0, yes
409070151,  ElisaCipo, 1, 1, 0, yes
2883942243,  ArrabitoLiliana, 1, 1, 0, yes
613365688,  SHEREATTA632, 1, 1, 0, yes
4438525763,  Nellos_wife, 1, 1, 0, yes
3065912861,  X_Norah3, 1, 1, 0, yes
2485024156,  amandaelliott03, 1, 1, 0, yes
2484510059,  MollyDenetciaw, 1, 1, 0, yes
3048816919,  Maisa__sya, 1, 1, 0, yes
788659428702711808,  GoliniSandra, 1, 1, 0, yes
2460265962,  aschirripa63, 2, 2, 0, yes
790981308520497153,  Christi50049861, 1, 1, 0, yes
455153348,  AntonioAmmendo4, 1, 1, 0, yes
2294458666,  Juannid92, 1, 1, 0, yes
787751257364656128,  MassimoCabriolu, 1, 1, 0, yes
702242905692438528,  Rifondazioneciv, 1, 1, 0, yes
402176204,  RobertoCardin, 1, 1, 0, yes
732255482,  AlessandroDeBat, 1, 1, 0, yes
214950633,  Axeloth78, 1, 1, 0, yes
4126616836,  vincenzo_vint72, 1, 1, 0, yes
16615022,  AntonioCubello, 1, 1, 0, yes
1971682968,  AndreaMHutchins, 1, 1, 0, yes
430906902,  cclaudio73, 2, 1, 1, neutral
44892328,  SilviaRapallo, 1, 1, 0, yes
2594589722,  MariaCarlaMign1, 1, 1, 0, yes
787222894153785344,  alfonsigno18, 1, 1, 0, yes
3331160387,  M_Pankay, 2, 2, 0, yes
1084100288,  FabfogFabrizio, 1, 1, 0, yes
480339529,  AnnaCeretti, 1, 1, 0, yes
1116345037,  ueffe01, 1, 1, 0, yes
2437504814,  SchillaciRoss, 3, 3, 0, yes
987148741,  RSiciliano25, 1, 1, 0, yes
414164912,  EmanueleFaieta, 1, 1, 0, yes
805680742667784192,  savragno, 1, 1, 0, yes
473930097,  6mericita, 1, 1, 0, yes
512370496,  MusacchioRomano, 1, 1, 0, yes
2366877929,  DemanthonyDe, 1, 1, 0, yes
408418039,  Leocv85, 1, 1, 0, yes
22044893,  piccolocarro, 1, 1, 0, yes
804047458334572546,  fradian79, 4, 4, 0, yes
4577470288,  MilluzzoM, 1, 1, 0, yes
2391558574,  GrifoniOlivo, 2, 2, 0, yes
608119347,  vicifilomp, 3, 3, 0, yes
2405280073,  azzurinoverde, 1, 1, 0, yes
507245942,  Federica1379, 1, 1, 0, yes
490472621,  manurossoblu, 1, 1, 0, yes
2563174160,  paolo_baiamonte, 7, 7, 0, yes
112550071,  Maurxr, 1, 1, 0, yes
748862663808221184,  Budulacci70, 1, 1, 0, yes
799659814200733696,  f_norelli92, 1, 1, 0, yes
412157593,  MassiGi80, 1, 1, 0, yes
2225279382,  eleonoraborghet, 1, 1, 0, yes
237665989,  Sirlight85, 1, 1, 0, yes
2714251069,  vittoriomurra, 1, 1, 0, yes
3436555222,  max59more, 1, 1, 0, yes
798485998183313408,  ShinyLale, 1, 1, 0, yes
1304986626,  cillo12, 1, 1, 0, yes
1280569322,  riccia721, 1, 1, 0, yes
1451116615,  Filippo_Ugo, 1, 1, 0, yes
2780900078,  TuskEU, 1, 1, 0, yes
443752341,  DanielaDiSanto3, 1, 1, 0, yes
2365333017,  franchi_gianni, 1, 1, 0, yes
299159229,  DanieleTodaro96, 1, 1, 0, yes
579829577,  nandopezz, 1, 1, 0, yes
1260018566,  AlbertoTronconi, 1, 1, 0, yes
743008518,  DavideTrotti1, 1, 1, 0, yes
501143308,  ZielonkaRobert, 4, 4, 0, yes
2285405345,  martelli_sandra, 7, 7, 0, yes
398867698,  Marco_Vacchieri, 1, 1, 0, yes
123275064,  iirfann, 1, 1, 0, yes
1960349744,  laM0RTE, 2, 2, 0, yes
383930445,  Atropo1974, 1, 1, 0, yes
423811258,  FraViolaRosso, 1, 1, 0, yes
2678006608,  ECampilii, 1, 1, 0, yes
796795293316612097,  Incazzante, 27, 1, 26, no
452923861,  CantoMarco, 1, 1, 0, yes
15637949,  pietrosperoni, 1, 1, 0, yes
260137014,  f_rubiconto, 1, 1, 0, yes
292446061,  StefaniaLeone, 1, 1, 0, yes
2160354942,  road552, 1, 1, 0, yes
312273541,  ivycasa1979, 1, 1, 0, yes
805426697151639552,  gianmarcofalco_, 1, 1, 0, yes
414050719,  DiegoDeCicc0, 1, 1, 0, yes
2964328161,  sergiovarvara1, 1, 1, 0, yes
345335051,  luca_jezzi, 1, 1, 0, yes
621815597,  rita_savasta, 1, 1, 0, yes
1492748089,  Webradio63, 1, 1, 0, yes
72521732,  lindina2996live, 1, 1, 0, yes
1063670918,  GadaCris, 1, 1, 0, yes
805714747064782848,  Vittoriodifior, 1, 1, 0, yes
765400964,  MauroBernuzzi, 3, 2, 1, yes
805718605430226946,  gio_vigliotti, 1, 1, 0, yes
2192978913,  Chiara_mastra, 1, 1, 0, yes
2921454058,  ClaritaLisari, 2, 2, 0, yes
25357767,  francescogrillo, 1, 1, 0, yes
1633564405,  isjustinsmonkey, 1, 1, 0, yes
435085205,  sandro_lip83, 2, 1, 1, neutral
248662100,  ThE___MaTrIx, 2, 2, 0, yes
497134514,  NonnaKiller, 2, 2, 0, yes
14373462,  StephenKurtzke, 1, 1, 0, yes
760859552510337024,  RSAINTPLLC4, 1, 1, 0, yes
2702033948,  kstewjessa394, 2, 2, 0, yes
1385129876,  MaurizioScalzi, 1, 1, 0, yes
3394487595,  SaraFox74, 1, 1, 0, yes
212931151,  schoolsam, 1, 1, 0, yes
302637617,  PilarGGranja, 1, 1, 0, yes
3031100452,  hipismototal15, 1, 1, 0, yes
3173278071,  ChioRagamuffin, 2, 2, 0, yes
446987691,  GiulioCollavoli, 1, 1, 0, yes
1176690054,  PennaFranca, 1, 1, 0, yes
793562202770907137,  rusticifranci, 1, 1, 0, yes
2741157917,  gmele81, 1, 1, 0, yes
785459014721212416,  DorotheaBrookeM, 2, 2, 0, yes
487563453,  Aannacera, 1, 1, 0, yes
496339879,  alecover, 2, 2, 0, yes
2362599808,  failla_gabriele, 1, 1, 0, yes
636526053,  marcocaso95, 1, 1, 0, yes
1871799302,  PinaCondo, 1, 1, 0, yes
2754829578,  Coffeebasta, 1, 1, 0, yes
610827126,  TestoneCiullo, 1, 1, 0, yes
67992426,  aloisam, 1, 1, 0, yes
397252594,  FedeFlute, 1, 1, 0, yes
75360445,  tladyinthetower, 2, 2, 0, yes
3663872297,  CoserValentino, 1, 1, 0, yes
2203958608,  PinkingSte, 1, 1, 0, yes
403764932,  GustavoPiga, 1, 1, 0, yes
2541458777,  ApAlessandro, 2, 2, 0, yes
17960216,  davidesan, 1, 1, 0, yes
1963495920,  RaffaMacente, 2, 2, 0, yes
3309912171,  GBaronz, 1, 1, 0, yes
1650183900,  UberAlles_2, 1, 1, 0, yes
539275897,  EmanueleImmesi, 1, 1, 0, yes
773112254501978113,  andreaprovaroma, 1, 1, 0, yes
3305612369,  carmelo64twitt, 2, 2, 0, yes
168574501,  ssamouilidis, 1, 1, 0, yes
1437686011,  max_van_o, 1, 1, 0, yes
711907324030537728,  kiedis8482, 3, 3, 0, yes
805553746499485696,  FRANCESCO110268, 1, 1, 0, yes
3212730269,  dz7274, 2, 2, 0, yes
2288237203,  FraProM, 1, 1, 0, yes
123664615,  chiarainno, 4, 4, 0, yes
3107312161,  zhiladavarpanah, 1, 1, 0, yes
2248431179,  gigidalco, 1, 1, 0, yes
487042796,  Samaggio66, 1, 1, 0, yes
987133836,  mariellaboerci, 2, 2, 0, yes
484941072,  Bloggerinf, 1, 1, 0, yes
422939927,  MarenzioM, 1, 1, 0, yes
2997335747,  Milanodascoprir, 1, 1, 0, yes
18945840,  salvatorenigro, 1, 1, 0, yes
2699272544,  Aket74, 1, 1, 0, yes
1915244449,  FulvioCei, 1, 1, 0, yes
241608899,  chiaberger, 4, 2, 2, neutral
792088850,  GGardella, 3, 3, 0, yes
418872324,  Luca_Guadagnin, 1, 1, 0, yes
573920332,  1881____1938, 1, 1, 0, yes
3382851429,  Hammond_Sizzy, 2, 2, 0, yes
374417424,  MarcoDeGirolamo, 4, 4, 0, yes
418170698,  83Nexus, 2, 2, 0, yes
1644660798,  feliciditirare, 1, 1, 0, yes
153931760,  alb_romero14, 1, 1, 0, yes
630184955,  AbbeyLavigne99, 2, 2, 0, yes
79699469,  PrincePFB, 1, 1, 0, yes
2913112732,  andreabarola_3, 1, 1, 0, yes
68674647,  ducciodesa, 1, 1, 0, yes
631902548,  TolaFabrizio, 1, 1, 0, yes
409266763,  caterinasoffici, 1, 1, 0, yes
448798907,  LucileCollin, 1, 1, 0, yes
360830746,  Luisella49, 9, 4, 5, no
922454119,  trrlda, 1, 1, 0, yes
50128895,  Imydal, 2, 2, 0, yes
825953046,  noel1304, 2, 2, 0, yes
332989973,  DariaBaietti, 2, 2, 0, yes
786216150103449600,  melawit78, 1, 1, 0, yes
4888718769,  fulgidoemanuele, 1, 1, 0, yes
313910441,  alenik91, 1, 1, 0, yes
770967421540761600,  SaraZanellasara, 5, 5, 0, yes
441004197,  VincenzoInverso, 2, 1, 1, neutral
198622417,  AvvBianca, 1, 1, 0, yes
480319523,  LuigiColangel, 1, 1, 0, yes
2758166528,  disegnidicalcio, 1, 1, 0, yes
215921499,  LocatelliRule, 1, 1, 0, yes
717328097,  GiovaMarocchi, 1, 1, 0, yes
386656967,  HPBlok, 1, 1, 0, yes
392952254,  stefanopcl, 1, 1, 0, yes
1864612442,  tullii_marc, 1, 1, 0, yes
1058809183,  LoriniLuana, 2, 1, 1, neutral
576412164,  vincast87, 1, 1, 0, yes
1042334540,  RazRoadWarrior, 1, 1, 0, yes
1346337180,  MarcoGervino, 2, 2, 0, yes
227110281,  JMMartin37, 3, 3, 0, yes
557651778,  GiordL, 1, 1, 0, yes
2739659428,  Christ_witter, 1, 1, 0, yes
413754635,  eliotwitting, 1, 1, 0, yes
984772638,  1492Ben, 1, 1, 0, yes
407674944,  tribabbo, 1, 1, 0, yes
134678634,  JonathanPineros, 1, 1, 0, yes
447340151,  stini76, 1, 1, 0, yes
3369651346,  JMikee7, 1, 1, 0, yes
1252904310,  FabioGabanella, 3, 3, 0, yes
1272123733,  pescetto73, 1, 1, 0, yes
730429353503412224,  jonnylanzetta1, 2, 1, 1, neutral
1327255934,  CarlaMonti5, 1, 1, 0, yes
430221751,  pascottoa, 1, 1, 0, yes
195734767,  Umbria24, 1, 1, 0, yes
275246085,  iamantonio0947, 1, 1, 0, yes
3085172513,  robertacapizzi, 1, 1, 0, yes
618689181,  BeautyIsSllent, 1, 1, 0, yes
1502345083,  ThibaultLpt, 1, 1, 0, yes
224351032,  theoretro, 3, 1, 2, no
47927039,  mimmo70, 2, 2, 0, yes
2187196541,  Maury70P98, 1, 1, 0, yes
3036050715,  MaristellaCala1, 2, 2, 0, yes
74979720,  MsFrancesca_r, 1, 1, 0, yes
2389629910,  lauramiele28, 1, 1, 0, yes
1318802474,  FedericoCarlott, 1, 1, 0, yes
47338813,  isoleestorie, 3, 3, 0, yes
467766369,  gulsahuzundrkn, 1, 1, 0, yes
405091168,  dad081, 1, 1, 0, yes
287815294,  FragileAlex, 1, 1, 0, yes
89185366,  CrisCapoz, 1, 1, 0, yes
139468470,  graziano17, 1, 1, 0, yes
169098435,  Giuliopalombi, 1, 1, 0, yes
489422493,  lucianaiannazzo, 1, 1, 0, yes
3598014375,  CampiGiovanna, 3, 3, 0, yes
117012571,  30miljardnl, 1, 1, 0, yes
405531047,  cost1993, 1, 1, 0, yes
3345662765,  77predip, 1, 1, 0, yes
2265867576,  GiuseppeAnon, 1, 1, 0, yes
862986014,  Ale_Manho, 27, 4, 23, no
1102374354,  danyfalasca, 1, 1, 0, yes
4209036093,  R_DeGiuli, 1, 1, 0, yes
432717347,  graziamanna1, 1, 1, 0, yes
1092079567,  DianaChiodi, 1, 1, 0, yes
285606028,  Doji81, 1, 1, 0, yes
1220844961,  Atira51, 1, 1, 0, yes
2753451123,  dererumlumina, 3, 3, 0, yes
393281265,  bibbo_82, 1, 1, 0, yes
50269311,  LucianoSemprini, 1, 1, 0, yes
105616077,  Roby_Romani, 11, 7, 4, yes
29176200,  natan_b, 1, 1, 0, yes
2493992556,  vincenz56476195, 1, 1, 0, yes
2173164022,  marescag68, 2, 1, 1, neutral
203591212,  lalidon1, 1, 1, 0, yes
1050435780,  pd_tusciaromana, 1, 1, 0, yes
36162307,  Robertacvt, 1, 1, 0, yes
609253702,  NathanBliemert, 1, 1, 0, yes
2220306028,  jojedapr, 1, 1, 0, yes
3137718506,  AnnDimaria17, 2, 2, 0, yes
376765802,  SilviaGuzzo, 23, 1, 22, no
3028051851,  DToffolon, 1, 1, 0, yes
271927785,  Danila7499, 1, 1, 0, yes
805698551972036610,  Jessica04986330, 1, 1, 0, yes
2426996976,  KossNino, 1, 1, 0, yes
1133672966,  Veron406, 1, 1, 0, yes
803325154084454400,  bruschicla19, 1, 1, 0, yes
859151486,  DigitalZelig, 1, 1, 0, yes
492580644,  SandroMenia, 1, 1, 0, yes
631827717,  pfdonovan64, 1, 1, 0, yes
949867081,  heresash, 1, 1, 0, yes
882314276,  gianpiero1971, 1, 1, 0, yes
56140855,  scighera25, 1, 1, 0, yes
2351913283,  ValerioMinnella, 1, 1, 0, yes
481296557,  TheEternalBoy83, 1, 1, 0, yes
728260979205804035,  pasqualebizzi, 1, 1, 0, yes
23979781,  ilariasmi, 1, 1, 0, yes
1445423113,  francogargano1, 2, 2, 0, yes
3869821037,  saviozzi1941, 1, 1, 0, yes
417004763,  Pone_Ale, 1, 1, 0, yes
565577878,  dariobrollo, 2, 2, 0, yes
538354982,  Giuly_Nardi, 1, 1, 0, yes
796732600706629633,  gloriagali4, 1, 1, 0, yes
38638858,  roby_robacuori, 1, 1, 0, yes
1533610867,  mjster_b, 1, 1, 0, yes
1065279234,  Antonio051250, 3, 1, 2, no
230742884,  renatapagliai, 1, 1, 0, yes
513139637,  sllitslien, 1, 1, 0, yes
1586541906,  LCapitaneo, 2, 2, 0, yes
2290429733,  03Azzi, 1, 1, 0, yes
33942642,  Mia_Dame, 1, 1, 0, yes
423792830,  cristinalanese, 1, 1, 0, yes
716624223519830016,  pipoli_maria, 2, 2, 0, yes
2356888209,  danilorst1, 3, 2, 1, yes
359421043,  ArabaFeni, 4, 2, 2, neutral
632978354,  claudia18481, 1, 1, 0, yes
805774410821025792,  Luisa34972534, 1, 1, 0, yes
333291361,  AntonioRossi14, 1, 1, 0, yes
2782565981,  paola70f, 3, 2, 1, yes
428412420,  PaoloBologna, 3, 3, 0, yes
469520961,  terrygia, 1, 1, 0, yes
2460693280,  trappolatwo, 1, 1, 0, yes
365443341,  LUCACICE, 1, 1, 0, yes
46457290,  AdamShellard, 1, 1, 0, yes
849074881,  aoussarmustapha, 1, 1, 0, yes
2486434053,  Kasha843, 1, 1, 0, yes
418634338,  Mikaelmachi, 1, 1, 0, yes
3065120507,  BVierling56, 1, 1, 0, yes
3305490406,  crisstella58, 1, 1, 0, yes
3051953546,  TrillMordecal, 1, 1, 0, yes
2485637116,  celladrc, 1, 1, 0, yes
3064387733,  celestial__herm, 1, 1, 0, yes
3052444674,  thaii__motionn, 1, 1, 0, yes
2480053461,  pecintasejati0, 1, 1, 0, yes
3050600114,  JHassenstab384, 1, 1, 0, yes
3064962874,  JetJames_5, 1, 1, 0, yes
3065716378,  georgiavanln, 1, 1, 0, yes
603372731,  SkwlntPrints, 1, 1, 0, yes
1732686991,  FabioLoci, 1, 1, 0, yes
1706993665,  MirKoPir, 2, 1, 1, neutral
1276951700,  gigidecollanz, 9, 9, 0, yes
1673306814,  orree_ble, 2, 2, 0, yes
1522973268,  Street_Zoulou, 1, 1, 0, yes
51064308,  V_Side, 1, 1, 0, yes
3586252337,  enri_boshco, 6, 6, 0, yes
2979458631,  antonel09519592, 1, 1, 0, yes
800754275030736896,  AntonioCresce20, 1, 1, 0, yes
56711345,  silviaullo, 1, 1, 0, yes
353718755,  LeonardoTaroni, 1, 1, 0, yes
968131621,  achizamb, 1, 1, 0, yes
48034878,  pabloariza, 1, 1, 0, yes
367750422,  aanndd76, 1, 1, 0, yes
2569838188,  demippo, 1, 1, 0, yes
2256696846,  Maxx905, 1, 1, 0, yes
29538237,  Troxy81, 2, 2, 0, yes
936660583,  SimoFranzi, 1, 1, 0, yes
2353177690,  lucadipietro7, 3, 1, 2, no
2159179113,  rossvalenzano, 1, 1, 0, yes
752576490231984128,  dadoravenna, 1, 1, 0, yes
405181881,  SarahBriand, 1, 1, 0, yes
337284197,  CriFranchetti, 5, 3, 2, yes
805554573016518656,  GLMWITALIA, 1, 1, 0, yes
4144514002,  mzannini78, 1, 1, 0, yes
1078819266,  aleselmi8, 3, 1, 2, no
2185108501,  _flowerly_, 1, 1, 0, yes
23545920,  adrianadesala, 1, 1, 0, yes
2696181785,  Marti97Porta, 1, 1, 0, yes
4193462705,  Reggia1G, 1, 1, 0, yes
325574520,  kuneijder, 2, 2, 0, yes
422019034,  pinola51, 1, 1, 0, yes
1216304184,  DarioGBonfiglio, 1, 1, 0, yes
4905466845,  Daniele_Flore, 1, 1, 0, yes
2986046349,  Dottor_Gorde, 1, 1, 0, yes
1858497348,  Appabvill, 1, 1, 0, yes
41153455,  francopasta, 1, 1, 0, yes
736666618303008768,  sarah_chiovetta, 1, 1, 0, yes
450687289,  VictoriaOyinda, 1, 1, 0, yes
3340908196,  Mae_Carson2, 1, 1, 0, yes
253714639,  nataleraineri, 1, 1, 0, yes
480513378,  J_Taylor_Foster, 1, 1, 0, yes
66119329,  yolsclemente, 1, 1, 0, yes
2879508977,  ngominellisara, 1, 1, 0, yes
711666924858507264,  bruny65, 1, 1, 0, yes
3214722334,  deboraspanu, 2, 2, 0, yes
1251723726,  luciam1441, 1, 1, 0, yes
613407082,  Eugenio_Izzo, 1, 1, 0, yes
221026693,  drmarcus65, 2, 1, 1, neutral
734057760258719744,  scibainu, 2, 2, 0, yes
360186116,  MatteoCarloni1, 1, 1, 0, yes
146557007,  dammelloo, 1, 1, 0, yes
805555317778108417,  malagoli_simona, 1, 1, 0, yes
51007536,  kerouac_zoso, 1, 1, 0, yes
870590246,  Nadiaspad, 1, 1, 0, yes
96868385,  IlTalento, 1, 1, 0, yes
237017504,  LaPedrazza, 2, 1, 1, neutral
1006166022,  anna91266, 1, 1, 0, yes
306421944,  Maxi_Gooner, 1, 1, 0, yes
430276296,  silvia_nossa, 1, 1, 0, yes
1167010458,  Niko95Monster, 2, 2, 0, yes
999351943,  rossella_falai, 1, 1, 0, yes
493547618,  anto_sal, 3, 3, 0, yes
76311999,  MartaAvogadri, 1, 1, 0, yes
77592732,  marinellanglano, 1, 1, 0, yes
395649454,  CINDY2099, 1, 1, 0, yes
254556286,  Reteconomy, 1, 1, 0, yes
282255921,  Charlie_Zhan, 1, 1, 0, yes
775681928,  closetobieb, 1, 1, 0, yes
762588881518821376,  ultraouf911, 2, 2, 0, yes
24038241,  property1, 4, 4, 0, yes
1433950422,  jacopo_porpora, 1, 1, 0, yes
2978508729,  may14csd, 2, 2, 0, yes
1248107742,  m_bellinazzi, 1, 1, 0, yes
341688379,  taylordiciocco, 1, 1, 0, yes
370356155,  Titti_Monaco, 1, 1, 0, yes
155647641,  carmen_antonino, 2, 2, 0, yes
322517438,  fefolone, 1, 1, 0, yes
888407419,  DarioPiermarini, 2, 1, 1, neutral
570587114,  cutini_f, 1, 1, 0, yes
2764649613,  LmbBrandoni, 1, 1, 0, yes
258952134,  semolino65, 2, 2, 0, yes
947579263,  enzo_russo95, 1, 1, 0, yes
397146585,  mascio72, 3, 3, 0, yes
209496449,  lorenzoci, 2, 2, 0, yes
313952903,  Maverick_pagano, 1, 1, 0, yes
426081997,  albertofaustini, 3, 3, 0, yes
429384871,  AlfredoSiani, 1, 1, 0, yes
2510597084,  EugeniaGermano, 1, 1, 0, yes
1039611120,  davideluciano3, 1, 1, 0, yes
408439846,  MyGi_5, 3, 3, 0, yes
359345806,  SasoIdeale91, 1, 1, 0, yes
878132748,  Alessiovoloo, 1, 1, 0, yes
471339442,  AndreasDAmico, 1, 1, 0, yes
123055989,  Roberto_Rubini, 1, 1, 0, yes
3060501056,  cri7376, 1, 1, 0, yes
2978803373,  MorandaMichele, 1, 1, 0, yes
1958200020,  OrnellaPetillo, 3, 1, 2, no
397527422,  RomanHiller, 1, 1, 0, yes
2723834461,  FabiCicia, 1, 1, 0, yes
1278011942,  cappe_97, 1, 1, 0, yes
2308437769,  susitango, 3, 3, 0, yes
1069184371,  dlongoni67, 1, 1, 0, yes
2483502135,  emshank3, 1, 1, 0, yes
801711044855037952,  mentatina, 1, 1, 0, yes
544497868,  swvsrt, 1, 1, 0, yes
2477082999,  maybluesky53, 2, 2, 0, yes
301256820,  VincenzoS_HalaM, 1, 1, 0, yes
369621332,  pietrotorrii, 1, 1, 0, yes
3025388525,  MacucciMarisa, 1, 1, 0, yes
598184647,  marieclaireki, 2, 2, 0, yes
1259170904,  abatefaria71, 2, 2, 0, yes
2900645163,  cuppone_daniele, 1, 1, 0, yes
210419020,  Maxct79, 1, 1, 0, yes
716072612,  AlfioCartillone, 1, 1, 0, yes
3212201980,  rightsideof_, 4, 4, 0, yes
1107131173,  777fede, 1, 1, 0, yes
2324022020,  Stefano_Gri, 4, 2, 2, neutral
18744112,  agnx, 1, 1, 0, yes
219342657,  PaoloMiscia, 1, 1, 0, yes
4062048802,  angelben53, 1, 1, 0, yes
496408642,  fitcre, 1, 1, 0, yes
174428238,  pvengu, 3, 3, 0, yes
102918775,  tfajon, 1, 1, 0, yes
794288211824615424,  Giamp1996, 1, 1, 0, yes
1449137114,  rickfimterni, 1, 1, 0, yes
2820480285,  reddie72, 1, 1, 0, yes
74701006,  fabiorossignoli, 1, 1, 0, yes
2400412774,  barbaramonti5, 4, 4, 0, yes
717467481414189057,  jtoni29, 1, 1, 0, yes
2352388954,  stellagng, 1, 1, 0, yes
356146461,  zioatti, 2, 2, 0, yes
998122807,  giulia_telesco, 1, 1, 0, yes
2273252468,  Rominacont95, 1, 1, 0, yes
2434058816,  MartaPuntino, 1, 1, 0, yes
712308188863971329,  carlotta_padua, 3, 1, 2, no
254621457,  matticolo, 1, 1, 0, yes
139083080,  Andasca, 1, 1, 0, yes
2215888891,  wilmidellalontr, 1, 1, 0, yes
3556903461,  didacbelles, 1, 1, 0, yes
1309717862,  SposatoCarla, 1, 1, 0, yes
108020816,  rickyjfk, 5, 5, 0, yes
283432802,  85cry85, 1, 1, 0, yes
196527314,  lernjaureguiaf, 2, 2, 0, yes
34641691,  carlopastore, 1, 1, 0, yes
320448235,  AngelaMilanese, 1, 1, 0, yes
1017045240,  Ferrarizer, 1, 1, 0, yes
21967402,  nikos95, 1, 1, 0, yes
2718691234,  ybp4real, 1, 1, 0, yes
731222880424480769,  alessia970, 1, 1, 0, yes
42647363,  Doc_Clo, 1, 1, 0, yes
1444264435,  FraIsHere, 1, 1, 0, yes
224194361,  sotiris_m, 1, 1, 0, yes
150622548,  marcellob87, 1, 1, 0, yes
366011205,  alessiuccia_5, 2, 2, 0, yes
3105597082,  AlessandraTest, 1, 1, 0, yes
168168878,  Sophie_Pons, 1, 1, 0, yes
1872495530,  HuertDeAuteuil, 3, 2, 1, yes
764483095437410304,  Paris25374455, 2, 2, 0, yes
1965465698,  MelaniaFiglia, 1, 1, 0, yes
466457131,  Pugi8Stefano, 1, 1, 0, yes
3011181466,  Jess_Chicchy, 1, 1, 0, yes
2340124419,  jpinkmn, 1, 1, 0, yes
1289612550,  stefralusi, 1, 1, 0, yes
405712768,  LucianoPintus, 1, 1, 0, yes
551272996,  gnichettiDNCA, 1, 1, 0, yes
426041996,  NiccoloPapucci, 1, 1, 0, yes
492561886,  IreneSciamanna, 1, 1, 0, yes
3065796047,  justpecks, 1, 1, 0, yes
787086834,  Cagnols, 1, 1, 0, yes
24504357,  lukagladwell, 1, 1, 0, yes
1485951925,  verificatore1, 8, 3, 5, no
448671883,  DavideMazzarell, 1, 1, 0, yes
431549777,  SiFabbri, 2, 2, 0, yes
3481791375,  giadase2013, 2, 2, 0, yes
3613367595,  annamariasmn, 2, 2, 0, yes
264015550,  comolower, 1, 1, 0, yes
1837470877,  ValloneFabio, 1, 1, 0, yes
489549580,  mimma41, 1, 1, 0, yes
2859533865,  Vitruvian_Duck, 1, 1, 0, yes
581968977,  FabioPittaluga3, 1, 1, 0, yes
213031898,  FikerZelalem, 1, 1, 0, yes
247905907,  b767_400xx, 2, 2, 0, yes
3105234051,  murantem1989, 2, 2, 0, yes
483977362,  LucyPato7, 1, 1, 0, yes
986752094,  gabri_isidoro, 1, 1, 0, yes
632803642,  StellaTringali, 1, 1, 0, yes
1472889176,  reveladormusic, 1, 1, 0, yes
410806087,  raffcur, 1, 1, 0, yes
1442053081,  violablu5, 1, 1, 0, yes
1101341150,  FGuastelluccia, 1, 1, 0, yes
482108655,  AntoninoSirchia, 1, 1, 0, yes
2867474025,  giulscoppo, 1, 1, 0, yes
44599331,  ilvile, 1, 1, 0, yes
118441496,  tierfj, 1, 1, 0, yes
486015701,  Ubalda2002, 2, 1, 1, neutral
2872304134,  mercyBLUExx, 1, 1, 0, yes
440074970,  RodolfiV, 1, 1, 0, yes
739185192204668928,  Nico07689502, 1, 1, 0, yes
4783046858,  Whims_Official, 1, 1, 0, yes
22006101,  gianlucamelillo, 1, 1, 0, yes
108708222,  rciniega1, 1, 1, 0, yes
789641061996134400,  annamartelli7, 1, 1, 0, yes
1880183936,  TizianoBin, 5, 4, 1, yes
419872457,  DomenicoPaletta, 1, 1, 0, yes
3005710365,  a_antonucci1926, 1, 1, 0, yes
390731426,  guspiccolo, 1, 1, 0, yes
195774026,  ilbuonFabioSilv, 1, 1, 0, yes
436474148,  wbrina, 1, 1, 0, yes
2273200191,  seba2916, 2, 2, 0, yes
6876542,  daniela_elle, 1, 1, 0, yes
3230089899,  ReverendoMoon, 1, 1, 0, yes
467282460,  AlessandroZoli, 1, 1, 0, yes
44887062,  winnik62, 1, 1, 0, yes
560577853,  albi_bas, 1, 1, 0, yes
457499223,  LaIsaRinaldi, 2, 1, 1, neutral
796351047165952000,  animasbaglia, 2, 2, 0, yes
601861508,  y0ungs4g3, 1, 1, 0, yes
418885515,  NadiaPontieri, 1, 1, 0, yes
2597684699,  AlviseFalleri, 1, 1, 0, yes
1323031944,  ScaraN14, 1, 1, 0, yes
949613514,  Salvamasi, 1, 1, 0, yes
804194731446116352,  picapau71, 1, 1, 0, yes
742646996314562560,  Donatel00293713, 1, 1, 0, yes
407213314,  AlessandraRaina, 1, 1, 0, yes
732894134906814464,  BledMagdalena, 1, 1, 0, yes
741227545471930368,  Chiarayeah_, 1, 1, 0, yes
28300953,  pelo2002, 1, 1, 0, yes
2788003186,  ada08112022, 2, 2, 0, yes
754074551743635456,  vivi_palumbo, 1, 1, 0, yes
805675285886681088,  SegatoClaudio, 1, 1, 0, yes
805675765065019392,  bussogiorgia, 1, 1, 0, yes
592091916,  angelarapidina, 2, 2, 0, yes
898173608,  Bot1980, 2, 2, 0, yes
311136807,  nusire, 1, 1, 0, yes
299714730,  ste92k, 1, 1, 0, yes
2559279620,  calme, 1, 1, 0, yes
3446687776,  f36a05042d0f4c8, 2, 2, 0, yes
421828997,  PatriziaCesaren, 5, 5, 0, yes
1354801496,  miapomette, 1, 1, 0, yes
751726954664042496,  angioletto110, 1, 1, 0, yes
2184610516,  DPennaNY, 1, 1, 0, yes
490499786,  saluterbe1, 1, 1, 0, yes
1058390108,  gd_doutes, 1, 1, 0, yes
994085474,  tanilan1, 1, 1, 0, yes
2589698269,  CIR_CSM, 1, 1, 0, yes
359590513,  cristiancosent7, 1, 1, 0, yes
396742614,  AndreaReale27, 1, 1, 0, yes
2361168001,  raffatucatuca, 1, 1, 0, yes
963271549,  keisyuu113, 1, 1, 0, yes
450113271,  AdrianoPezzino, 3, 3, 0, yes
416084427,  misomic, 1, 1, 0, yes
81467672,  luckymooon, 6, 3, 3, neutral
2357580293,  Lookdownpg, 1, 1, 0, yes
425718839,  barneycom, 1, 1, 0, yes
2474149333,  Wharbehn, 1, 1, 0, yes
2348648967,  dony_467, 4, 4, 0, yes
805755593944338432,  robertaballari, 1, 1, 0, yes
1861413494,  PaulinaAstrozaS, 2, 2, 0, yes
2242450460,  AlessiaVettori7, 1, 1, 0, yes
2354657648,  sifmedico, 1, 1, 0, yes
88220481,  pirlosantos, 3, 2, 1, yes
612864336,  bluntsashes, 2, 2, 0, yes
476137295,  AlePatelli, 1, 1, 0, yes
24147393,  riccardoldani, 1, 1, 0, yes
792428742371082240,  maria_coppa, 1, 1, 0, yes
1059804050,  mdlbox, 1, 1, 0, yes
19306779,  Sim_MB, 1, 1, 0, yes
1700202835,  AuroraAurBieber, 1, 1, 0, yes
479824519,  Aldosnaidero, 1, 1, 0, yes
3294331011,  fiammettarossa1, 2, 2, 0, yes
2951423075,  FdeFab, 1, 1, 0, yes
3032704223,  AScialappa, 1, 1, 0, yes
204308886,  sabrinaldrighi, 1, 1, 0, yes
405731693,  AlessioRossi78, 1, 1, 0, yes
1488372031,  MEF_GOV, 7, 7, 0, yes
125075993,  biagginimedical, 2, 2, 0, yes
3613471341,  GiuCabianca, 1, 1, 0, yes
50249326,  TommasoCarinci, 1, 1, 0, yes
3544569975,  RaffaRossWriter, 1, 1, 0, yes
497997424,  MarcelloBertani, 1, 1, 0, yes
588409877,  danielazerbini2, 1, 1, 0, yes
740902691858178048,  boccoli88, 2, 1, 1, neutral
763931106869522435,  fenrir4471, 1, 1, 0, yes
186115457,  AlmaPantaleo, 1, 1, 0, yes
730779977847848960,  gialuia, 1, 1, 0, yes
114459330,  danytaibbi, 1, 1, 0, yes
773797430,  o_santoro, 1, 1, 0, yes
1124411316,  Maelganis, 1, 1, 0, yes
971945852,  Stefano75MI, 1, 1, 0, yes
2461919637,  AlessandraDe_Lu, 1, 1, 0, yes
104504815,  christiansurchi, 1, 1, 0, yes
2336962634,  sndlfr58d, 2, 2, 0, yes
3222349996,  camillodigiulio, 1, 1, 0, yes
1729106083,  bianchi_olivia, 1, 1, 0, yes
714189601997529088,  m9_veru, 3, 2, 1, yes
3295737298,  rickniky, 1, 1, 0, yes
2854783919,  Niki72Rossi, 1, 1, 0, yes
308500552,  GiulioAlcaras, 1, 1, 0, yes
728288391050170368,  lavanderinaops, 1, 1, 0, yes
498937500,  DelAdv, 1, 1, 0, yes
2361027657,  pattino5855, 1, 1, 0, yes
2361220234,  PatriziaBuccia3, 1, 1, 0, yes
1413547340,  AnnaPal66, 1, 1, 0, yes
122702609,  adrianovaroli, 1, 1, 0, yes
801755876155650048,  margherita_22, 1, 1, 0, yes
437625611,  ldechiara, 1, 1, 0, yes
1532086514,  cinefabry, 2, 1, 1, neutral
1074704401,  SebastianPizzol, 1, 1, 0, yes
805717589217439744,  AnnaCentofante2, 1, 1, 0, yes
130507715,  CuiProdestNews, 1, 1, 0, yes
496370348,  JohnDodds5, 1, 1, 0, yes
805715101651189760,  AssensoUmberto, 1, 1, 0, yes
923552168,  A_Ferraiolo, 1, 1, 0, yes
2284493280,  launicatana, 1, 1, 0, yes
805524435478441984,  CarlottiMichael, 1, 1, 0, yes
740167265606336512,  marscu46, 3, 1, 2, no
3245146540,  max_lardi, 1, 1, 0, yes
3254498950,  antonellacara50, 1, 1, 0, yes
799398669036425216,  Terrorista_boom, 1, 1, 0, yes
200214600,  king_michael_ca, 1, 1, 0, yes
2176873756,  ChiaraDodero, 1, 1, 0, yes
3321556576,  LucaMasi41, 2, 1, 1, neutral
501523214,  pietrosp_, 1, 1, 0, yes
2358588213,  paole1967, 1, 1, 0, yes
1234315435,  FlakoneFlavio, 1, 1, 0, yes
457697338,  PierRolla, 1, 1, 0, yes
31738632,  NutKee, 1, 1, 0, yes
1049494609,  Tlahuitoltzin, 1, 1, 0, yes
194514787,  GLBouchez, 1, 1, 0, yes
1525423148,  Carmen2390, 1, 1, 0, yes
32917922,  XtinaLGN, 2, 2, 0, yes
266228055,  mapinkmablu1, 1, 1, 0, yes
17423554,  ArnMenconi, 1, 1, 0, yes
758662050612649984,  fenji_angy, 1, 1, 0, yes
83519758,  vannizagnoli, 1, 1, 0, yes
2731498990,  amusso153, 1, 1, 0, yes
146000057,  p76claudio, 7, 7, 0, yes
251556401,  yongf14, 1, 1, 0, yes
544465731,  OrtolanoC, 2, 2, 0, yes
65986070,  cosechadel83, 3, 1, 2, no
2855125287,  danisa_fi, 1, 1, 0, yes
2196906723,  bf_fra, 1, 1, 0, yes
378243808,  angeloluongo, 1, 1, 0, yes
377535642,  maribera74, 1, 1, 0, yes
787353335351377920,  enrymusic, 1, 1, 0, yes
2589059304,  Edorsi53, 1, 1, 0, yes
48732475,  baromo, 1, 1, 0, yes
805781580161675264,  Lara0173, 1, 1, 0, yes
923368536,  balduz88, 1, 1, 0, yes
2405329984,  CremisiLuna64, 1, 1, 0, yes
1063704396,  IsabellaSacco5, 1, 1, 0, yes
749003664,  LilianaRubbino, 1, 1, 0, yes
298475888,  RositaTurco, 1, 1, 0, yes
805681905203027968,  fabrigemelli, 1, 1, 0, yes
20143373,  andreas212nyc, 1, 1, 0, yes
567593615,  ElenaRosi1, 1, 1, 0, yes
197040865,  ConteTangari, 1, 1, 0, yes
3672868817,  gio3457, 1, 1, 0, yes
2192052075,  L_Sabbi, 1, 1, 0, yes
3006719945,  Readtoinnovate, 1, 1, 0, yes
324476158,  paolosalvemini, 1, 1, 0, yes
366591210,  LaviniaHCR, 1, 1, 0, yes
185183592,  carmelogeom, 1, 1, 0, yes
802044396212457472,  nunziadany, 1, 1, 0, yes
1270733430,  raffaelepascare, 1, 1, 0, yes
166365988,  gervaswatch, 2, 2, 0, yes
2737846557,  ferrich2, 1, 1, 0, yes
492109253,  Ned1970, 1, 1, 0, yes
436221487,  cinzia_vottari, 1, 1, 0, yes
375651212,  giozonca, 1, 1, 0, yes
60159920,  AttilaRock, 12, 4, 8, no
2526938820,  tulipanocattivo, 9, 9, 0, yes
1011166508,  gemssftlou, 1, 1, 0, yes
943976030,  DomenicoQuercia, 1, 1, 0, yes
772078614087102464,  duccio_73, 1, 1, 0, yes
50590153,  testudoweb, 1, 1, 0, yes
4737338194,  marconughes_100, 1, 1, 0, yes
490576482,  MauroFabi, 2, 2, 0, yes
45541132,  alecensi82, 2, 2, 0, yes
398045546,  romar75, 1, 1, 0, yes
2170606681,  FiliMonte, 1, 1, 0, yes
1319035447,  fulminouis, 2, 2, 0, yes
127900308,  HaticeAVCI_, 1, 1, 0, yes
166258411,  giovinka96, 1, 1, 0, yes
790178821601431552,  pat111111112, 1, 1, 0, yes
245292287,  AndreaWazowski, 1, 1, 0, yes
478976238,  AlbertoBebowsky, 1, 1, 0, yes
516634164,  barbaramerlo2, 1, 1, 0, yes
2313969829,  Mrw_Clay, 1, 1, 0, yes
2479891578,  parresia63, 4, 4, 0, yes
796843234844614656,  Anna060672, 1, 1, 0, yes
1042950181,  LgifVincenzo, 1, 1, 0, yes
3926659804,  DaviddiMara, 2, 2, 0, yes
2405938781,  AnitacettaAnita, 1, 1, 0, yes
774496423668752385,  NATOIL412, 1, 1, 0, yes
128264270,  Dixer5000, 1, 1, 0, yes
804268897323122688,  lagrecamc, 1, 1, 0, yes
802948241725726721,  CamPatriarca, 2, 2, 0, yes
600232964,  CettaFerrara, 3, 1, 2, no
587771041,  brigante40, 1, 1, 0, yes
183346959,  Miruku__, 1, 1, 0, yes
1860286387,  davijuve00, 1, 1, 0, yes
285835110,  Aly_s__, 1, 1, 0, yes
476257511,  fsalucci, 1, 1, 0, yes
724966904515969024,  half_bloodgirl, 1, 1, 0, yes
2639724503,  besastefano, 1, 1, 0, yes
2363532191,  CeccoAnd, 1, 1, 0, yes
604829592,  GiuliaMil, 1, 1, 0, yes
1966481568,  crisgaldesign, 1, 1, 0, yes
628224675,  PDPartanna, 1, 1, 0, yes
414907807,  BiagioIndino, 1, 1, 0, yes
375742012,  edo_meng, 1, 1, 0, yes
222725904,  betelgeuse2010, 1, 1, 0, yes
2410504626,  antonioragct, 1, 1, 0, yes
713002459870937088,  AlessRaimondi, 2, 1, 1, neutral
489300997,  IVught, 1, 1, 0, yes
796135243,  giorgialfarano, 3, 2, 1, yes
1722272466,  Davidz_93, 1, 1, 0, yes
52364658,  matxyz, 1, 1, 0, yes
763869506913636352,  lanciotti_paola, 1, 1, 0, yes
1252183285,  MariaRosariaS14, 1, 1, 0, yes
1305967158,  PellegrinoCaru1, 1, 1, 0, yes
390688557,  alexdigio, 1, 1, 0, yes
501119273,  AndreaRozzato, 1, 1, 0, yes
3267183562,  ceronifranci, 1, 1, 0, yes
432314174,  MarilPitt, 2, 2, 0, yes
1295714208,  PatriziaZambon1, 1, 1, 0, yes
1279865982,  alebattellino, 1, 1, 0, yes
2184883564,  fragorini, 1, 1, 0, yes
474292203,  marikona98, 1, 1, 0, yes
470596432,  riccardoesse, 1, 1, 0, yes
135447392,  Federica_Fr, 1, 1, 0, yes
518566782,  Matte2101, 1, 1, 0, yes
2864756907,  Nazionaldevis, 1, 1, 0, yes
155696776,  benbawan, 1, 1, 0, yes
467464606,  MASTELLATO74, 1, 1, 0, yes
804957123557883905,  giancarlogazzo3, 1, 1, 0, yes
250564609,  echodelta9, 1, 1, 0, yes
4829916737,  TonaniFederica, 5, 3, 2, yes
1351574334,  alero002, 1, 1, 0, yes
99311786,  Gianmarco90, 3, 3, 0, yes
3085062651,  albertolison, 1, 1, 0, yes
730714544,  CIAMPOLIS, 1, 1, 0, yes
2375645982,  nicolettaC4, 2, 2, 0, yes
370583061,  bitterness2, 2, 2, 0, yes
1059054242,  fmessina81, 1, 1, 0, yes
474724931,  lucadere, 1, 1, 0, yes
363916807,  kekka09, 1, 1, 0, yes
245372363,  scamusu, 4, 3, 1, yes
396727185,  ArmandoGattai, 1, 1, 0, yes
3049824545,  kinshasaweb, 3, 3, 0, yes
240248557,  patrovale, 1, 1, 0, yes
1410214789,  alessandrobucc, 3, 2, 1, yes
334035737,  Marco_Federici, 2, 2, 0, yes
600865001,  fedeiach, 3, 3, 0, yes
295781571,  LauraCarpini, 1, 1, 0, yes
447258483,  CorradoPecchio, 2, 2, 0, yes
702767612,  AndreaCrapis, 1, 1, 0, yes
123336852,  rafaelroman2012, 1, 1, 0, yes
288907383,  ilaryi_, 1, 1, 0, yes
767765638056185856,  vincenzociro, 1, 1, 0, yes
331255590,  CandidoDalMas, 2, 2, 0, yes
277023339,  ciaely, 1, 1, 0, yes
489523055,  sim_romano, 1, 1, 0, yes
34423857,  czorrinho, 1, 1, 0, yes
2253896635,  SandwormPT, 1, 1, 0, yes
453815626,  michiamofenice, 3, 3, 0, yes
1409866195,  f_orobello, 1, 1, 0, yes
4706663313,  Frances10187327, 8, 2, 6, no
332223277,  EBertuccio, 1, 1, 0, yes
2744277820,  DottoriClaudio, 2, 2, 0, yes
2458049437,  JRamonGonzalez_, 1, 1, 0, yes
1456018832,  TarabellaPaolo, 3, 3, 0, yes
2346488962,  agitalyw, 1, 1, 0, yes
386999042,  paolodaloiso, 2, 2, 0, yes
3294175732,  gianni1115, 2, 2, 0, yes
412587936,  fedefresa, 6, 6, 0, yes
787678618726072320,  FiloretoF, 1, 1, 0, yes
1494535956,  NDiserio, 1, 1, 0, yes
798155169036898304,  Salentopower76, 3, 3, 0, yes
747771697290485760,  Gerardina16, 2, 2, 0, yes
804732323501670400,  EKOTORINO, 1, 1, 0, yes
1320523968,  x_louissmile, 1, 1, 0, yes
773069091003371520,  JeakMe, 1, 1, 0, yes
2192421606,  giuppyglobo, 2, 2, 0, yes
407837397,  carlo_candido, 1, 1, 0, yes
802139996929085440,  JackSacchi, 1, 1, 0, yes
801394827569070080,  luca_martini97, 1, 1, 0, yes
330502291,  bisicchia, 2, 1, 1, neutral
2296829958,  billy75x, 1, 1, 0, yes
500246389,  NobileMarco1, 1, 1, 0, yes
354138304,  paperino02, 1, 1, 0, yes
2724374409,  PatriziaMiu, 1, 1, 0, yes
2969670790,  andre_grieco, 1, 1, 0, yes
734418757515411456,  bertidaniela0, 1, 1, 0, yes
805008820065935364,  EdmondoLenzo, 1, 1, 0, yes
762011762468225024,  falu2016, 2, 1, 1, neutral
2267087299,  luciano41607805, 1, 1, 0, yes
798623808546635780,  francescarpino, 1, 1, 0, yes
3007544649,  genki5518, 1, 1, 0, yes
170944795,  gianboriello, 1, 1, 0, yes
3016866141,  PFarneda, 1, 1, 0, yes
769509046227496960,  Maddalenaimma73, 1, 1, 0, yes
1288175718,  caposeco, 2, 2, 0, yes
767364312054792192,  StefoniLorenzo, 1, 1, 0, yes
269275889,  Matdegra, 2, 1, 1, neutral
250131497,  AnMailleach, 1, 1, 0, yes
722067166380617728,  ClaudioFC73, 4, 4, 0, yes
2558940949,  annamariam621, 1, 1, 0, yes
393278455,  LauraIncantalup, 1, 1, 0, yes
2176747811,  EmanTarantino, 1, 1, 0, yes
1249472208,  LuigiPa70, 10, 7, 3, yes
3091327516,  BarbaraGen82, 1, 1, 0, yes
2177287618,  antonio65142683, 1, 1, 0, yes
129124707,  desmosetta, 1, 1, 0, yes
745255946528636928,  nadyiaviolinist, 1, 1, 0, yes
721673315480399872,  AdelaideFantoz1, 1, 1, 0, yes
1466474701,  maryasini, 1, 1, 0, yes
531299176,  MaddalenaDi, 2, 2, 0, yes
48987948,  mattiafiorini, 2, 2, 0, yes
2607049369,  RPolchi, 1, 1, 0, yes
2764705264,  leopoldorossi9, 1, 1, 0, yes
1462179565,  Domenicorocco52, 4, 4, 0, yes
1368054770,  Pokeramoit, 2, 2, 0, yes
1496555977,  143ttVittorio, 1, 1, 0, yes
410761921,  navinalruf, 1, 1, 0, yes
566896667,  TelliniMassim, 1, 1, 0, yes
272185225,  fsorbara, 1, 1, 0, yes
2862264726,  lilianafaraone, 5, 4, 1, yes
137375100,  globalpisobego, 1, 1, 0, yes
1540670084,  lucamarino894, 1, 1, 0, yes
1454209170,  SQuacqua, 1, 1, 0, yes
585822369,  DalmonteGiacomo, 1, 1, 0, yes
429207788,  pierluigi_serra, 1, 1, 0, yes
271135852,  MisterAlex90, 1, 1, 0, yes
2207306586,  fioreviola138, 1, 1, 0, yes
256349599,  H0racio_, 1, 1, 0, yes
75882285,  acrashmarco, 1, 1, 0, yes
1047085261,  rand_vibration, 1, 1, 0, yes
3519550996,  moscafausto1942, 1, 1, 0, yes
2388851034,  MARI93886328, 3, 3, 0, yes
721797610286268417,  BTommasella, 1, 1, 0, yes
7706172,  angelosays, 1, 1, 0, yes
2277535545,  SUbbiali, 1, 1, 0, yes
446480030,  Ren_Burri, 1, 1, 0, yes
90534916,  alecanepa, 1, 1, 0, yes
788762450439135232,  francobello214, 1, 1, 0, yes
720871070492807168,  VincenzoLucent3, 2, 1, 1, neutral
4285369709,  franca_lenzi, 2, 2, 0, yes
221786478,  fabri1166, 3, 2, 1, yes
67289408,  scorpioncino, 1, 1, 0, yes
33249393,  salvamerando, 1, 1, 0, yes
597944505,  bukerex27, 1, 1, 0, yes
461180122,  AnnalisaMassar1, 5, 5, 0, yes
737762849565626368,  BorgonSPdicesi, 1, 1, 0, yes
1351222266,  dm1969dm, 1, 1, 0, yes
229821777,  svippy, 8, 1, 7, no
757297363019001856,  raffaeleleopard, 1, 1, 0, yes
467353699,  principeperduto, 2, 2, 0, yes
32982389,  jako64, 1, 1, 0, yes
545193639,  filippoforti1, 2, 2, 0, yes
2509748538,  jder490, 2, 2, 0, yes
186305968,  fiorewomy, 1, 1, 0, yes
982441224,  marta_zambon, 1, 1, 0, yes
30538558,  DidiMiaFornaro, 1, 1, 0, yes
2367453471,  MaraTaroni, 1, 1, 0, yes
2352686548,  promartipro, 3, 3, 0, yes
1055811668,  CeciliaVianello, 1, 1, 0, yes
2743623190,  CarlaVolpecarla, 1, 1, 0, yes
261602574,  brytieamps, 2, 1, 1, neutral
2240897310,  AntoFattore, 3, 3, 0, yes
878960803,  MarioDAsta, 1, 1, 0, yes
307531089,  totoscalisi, 1, 1, 0, yes
227954915,  Bombibetty, 1, 1, 0, yes
1860109214,  alessiaamendol2, 1, 1, 0, yes
139682642,  raciriello, 1, 1, 0, yes
524616182,  marco68perini, 1, 1, 0, yes
359968999,  zacchy71, 1, 1, 0, yes
305224209,  lzuffo, 1, 1, 0, yes
255955670,  gabribotia, 1, 1, 0, yes
759147924374728704,  ManniGregorio, 1, 1, 0, yes
365535730,  simoz75, 1, 1, 0, yes
115459096,  leonardobis_, 1, 1, 0, yes
22238986,  SFAuGrrl, 1, 1, 0, yes
1106111024,  CoastAndrew, 1, 1, 0, yes
572833124,  Ithacanexile, 1, 1, 0, yes
221111568,  Vagar79, 1, 1, 0, yes
281651828,  IlBaldogiovane, 2, 1, 1, neutral
1515511260,  Vacsavvocati, 1, 1, 0, yes
282226804,  Twitt2Flyer, 2, 2, 0, yes
2237752576,  DBorsci, 1, 1, 0, yes
759349593859653632,  AllievBarbarina, 1, 1, 0, yes
40843845,  gianlucasalina, 1, 1, 0, yes
3044664286,  QuintaColonnaTv, 6, 6, 0, yes
1661062764,  marcuzziwalter, 11, 10, 1, yes
1072012310,  luca_valtolina, 1, 1, 0, yes
3010291918,  adorvelarrie, 1, 1, 0, yes
1284449461,  VeronesiJacopo, 2, 2, 0, yes
731522732345688064,  S7EVINKELEVRA_, 2, 2, 0, yes
1464201175,  lucreziarossi11, 1, 1, 0, yes
40263627,  haunted90, 3, 2, 1, yes
3226175572,  MatandMax, 3, 2, 1, yes
536340991,  amicodelpopolo1, 6, 2, 4, no
4363095615,  panlchi, 1, 1, 0, yes
779685796936839168,  vitturisa, 5, 4, 1, yes
745877174,  taddei_simone, 1, 1, 0, yes
951466970,  GioSignorile, 2, 1, 1, neutral
47298412,  CVM_AN, 1, 1, 0, yes
722851120587022336,  scarcelliv1, 1, 1, 0, yes
118092016,  vandy2110, 6, 6, 0, yes
2503841804,  Giuse_B149, 5, 1, 4, no
723790218764124161,  Valerio73606196, 1, 1, 0, yes
418936091,  LucaVogrig, 4, 4, 0, yes
2876220795,  anti_pol, 1, 1, 0, yes
2778636965,  fatimaaquino41, 2, 2, 0, yes
761111427759214592,  RepRegMantova, 1, 1, 0, yes
935131632,  giovannire8, 4, 1, 3, no
785770553026023425,  manu_b89, 1, 1, 0, yes
712717967524499456,  claudioprince11, 1, 1, 0, yes
1090118378,  GiambattistaMar, 4, 4, 0, yes
1241969216,  parlaipelu, 1, 1, 0, yes
712314558,  marcomongelli2, 1, 1, 0, yes
1063911721,  orologiaioenzo, 2, 2, 0, yes
557009624,  EdoFra2kia, 1, 1, 0, yes
2842209970,  Perdenti, 1, 1, 0, yes
1036953175,  SoniaVigoson, 1, 1, 0, yes
341590403,  Alepivaral, 1, 1, 0, yes
768819803737952256,  marcellorende47, 1, 1, 0, yes
61871127,  DottorChe, 1, 1, 0, yes
717770955192471552,  ferrzen, 4, 4, 0, yes
382138494,  AndreaTronzano, 1, 1, 0, yes
2249190396,  HantoxPatty, 1, 1, 0, yes
786347436595970048,  sacchi70, 1, 1, 0, yes
1966371889,  NAAAonlus, 1, 1, 0, yes
701361125460484096,  Nordwest600, 1, 1, 0, yes
519402060,  alecimoli, 6, 6, 0, yes
398710426,  TgZeroCapital, 9, 9, 0, yes
790939624977891328,  AdeleMazz1, 4, 3, 1, yes
799977768746414080,  _senzanome1_, 1, 1, 0, yes
1222324963,  red_1278, 4, 4, 0, yes
1978367174,  miriam_scarpa, 3, 3, 0, yes
502663124,  CarraraAlberto, 1, 1, 0, yes
352268114,  FrancescoLenoci, 2, 2, 0, yes
405022704,  GiovanniTucciJr, 1, 1, 0, yes
83091296,  CJ_giacosa, 1, 1, 0, yes
3020472585,  Filopemene, 1, 1, 0, yes
1600776799,  MsrosaRosa, 1, 1, 0, yes
2900884007,  r_bargagni, 1, 1, 0, yes
403468828,  AForattini, 1, 1, 0, yes
167410534,  TommasoSavina, 2, 2, 0, yes
2478069432,  Luca_emme85, 1, 1, 0, yes
2720722905,  ferdi8157, 1, 1, 0, yes
707470497487917056,  arcuanto, 2, 2, 0, yes
213451073,  mauneobux, 6, 6, 0, yes
412541953,  interistimda, 1, 1, 0, yes
399560982,  julien883, 4, 1, 3, no
792801457158381568,  Enzino10512180, 1, 1, 0, yes
1064141546,  SilvanoCastelle, 2, 2, 0, yes
3151755743,  Giu_Savi, 4, 4, 0, yes
3300837263,  MerolliAndrea, 1, 1, 0, yes
707527220345118724,  daniel_tibi, 1, 1, 0, yes
999155473,  robertob76, 1, 1, 0, yes
2217600713,  Poli12Daniele, 1, 1, 0, yes
375704282,  michelatini, 1, 1, 0, yes
872318838,  David69Bel, 1, 1, 0, yes
340830425,  dvestito, 2, 2, 0, yes
606979822,  ilventodelmare, 1, 1, 0, yes
2688308934,  mcduella, 1, 1, 0, yes
820213640,  brunomaniga, 1, 1, 0, yes
51067487,  MattBiff, 4, 4, 0, yes
324761564,  claudenader, 3, 3, 0, yes
408721237,  AntoninoMusca, 4, 4, 0, yes
143440934,  pgallir, 3, 2, 1, yes
1579500278,  barbara19184542, 1, 1, 0, yes
298191851,  Beddoni, 7, 7, 0, yes
4056427037,  USiracusa, 4, 4, 0, yes
798559031887560705,  g_centristi, 3, 3, 0, yes
1323536942,  nikdesimone, 8, 6, 2, yes
91233153,  mattialarovere, 1, 1, 0, yes
2694146772,  ChistoliniFede, 3, 1, 2, no
3248837686,  alessandra_adn, 1, 1, 0, yes
1228038684,  doncaster62, 1, 1, 0, yes
1937296980,  robertoindolfi1, 1, 1, 0, yes
803276056132251653,  mikedipalo1972, 5, 5, 0, yes
711971164185169920,  Charlie630113, 1, 1, 0, yes
409841077,  alepipit, 1, 1, 0, yes
803160024319139840,  Anna_Longo_Borg, 1, 1, 0, yes
482210278,  jacopofattori, 1, 1, 0, yes
2457789161,  oraz82, 1, 1, 0, yes
2463036630,  GDMerate, 1, 1, 0, yes
477552640,  SalvoContino11, 1, 1, 0, yes
591711454,  ilaboi75, 3, 3, 0, yes
906177138,  Maior_L, 1, 1, 0, yes
435240633,  misteriavarone, 1, 1, 0, yes
581968820,  Davide_Valieri, 4, 4, 0, yes
2481933871,  AngSte53, 1, 1, 0, yes
431663224,  FabrizioCei, 5, 4, 1, yes
772369470635606016,  GraziaDolisi, 2, 2, 0, yes
2524398631,  GiusiStrati, 1, 1, 0, yes
239898664,  archilorenzo, 1, 1, 0, yes
767812848,  francescomura59, 1, 1, 0, yes
132880191,  Avvenire_NEI, 2, 2, 0, yes
3097809495,  BindiTony, 2, 2, 0, yes
827407754,  p_pgar, 10, 10, 0, yes
965068518,  uanbimbumbam, 8, 8, 0, yes
3199409086,  santo_robertino, 2, 1, 1, neutral
368563730,  danielabianchin, 1, 1, 0, yes
3299274394,  ElisabettaAliv1, 1, 1, 0, yes
107095492,  FrankieZirpo, 1, 1, 0, yes
736399368,  Marinella_Maria, 1, 1, 0, yes
380912265,  liuk1000, 1, 1, 0, yes
823147850,  SaadiensMisha, 1, 1, 0, yes
2797648695,  MRusciadelli, 1, 1, 0, yes
799574384763686912,  VolpiTiziano, 1, 1, 0, yes
100396172,  erion80, 1, 1, 0, yes
472043400,  roccocampobasso, 1, 1, 0, yes
3062947644,  VScoccia, 1, 1, 0, yes
3422740641,  GuidoPistilli, 1, 1, 0, yes
434110647,  romanaranucci, 1, 1, 0, yes
246741652,  delicate_purple, 1, 1, 0, yes
369655257,  giannattasius, 1, 1, 0, yes
924918487,  spinelligiovan1, 1, 1, 0, yes
1299807378,  tedpanski, 3, 2, 1, yes
741250447781040128,  Antoniouferraru, 3, 1, 2, no
3167141009,  poldilluminati, 1, 1, 0, yes
332389973,  MatteoPine, 2, 2, 0, yes
3119244148,  fanguru_, 1, 1, 0, yes
93591010,  simonegiglioli, 1, 1, 0, yes
3428587589,  TalaricoMiranda, 2, 1, 1, neutral
756108398974951425,  AlbertoSalina4, 1, 1, 0, yes
453286100,  AlexMascitti, 1, 1, 0, yes
342104047,  alessiaarde, 1, 1, 0, yes
1091433403,  velista44, 1, 1, 0, yes
2725236881,  trottoladimare, 1, 1, 0, yes
2732288357,  delussu57, 2, 2, 0, yes
2871517500,  porcamaledetta, 4, 3, 1, yes
3059230707,  dani8217213555, 6, 6, 0, yes
803336744909373440,  JastinTosku, 1, 1, 0, yes
416851826,  Zangi67, 1, 1, 0, yes
571713284,  VerbenaViscigli, 1, 1, 0, yes
2371882145,  pc_colucci, 4, 4, 0, yes
840370952,  PagellaPolitica, 3, 2, 1, yes
923085680,  nicoladiLernia1, 1, 1, 0, yes
2533191487,  LidiaeLuca, 2, 2, 0, yes
861812858,  poetry1976, 1, 1, 0, yes
405858302,  Damiano_81, 1, 1, 0, yes
531645942,  AgoPepe, 1, 1, 0, yes
2417069802,  partnerdigitale, 7, 2, 5, no
797782401090985984,  FrancescaAbbat4, 2, 2, 0, yes
207952142,  garful2, 4, 2, 2, neutral
1319060210,  NCalderaio, 1, 1, 0, yes
951188586,  fornari_marco, 1, 1, 0, yes
360540569,  matteomozzanini, 1, 1, 0, yes
3068826741,  nicola_rocker, 1, 1, 0, yes
1452431508,  ottolibero, 4, 1, 3, no
590049424,  lidiapandiani, 1, 1, 0, yes
505768568,  FabioCapodiferr, 1, 1, 0, yes
175200284,  facebeck, 1, 1, 0, yes
621461220,  D3r4lte, 1, 1, 0, yes
1726358556,  Ciarma76, 4, 4, 0, yes
1440383084,  NuzzoE, 2, 1, 1, neutral
715278291947687936,  lili_corsi, 1, 1, 0, yes
2845508824,  pskol50, 1, 1, 0, yes
406364563,  LambertiLuca, 2, 2, 0, yes
799289013907681280,  bisconti46, 1, 1, 0, yes
1278076698,  mimmomiz56, 2, 2, 0, yes
726711067750088704,  ChiumaruloMarco, 1, 1, 0, yes
752801595180670976,  Alessandra82P, 1, 1, 0, yes
1399215715,  mptsac, 1, 1, 0, yes
373908687,  flovien, 1, 1, 0, yes
373472218,  AlessioMavica, 1, 1, 0, yes
495785040,  Simone__Ferrari, 2, 2, 0, yes
464991280,  GarbagnatePD, 1, 1, 0, yes
484228064,  Jovanni55, 3, 3, 0, yes
304306690,  RedattoreSocial, 1, 1, 0, yes
711302461097689088,  annatonon2801, 2, 1, 1, neutral
3717111075,  mjonlnir, 1, 1, 0, yes
3817344621,  obliviall, 1, 1, 0, yes
753581604350615552,  EmersonMontani3, 1, 1, 0, yes
1061430067,  lombradime, 4, 4, 0, yes
390421105,  StabileCristian, 2, 2, 0, yes
495131109,  mauromaniero1, 2, 1, 1, neutral
3424532134,  Antodls22, 5, 2, 3, no
1017939222,  Teoscrofalo, 2, 2, 0, yes
799607715857317888,  Chiara193182441, 4, 3, 1, yes
468422004,  FabioMicheli1, 1, 1, 0, yes
728242468349722624,  BagnaraOlivier, 1, 1, 0, yes
2942118633,  trendingnewsf4f, 1, 1, 0, yes
598223193,  Andrea_Certini, 1, 1, 0, yes
2981137990,  GSenzolo, 4, 4, 0, yes
50038997,  kpalva, 1, 1, 0, yes
486878428,  cadeicadei, 1, 1, 0, yes
542048812,  antosca74, 1, 1, 0, yes
1394005098,  VanessPetrocchi, 1, 1, 0, yes
264760596,  mauriviv, 2, 2, 0, yes
1565958488,  f_festuccia, 2, 2, 0, yes
4121972601,  MariaBolzinger, 1, 1, 0, yes
19650966,  bernardoferrao, 2, 1, 1, neutral
518831617,  BellatiStefano, 1, 1, 0, yes
1086368970,  CarolaRula, 1, 1, 0, yes
3434186753,  giovannisozzo, 1, 1, 0, yes
468649299,  Pawel_Tokarski, 1, 1, 0, yes
257040876,  studiorondanini, 1, 1, 0, yes
548553549,  mariagallletti, 2, 1, 1, neutral
4764726920,  Giacomo_Dani01, 2, 2, 0, yes
1262734872,  jimdoesVLOGGING, 1, 1, 0, yes
1603117004,  natalia63125, 1, 1, 0, yes
521544632,  chiarazatti, 1, 1, 0, yes
3088795798,  caretta22, 1, 1, 0, yes
81915249,  Blizzard1001, 1, 1, 0, yes
259100407,  Lazzaro80, 1, 1, 0, yes
50587629,  concettabonini, 1, 1, 0, yes
285746545,  christianrouges, 1, 1, 0, yes
3248762417,  6f053f1a05ed448, 1, 1, 0, yes
792100549,  SilvANA_Iv, 1, 1, 0, yes
3357341475,  MatthewOldman9, 1, 1, 0, yes
801580745290551296,  LucaScarcia21, 1, 1, 0, yes
354949679,  frgonzalomeza, 1, 1, 0, yes
547085960,  yjiumy, 1, 1, 0, yes
543062643,  AlHortis, 2, 1, 1, neutral
2865838163,  RacheleZuena, 1, 1, 0, yes
1002410604,  bobo6909, 1, 1, 0, yes
244078315,  federicodeejay, 1, 1, 0, yes
4829498067,  Barbara72512491, 1, 1, 0, yes
381524196,  dianasanti78, 1, 1, 0, yes
60398437,  domeniconaso, 1, 1, 0, yes
236352428,  checcomonty, 2, 2, 0, yes
2950362430,  RosanaMantovan2, 1, 1, 0, yes
249240171,  tcochran_mayors, 2, 2, 0, yes
125371018,  alix61, 1, 1, 0, yes
2461152059,  Marco_Lundgren, 1, 1, 0, yes
755942526,  GiovanniLuiso, 1, 1, 0, yes
718337999474401280,  DestoRibelle, 39, 39, 0, yes
4865184580,  CharliChriss, 1, 1, 0, yes
3026781512,  ziopirro, 1, 1, 0, yes
759708394122977280,  domenico_luise, 1, 1, 0, yes
2355023489,  eniiolucherini, 5, 3, 2, yes
4914304701,  virgilioatzori1, 2, 2, 0, yes
371724923,  MicaelRosano, 1, 1, 0, yes
200985380,  rocustro, 1, 1, 0, yes
383739575,  FiloPucci, 1, 1, 0, yes
1622246916,  ElenaPanazzolo, 1, 1, 0, yes
2757933645,  monica_marchini, 1, 1, 0, yes
711544834499223552,  luisa_biglia, 1, 1, 0, yes
29299066,  twitteva, 1, 1, 0, yes
803557366662893568,  ghimauri64, 2, 2, 0, yes
706941798128680960,  MauroLong_osteo, 1, 1, 0, yes
2736297508,  Alespy85, 2, 2, 0, yes
155032032,  aliceluce, 1, 1, 0, yes
2236533337,  gibluvi, 1, 1, 0, yes
328407779,  AndreaRepek, 1, 1, 0, yes
1262242734,  scpdnc, 1, 1, 0, yes
2962851203,  BarbarellaYr, 1, 1, 0, yes
780254767,  Tatiana_Longo, 1, 1, 0, yes
450457312,  paolo_ravelli, 1, 1, 0, yes
1168659224,  FataritaRita, 1, 1, 0, yes
2388953123,  rsodano56, 1, 1, 0, yes
1420960070,  berngiacomazzo, 1, 1, 0, yes
784379773,  caterinaquerci, 1, 1, 0, yes
513561660,  Gabriy04, 1, 1, 0, yes
273095539,  LauCastelletti, 4, 3, 1, yes
294048506,  MagriDen, 1, 1, 0, yes
2347398695,  ACmcoppola, 1, 1, 0, yes
3217420637,  BroshkaRonaldo, 1, 1, 0, yes
370243466,  andrewamonti, 1, 1, 0, yes
238696316,  RealO530Fn94, 1, 1, 0, yes
14531672,  vincenzo_ampolo, 1, 1, 0, yes
1598022716,  magero5, 1, 1, 0, yes
3982848198,  mo_riarty, 1, 1, 0, yes
2866875900,  campanella93, 1, 1, 0, yes
266120929,  chanudaro, 1, 1, 0, yes
280010874,  nicola_basso, 2, 2, 0, yes
629680392,  AngeloValentina, 2, 1, 1, neutral
921109596,  FantozziPrimo, 1, 1, 0, yes
96527008,  Ahasvero, 1, 1, 0, yes
723495512,  marcpalaver, 1, 1, 0, yes
738070283819581440,  EgidioGioia5, 2, 2, 0, yes
437734783,  laviniaefarnese, 1, 1, 0, yes
1219349184,  bartlollo, 1, 1, 0, yes
1192730816,  a_ricchiuti, 1, 1, 0, yes
2492776739,  giorgiobruzze, 1, 1, 0, yes
790999460495159297,  _Garbo_, 1, 1, 0, yes
1316622386,  RickyCavo, 1, 1, 0, yes
2971110503,  furlo02, 2, 2, 0, yes
462371225,  AF_NCC, 4, 4, 0, yes
1904922540,  salvapersico, 1, 1, 0, yes
125777851,  piripipiu, 1, 1, 0, yes
770253758630592512,  palnina64, 2, 2, 0, yes
781752355351953408,  gabusigusi, 1, 1, 0, yes
508781270,  pobreloba, 1, 1, 0, yes
489300960,  AlessandroBari1, 1, 1, 0, yes
785124249707089920,  Paolocarboncini, 2, 2, 0, yes
783753179095789568,  Paolo76049880, 1, 1, 0, yes
703299786720591872,  crescentinbosco, 1, 1, 0, yes
2190513360,  ohanabiba, 1, 1, 0, yes
590675894,  AlbericoEmi, 3, 2, 1, yes
298646026,  Lghiglio, 1, 1, 0, yes
8629982,  donnaeffe, 1, 1, 0, yes
4019880208,  Lerch_80, 2, 2, 0, yes
376210328,  AntonioDePoli, 1, 1, 0, yes
1642443505,  Estcheema, 9, 1, 8, no
803211879560736768,  plebeo78, 2, 2, 0, yes
997130850,  _quindle, 1, 1, 0, yes
389936644,  samverof, 13, 13, 0, yes
460914555,  Dalerba, 1, 1, 0, yes
1126107828,  eleofab, 1, 1, 0, yes
986157067,  fiammettaperito, 1, 1, 0, yes
729372507392847873,  cassandra_s7, 4, 4, 0, yes
1353703069,  vit0940, 2, 2, 0, yes
2222011724,  robertateano, 3, 3, 0, yes
2287988903,  inpopularia, 1, 1, 0, yes
1275400561,  antoniomilella1, 1, 1, 0, yes
378304814,  stefano88dude, 1, 1, 0, yes
591029852,  GIACCOGI, 1, 1, 0, yes
359638420,  hamidasa, 2, 2, 0, yes
2799854505,  franc_michelini, 1, 1, 0, yes
723168418120249344,  Davide14305443, 2, 2, 0, yes
2277608809,  rosso_fabrizio, 1, 1, 0, yes
510750553,  ste6ste, 1, 1, 0, yes
318577930,  indignindigente, 1, 1, 0, yes
84444968,  Vespiria, 1, 1, 0, yes
3175730218,  yogabunny14, 1, 1, 0, yes
1332000314,  Francesca_JBS, 1, 1, 0, yes
712547794746269696,  serino_paolo, 1, 1, 0, yes
1448722532,  vicky_ninav, 1, 1, 0, yes
311925651,  Erosunique, 1, 1, 0, yes
589243077,  gianpietrosery, 1, 1, 0, yes
745990974673924096,  SalGal1899, 1, 1, 0, yes
1546374314,  paolo_airoldi, 1, 1, 0, yes
1299201158,  francy_wonder, 1, 1, 0, yes
72702510,  punk_hearts, 1, 1, 0, yes
49639363,  earlgrillo, 1, 1, 0, yes
1585138993,  LineDaidouji, 1, 1, 0, yes
566841192,  NicoDurante22, 3, 2, 1, yes
2849205912,  Mendict95, 1, 1, 0, yes
1691564629,  TheBest_Chrono, 1, 1, 0, yes
405622641,  kyjpino, 1, 1, 0, yes
435106407,  michelelaviola, 1, 1, 0, yes
1047012938,  Vale_287, 1, 1, 0, yes
2420586676,  gambett1, 3, 3, 0, yes
503304697,  masolosilvia, 2, 1, 1, neutral
778952595062874112,  F_FCalandrino, 2, 1, 1, neutral
976618278,  FrenkyFox87, 3, 3, 0, yes
1700834768,  IsolaTina83, 1, 1, 0, yes
141331080,  maurofaina, 1, 1, 0, yes
4794560983,  annacuordileone, 1, 1, 0, yes
262194160,  micioalato, 10, 5, 5, neutral
1443295188,  _torredelgreco_, 1, 1, 0, yes
3043464539,  marchisio_mauro, 1, 1, 0, yes
782171272709021696,  Filippo30774083, 2, 2, 0, yes
475784411,  Ziba58, 1, 1, 0, yes
2678632959,  scarsafa, 1, 1, 0, yes
18863361,  contribuenti, 1, 1, 0, yes
228325926,  MauroCossoine, 1, 1, 0, yes
819138062,  VShuaib, 1, 1, 0, yes
188336872,  Taschigno, 1, 1, 0, yes
2999587893,  WilliamDaniele2, 1, 1, 0, yes
155743839,  Nicola_Origgi, 1, 1, 0, yes
104434811,  Hugues_di_Payns, 1, 1, 0, yes
1085665506,  fabio_lisio, 1, 1, 0, yes
723198319,  aka_Gb, 3, 2, 1, yes
3010276522,  a3ffd293e6c1432, 2, 2, 0, yes
1213596138,  ErsilioL, 4, 1, 3, no
54887680,  bru_16, 1, 1, 0, yes
803259004046704641,  ikiedodo, 1, 1, 0, yes
516753630,  208rita, 1, 1, 0, yes
2485514081,  luuluu_6, 2, 2, 0, yes
759003465808883712,  francol96305026, 1, 1, 0, yes
782861338066427904,  buchot74, 1, 1, 0, yes
877371211,  pprati60, 1, 1, 0, yes
383982534,  er_canaro, 3, 3, 0, yes
794578599445745664,  glanico5, 1, 1, 0, yes
2428565909,  cosdemed, 4, 4, 0, yes
987269881,  MaurizioTura, 1, 1, 0, yes
796442124145176576,  OrtoLaura, 2, 2, 0, yes
2867129248,  31c1c554bc7e4a7, 1, 1, 0, yes
1267294986,  TheArtOfNature_, 2, 2, 0, yes
712224248916480000,  claudio7883, 1, 1, 0, yes
2941216983,  Ferracci1953, 1, 1, 0, yes
737342436792532992,  sermeppo, 1, 1, 0, yes
476769374,  RobertoDiTolve, 1, 1, 0, yes
1153555688,  massimogianner1, 2, 1, 1, neutral
337568280,  fippone13, 1, 1, 0, yes
781216231298895873,  roberto07487724, 1, 1, 0, yes
835690429,  anna_percio, 1, 1, 0, yes
2437249428,  Niessen93, 1, 1, 0, yes
2361641823,  cinzias74, 2, 2, 0, yes
729440748110811137,  grupoflas, 2, 2, 0, yes
434313121,  Stewvart, 1, 1, 0, yes
1357694676,  GPizzoleo, 2, 2, 0, yes
2176449613,  Omninapoli, 4, 4, 0, yes
757352340756295684,  gigio1954, 1, 1, 0, yes
268484630,  gigday, 1, 1, 0, yes
1618658132,  Catia28574653, 1, 1, 0, yes
44093281,  ba1963, 1, 1, 0, yes
1556587082,  rtavarescosta, 1, 1, 0, yes
2696032865,  manganellibibin, 1, 1, 0, yes
1058085139,  GiulioMarcon1, 1, 1, 0, yes
2444111659,  caterinaberardi, 1, 1, 0, yes
2797990562,  LUIPOLICASTRO1, 1, 1, 0, yes
1288970058,  irenegaviano2, 1, 1, 0, yes
757119384691339264,  patrizia181261, 1, 1, 0, yes
86273901,  panatriello, 1, 1, 0, yes
620859402,  IvanDellaValle, 2, 1, 1, neutral
803519455359864832,  juventinodoc0, 2, 2, 0, yes
1230117870,  FedSanita, 2, 2, 0, yes
2164423599,  rizziantonio51, 2, 2, 0, yes
718469675248717825,  fl3m1, 1, 1, 0, yes
50805256,  AeonFlux71, 1, 1, 0, yes
3248803846,  gt_romeuf, 1, 1, 0, yes
737353823849730048,  giusedelga98, 1, 1, 0, yes
791339969667293186,  BigDon00, 1, 1, 0, yes
232861411,  coludino, 1, 1, 0, yes
3982361956,  italonews, 1, 1, 0, yes
3375293169,  lamorteneuro, 2, 2, 0, yes
791150419007406080,  LacagninaPeppe, 2, 1, 1, neutral
454146916,  itekne_ferrari, 1, 1, 0, yes
799900638410895360,  ilove_firenze, 1, 1, 0, yes
417347952,  gmalloro, 1, 1, 0, yes
436089529,  MauroCrapa, 1, 1, 0, yes
802885932202475520,  RobertoFulgini, 1, 1, 0, yes
156291706,  Rebeccapalagi, 1, 1, 0, yes
492136849,  fedetant63, 1, 1, 0, yes
81572849,  piac82, 2, 2, 0, yes
2824541683,  tome_katia, 1, 1, 0, yes
427433906,  JamesSalKirk, 1, 1, 0, yes
4915748854,  pasgiova, 1, 1, 0, yes
819170695,  rovetta_diego, 1, 1, 0, yes
484228520,  FrancescaDiLuca, 2, 1, 1, neutral
789081376150683648,  DellafioreG, 1, 1, 0, yes
96344993,  giovibruno, 2, 2, 0, yes
2453325796,  82mpagani, 1, 1, 0, yes
72381260,  fantalex, 5, 2, 3, no
348313617,  CorradoPani, 3, 2, 1, yes
1850953207,  Koukun_Pol, 2, 2, 0, yes
1425509702,  maxberry9, 2, 2, 0, yes
565627980,  LUISICUSERRA, 1, 1, 0, yes
1007166056,  marioleonardi6, 1, 1, 0, yes
92062981,  Lucavika, 2, 1, 1, neutral
554529672,  MarioGranozio1, 1, 1, 0, yes
87398011,  CarloTollini, 2, 2, 0, yes
727045398901186560,  NowViz, 5, 4, 1, yes
930324210,  sandrabargellin, 2, 1, 1, neutral
1319113675,  SBussetti, 1, 1, 0, yes
1196181998,  tripleange, 2, 2, 0, yes
169935992,  misschiariss, 2, 1, 1, neutral
1551103609,  Lakremetta, 3, 3, 0, yes
42833853,  cesaregioconews, 2, 1, 1, neutral
778257033023946752,  mimmozen1, 2, 2, 0, yes
1355243869,  Underground1011, 1, 1, 0, yes
736130960736067584,  alessia281084, 2, 2, 0, yes
405832858,  umbertofava65, 5, 3, 2, yes
3207791139,  mghilard50, 2, 2, 0, yes
1156640863,  MGiuliaSerazzi, 1, 1, 0, yes
2321400882,  stegiova58, 1, 1, 0, yes
714514480785408001,  Pasqualesurace2, 2, 2, 0, yes
192610923,  FrederickRolfe, 1, 1, 0, yes
96304737,  Grazia_To, 1, 1, 0, yes
82864742,  carlobiasia, 1, 1, 0, yes
409130756,  lorenzobandera, 5, 5, 0, yes
920612912,  santarelli_gab, 1, 1, 0, yes
3317247983,  VelvetVinz, 2, 1, 1, neutral
1956114378,  FrancescChirico, 3, 1, 2, no
3426491,  clagher, 5, 5, 0, yes
456874284,  DaniloRestagno, 1, 1, 0, yes
2999809657,  v_milanese, 1, 1, 0, yes
632730713,  e_gramaglia, 1, 1, 0, yes
735551927392567297,  p_Myskyn, 6, 0, 6, no
349749435,  luigidecristofa, 4, 0, 4, no
95647096,  Gianluca_73, 3, 1, 2, no
374069207,  jokerGianlu, 1, 0, 1, no
2392648392,  antopillosio, 1, 0, 1, no
749991934165385217,  ElisaPistolesi1, 11, 0, 11, no
2409766709,  NardinDaniela, 4, 3, 1, yes
721281920747839488,  CarCarlomcc, 4, 1, 3, no
482228231,  BrunoRedditi, 2, 0, 2, no
2534314678,  depalmavito, 6, 0, 6, no
1327139821,  IdamiladyG, 1, 0, 1, no
612576300,  fornarilorenzo, 2, 0, 2, no
2212866474,  salvogambi, 1, 0, 1, no
4414252179,  FIgiovani_Bas, 3, 1, 2, no
1140366230,  frau_simonetta, 1, 0, 1, no
726852195501629440,  silvia_pispico, 2, 0, 2, no
300178715,  BaggioCarlo, 2, 1, 1, neutral
797923040692535300,  No89582127, 5, 1, 4, no
1263967111,  belgi11, 1, 0, 1, no
447352763,  ASciullo, 4, 1, 3, no
775959412087193600,  RosarioFrancese, 4, 0, 4, no
565252532,  SindacoCampagna, 1, 0, 1, no
946012470,  RufoloTeresa, 1, 0, 1, no
447231795,  deboraDDI, 5, 1, 4, no
2314042430,  giosparver, 4, 1, 3, no
44847572,  facc8, 1, 1, 0, yes
4197302427,  BarboniGennaro, 5, 5, 0, yes
2659556391,  gianni_ercole, 1, 1, 0, yes
2393147574,  FraTrani, 1, 1, 0, yes
2238143360,  evaruggini, 1, 1, 0, yes
506113159,  ZioDal, 5, 3, 2, yes
249762131,  NinniTer, 6, 3, 3, neutral
55038103,  rubiku, 3, 1, 2, no
177087045,  sebarizzardi, 7, 7, 0, yes
392640024,  AlessandroSemen, 1, 1, 0, yes
48667774,  robertorotondo, 2, 1, 1, neutral
1295326790,  morevalenti, 1, 1, 0, yes
289427111,  pgmalusardi, 2, 1, 1, neutral
182973078,  ancas64, 2, 2, 0, yes
1146253243,  BioMedMax, 5, 2, 3, no
1055565486,  rosannagrossi, 1, 1, 0, yes
510451452,  GiannaIfioriblu, 2, 2, 0, yes
187491410,  AntiCosimo, 1, 1, 0, yes
148130804,  dudes80, 1, 1, 0, yes
1260582402,  Sira29Sira, 3, 3, 0, yes
452858854,  OmbrettaBuzzi, 32, 1, 31, no
2460156165,  Vitullo6Donato, 2, 2, 0, yes
48465226,  WFWPEurope, 1, 1, 0, yes
405433687,  ZambonEM, 1, 1, 0, yes
119178709,  francopercolla, 6, 1, 5, no
1707513894,  CINOdaFIRENZE, 9, 3, 6, no
81136165,  ilarioq, 2, 2, 0, yes
25307802,  G_DeMarchis, 4, 3, 1, yes
1228034468,  giocontarello, 1, 1, 0, yes
496201411,  GuerraCosimo, 1, 1, 0, yes
2425543798,  MatteazziPaolo, 1, 1, 0, yes
463591267,  namarte15, 11, 3, 8, no
1910925626,  biancolone, 1, 1, 0, yes
714837025153744896,  EpilessiaVeneto, 3, 3, 0, yes
840416504,  JerryDrake02, 1, 1, 0, yes
704259717833613313,  bisobad62, 1, 1, 0, yes
260626836,  UgoMancioli, 73, 69, 4, yes
975335252,  TheGiops, 1, 1, 0, yes
418983027,  marcocorazzesi, 3, 2, 1, yes
44178283,  CarloCummaudo, 7, 4, 3, yes
132227549,  lucianoavogadri, 1, 1, 0, yes
2851580481,  nick100_once, 2, 2, 0, yes
2313949123,  giodoglio, 4, 2, 2, neutral
786647301884375044,  rivajuls, 1, 1, 0, yes
2599783248,  marcoagostini16, 1, 1, 0, yes
436573340,  LisaFrattino, 1, 1, 0, yes
514806426,  ianoantoci1, 2, 1, 1, neutral
786144533050494976,  ghayate1963, 1, 1, 0, yes
798968270527332354,  rosso_fraia, 2, 2, 0, yes
728712127,  delfino1954, 1, 1, 0, yes
2621271975,  1950GENTILE, 1, 1, 0, yes
1432540592,  GiulioMorera, 1, 1, 0, yes
238105558,  solarplexus75, 5, 1, 4, no
1474536614,  RubertoFrances, 6, 1, 5, no
1012990321,  angelosavoia1, 1, 1, 0, yes
403684823,  MarinoTodesco, 12, 1, 11, no
613856938,  ReWiGoMlnistry, 2, 1, 1, neutral
473509127,  NlcolasDelao, 2, 1, 1, neutral
982162434,  FlaviaVirilli, 1, 1, 0, yes
551366466,  cesarinoBomba, 1, 1, 0, yes
432640046,  robip51, 4, 2, 2, neutral
2222960542,  Nico_Leo78, 5, 3, 2, yes
847325940,  guillermoesnal, 14, 8, 6, yes
2490640097,  Vulcanelios, 5, 5, 0, yes
359933447,  w_rizzetto, 1, 1, 0, yes
406366657,  titticri, 9, 1, 8, no
272382855,  Brigaden5s, 42, 2, 40, no
869332554,  ppesale, 3, 2, 1, yes
1265375377,  TinaRengo, 6, 1, 5, no
4902200932,  Ricky83pa, 11, 0, 11, no
2288512031,  MCustro, 9, 3, 6, no
501095818,  GiovanniBFucini, 4, 0, 4, no
801473324744376320,  garz66, 2, 0, 2, no
1903397372,  forzaitaliaud, 5, 0, 5, no
798768212598931458,  ozzi_ali, 2, 1, 1, neutral
493318360,  370849, 8, 0, 8, no
1068878065,  graffa83, 7, 2, 5, no
3389194037,  rivcristiana, 36, 0, 36, no
165500493,  Vipper_it, 2, 2, 0, yes
1045846418,  palmucciroby, 1, 1, 0, yes
3239351711,  chiara1022, 4, 4, 0, yes
2207712781,  DanyData, 1, 1, 0, yes
2186400145,  RosannaToma, 1, 1, 0, yes
4687054969,  brunomar60, 1, 1, 0, yes
785257393668042752,  BatMan29335606, 3, 3, 0, yes
995799343,  TrottolinPeloso, 2, 2, 0, yes
2673334859,  massimolelli72, 2, 1, 1, neutral
330459823,  GiuseppeVacca82, 3, 3, 0, yes
70201562,  umby51, 2, 1, 1, neutral
418013478,  Francy_25, 2, 2, 0, yes
4764734509,  tiazfreestyle12, 1, 1, 0, yes
2432643371,  DebbyTulipano, 2, 2, 0, yes
297946868,  mimmilove_, 1, 1, 0, yes
192113061,  Robbino73, 6, 6, 0, yes
3367448397,  jddeus95, 1, 1, 0, yes
4084319219,  maryyy1393, 1, 1, 0, yes
400795945,  vincentino63, 2, 1, 1, neutral
3408879825,  FLuccon, 1, 1, 0, yes
3404426943,  Ryky8358, 1, 1, 0, yes
393392832,  Dondolino72, 4, 1, 3, no
3068312621,  MAXI_titano, 2, 2, 0, yes
596266065,  mauriziosgh, 2, 2, 0, yes
1381217636,  Ludovyco44, 1, 1, 0, yes
2242019356,  MarcoMarcotimex, 12, 1, 11, no
1296656894,  globaltavor, 1, 1, 0, yes
426053339,  fabiochiarugi, 1, 1, 0, yes
527340467,  stefypregno, 1, 1, 0, yes
2961226822,  lumontag, 1, 1, 0, yes
372781661,  robyghila, 1, 1, 0, yes
292872995,  matteocaldo, 1, 1, 0, yes
433989119,  naladiana, 2, 2, 0, yes
3109698387,  a0479f636775423, 7, 7, 0, yes
1035593826,  liaglamour, 2, 2, 0, yes
417833029,  ADELAIDECONTI, 1, 1, 0, yes
1048295388,  EnzoSalviFansCl, 15, 15, 0, yes
535562023,  mauriziocarta4, 3, 3, 0, yes
499910304,  Peppe_Longo, 1, 1, 0, yes
2938454181,  GenFarina, 2, 2, 0, yes
768014298,  85giampiero, 3, 1, 2, no
2787493962,  lacanaccia, 1, 1, 0, yes
2364670551,  Claudionettuno, 3, 2, 1, yes
2568749263,  FasolinoSalvo, 1, 1, 0, yes
240266199,  fiorenzobike, 3, 3, 0, yes
557744071,  stefyloveb, 2, 2, 0, yes
2212054621,  affittiannuali, 1, 1, 0, yes
411614013,  BandiniClaudio, 5, 3, 2, yes
439306204,  LallaRegenbogen, 1, 1, 0, yes
2950813474,  c_prince_77, 1, 1, 0, yes
794724626,  AntonioMorabit0, 1, 1, 0, yes
360707882,  achos86, 1, 1, 0, yes
984760590,  lazzareschibrun, 2, 2, 0, yes
2589240495,  lia_meloni, 1, 1, 0, yes
4098014589,  GabriellaPirone, 3, 3, 0, yes
448121493,  BTatangelina, 2, 2, 0, yes
757875200050470912,  ladyoscarmuk, 8, 4, 4, neutral
3119868942,  brunogab73, 7, 1, 6, no
2280675841,  simo_l3, 1, 1, 0, yes
3320939031,  JandMilano, 1, 1, 0, yes
1033370034,  Annalisa7873, 1, 1, 0, yes
3244671317,  superfrancob, 1, 1, 0, yes
94523416,  ideaCinema, 3, 3, 0, yes
472893871,  ernestoluciani, 11, 5, 6, no
803747368390848512,  Moonmadness12, 6, 1, 5, no
1163827453,  monyTigra, 1, 1, 0, yes
4353573375,  Luchino13821583, 1, 1, 0, yes
757870675482800128,  AryAsroma1927, 5, 4, 1, yes
2881504282,  TimeRemmus, 2, 2, 0, yes
632811560,  Eliana_Mento, 1, 1, 0, yes
556894842,  SipontaS, 1, 1, 0, yes
99753069,  Eclissix, 2, 2, 0, yes
3241115409,  saverio_va, 6, 1, 5, no
410107394,  CoolTore, 1, 1, 0, yes
3373946223,  Hanto89Hantony, 1, 1, 0, yes
3604001897,  it_giuliana, 1, 1, 0, yes
556946532,  Ma29Ma7, 4, 4, 0, yes
428231271,  Fiorellina83, 1, 1, 0, yes
796097572167417856,  gianfrarock, 2, 1, 1, neutral
1037651766,  anna_annalu, 8, 3, 5, no
4696957188,  Cristin97215062, 1, 1, 0, yes
45519126,  Sambuca85, 1, 1, 0, yes
965897887,  FedericoCaland4, 1, 1, 0, yes
490139250,  EddaMurgo, 1, 1, 0, yes
4129718181,  fannyevakant, 3, 3, 0, yes
2417353110,  Massimo72867, 2, 1, 1, neutral
470030560,  marikasantaross, 2, 2, 0, yes
3071820420,  alebeef2, 1, 1, 0, yes
760254962966364160,  tito707110651, 5, 2, 3, no
375600955,  ziaaby, 1, 1, 0, yes
476303634,  gastone72, 1, 1, 0, yes
3042240317,  RosaRugna, 1, 1, 0, yes
358015849,  gabribinot_77, 1, 1, 0, yes
3226612972,  giostina6264, 4, 3, 1, yes
2333732932,  AndreaRicciar12, 1, 1, 0, yes
277446800,  simondritt, 2, 2, 0, yes
785250620483731456,  Nicolo44747601, 1, 1, 0, yes
3927720435,  AntonioGuiccia, 4, 2, 2, neutral
81350058,  Marco3372, 4, 4, 0, yes
710033402074959872,  Selene520497211, 1, 1, 0, yes
797322522,  Dalea74, 1, 1, 0, yes
1317829602,  FabrizioS5, 3, 3, 0, yes
291290398,  ilgianky2, 1, 1, 0, yes
107019869,  Keanu_Kian, 3, 2, 1, yes
703292189913251841,  MgvGrazia, 2, 2, 0, yes
390297468,  giustigiovi, 3, 1, 2, no
409175847,  cheamarena, 3, 3, 0, yes
140724864,  FabrizioFattori, 1, 1, 0, yes
400622438,  S_CheSpettacolo, 1, 1, 0, yes
244886806,  silvertongue77, 1, 1, 0, yes
605858121,  fraganofra, 1, 1, 0, yes
2250936137,  gfvlxx, 7, 1, 6, no
398220499,  iz2wya, 1, 1, 0, yes
2866618995,  amoroso_nello, 1, 1, 0, yes
2236456577,  GraziellaVespa, 1, 1, 0, yes
780503676666413056,  alejex91, 1, 1, 0, yes
2258170901,  Onlyproblemj, 1, 1, 0, yes
740965050836455424,  Crisantemo12345, 4, 1, 3, no
736503991467708417,  amedeonapoli65, 1, 1, 0, yes
2459519979,  GiorgettiDavide, 1, 1, 0, yes
3299837380,  bepyliso, 2, 2, 0, yes
151241578,  Giorgiocard1, 1, 1, 0, yes
631825093,  triskeleAP, 1, 1, 0, yes
500655993,  yari_lisa, 1, 1, 0, yes
1868117000,  giascia348, 1, 1, 0, yes
1934154674,  medusa_film, 3, 3, 0, yes
1687760882,  driverdriver71, 1, 1, 0, yes
1318670960,  fiorealieno, 14, 2, 12, no
82902889,  Dudu2507, 25, 3, 22, no
524809983,  ienapriski, 28, 4, 24, no
562023808,  fabiomisha, 5, 0, 5, no
230453692,  mobertos, 32, 14, 18, no
4090432522,  cerlibre, 2, 1, 1, neutral
183556691,  eSseTiGiA, 2, 0, 2, no
513213473,  GattiAldo, 1, 0, 1, no
701747343339741184,  linuxian_5s, 15, 0, 15, no
4527310402,  ChetriL, 5, 0, 5, no
234868966,  chesko76, 6, 1, 5, no
167014241,  bolartur, 14, 0, 14, no
242392452,  amorbide77, 10, 0, 10, no
533332467,  gabriel7022, 28, 1, 27, no
1171904442,  lucapuc62, 3, 0, 3, no
944558094,  aeroforceso, 2, 1, 1, neutral
1026484628,  VincenzoCanon, 4, 1, 3, no
3032272127,  GiannarelliM5S, 26, 0, 26, no
742455271,  MedaEmanuele, 14, 1, 13, no
240389640,  thor3u, 2, 0, 2, no
947223368,  CrifCrifasi, 1, 0, 1, no
203717084,  probo8, 14, 0, 14, no
557477939,  NCaianiello, 2, 1, 1, neutral
2751782307,  AvvocatoLorenti, 4, 0, 4, no
531746865,  AlessandGr, 3, 0, 3, no
930237486,  vanessacombttll, 1, 0, 1, no
464536669,  stefanocolombi3, 10, 0, 10, no
1113910442,  LinaGalLina, 3, 0, 3, no
906224444,  09Zouzou, 40, 1, 39, no
4353226283,  Annamar14426970, 1, 0, 1, no
2465437060,  gelosiale, 4, 1, 3, no
803591105413545984,  aloia2_antonio, 6, 2, 4, no
4008843159,  roberto_pella, 7, 0, 7, no
128609313,  agambella, 2, 1, 1, neutral
136561250,  CinziaPitru, 7, 3, 4, no
738626681418579968,  renataburl1, 3, 0, 3, no
2984271976,  paolamaranelli, 2, 0, 2, no
2973687160,  ErDitoArCulo, 4, 2, 2, neutral
451607723,  AlessioTres, 1, 0, 1, no
480215189,  MilaByNight, 1, 0, 1, no
3401298100,  claudigili1965, 1, 0, 1, no
1160507178,  Astra_x_Aspera, 19, 3, 16, no
579662557,  ennioidea, 5, 3, 2, yes
168605766,  Marco_Giacomini, 1, 0, 1, no
20336368,  mikimod, 2, 0, 2, no
2225287925,  massimpp60, 1, 0, 1, no
250336400,  Frankmazzo90, 2, 0, 2, no
87048339,  markbezdicek, 3, 0, 3, no
374006406,  sarahmarty78, 2, 0, 2, no
2359281943,  TatyLorenzini, 10, 0, 10, no
268910347,  emanuelapatti, 15, 0, 15, no
3321167483,  DaniBanx198244, 2, 1, 1, neutral
587677613,  Giorgio1951, 3, 0, 3, no
259778195,  ski12665, 4, 0, 4, no
3223932303,  socec_jasnica, 41, 0, 41, no
574117698,  leoaifon, 3, 0, 3, no
47252494,  MarioBubu, 6, 2, 4, no
2341257671,  MaraZicky, 4, 2, 2, neutral
526606808,  stelladiterra, 10, 0, 10, no
2307296066,  suzettepetillo, 4, 0, 4, no
887379080,  raffaelejosesti, 1, 0, 1, no
203915389,  cla_cominardi, 4, 0, 4, no
1679376193,  __Nemesi_, 12, 2, 10, no
774525301175029760,  abelebogarellim, 4, 1, 3, no
714891080349704193,  Angelo853480981, 1, 0, 1, no
2323711273,  claudio96875335, 3, 0, 3, no
277460126,  Chiara_DiBe, 3, 0, 3, no
2318230960,  F_Abeja82, 2, 0, 2, no
194706083,  GabrieleCelso, 3, 0, 3, no
2615032505,  FhdmMax, 2, 0, 2, no
2721968416,  nu_vola, 4, 0, 4, no
199413728,  ubbi57, 3, 1, 2, no
2416137887,  bozz_ferrari, 3, 2, 1, yes
193663495,  GiovyCadeddu, 1, 0, 1, no
84274436,  Bul_Von_klark, 4, 0, 4, no
79003916,  Valeriopetrucci, 1, 0, 1, no
777777871,  DipRoss, 11, 2, 9, no
2278659026,  iphoneapple6S, 3, 0, 3, no
605614784,  ElioLannutti, 27, 7, 20, no
238781806,  weddelll, 7, 1, 6, no
4857911091,  mariannade47, 5, 0, 5, no
1229398160,  Curti8Curti, 3, 0, 3, no
390978069,  MaxPinelli, 3, 0, 3, no
2450692721,  triamilton, 6, 2, 4, no
535860015,  MrTonics, 2, 1, 1, neutral
1490741580,  PAmbruosi, 3, 0, 3, no
2389335829,  tru3dom, 2, 0, 2, no
555323868,  scampoli3, 6, 2, 4, no
1038389942,  Rase81, 3, 0, 3, no
432948268,  fede_corsi, 2, 0, 2, no
1070320532,  cit58, 11, 1, 10, no
342308195,  mara_cogoni, 8, 3, 5, no
418683219,  SemioLogico, 5, 0, 5, no
264300089,  annamariavasile, 13, 0, 13, no
540455433,  AlmaGiusyRosa, 1, 0, 1, no
737734557777178624,  DeerEwan, 12, 0, 12, no
4927630252,  biagiodalponte, 9, 6, 3, yes
1065242010,  BernabeiPiero, 1, 0, 1, no
301476756,  MarcoBrasili, 4, 2, 2, neutral
446122798,  kavitina, 14, 1, 13, no
2970333513,  melcinzia, 8, 1, 7, no
39975495,  popolinotwits, 53, 1, 52, no
450089689,  SimonPazienza, 1, 1, 0, yes
708653772030001152,  Giuseppe_alari, 1, 1, 0, yes
570144271,  luci560, 11, 2, 9, no
805815682491416577,  newferruccio, 2, 1, 1, neutral
65939345,  sonostorie, 6, 2, 4, no
581167908,  MACMURA77, 3, 1, 2, no
1857003602,  PierluigiDesina, 3, 2, 1, yes
1262138317,  SusyBelm, 16, 2, 14, no
2508409940,  PValefiore1983, 2, 1, 1, neutral
35181867,  luigicristaldi, 4, 1, 3, no
3131360284,  SolutionCenterP, 3, 1, 2, no
3081057804,  3c2314ce1af64ce, 3, 1, 2, no
331769401,  luciano_manna, 3, 2, 1, yes
174237217,  DamianoBrattoli, 4, 0, 4, no
792734918552018944,  Antonio38506681, 3, 0, 3, no
2365416492,  fberrys, 2, 0, 2, no
747492094881726464,  ugl_saaf, 4, 0, 4, no
508825719,  fabiopise1, 2, 0, 2, no
919864976,  MariPeppeKa, 3, 0, 3, no
1602804482,  liuk71rm, 15, 0, 15, no
12679502,  MarcoFanteg, 2, 0, 2, no
1163339742,  FrancoBianc, 12, 2, 10, no
3349890172,  AmorinoMario, 9, 9, 0, yes
395556267,  PGragnano, 2, 1, 1, neutral
404892841,  PasqualeMotta1, 5, 5, 0, yes
4767533802,  fburlaf, 1, 1, 0, yes
140518657,  corallino72, 1, 1, 0, yes
3295052051,  Antonia_Pozzi, 1, 1, 0, yes
2159086337,  PaoloDominici65, 2, 1, 1, neutral
788680693559783424,  dasvidania193, 1, 1, 0, yes
274694406,  il_democritico, 3, 1, 2, no
142244665,  indypende, 1, 1, 0, yes
793696853451743232,  Casalingitudine, 3, 1, 2, no
255505106,  piergiuseppe2, 7, 6, 1, yes
419094387,  dellandro58, 11, 2, 9, no
479569415,  MelGerbino, 3, 1, 2, no
702989036391112704,  ernesto06492956, 23, 2, 21, no
800959920132780032,  mirianasole1, 5, 2, 3, no
3199220876,  emmpad2, 25, 2, 23, no
2447306083,  VivaSankara, 8, 0, 8, no
713725818548199424,  Flavian17544897, 6, 1, 5, no
869896987,  Claudio59Lecce, 2, 0, 2, no
341954217,  nicola_lucchi, 7, 0, 7, no
528515428,  AAAMARIO, 5, 1, 4, no
1262874817,  Alinax2311, 2, 0, 2, no
54964317,  catetom, 2, 0, 2, no
757833847572574208,  TwittaLibro, 3, 0, 3, no
910601880,  albertigiannaro, 12, 4, 8, no
507570761,  MarcoFaccendi1, 2, 0, 2, no
2327807238,  verafale, 3, 1, 2, no
1220767266,  librella15, 5, 2, 3, no
975443228,  vincenzobifulc3, 5, 2, 3, no
253207225,  fmanca, 3, 0, 3, no
1307817714,  gri_gio_69, 8, 1, 7, no
47593206,  artistasacro, 2, 0, 2, no
700445613842964481,  BrunaGandolfi2, 2, 0, 2, no
2967051688,  ilpiucompleto1, 4, 0, 4, no
85670395,  Alise0, 6, 1, 5, no
1895164603,  NotiziedalM5S, 21, 1, 20, no
2904244365,  the_longo, 2, 0, 2, no
2730634557,  Sam_12345_, 3, 0, 3, no
260912864,  Bruce0770, 3, 0, 3, no
893666054,  iostoconlafiom, 3, 0, 3, no
37768869,  Adrastea_it, 3, 0, 3, no
4830186521,  franziesc, 2, 0, 2, no
2198507410,  VoyagerAlmayer, 2, 0, 2, no
247737545,  Amoreperilbuio, 2, 0, 2, no
1014721082,  onofriorossini, 6, 0, 6, no
52881654,  rsantopietro, 2, 0, 2, no
2986302741,  GloriaFugginani, 3, 0, 3, no
478620962,  MikemixBo, 3, 0, 3, no
461190832,  LuckyMario82, 8, 1, 7, no
446539712,  PaolaMarrone, 2, 1, 1, neutral
733914785780236288,  pinovichingo, 2, 0, 2, no
3377153333,  FrancoConti60, 11, 0, 11, no
419862356,  pananost, 13, 4, 9, no
5427422,  quinta, 7, 6, 1, yes
788474035588005888,  mariapiadic, 9, 9, 0, yes
727840452150464512,  fedecoluccia22, 10, 9, 1, yes
2653454464,  Gino51Gl, 2, 0, 2, no
2181771883,  fkaLaMusa, 3, 0, 3, no
1164081451,  LiceLicetta, 6, 2, 4, no
701849940809662464,  Umberto_Ecco, 4, 1, 3, no
2375430686,  raffaelefus, 2, 0, 2, no
14145846,  flavia_marzano, 31, 3, 28, no
777919508250030080,  Maura_Master, 6, 0, 6, no
2370797451,  angelo_fornaro, 8, 0, 8, no
780089815786283008,  giovann13963232, 57, 5, 52, no
1114905660,  GiuseppePesce3, 2, 0, 2, no
425122600,  Andrea_Manci, 5, 0, 5, no
2767422555,  luca_masoero, 26, 4, 22, no
1257072463,  fraga801, 2, 0, 2, no
81318149,  semplicefabio, 20, 5, 15, no
2253510097,  giuliafederico8, 3, 2, 1, yes
605377369,  DottMilone, 11, 0, 11, no
1372859420,  AntonellaCrima2, 15, 5, 10, no
2324228217,  GrimaniFilippo, 3, 0, 3, no
486077820,  ciemme71, 8, 0, 8, no
738803856906301440,  Valter14032653, 9, 1, 8, no
1555357356,  SpinaTourViaggi, 3, 0, 3, no
984851042,  AnnareColonnese, 5, 1, 4, no
2460943169,  nat201012, 1, 0, 1, no
2938235393,  Sarago85, 8, 0, 8, no
265494725,  vitoperrino, 6, 2, 4, no
568604367,  Pasquorum, 8, 3, 5, no
941761956,  Mitch1978Ar, 6, 0, 6, no
159910237,  Stefaniscion, 2, 0, 2, no
425257616,  calogeromanera, 1, 0, 1, no
1018018543,  CampitelliMarco, 3, 0, 3, no
1154178326,  Alessio_CraSh, 2, 1, 1, neutral
220390146,  lucasolo, 3, 0, 3, no
84582608,  massimo0551, 2, 0, 2, no
525240553,  Bapattis, 8, 3, 5, no
401195931,  flaviosoriga, 1, 1, 0, yes
2603234317,  libertaediritti, 11, 10, 1, yes
2611313426,  ItPrevidenziali, 10, 6, 4, yes
763041762243907586,  Menta_Lime, 1, 1, 0, yes
350399652,  Sabrinab67, 3, 3, 0, yes
2761187477,  ForceGiusy, 1, 1, 0, yes
355400655,  kalos6868, 4, 0, 4, no
1095188802,  Ernesto_Bazan, 7, 3, 4, no
2508454141,  ViterboFra, 5, 0, 5, no
1639844875,  enzopalazzo4, 1, 0, 1, no
1161727848,  brunopisani9, 1, 0, 1, no
316374588,  AndreaBacchio, 4, 0, 4, no
4898877849,  PuntoebastaBas, 1, 0, 1, no
499626957,  AndreaForoni1, 1, 0, 1, no
484122940,  enricosprea, 4, 3, 1, yes
791764138498387968,  ilgrilloparlan2, 3, 1, 2, no
2353012439,  MattiaIervella, 7, 1, 6, no
762727876286410752,  sogncin, 13, 5, 8, no
4437690677,  piero_1959, 1, 0, 1, no
4394191913,  pietro_tassani, 2, 0, 2, no
730931221841256448,  socialtvntw, 14, 2, 12, no
1226139085,  oriettariccetti, 13, 0, 13, no
3298371244,  piccio1968, 2, 0, 2, no
862701492,  osimo5stelle, 5, 0, 5, no
201359673,  Emiliailim3, 2, 1, 1, neutral
270679712,  BourneInTexas, 1, 0, 1, no
318400179,  vitopetrocelli, 5, 0, 5, no
938810556,  roberto__73, 1, 0, 1, no
473072448,  FrancescoLamana, 3, 1, 2, no
204701915,  qiov4nni, 5, 0, 5, no
139345099,  Zenigarda, 1, 0, 1, no
1167315614,  spumettina, 1, 0, 1, no
886499509,  CamilloAuricchi, 8, 0, 8, no
421319874,  BrunoMaggi, 4, 1, 3, no
731343264,  massimo_avv, 2, 0, 2, no
14184504,  latente_flickr, 5, 0, 5, no
471390400,  db_anna, 1, 0, 1, no
1650015702,  RobertaRodelli, 2, 0, 2, no
479440108,  SabbaZion, 6, 0, 6, no
118401565,  fabiogiannetti, 5, 2, 3, no
791726904856416257,  matthewhashstar, 2, 0, 2, no
321463844,  Enrico_Casalino, 4, 1, 3, no
2957360231,  Tess_1966, 3, 2, 1, yes
612374141,  paolamodenaa, 11, 4, 7, no
3032986251,  MariaPetruccel3, 1, 0, 1, no
251732759,  paramorwth, 2, 0, 2, no
204820142,  stormy8530, 1, 0, 1, no
1107334009,  OrioliAlberto, 1, 0, 1, no
764201799217717248,  Ivianti777, 20, 5, 15, no
431976775,  rob_rio, 11, 1, 10, no
72036914,  giuli_vale, 2, 1, 1, neutral
96346472,  carlitosday, 4, 2, 2, neutral
407816941,  Rocco_mitico, 6, 0, 6, no
926261881,  LauraBignami1, 15, 1, 14, no
789699968,  FabioCarrirolo, 34, 34, 0, yes
391243186,  dtumietto, 2, 2, 0, yes
963292848,  menocarta, 3, 3, 0, yes
1591397198,  BaldiDario, 1, 1, 0, yes
527367280,  TheFrank8, 1, 1, 0, yes
283445858,  manuelferrara97, 1, 1, 0, yes
1966543652,  MatteoTabasso, 2, 2, 0, yes
803898061382701056,  am_daniotti, 1, 1, 0, yes
721630993233395712,  taxpolighis, 1, 1, 0, yes
2827286368,  magno_sauro, 2, 2, 0, yes
1345014937,  CuccuIvano, 1, 1, 0, yes
213663506,  GiuseppeGalati, 2, 2, 0, yes
474348821,  VialeCesare, 3, 3, 0, yes
4547911761,  gr_9_ok, 1, 1, 0, yes
1071018919,  StefaniaProfili, 3, 0, 3, no
1042739358,  MatteoZagheno, 5, 0, 5, no
365935751,  ilQuintuplo, 24, 0, 24, no
1111625298,  lucaantonini6, 3, 0, 3, no
1495775148,  miriamberzi, 1, 0, 1, no
191364077,  Fanti1959, 4, 0, 4, no
2321086998,  LucaDelVitto1, 2, 0, 2, no
1331997001,  ReputationAGCY, 5, 0, 5, no
2774524642,  VellaCristiano, 2, 0, 2, no
803286709253341184,  teresagervasio1, 2, 0, 2, no
81315998,  andreacasadeiVE, 1, 0, 1, no
237332532,  c_calvano, 4, 0, 4, no
3323385291,  cbergy69, 3, 1, 2, no
235486421,  oreeglia, 4, 2, 2, neutral
978121892,  RaffoGagliardi, 1, 0, 1, no
1855341199,  44Mallamace, 1, 0, 1, no
241862771,  darlaspesso, 1, 0, 1, no
489577086,  IulianoPino, 1, 0, 1, no
1536506010,  EconomyUp, 2, 1, 1, neutral
2884807616,  maurizio_crippa, 1, 0, 1, no
389115081,  nicolarosetti1, 4, 0, 4, no
97281454,  gmboccanera, 1, 0, 1, no
16824428,  commercialista, 6, 2, 4, no
381430358,  superciuk1, 2, 1, 1, neutral
1610426412,  SCG341, 9, 3, 6, no
1101713905,  mschiavone75, 9, 4, 5, no
581881187,  Firmiamo, 1, 1, 0, yes
2872707029,  FaenzaProject, 2, 2, 0, yes
214090646,  Emmapretti, 2, 1, 1, neutral
121729205,  Federlegno, 13, 13, 0, yes
299543588,  abioplastiche, 10, 10, 0, yes
801458872896679936,  JanusCAI, 1, 1, 0, yes
3325361243,  AssoArpa, 2, 2, 0, yes
4120255757,  FattoriedelSole, 1, 1, 0, yes
77530521,  virgiliofalco, 1, 1, 0, yes
481154512,  minambienteIT, 7, 7, 0, yes
193828240,  annagiunchi, 1, 1, 0, yes
4235856255,  puck0507, 1, 1, 0, yes
1129181246,  LFiumi, 1, 1, 0, yes
4784064395,  EventsCongressi, 1, 1, 0, yes
761218843482157058,  CentristixilSi, 9, 9, 0, yes
538178700,  mary_lyin, 1, 1, 0, yes
179115582,  VaneLeonardi, 1, 1, 0, yes
1037498628,  ClaudiaC111, 2, 2, 0, yes
92639485,  precarispra, 1, 1, 0, yes
1854355219,  sissi_max, 1, 1, 0, yes
1410435572,  FranciCipolloni, 1, 1, 0, yes
3213463427,  ANBI_Nazionale, 1, 1, 0, yes
777697622,  marcofoti3, 1, 1, 0, yes
448210781,  giulon73, 1, 1, 0, yes
99074298,  Fondazione_ANT, 2, 2, 0, yes
3676153480,  CsrMarisa, 2, 2, 0, yes
1933850857,  RepubblicaAF, 3, 3, 0, yes
509344089,  NoTaVxVendetta, 1, 1, 0, yes
1463346570,  francesca_ciak, 1, 1, 0, yes
440749601,  ChelsLllli, 1, 0, 1, no
2985415239,  _giunio_, 5, 1, 4, no
425438518,  LeonorIvorla, 1, 0, 1, no
452666770,  Adam0459, 1, 0, 1, no
2377412736,  SienaconPicchi, 7, 0, 7, no
2380646586,  ArezzoconPicchi, 6, 0, 6, no
2394211062,  EmpoliconPicchi, 8, 0, 8, no
277876200,  smllysportsgirl, 1, 0, 1, no
290495349,  94No_Love, 1, 0, 1, no
433778232,  DandKMenswear22, 1, 0, 1, no
426207687,  OkiahomaTheBand, 1, 0, 1, no
281949979,  bethdt0rre, 1, 0, 1, no
17532492,  Rinascimento65, 6, 1, 5, no
630499526,  VittorioPerazzo, 1, 0, 1, no
283465791,  ItsT0byBear, 1, 0, 1, no
301580701,  __xavi__fernand, 1, 0, 1, no
3303841109,  PistoiaxPicchi, 6, 0, 6, no
477202343,  anicole073, 1, 0, 1, no
282034070,  sldcrawford, 1, 0, 1, no
463311374,  gladlnsam, 2, 0, 2, no
446770906,  BekkahSorens0n, 1, 0, 1, no
474546913,  joboblshere, 1, 0, 1, no
277902589,  PollSciMTSU, 1, 0, 1, no
296894564,  michealvidal074, 1, 0, 1, no
412283744,  Dtre0Short, 1, 0, 1, no
433926099,  KINGDJ951, 1, 0, 1, no
425425345,  futbollssa, 1, 0, 1, no
465864274,  BCMHarlsr, 1, 0, 1, no
81656841,  EnricoVerga, 2, 0, 2, no
40745772,  autolavaggio, 1, 0, 1, no
283468448,  HushQulets, 1, 0, 1, no
464798861,  athletellfesty, 1, 0, 1, no
427919826,  TaYyBo5gS, 1, 0, 1, no
3312025672,  2016Milano, 1, 0, 1, no
2426870389,  AntonioVivoli, 1, 0, 1, no
964091312,  BozzoliGiovanni, 1, 0, 1, no
2377429910,  CampixPicchi, 1, 0, 1, no
823262870,  ForzaItaliaEU, 2, 0, 2, no
2395047265,  FILucca, 1, 0, 1, no
871677924,  FIBruxelles, 1, 0, 1, no
2417204762,  ForzaItaliaQ4, 1, 0, 1, no
2415583820,  ForzaItaliaSen, 1, 0, 1, no
2349873744,  ForzaItaliaEuro, 1, 0, 1, no
2369170723,  ForzaItMondo, 1, 0, 1, no
2386617072,  ForzaFiesole, 1, 0, 1, no
4255982193,  CentrodestraMi, 1, 0, 1, no
1457630209,  FirenzeRinasce, 1, 0, 1, no
833314411,  DarioGuriotto, 1, 0, 1, no
2415564908,  siCelafaremo, 1, 0, 1, no
828687679,  EuroViva, 1, 0, 1, no
2415549036,  AzzurroDonnaFI, 1, 0, 1, no
2351311585,  le_cure, 1, 0, 1, no
2386639135,  FISestoFiorenti, 1, 0, 1, no
3306407121,  ForzaItaliaPisa, 1, 0, 1, no
2386635408,  FIScandicci, 1, 0, 1, no
2406613610,  FITavarnelle, 1, 0, 1, no
2356425302,  ForzaItaliaQ5, 1, 0, 1, no
2354417048,  ForzaItLondra, 1, 0, 1, no
2354451132,  FIQuartiere1, 1, 0, 1, no
2395025780,  FIAltopascio, 1, 0, 1, no
2417193085,  MatteoStaiSeren, 1, 0, 1, no
1878638162,  ForzaItaliaFi, 1, 0, 1, no
857964139,  ItaliaFuturaMon, 1, 0, 1, no
4425663915,  CdxToscana, 1, 0, 1, no
2356378256,  NovoliconPicchi, 1, 0, 1, no
984785090,  italia2p0, 1, 0, 1, no
943600765,  GigliErica, 1, 0, 1, no
1457632182,  PicchiSindaco, 1, 0, 1, no
4426336102,  CdxGermania, 1, 0, 1, no
2443720207,  No_Renzi, 1, 0, 1, no
2380661778,  PiemonteconPicc, 1, 0, 1, no
2452964504,  VotaBianchi, 1, 0, 1, no
4255793344,  circolocdx, 1, 0, 1, no
855378650,  FIBelgio, 1, 0, 1, no
943649954,  PDLGermania, 1, 0, 1, no
2353222434,  GiorGrandi, 1, 0, 1, no
1474478119,  OltrarnoxPicchi, 1, 0, 1, no
2395010906,  FIFigline, 1, 0, 1, no
602788028,  PDLMondo, 1, 0, 1, no
2369149224,  MissioneAzzurFI, 1, 0, 1, no
288176791,  ladyqualnt, 1, 0, 1, no
270249473,  kndanner981, 1, 0, 1, no
832963470,  LiberOpinione, 4, 0, 4, no
439660692,  MearEdlts, 2, 0, 2, no
471836919,  InstantiyMary, 1, 0, 1, no
473457759,  MarkCalvin__, 1, 0, 1, no
402819477,  paolopi14, 2, 2, 0, yes
196146480,  LuigiSigismondi, 2, 2, 0, yes
598628475,  CONAPO_VF, 1, 1, 0, yes
516631427,  BiboDessi, 1, 1, 0, yes
2506713271,  fricano24, 1, 1, 0, yes
1437778471,  RagnacciG, 11, 5, 6, no
420977208,  dannyturmoils, 3, 3, 0, yes
2271137279,  Lacatena83, 3, 3, 0, yes
724208389,  matteotuccini, 2, 2, 0, yes
339756851,  fortysalemme, 1, 1, 0, yes
71837289,  mlosavio, 2, 1, 1, neutral
40633397,  LaRadman, 2, 2, 0, yes
1267449962,  fepav, 2, 2, 0, yes
2362844389,  ItalyinBelgium, 2, 2, 0, yes
439040430,  lanuovaimmagine, 1, 1, 0, yes
4919921847,  chiccolavesca, 1, 1, 0, yes
475667504,  ElenaScaroni, 3, 3, 0, yes
519694667,  AndreaBartucci, 4, 4, 0, yes
2184184290,  Unosa62, 2, 2, 0, yes
1142166986,  RelmeRiganti, 2, 2, 0, yes
4375454417,  Maurizi18081084, 3, 2, 1, yes
781239864121589760,  papi_effe_erre, 2, 2, 0, yes
758715178259210240,  ValeLucchini93, 2, 2, 0, yes
482180363,  mariaelia4, 2, 2, 0, yes
64784847,  DanieleRaponi, 2, 2, 0, yes
407954582,  AldoPerrella49, 2, 2, 0, yes
1538318485,  ilmemoriAle, 4, 2, 2, neutral
66133398,  bavarese, 6, 2, 4, no
700715250,  Lucianoimparato, 2, 2, 0, yes
2946495526,  RossellaFlorean, 2, 2, 0, yes
301717777,  carloangeli, 2, 1, 1, neutral
1079592241,  Mistakenness, 4, 0, 4, no
1882963957,  peterpark06, 3, 0, 3, no
793544520642224128,  TRINGA51149298, 1, 1, 0, yes
4397747957,  Armance051215, 5, 5, 0, yes
222175287,  enoturismotop, 1, 1, 0, yes
793071301200113665,  MicheleColetto, 12, 12, 0, yes
135267045,  vincentconsulti, 9, 3, 6, no
2172547065,  marthaimthale, 1, 1, 0, yes
1020566803,  antonbasciu, 1, 1, 0, yes
1066679460,  elena_ianna, 1, 1, 0, yes
2845668851,  extraterra62, 15, 13, 2, yes
1645553184,  Mirabuccia, 4, 4, 0, yes
441158014,  laurasanvito, 2, 2, 0, yes
1522137966,  BarbaraRindone, 3, 3, 0, yes
240253625,  jomass73, 2, 2, 0, yes
350735540,  DMarite, 4, 4, 0, yes
404880068,  giuseppe_iori, 1, 1, 0, yes
2897671739,  gabrisca_85, 1, 1, 0, yes
707289158126010368,  mariacr41080325, 1, 1, 0, yes
1920228356,  EP_YouthEvent, 3, 3, 0, yes
3291950809,  dadou_moano, 1, 1, 0, yes
311352886,  Saxo_G, 2, 2, 0, yes
2221644847,  LeoneSaija, 2, 1, 1, neutral
321290793,  Jacopo_Ssl, 1, 1, 0, yes
1727982696,  Luca_Daprato, 1, 1, 0, yes
725357680693530624,  lzbthle, 1, 1, 0, yes
463911801,  CamillaGalante, 8, 3, 5, no
381495457,  Namox11, 1, 1, 0, yes
4691238559,  xiomaracastellR, 1, 1, 0, yes
3380332570,  FelixPistor, 1, 1, 0, yes
328617618,  canosaviva, 2, 1, 1, neutral
4549226901,  nderosso_ndr, 1, 1, 0, yes
779645623800856576,  ComunitasE, 1, 1, 0, yes
390337126,  123epoli, 2, 2, 0, yes
2235126823,  angelatrovato17, 1, 1, 0, yes
2271776366,  occhidastrega, 2, 2, 0, yes
713388865239826432,  jo_ute, 1, 1, 0, yes
2698192537,  MirfetPiccolo, 5, 4, 1, yes
544388330,  ValeriaConsy, 5, 5, 0, yes
401374007,  lorescot, 2, 2, 0, yes
379317467,  vincentius1984, 1, 1, 0, yes
797846353049223168,  Mansi_142, 1, 1, 0, yes
3289742169,  emilianalfano, 9, 6, 3, yes
445660248,  spinellibarrile, 4, 4, 0, yes
330493217,  Alessio_Testa, 1, 1, 0, yes
2865677793,  bussolarai, 10, 10, 0, yes
266213305,  DioIAm, 4, 1, 3, no
2970118150,  archie723fp, 2, 2, 0, yes
4881986945,  BohemondDt, 3, 3, 0, yes
747013422907277312,  Gabriellagiallo, 5, 3, 2, yes
1316859552,  PJA_TalkLine, 1, 1, 0, yes
395224728,  RizzoLorenzo, 1, 1, 0, yes
202614912,  simamafrica, 1, 1, 0, yes
455999497,  Andgasperini, 4, 2, 2, neutral
41324433,  knottyhead, 1, 1, 0, yes
405584031,  MrMiguelon74, 1, 1, 0, yes
45863022,  fabjorov, 2, 1, 1, neutral
782606963393892352,  ilduce1971nobis, 1, 1, 0, yes
309750549,  EnzoSollo, 15, 14, 1, yes
405443521,  chiar9, 1, 1, 0, yes
264333523,  h3v1l, 1, 1, 0, yes
60981224,  TheMyx, 1, 1, 0, yes
4619528355,  Extrac_CH, 3, 2, 1, yes
2264200452,  musondolya, 1, 1, 0, yes
754089900,  Fas_04, 1, 1, 0, yes
3346593934,  claretta_44, 1, 1, 0, yes
110520087,  silzmaria, 1, 1, 0, yes
96355894,  massimotirabass, 2, 2, 0, yes
1216152762,  MillyBcc, 1, 1, 0, yes
710956626220552192,  musafiridm, 1, 1, 0, yes
2351660264,  LaStorica, 1, 1, 0, yes
480494987,  giopisan, 2, 1, 1, neutral
422939255,  WillyStardust, 3, 3, 0, yes
3018829461,  lorenzobtt, 1, 1, 0, yes
799174229488963584,  PaneEMusiche, 1, 1, 0, yes
2614952764,  l_o_s_t_e_r, 5, 2, 3, no
418241458,  SaraAuriletto, 1, 1, 0, yes
501273149,  gallale1, 1, 1, 0, yes
767716997568270336,  siavarone, 4, 3, 1, yes
2593259168,  Magocassandro, 2, 1, 1, neutral
45886734,  Baci86, 2, 1, 1, neutral
120380619,  AleGuerani, 10, 5, 5, neutral
805310907282837504,  PEPPESTARK98, 4, 2, 2, neutral
2968660427,  giansy88, 6, 3, 3, neutral
763745686982692864,  mirco_tenebroso, 6, 3, 3, neutral
2336949294,  Monitor_sur, 3, 2, 1, yes
2426748215,  lallamlie, 2, 1, 1, neutral
2323501770,  tothemoon_31211, 4, 2, 2, neutral
1050070874,  GuglielmoIavaro, 2, 1, 1, neutral
413916151,  GuidoCrosetto, 32, 8, 24, no
724647652101595136,  haindersafronov, 2, 1, 1, neutral
164008619,  Harizona88, 4, 2, 2, neutral
322054650,  pelias01, 4, 2, 2, neutral
281457720,  Giofrassinesi, 5, 1, 4, no
439362823,  erremonte, 5, 1, 4, no
2895469174,  MessicoMinister, 9, 4, 5, no
706570552031444992,  For_Trump_ITALY, 3, 2, 1, yes
2828316939,  oioli_loredana, 2, 1, 1, neutral
777607143931408384,  telomettonline, 7, 4, 3, yes
762264010070851584,  poloni_mario, 2, 1, 1, neutral
558031527,  blanbet11, 2, 1, 1, neutral
256628704,  diegopfaff, 2, 1, 1, neutral
2380809738,  savemadancy, 6, 3, 3, neutral
1207283455,  avana1959, 2, 1, 1, neutral
270611168,  penzador12, 2, 1, 1, neutral
134514942,  bgflip, 2, 1, 1, neutral
33891215,  aleshey, 10, 5, 5, neutral
3379488766,  zosimov00, 2, 1, 1, neutral
469630208,  RobySangi, 2, 1, 1, neutral
2905617357,  pierluigi958, 5, 3, 2, yes
274106393,  SandraVolpe, 2, 1, 1, neutral
618934256,  StefanoDUffizi, 3, 1, 2, no
3740658136,  marco_marcangio, 3, 1, 2, no
615943451,  ADebiasi1, 2, 1, 1, neutral
3041218581,  stellacomello, 2, 1, 1, neutral
52940002,  vanvinzo, 2, 1, 1, neutral
794945413317066752,  deltamid1, 2, 1, 1, neutral
4275490114,  bafona54, 8, 4, 4, neutral
1176516566,  gobba_rancorosa, 2, 1, 1, neutral
947272602,  GianniScapellat, 83, 41, 42, no
2734322301,  Rizzo89Prizzo05, 7, 3, 4, no
53994592,  frankforu, 3, 1, 2, no
1385256108,  LiberoParrotta, 5, 1, 4, no
3295563335,  LNlegalombarda, 2, 1, 1, neutral
746201381912993794,  j_drum123, 4, 1, 3, no
741452070,  FrancescaPepe12, 3, 1, 2, no
33676387,  giulezio, 7, 3, 4, no
15333818,  showreel, 2, 1, 1, neutral
1360264134,  dalmasso_enrico, 2, 1, 1, neutral
3234403378,  amkovis, 2, 1, 1, neutral
73193003,  DiegoMalara, 7, 3, 4, no
152639046,  splushaut, 2, 1, 1, neutral
517347417,  corneliacioaca, 2, 1, 1, neutral
49036389,  rem769, 2, 1, 1, neutral
23798374,  tomzanardi, 2, 1, 1, neutral
4860906586,  NuNuZ_00, 3, 1, 2, no
2960103832,  riccardvincenzi, 2, 1, 1, neutral
1038142573,  rosaalba147, 2, 1, 1, neutral
2194433942,  chinasky11, 13, 5, 8, no
2668009337,  iskiator, 2, 1, 1, neutral
560509154,  franciungaro, 10, 5, 5, neutral
2755001196,  Rossana7336, 16, 7, 9, no
157318900,  zodluc, 2, 1, 1, neutral
256688538,  GruppoNosce, 2, 1, 1, neutral
3191176588,  ritagraziano48, 12, 3, 9, no
421098765,  millybrightstar, 13, 2, 11, no
183746408,  robypuck, 2, 1, 1, neutral
3134863127,  filippomarr, 2, 1, 1, neutral
2923022765,  _charles_00, 2, 1, 1, neutral
1691920314,  manumakeup83, 2, 1, 1, neutral
4228909960,  ARTAX_77, 2, 1, 1, neutral
399004979,  NicolaPorro, 2, 1, 1, neutral
2987000517,  il_quoti, 13, 5, 8, no
3343930090,  ilcomizio, 4, 3, 1, yes
585436880,  LeifSiv_Falk, 2, 1, 1, neutral
709013795675480064,  alemi1715, 2, 1, 1, neutral
2942275894,  stefania2205, 30, 5, 25, no
514592290,  AlessandroCochi, 3, 1, 2, no
721386970493108224,  aryamarsil10, 2, 1, 1, neutral
2195623517,  FerrariSilvi, 2, 1, 1, neutral
3772059801,  andreadeeriu, 2, 1, 1, neutral
3227683351,  Umberto_D_G, 4, 1, 3, no
475642592,  thekings9, 6, 3, 3, neutral
547980228,  Robisala, 5, 3, 2, yes
778530030,  topoloninobg, 7, 1, 6, no
1557375199,  BenitoKlinker, 2, 1, 1, neutral
2362991869,  Linda_riu, 2, 1, 1, neutral
700602629773201409,  CentroPatriote, 2, 1, 1, neutral
2953261335,  Gourlotpascon, 2, 1, 1, neutral
3996421990,  evepazzaglia, 2, 1, 1, neutral
1071686498,  dacinka95, 2, 1, 1, neutral
411622332,  MassimoStefani1, 6, 4, 2, yes
799603879746895872,  F67817945, 2, 1, 1, neutral
428910342,  Fiooooz, 5, 4, 1, yes
3334729282,  cvrlyhair, 2, 1, 1, neutral
2912985663,  annielletta, 14, 8, 6, yes
60286717,  steinbock41, 2, 1, 1, neutral
2584582892,  luisthenewblack, 3, 1, 2, no
1213238388,  dufrefrene, 2, 1, 1, neutral
635613198,  stephzoina, 2, 1, 1, neutral
4691712930,  Guardiandelfar, 9, 4, 5, no
957926748,  PCazzani, 6, 1, 5, no
730123768350314498,  388_759, 5, 1, 4, no
819337976,  NadiaRubbini, 2, 1, 1, neutral
942547687,  FanyBonsignore, 4, 2, 2, neutral
574053138,  Milouse96, 2, 1, 1, neutral
341654059,  ozremyoz, 2, 1, 1, neutral
311449327,  sarcasmsaveus, 2, 1, 1, neutral
2511081038,  zaynliamzee, 2, 1, 1, neutral
704690252104003585,  Claudiopigpen, 2, 1, 1, neutral
778879903810908160,  stedol06, 2, 1, 1, neutral
1395071677,  nelloxfranko, 2, 1, 1, neutral
725981859910418436,  JohnKennu, 2, 1, 1, neutral
2836587826,  NelMeridione, 3, 2, 1, yes
314453947,  DucaAlfio, 2, 1, 1, neutral
3257489410,  _im_a_Mess_29, 2, 1, 1, neutral
787574840077213696,  StranaGenia, 3, 2, 1, yes
2910770733,  pradasdeviI, 2, 1, 1, neutral
4446950260,  hors_les_murs, 2, 1, 1, neutral
293025517,  TheJayCalledLee, 2, 1, 1, neutral
571891468,  c_spheris, 2, 1, 1, neutral
564689324,  ChiaraElanor, 2, 1, 1, neutral
612113541,  tweetmaurizio, 2, 1, 1, neutral
261745556,  aleventu, 4, 2, 2, neutral
2572210756,  _easiertorun, 3, 1, 2, no
4641805162,  m_pagliaro, 2, 1, 1, neutral
1525283119,  kurtyeol, 2, 1, 1, neutral
249861738,  _Cicci0, 2, 1, 1, neutral
787240062773854209,  roberto_carrino, 6, 3, 3, neutral
548738657,  enrg13, 3, 2, 1, yes
2314336627,  POTorpigna, 2, 1, 1, neutral
3309178241,  sandra_archetti, 2, 1, 1, neutral
707331857843675136,  Puzzitudine, 2, 1, 1, neutral
4074284903,  ddreamer92, 2, 1, 1, neutral
788981779340361728,  jo_armstrong_, 2, 1, 1, neutral
1853722758,  Wanda_Porrani, 11, 4, 7, no
96508559,  dreamcatcher5_7, 2, 1, 1, neutral
490641679,  StefanoEmanuel1, 8, 4, 4, neutral
435148896,  LokriUrbemMundi, 2, 1, 1, neutral
507639440,  marco14ar, 2, 1, 1, neutral
460438110,  Tana_del_Lupo, 2, 1, 1, neutral
749593867,  MiluRamalho, 8, 4, 4, neutral
955733516,  seneca6a, 4, 2, 2, neutral
250778267,  morethangiulia, 2, 1, 1, neutral
800017250845687808,  BernardRothmann, 6, 3, 3, neutral
707335640954871808,  PorticelliMimmo, 2, 1, 1, neutral
2845778056,  CasconeWepe, 2, 1, 1, neutral
781193970948902912,  tony_elias15, 4, 2, 2, neutral
486523144,  69Massy, 2, 1, 1, neutral
921043110,  Rinascvere, 2, 1, 1, neutral
1311541112,  hannivgram, 2, 1, 1, neutral
339204587,  antonio_salvati, 4, 3, 1, yes
3918760877,  _wolstenlollo, 2, 1, 1, neutral
231766882,  fabisknotonfier, 4, 2, 2, neutral
1421358978,  mychristieroad, 2, 1, 1, neutral
564904778,  holamishamigos_, 10, 5, 5, neutral
2422593900,  agent_Cogne, 2, 1, 1, neutral
1218580224,  ManuelaGilardi1, 4, 1, 3, no
3352952585,  wirteddy, 2, 1, 1, neutral
774232452806086656,  lucianoviviani3, 6, 2, 4, no
3064971683,  VacatlonJam, 2, 1, 1, neutral
454015199,  LaGrigoB, 6, 3, 3, neutral
3657151161,  WalterDiGaspero, 4, 3, 1, yes
704441380425375744,  mouradchezmario, 3, 2, 1, yes
444698119,  Juls_angel1D, 2, 1, 1, neutral
592932146,  jogndaes, 2, 1, 1, neutral
2276600793,  farxy_27, 2, 1, 1, neutral
1708267843,  francescadore__, 3, 2, 1, yes
1023649345,  tpel78, 2, 1, 1, neutral
433440575,  beliezus, 2, 1, 1, neutral
4299665086,  TombesiM, 2, 1, 1, neutral
2344694171,  reddydemey, 2, 1, 1, neutral
796439720926597121,  LiviaBartolozzi, 3, 2, 1, yes
489601463,  ChefMolon, 2, 1, 1, neutral
779862494361841664,  tommasotes, 2, 1, 1, neutral
18188941,  mzeloni, 9, 3, 6, no
2778286474,  christian_vit85, 4, 2, 2, neutral
2186263680,  AielJak, 2, 1, 1, neutral
3079043344,  zamozix, 4, 2, 2, neutral
765065004370501632,  official_adella, 2, 1, 1, neutral
3385939450,  furnari80, 2, 1, 1, neutral
910414488,  barbaragianna, 8, 4, 4, neutral
2882347685,  The_Biblist, 3, 2, 1, yes
216771953,  RacchiMarco, 5, 2, 3, no
367605848,  FPalladini, 2, 1, 1, neutral
756987907852890112,  jeanjean832, 2, 1, 1, neutral
774013810617319424,  JIdentitaire, 2, 1, 1, neutral
1166339754,  MaraMobile, 19, 9, 10, no
4181180835,  ArdalionBorisyc, 4, 3, 1, yes
2982624400,  FNvaucluse, 2, 1, 1, neutral
130853128,  ciastinbieber, 2, 1, 1, neutral
804544873940611072,  elnetbapost1986, 2, 1, 1, neutral
766739706906341376,  mai_thai77, 2, 1, 1, neutral
3241758183,  agostino31139, 3, 1, 2, no
51674259,  ANNAMONTEVERDI, 2, 1, 1, neutral
792796905558446081,  marco_celtico, 6, 2, 4, no
738736280624844800,  encore_fred, 2, 1, 1, neutral
1498570615,  melancholia_LC, 2, 1, 1, neutral
831325898,  idirntcare, 5, 3, 2, yes
1544134861,  Rotlieber, 2, 1, 1, neutral
949464841,  MarroneCaterina, 10, 8, 2, yes
832033056,  Monicoser, 3, 2, 1, yes
802915337352212483,  odiotutti29, 2, 1, 1, neutral
3662970074,  MarkGelain, 3, 2, 1, yes
2365009229,  salomone_l, 2, 1, 1, neutral
53935265,  NinoSavalli, 2, 1, 1, neutral
549484011,  TAK3ITSL0W, 2, 1, 1, neutral
486617604,  GMonturano, 6, 3, 3, neutral
2450342903,  SaraSaraz13x, 2, 1, 1, neutral
1379956645,  Do_Dec, 2, 1, 1, neutral
2459950812,  Mav_008, 2, 1, 1, neutral
4075468583,  Apo_Strofo, 6, 2, 4, no
436928552,  EricBarker3, 2, 1, 1, neutral
799218258209546240,  anzhrtiv, 2, 1, 1, neutral
3367464436,  MaraPoli4, 2, 1, 1, neutral
497009003,  itechswiss, 3, 2, 1, yes
3024020530,  SBircesa, 2, 1, 1, neutral
752299549637668864,  leeellie811, 11, 7, 4, yes
4885967061,  BigaroniSilvia, 2, 1, 1, neutral
1066267118,  itsmikapenniman, 2, 1, 1, neutral
458670095,  lucilla171, 5, 1, 4, no
455939725,  Barabba1, 3, 1, 2, no
1543813320,  MrJumper02, 2, 1, 1, neutral
59912689,  HubertusVenator, 4, 2, 2, neutral
3255977488,  Jean_Nadjib, 2, 1, 1, neutral
3326859207,  AssistenzaInter, 6, 1, 5, no
713367031194730496,  FN_ScPo_Bdx, 2, 1, 1, neutral
1201732994,  morachiche, 3, 1, 2, no
17679623,  alicelibre, 2, 1, 1, neutral
1920649536,  MaurizioG6, 2, 1, 1, neutral
584704603,  oth_17, 2, 1, 1, neutral
746005358733365248,  GuilbauxRina, 2, 1, 1, neutral
954274980,  daniloconversi, 3, 1, 2, no
416392009,  salvolicitra, 2, 1, 1, neutral
469376838,  flautio, 2, 1, 1, neutral
1275023383,  Peppino_ITALIA, 2, 1, 1, neutral
1362865842,  maminoujolie, 2, 1, 1, neutral
804686669454733313,  titounet06, 2, 1, 1, neutral
1011345716,  DEFVSOUL, 2, 1, 1, neutral
134063240,  carolinabellogi, 2, 1, 1, neutral
2865955714,  manestria, 2, 1, 1, neutral
509321895,  Stella_LaSala, 2, 1, 1, neutral
3306530603,  sumofcydonia, 2, 1, 1, neutral
2882599205,  leonardofanci, 2, 1, 1, neutral
883210339,  vberezovski, 2, 1, 1, neutral
1030774051,  TommasoBarbaro, 2, 1, 1, neutral
423508034,  BertoGabriele, 2, 1, 1, neutral
59913807,  MarcusKoenig, 2, 1, 1, neutral
2314102182,  Jeffrey_Andrew7, 2, 1, 1, neutral
617395407,  BrillanteAlf, 2, 1, 1, neutral
1221719288,  StivalDaniele, 7, 4, 3, yes
723258299483885568,  PdPdeju, 2, 1, 1, neutral
563999084,  marini_samuele, 7, 3, 4, no
2762061357,  arimancijr, 3, 2, 1, yes
18582562,  OfficialGattara, 10, 3, 7, no
795195321294979072,  GiovanniAlpi, 2, 1, 1, neutral
578444884,  MaryMaryMRA, 10, 5, 5, neutral
465973745,  akoualong, 2, 1, 1, neutral
3305577839,  inthehatterslab, 2, 1, 1, neutral
3030533474,  angiuoniluigi, 6, 5, 1, yes
1872689394,  Acciaio123, 2, 1, 1, neutral
627784163,  jeanontwitt, 5, 2, 3, no
798261254536183808,  TeamTrump4, 7, 3, 4, no
4370394857,  paolomalfy, 4, 1, 3, no
1265206519,  Antonio18008195, 2, 1, 1, neutral
2765762353,  viola_samantha, 2, 1, 1, neutral
789389029657616384,  Z4T4R4, 2, 1, 1, neutral
2970007565,  ChefHarden13, 2, 1, 1, neutral
2375661338,  roccoscozzarell, 10, 7, 3, yes
781462292198199296,  ItsSoEl, 2, 1, 1, neutral
28308468,  neon_light, 2, 1, 1, neutral
20940460,  IraMency, 15, 7, 8, no
3087113802,  MMilani7, 2, 1, 1, neutral
754069345513406464,  ronzu76, 2, 1, 1, neutral
705425662304247808,  lastchance4usa, 2, 1, 1, neutral
525584324,  xhitemup, 2, 1, 1, neutral
2497628532,  233Davide, 3, 2, 1, yes
1070987708,  giudit70, 2, 1, 1, neutral
3081747118,  maybegaia, 2, 1, 1, neutral
929636678,  siberianoia, 4, 2, 2, neutral
784654056,  JunDufour, 2, 1, 1, neutral
2180630834,  CombattantFN, 2, 1, 1, neutral
970970300,  zardoni_a, 2, 1, 1, neutral
2983340421,  OfficineTorine1, 2, 1, 1, neutral
3395390663,  xistheway, 6, 3, 3, neutral
818453510,  clovis_freeman, 2, 1, 1, neutral
1009240776,  mingyate, 2, 1, 1, neutral
1102242762,  EnricoBett, 2, 1, 1, neutral
3851322407,  melodramalice, 2, 1, 1, neutral
1917128378,  110149avJC, 2, 1, 1, neutral
4512366975,  andrefalko2611, 2, 1, 1, neutral
754037580308606976,  chiccalapenna, 2, 1, 1, neutral
858613189,  astryun, 2, 1, 1, neutral
186027722,  _proudofthem, 2, 1, 1, neutral
805849108929974272,  bill_vesee, 2, 1, 1, neutral
93877894,  mukedammit, 2, 1, 1, neutral
268696849,  jetblckmalec, 2, 1, 1, neutral
964574712,  alexeicoianiz, 2, 1, 1, neutral
4891778626,  sarablurryface, 2, 1, 1, neutral
3836479403,  konnorpope, 2, 1, 1, neutral
701974383,  annaponta19, 2, 1, 1, neutral
3321312502,  CatiaButterfly, 5, 2, 3, no
1089245906,  sunhoesdun, 6, 3, 3, neutral
768999832958570496,  Bell_In_Hand, 2, 1, 1, neutral
845468852,  AnnaLoppo, 3, 1, 2, no
3079355507,  LallaLaurav, 2, 1, 1, neutral
3046930360,  cvcekd, 4, 2, 2, neutral
768282703107989504,  carlo09121955, 2, 1, 1, neutral
1428360464,  datomasino, 3, 1, 2, no
811657290,  itsmrsnobody, 2, 1, 1, neutral
4450843419,  Denis196821, 2, 1, 1, neutral
728925994233569280,  GianfryPet, 2, 1, 1, neutral
2498958865,  FanFiore, 2, 1, 1, neutral
2277405288,  dstu93, 2, 1, 1, neutral
87967184,  Occidentale, 4, 1, 3, no
51792177,  fra_paolo, 2, 1, 1, neutral
796099898189946880,  GaburroIris, 2, 1, 1, neutral
3145421452,  GCavalaglio, 2, 1, 1, neutral
260186256,  sirmacs, 8, 5, 3, yes
595862043,  pax_pelli, 2, 1, 1, neutral
569971949,  SalvoDal1, 3, 2, 1, yes
961524896,  MCanovaro, 6, 3, 3, neutral
2227272272,  Malasanita_, 2, 1, 1, neutral
405632524,  FDS90, 2, 1, 1, neutral
210861627,  AlessioPisano, 6, 5, 1, yes
390317285,  innavoig56, 2, 1, 1, neutral
1171945117,  _INFORMAZIONE_, 4, 2, 2, neutral
2225607369,  Danide20, 2, 1, 1, neutral
1857838688,  FLIBLOC, 11, 3, 8, no
67271025,  Effe5, 2, 1, 1, neutral
2757377255,  sara_manga79, 2, 1, 1, neutral
4744344981,  randagiume, 4, 2, 2, neutral
4266188127,  bellalilli16, 25, 14, 11, yes
425026301,  jordanmartinell, 3, 2, 1, yes
2339357169,  Lord_Vise, 2, 1, 1, neutral
528832755,  DiRoxy88, 2, 1, 1, neutral
2268895338,  pandorarivista, 2, 1, 1, neutral
158813892,  malux63, 2, 1, 1, neutral
730859423803924481,  CGIEmondo, 2, 1, 1, neutral
68640468,  cogitosergiosum, 12, 7, 5, yes
2911731604,  ioinsofferente, 2, 1, 1, neutral
1193947687,  HaRagioneNonno, 2, 1, 1, neutral
420572029,  martenspil, 2, 1, 1, neutral
1376674190,  Marcooppes, 4, 2, 2, neutral
281417880,  AndreaBrusetti, 4, 3, 1, yes
1107302042,  Sharbe27, 2, 1, 1, neutral
7654802,  emanuelemura, 2, 1, 1, neutral
1891067288,  shaddai7777, 5, 2, 3, no
1326429109,  RobertoCastaldi, 2, 1, 1, neutral
300344361,  nr6_kar120c, 2, 1, 1, neutral
580022142,  hamiltonsantia, 4, 2, 2, neutral
371808189,  Lukitomado, 2, 1, 1, neutral
892666663,  jlk4naples, 2, 1, 1, neutral
157316810,  _PIETROLOVEGAGA, 4, 2, 2, neutral
428908411,  VareseProvincia, 4, 2, 2, neutral
432459379,  carlo_pierelli, 3, 2, 1, yes
147966868,  DavideBergna, 2, 1, 1, neutral
413235901,  luca_sbardella, 3, 1, 2, no
1292285090,  sciacca_andrea, 2, 1, 1, neutral
1254580586,  TIZIANABELLINA1, 4, 1, 3, no
48555881,  FrenkWho, 2, 1, 1, neutral
439852615,  FLaghezza, 6, 3, 3, neutral
265360159,  laura_lavespa, 5, 4, 1, yes
40653660,  marzia75, 7, 6, 1, yes
410808584,  FedeAngeli, 13, 6, 7, no
434333043,  GiulioCas, 2, 1, 1, neutral
28779568,  Jankuzz, 2, 1, 1, neutral
2497742098,  LaZiaLaSandra, 2, 1, 1, neutral
53481195,  marcello252, 5, 2, 3, no
423703326,  MrSanfo, 2, 1, 1, neutral
4308941656,  ildannanto, 3, 2, 1, yes
125786855,  stefanomocellin, 2, 1, 1, neutral
52150804,  pieromerola, 2, 1, 1, neutral
144238332,  marctarabella, 12, 6, 6, neutral
384166561,  forsepuodarsi, 2, 1, 1, neutral
1404492552,  fabdf1, 2, 1, 1, neutral
722328402515075072,  galuppimarcone, 2, 1, 1, neutral
341389032,  giovanniaddeo, 2, 1, 1, neutral
757974675083370496,  Eugenio15028208, 4, 1, 3, no
2738358863,  mantila79, 2, 1, 1, neutral
2571433091,  higuera2866, 2, 1, 1, neutral
3423738129,  KhaleesiDestiel, 2, 1, 1, neutral
935056956,  mruggiero69, 2, 1, 1, neutral
802263358674206720,  framilanista, 2, 1, 1, neutral
984049369,  AudilioSudati, 2, 1, 1, neutral
2155585841,  momenvts, 2, 1, 1, neutral
173967262,  e_quintana, 2, 1, 1, neutral
2756691348,  jareddino, 2, 1, 1, neutral
1427463589,  CasulloRocco, 2, 1, 1, neutral
92336043,  Union_Patriotes, 2, 1, 1, neutral
991283983,  carlomalocco, 2, 1, 1, neutral
3121940993,  jolandissima, 7, 4, 3, yes
827429744,  Gigici50, 2, 1, 1, neutral
2737168551,  giomarangi, 3, 1, 2, no
544537996,  illusiam, 2, 1, 1, neutral
2557036036,  AndreaBrandima1, 2, 1, 1, neutral
3182786127,  demian_online, 2, 1, 1, neutral
2652883779,  fazi_fazi50, 2, 1, 1, neutral
1080692876,  Labur1967, 2, 1, 1, neutral
2683032895,  Holmesdonna1, 2, 1, 1, neutral
2169551812,  pietro_giannini, 3, 1, 2, no
2903201591,  birdy_pa, 2, 1, 1, neutral
2274898827,  dvunksjit, 4, 2, 2, neutral
408050299,  cheratoconico, 3, 1, 2, no
229502990,  NormanP91, 3, 2, 1, yes
87932947,  Dany1578, 2, 1, 1, neutral
735759987452960772,  MassimoBusardo, 2, 1, 1, neutral
2388833787,  Seidigallarate, 3, 2, 1, yes
790646624267763712,  ComitatoVotoNo, 5, 3, 2, yes
409465128,  ClaudiaRegan85, 2, 1, 1, neutral
3698870296,  francadss79, 3, 2, 1, yes
455620250,  carmarano, 3, 1, 2, no
709601106,  OriettaTabanell, 4, 1, 3, no
238212600,  FerAlgaba, 2, 1, 1, neutral
4233541725,  ITINERARIASmart, 6, 1, 5, no
200803896,  patriziamolina, 3, 1, 2, no
2372887943,  viganoabi, 2, 1, 1, neutral
1076206273,  fraribe88, 2, 1, 1, neutral
433754193,  AntonioCampo4, 9, 4, 5, no
830747983,  abruzzomyself, 2, 1, 1, neutral
336507961,  Gaetanobox, 2, 1, 1, neutral
4832516829,  Paolonik_, 4, 2, 2, neutral
2343293185,  Mme_Bathory, 12, 6, 6, neutral
550325863,  antoniettafo, 3, 2, 1, yes
483051922,  paolocol1, 2, 1, 1, neutral
2415846904,  EEnzogrosso52, 3, 1, 2, no
315967183,  a_rozzoni, 2, 1, 1, neutral
405468476,  MaurizioGironi, 3, 2, 1, yes
552851153,  DanziAlessandro, 3, 2, 1, yes
2457219327,  brantolo69, 7, 3, 4, no
36635670,  ermegal, 4, 2, 2, neutral
341020248,  Yossa_rian, 2, 1, 1, neutral
1049130138,  portenv, 2, 1, 1, neutral
1439340768,  FranXav06, 2, 1, 1, neutral
592794332,  Klau_995, 4, 3, 1, yes
2228625859,  DZ_Zilli, 2, 1, 1, neutral
1045369358,  davide_poletti, 9, 7, 2, yes
22007073,  valesarastella, 2, 1, 1, neutral
873793824,  Lele_x_sun, 2, 1, 1, neutral
760886360999858176,  MyfriendGuetta, 2, 1, 1, neutral
2260290943,  falsus63, 4, 1, 3, no
249625261,  Scarlet_Agnes, 8, 3, 5, no
2751789375,  IndriLuca, 2, 1, 1, neutral
2313205965,  hoproblemiziam, 4, 2, 2, neutral
3242209649,  nnbruciarlaglio, 7, 5, 2, yes
56392390,  aranciaverde, 5, 3, 2, yes
2523533104,  cag_mar, 2, 1, 1, neutral
770398549087490048,  andrebliz99, 2, 1, 1, neutral
801573647911620608,  itskepamul1975, 2, 1, 1, neutral
1069271424,  ambroperego, 2, 1, 1, neutral
523884698,  pazzo161, 2, 1, 1, neutral
2184428750,  maurosospetti, 2, 1, 1, neutral
17295951,  pdfubine, 2, 1, 1, neutral
1142457488,  cimax01, 2, 1, 1, neutral
419868026,  ivotnip, 2, 1, 1, neutral
706491889701277700,  gabrimargherita, 8, 4, 4, neutral
3328962976,  Cesaremacc, 2, 1, 1, neutral
3337033395,  _federica_m_, 2, 1, 1, neutral
2345625552,  pumba88it, 2, 1, 1, neutral
425693013,  padovaoggi, 2, 1, 1, neutral
417792554,  FilippoDentini, 2, 1, 1, neutral
332990530,  riccardo4d, 2, 1, 1, neutral
2873811161,  wiguzz25, 2, 1, 1, neutral
1063503469,  Insp_Chateau, 3, 1, 2, no
1246974960,  popeoe64, 12, 6, 6, neutral
1225534116,  zuc_g, 4, 1, 3, no
353555558,  fabioscarsi, 2, 1, 1, neutral
436838636,  mimmoperrone, 2, 1, 1, neutral
2264046682,  vike_pa, 2, 1, 1, neutral
1904885862,  verdiana_v, 6, 2, 4, no
2881497513,  ComfortablyFool, 2, 1, 1, neutral
74305366,  givagivaz, 2, 1, 1, neutral
1366710674,  mbonati63, 5, 3, 2, yes
1354460304,  MauroFalini, 2, 1, 1, neutral
71529985,  luisorel, 7, 5, 2, yes
3194910328,  SenMSpilabotte, 2, 1, 1, neutral
396591679,  potessio, 2, 1, 1, neutral
353894758,  asvaresino, 3, 1, 2, no
2480085912,  swimmerpg, 3, 2, 1, yes
512987105,  barbarabovone, 4, 1, 3, no
844743386,  SilviaFontana05, 3, 2, 1, yes
25097927,  magdavillani, 2, 1, 1, neutral
935490462,  brividocosmico_, 2, 1, 1, neutral
2301252082,  Ciscogrifo, 3, 2, 1, yes
2430411374,  Tomtomtof, 23, 9, 14, no
2885393529,  almabalz_alma, 7, 1, 6, no
32947390,  tbonini, 2, 1, 1, neutral
416161725,  MattiaAltobelli, 2, 1, 1, neutral
303936344,  Robisign, 3, 1, 2, no
711105714937323520,  TininatinaE, 4, 3, 1, yes
86061126,  alexqualcosa, 2, 1, 1, neutral
2977709325,  CharlesDeche, 5, 2, 3, no
927724410,  MarinaBaronti, 3, 1, 2, no
425414807,  giuseppe__massa, 2, 1, 1, neutral
490358485,  martina_gnd, 2, 1, 1, neutral
429742887,  IvanScuderi, 2, 1, 1, neutral
54507928,  gianlucacravera, 2, 1, 1, neutral
761084746315149312,  Dianora1982, 3, 2, 1, yes
254725263,  stefanopreto, 3, 2, 1, yes
755852992600010753,  AMarincioni, 2, 1, 1, neutral
930416396,  ilSaronno, 2, 1, 1, neutral
478591778,  Paolo_Perini83, 8, 6, 2, yes
350949910,  MarcoCapizzi1, 4, 2, 2, neutral
1346055018,  scoutfinche, 8, 5, 3, yes
708270672817082369,  gstmnc1, 10, 2, 8, no
50334860,  markgrika, 2, 1, 1, neutral
578825573,  LetiziaGargiulo, 5, 3, 2, yes
444419216,  MarcoPiraino1, 2, 1, 1, neutral
527384500,  AlbertoPezzali, 2, 1, 1, neutral
14236096,  epanto, 2, 1, 1, neutral
82666476,  charuka23, 2, 1, 1, neutral
571922344,  ljveformagcon, 2, 1, 1, neutral
723552821040320512,  crify1991, 2, 1, 1, neutral
3030153802,  Paol_pabs, 2, 1, 1, neutral
578946799,  MARCO47205596, 4, 2, 2, neutral
3094711139,  gabriesalvatori, 2, 1, 1, neutral
495717341,  estermirry, 8, 2, 6, no
74968602,  TheLifeIsMau, 2, 1, 1, neutral
257474781,  Carol8QS, 2, 1, 1, neutral
697525270593540096,  patrocloachille, 2, 1, 1, neutral
293146567,  CapelliStefano, 5, 4, 1, yes
115675193,  matterice, 11, 3, 8, no
1282918945,  WhisperCar, 3, 1, 2, no
244865065,  IlBarbone, 2, 1, 1, neutral
319527387,  francomaro, 2, 1, 1, neutral
4646720549,  ManuelGobbo1, 2, 1, 1, neutral
2361834495,  nina_leri, 2, 1, 1, neutral
483046948,  tonycapo66, 4, 2, 2, neutral
1112700469,  filippinipaolo1, 6, 5, 1, yes
248459008,  Ssiu_, 3, 1, 2, no
1215863226,  BBeatricegemma, 2, 1, 1, neutral
462900728,  ephemerol1, 3, 1, 2, no
450999685,  mik_saint, 2, 1, 1, neutral
235660726,  Luckyluciano971, 3, 1, 2, no
358051613,  davided81, 7, 4, 3, yes
1605328957,  BePietro, 6, 2, 4, no
489630689,  _Mbuton, 3, 1, 2, no
1289725328,  marilaba1, 5, 3, 2, yes
407116818,  nia_lavi, 2, 1, 1, neutral
705772931981418497,  gianfrancotumm2, 2, 1, 1, neutral
70946877,  novelune, 3, 1, 2, no
100961915,  maurovalenza, 5, 3, 2, yes
421110631,  SteDepo, 5, 4, 1, yes
786902810,  f_arcostanzo, 2, 1, 1, neutral
242698861,  salvyx88, 5, 2, 3, no
910465218,  AntonucciAldo, 8, 2, 6, no
269189626,  Andrea_Saiani, 2, 1, 1, neutral
732701339801780224,  tricellla, 3, 1, 2, no
708970152,  whitesnake66, 2, 1, 1, neutral
2301455117,  antonio76760, 2, 1, 1, neutral
2213272302,  Danynardy, 2, 1, 1, neutral
2435916027,  tbuccico69, 3, 2, 1, yes
56957163,  gighen_33, 2, 1, 1, neutral
256163349,  alessiarotta, 4, 3, 1, yes
725637690,  ulissetatuato, 2, 1, 1, neutral
951354751,  E_Man_G, 2, 1, 1, neutral
417356257,  massi_ba68, 2, 1, 1, neutral
213274510,  Vado_Di_Fretta, 7, 4, 3, yes
706117842815623168,  maxpix6251, 4, 1, 3, no
2813661651,  nauticanumber1_, 4, 2, 2, neutral
151395657,  MathiaFeba, 3, 2, 1, yes
1137221989,  JagodiOz, 2, 1, 1, neutral
1465372314,  La_Suami, 3, 2, 1, yes
2981642447,  stefania_poggio, 3, 1, 2, no
28847707,  Mas313, 2, 1, 1, neutral
2541569407,  ragazzodagliocc, 5, 1, 4, no
239871080,  tamaron07, 2, 1, 1, neutral
1273044126,  simopappa97, 2, 1, 1, neutral
1460431345,  AndreaGhiringh2, 3, 1, 2, no
3014227258,  piglione_laura, 4, 1, 3, no
407115874,  Violaklis, 2, 1, 1, neutral
1551339876,  E_Bellomi, 2, 1, 1, neutral
213091006,  Iddy_Goccia, 12, 7, 5, yes
789042545963724800,  rasseganadia5, 2, 1, 1, neutral
2419772543,  Eedaii, 2, 1, 1, neutral
482852345,  Axmar75, 3, 1, 2, no
804411273332957184,  ualelmanthank11, 2, 1, 1, neutral
706397427,  PasCoNaples, 3, 1, 2, no
3587936236,  antonellader, 2, 1, 1, neutral
547558786,  PIZZAUPUrbania, 2, 1, 1, neutral
2446945421,  marco_borrano, 5, 3, 2, yes
3395557228,  EricBufalino, 2, 1, 1, neutral
491167846,  celhoceruleo, 3, 1, 2, no
161044379,  danielamartani, 8, 6, 2, yes
753668010,  MissYleniaS, 2, 1, 1, neutral
447335723,  embasio, 2, 1, 1, neutral
478894654,  Keynesblog, 3, 1, 2, no
617234985,  MauroVari, 4, 2, 2, neutral
149959178,  emidiodl, 2, 1, 1, neutral
238192640,  laurascheri, 4, 2, 2, neutral
3147713225,  JJM_DigiMedia, 2, 1, 1, neutral
96659291,  kokoraggamuffin, 3, 2, 1, yes
424981740,  ariesilvia, 4, 2, 2, neutral
989195636,  Deborah__88, 2, 1, 1, neutral
724927983199330305,  francesco19610, 2, 1, 1, neutral
413883002,  GFScavuzzo, 2, 1, 1, neutral
151156512,  Peperlizio9, 4, 2, 2, neutral
4798705814,  Federation_FN68, 4, 2, 2, neutral
2871150859,  misundersthood_, 2, 1, 1, neutral
545214546,  winchesters221B, 2, 1, 1, neutral
1146181963,  paradasiall, 2, 1, 1, neutral
103077927,  Dan_skorpio87, 7, 2, 5, no
1356893726,  rtpertutti, 2, 1, 1, neutral
384541789,  ArtemisiaGentil, 2, 1, 1, neutral
307256067,  FozzaInda, 2, 1, 1, neutral
38897110,  Fanello_74, 2, 1, 1, neutral
3399841755,  natalino_talin, 4, 2, 2, neutral
841547198,  FilippoCarnier, 2, 1, 1, neutral
2577286702,  lucreziam666, 2, 1, 1, neutral
2197114439,  giulia_grandin, 2, 1, 1, neutral
1491434504,  boobsftme, 2, 1, 1, neutral
2512612640,  rubino7004, 3, 1, 2, no
529548417,  evaksaetre, 2, 1, 1, neutral
970157504,  enroutevers2022, 2, 1, 1, neutral
432749753,  lilector, 2, 1, 1, neutral
2327312221,  itsevakbitch, 2, 1, 1, neutral
57296195,  marco_scala, 2, 1, 1, neutral
1622189670,  kairosIwt, 2, 1, 1, neutral
978710568,  leuconoe76, 7, 4, 3, yes
64369261,  LucaCMZ, 2, 1, 1, neutral
510529234,  stefanomuzi2, 2, 1, 1, neutral
2983945431,  L_oranaise_, 2, 1, 1, neutral
2261320772,  Pascal_Girardin, 4, 3, 1, yes
987114463,  padella39, 5, 1, 4, no
2640157312,  castumandus, 2, 1, 1, neutral
1632879812,  mariscollo1, 2, 1, 1, neutral
980971442,  lannivster, 2, 1, 1, neutral
2506237877,  Smoker9511, 5, 3, 2, yes
336098797,  gomininie, 2, 1, 1, neutral
768163767376936960,  LeonReport, 4, 2, 2, neutral
736770542,  Kira_Wolf97, 2, 1, 1, neutral
717029975849828352,  AnimoItalico, 3, 2, 1, yes
362443298,  EhiPasqualino, 2, 1, 1, neutral
545160222,  RogerKulmala, 2, 1, 1, neutral
804468875245060096,  MarineSoutien, 2, 1, 1, neutral
210112666,  AlexAtlantis, 2, 1, 1, neutral
2188651507,  Baekho2000, 2, 1, 1, neutral
3290324645,  ChcIL_, 2, 1, 1, neutral
302929777,  Ultor42, 2, 1, 1, neutral
798224678531854340,  RolanAmorrortu, 2, 1, 1, neutral
2342356352,  cikibucka, 2, 1, 1, neutral
326883526,  Diego_Garijo, 2, 1, 1, neutral
368346254,  Chia_AA_, 5, 3, 2, yes
3394601549,  AmericanBrawn1, 2, 1, 1, neutral
2861497810,  PaolaFNJ, 2, 1, 1, neutral
603836700,  cucchiaia, 2, 1, 1, neutral
460478784,  AlexBaldi15, 3, 2, 1, yes
3306404625,  lannisteris, 3, 2, 1, yes
2590330340,  Sabseyo, 2, 1, 1, neutral
618235367,  sonrisaslalemi, 2, 1, 1, neutral
2232475539,  robeta_ro, 2, 1, 1, neutral
1129073232,  idolsakamyljfe, 5, 2, 3, no
4854897735,  degeneroh, 2, 1, 1, neutral
252633455,  SailorAnna, 17, 9, 8, yes
3697136734,  _wiccan, 2, 1, 1, neutral
3081581745,  claviedidier, 2, 1, 1, neutral
1222708867,  inlovewithjen, 2, 1, 1, neutral
2260805706,  MadMonarchist1, 2, 1, 1, neutral
138388479,  agimcorp, 2, 1, 1, neutral
1591909939,  eclivpsarry, 2, 1, 1, neutral
747532152808574976,  FN_nonofficiel, 4, 2, 2, neutral
187229709,  Makout57, 2, 1, 1, neutral
4456361601,  girard_jessy, 2, 1, 1, neutral
3017451135,  umyoxyjin, 4, 2, 2, neutral
785279359829549056,  briasupportarg, 2, 1, 1, neutral
763755601746878465,  fernando17pm, 2, 1, 1, neutral
4069706849,  ChildofLuso, 2, 1, 1, neutral
4198769722,  The_Crusader82, 2, 1, 1, neutral
3291043083,  MFra85, 3, 2, 1, yes
752336219804016640,  Indomiti, 2, 1, 1, neutral
57367753,  fabpvc, 2, 1, 1, neutral
341763587,  filippozambet, 3, 2, 1, yes
802130232,  carterslaugh, 4, 2, 2, neutral
401244307,  ikigaizay, 2, 1, 1, neutral
3105483519,  olf39, 2, 1, 1, neutral
768129223550697472,  _lovingleeyum_, 2, 1, 1, neutral
501159439,  FBottarelli, 2, 1, 1, neutral
361483811,  LucaLagana, 2, 1, 1, neutral
3380140173,  evebelya, 4, 2, 2, neutral
4528993047,  FIFI95_, 2, 1, 1, neutral
1917473587,  AlessioC_96, 8, 4, 4, neutral
33986651,  _MAriANotONsi_, 4, 3, 1, yes
163417391,  Manumelamanu, 2, 1, 1, neutral
888204092,  EricOderman, 2, 1, 1, neutral
1330120332,  Alcuin66, 2, 1, 1, neutral
4622550376,  saeptvm, 3, 2, 1, yes
820293164,  rayshairwaa, 6, 3, 3, neutral
457878187,  JeanLukeTele, 2, 1, 1, neutral
1042238102,  comesietebanali, 2, 1, 1, neutral
217784655,  zingaro59, 2, 1, 1, neutral
763143014353174528,  Giorgio60343686, 3, 2, 1, yes
29665462,  filippocioni, 3, 2, 1, yes
740874648,  darkvnessallure, 2, 1, 1, neutral
803294805807792129,  Revan301, 5, 4, 1, yes
1055484026,  smalltimedreams, 4, 2, 2, neutral
538230890,  GiovannaLollo, 4, 2, 2, neutral
4483045997,  MoCiCasco, 2, 1, 1, neutral
370220219,  AnnaGuerrieri, 2, 1, 1, neutral
2163076862,  ShadowStille, 2, 1, 1, neutral
723967167486668801,  gabrielerennaq, 2, 1, 1, neutral
2728937680,  Pizza_Secs, 2, 1, 1, neutral
3694054096,  delalande72, 2, 1, 1, neutral
4047355091,  68avecMarine, 4, 2, 2, neutral
1347875294,  Austrasien57, 2, 1, 1, neutral
854909414,  miss_laventu, 2, 1, 1, neutral
2334303233,  PeroniGiulia, 2, 1, 1, neutral
2543855680,  manuliga83, 2, 1, 1, neutral
480608415,  HaiMicaUnAmaca, 2, 1, 1, neutral
4782660614,  trattomale, 2, 1, 1, neutral
805645888618106880,  MarxismCultural, 2, 1, 1, neutral
2194049697,  gigizik, 2, 1, 1, neutral
13885412,  fgfoto, 2, 1, 1, neutral
3840815391,  jeannebon44, 2, 1, 1, neutral
770221658145566722,  lobster_sharif, 2, 1, 1, neutral
406302458,  AngeloPillon, 2, 1, 1, neutral
405054041,  nicogoy1, 2, 1, 1, neutral
411304327,  quoquetu, 4, 1, 3, no
790854953615130625,  DamienF84, 2, 1, 1, neutral
3360180071,  Peuplecelte, 2, 1, 1, neutral
213024678,  GAlleraBarbi, 2, 1, 1, neutral
107562073,  DJavierTH, 2, 1, 1, neutral
2597445738,  rofepena, 6, 3, 3, neutral
2519021771,  MLeonti, 2, 1, 1, neutral
719915239513436160,  DavidLovett98, 2, 1, 1, neutral
182859080,  ItssAntonella, 2, 1, 1, neutral
4871337387,  tbhureyesbleeds, 2, 1, 1, neutral
798456707513024512,  dsmitty7773, 2, 1, 1, neutral
171422343,  lorenzoc31, 2, 1, 1, neutral
532354356,  N0EARCHIVISTE, 2, 1, 1, neutral
711644026542399488,  Fuchsy95, 2, 1, 1, neutral
4883316729,  stroili_a, 2, 1, 1, neutral
549064750,  mickeled, 4, 2, 2, neutral
440120294,  Kleosnike, 2, 1, 1, neutral
2767073855,  ange1914, 2, 1, 1, neutral
2761898817,  dualkoondog, 2, 1, 1, neutral
4502427562,  PierreF34, 2, 1, 1, neutral
1341279649,  ichbineingeek, 2, 1, 1, neutral
358805940,  PartisansMarine, 2, 1, 1, neutral
1404546271,  nizan22130, 2, 1, 1, neutral
1581537397,  disalss, 2, 1, 1, neutral
223802684,  travirgolette, 2, 1, 1, neutral
3342791722,  CCRD7, 2, 1, 1, neutral
4506049942,  colette_mathieu, 2, 1, 1, neutral
2972964329,  megafonomagico, 3, 2, 1, yes
431657554,  seguaquellauto, 2, 1, 1, neutral
1323124038,  dingologue, 2, 1, 1, neutral
529566930,  FranciBen, 2, 1, 1, neutral
2207625535,  JonathanTehau, 4, 2, 2, neutral
229791732,  valeriochiola, 10, 7, 3, yes
802180749998850048,  iantospizza, 3, 2, 1, yes
1898486876,  zilvia82, 2, 1, 1, neutral
2862499199,  sinisterkiddo, 8, 4, 4, neutral
277076241,  bettercallseul, 2, 1, 1, neutral
2494379611,  CalcagnileG, 6, 2, 4, no
114200932,  OcramMaco, 3, 2, 1, yes
2419386494,  MarioBi28881463, 2, 1, 1, neutral
2872626047,  RenMasi, 2, 1, 1, neutral
164412025,  SpiderMeg_, 2, 1, 1, neutral
182935367,  puregreymorning, 2, 1, 1, neutral
1503550754,  marvelousnerd, 2, 1, 1, neutral
847536198,  Paolomasi72Li, 9, 5, 4, yes
80698046,  2dekamerpvv, 2, 1, 1, neutral
579966216,  alessioluna97, 2, 1, 1, neutral
333959519,  lucadragoni, 2, 1, 1, neutral
443916262,  clubdanae, 2, 1, 1, neutral
345929067,  Bea_Mantov, 3, 2, 1, yes
2975372100,  pessimoumore, 8, 7, 1, yes
2170967705,  itslokisnak, 2, 1, 1, neutral
210981281,  vicgri2, 3, 2, 1, yes
170003040,  channelder, 2, 1, 1, neutral
409539899,  france_sor, 4, 1, 3, no
30892269,  gianbor, 7, 3, 4, no
4122229647,  maripalmii, 2, 1, 1, neutral
172105123,  martinalab_8, 2, 1, 1, neutral
216471530,  rhodibus, 2, 1, 1, neutral
396699676,  darraen, 2, 1, 1, neutral
334748858,  RobertaLepori, 2, 1, 1, neutral
467370438,  giuliven, 2, 1, 1, neutral
16113204,  katieparla, 2, 1, 1, neutral
3042456095,  hufflecass, 4, 2, 2, neutral
761512773490733056,  Skelan_, 2, 1, 1, neutral
4068202785,  giornalecchismo, 7, 1, 6, no
4143185404,  V_M5S_, 8, 1, 7, no
4046591470,  GrilLOST_M5S, 2, 1, 1, neutral
2891799633,  giuseppe488, 10, 5, 5, neutral
68943667,  Defcon1979, 2, 1, 1, neutral
450583311,  roffi_nicolo, 2, 1, 1, neutral
703307259607126016,  sauchack, 7, 2, 5, no
303757962,  thewankingbeard, 2, 1, 1, neutral
3050023667,  improta80, 4, 1, 3, no
1166270324,  aperru1, 7, 6, 1, yes
505095711,  unabellaestate, 6, 4, 2, yes
240709858,  Paris_Bangrazi, 2, 1, 1, neutral
1901906809,  MarmoAColazione, 2, 1, 1, neutral
173816714,  jessfleisdead, 2, 1, 1, neutral
802877940958642176,  AllAtOnce89, 2, 1, 1, neutral
762396908409253888,  ilbaronejager, 7, 4, 3, yes
1183974055,  giovannibrenteg, 2, 1, 1, neutral
187891681,  by_giuliaP, 2, 1, 1, neutral
411406380,  BCilio, 7, 5, 2, yes
109001462,  MTREVISIOL, 4, 3, 1, yes
378498156,  Violet_Said, 2, 1, 1, neutral
707295292253716480,  staf_ma, 2, 1, 1, neutral
509128533,  GioriFerrazzi, 2, 1, 1, neutral
89459181,  gsquarcina, 2, 1, 1, neutral
2169041137,  civettexcivati, 5, 1, 4, no
825924643,  OrnellaFaro, 2, 1, 1, neutral
708241822263418882,  Dany86972080, 2, 1, 1, neutral
990775538,  palorena71, 2, 1, 1, neutral
540740277,  ahp68, 2, 1, 1, neutral
471973931,  eucromia, 2, 1, 1, neutral
781437278228996096,  Jhontherev, 2, 1, 1, neutral
141975784,  jan_sobi, 9, 4, 5, no
600145734,  FiertNationale, 2, 1, 1, neutral
2889221200,  theunderdog61, 2, 1, 1, neutral
347967498,  grumpytaire, 2, 1, 1, neutral
2722795647,  coulsovn, 2, 1, 1, neutral
1413711301,  rainblowjob, 2, 1, 1, neutral
744869633912606720,  swana320, 2, 1, 1, neutral
488742003,  bene_18, 2, 1, 1, neutral
18916243,  ___ila, 2, 1, 1, neutral
76355268,  CarloLombardi, 2, 1, 1, neutral
3344602564,  raff8181, 9, 1, 8, no
412230108,  ilariovs, 5, 2, 3, no
213510449,  JesBF, 3, 1, 2, no
729773119481729025,  90minofglory, 2, 1, 1, neutral
3920924531,  blackishbird, 2, 1, 1, neutral
104743153,  Pantupino, 2, 1, 1, neutral
459376232,  gian_per, 2, 1, 1, neutral
771069585437106176,  Costa9Domenico, 4, 2, 2, neutral
2975150735,  cmartinezfn, 2, 1, 1, neutral
519371670,  Michaelpayet_06, 2, 1, 1, neutral
163431724,  LucaChieri, 2, 1, 1, neutral
1095557395,  FanisaUnicorn, 5, 3, 2, yes
321885054,  flamanc24, 3, 2, 1, yes
2958337995,  itswaya, 3, 2, 1, yes
791324802,  lightning4lou, 2, 1, 1, neutral
4872175240,  jauxyg, 2, 1, 1, neutral
738350242597310464,  atimo13, 2, 1, 1, neutral
1357729789,  cookieschipsj, 2, 1, 1, neutral
720194261195612161,  nikileroy, 2, 1, 1, neutral
1622764164,  danilo71L, 3, 2, 1, yes
4889123818,  lauzzajuliette1, 2, 1, 1, neutral
1395347809,  ThiebauldVEGA, 2, 1, 1, neutral
710406576,  Riddlebitches, 2, 1, 1, neutral
2814040655,  _snowqveen_, 2, 1, 1, neutral
545187530,  DE92VRIL84, 2, 1, 1, neutral
767081839592898560,  MAGA4MAGA, 2, 1, 1, neutral
2879695709,  frances_fangirl, 2, 1, 1, neutral
960220688,  MaCamiRichard, 2, 1, 1, neutral
1399672915,  AimAgnes, 2, 1, 1, neutral
2210367702,  _eriss, 2, 1, 1, neutral
472031486,  kingiuseppe, 4, 2, 2, neutral
486094670,  michela_juve, 2, 1, 1, neutral
520808720,  9953_maria, 5, 2, 3, no
740809051,  mikasjeyes, 3, 2, 1, yes
282118722,  camizecson, 2, 1, 1, neutral
52056974,  _andreaci, 2, 1, 1, neutral
90414424,  bentthebow, 2, 1, 1, neutral
182506310,  llemj, 10, 7, 3, yes
109318878,  adelu1893, 2, 1, 1, neutral
302574460,  RubenMigliardi, 2, 1, 1, neutral
93908411,  mmarziapan, 2, 1, 1, neutral
48986651,  DavideGiaquinta, 2, 1, 1, neutral
2934981209,  killemwithbooks, 2, 1, 1, neutral
808878834,  EPalazzotto, 2, 1, 1, neutral
1718923932,  lores996, 2, 1, 1, neutral
792376445234544642,  Delille73485885, 2, 1, 1, neutral
546360278,  AchilleOrti, 2, 1, 1, neutral
795924287827886080,  PRFNINA, 2, 1, 1, neutral
2688034927,  SerenaGullo, 4, 2, 2, neutral
493203375,  admaioraasemper, 2, 1, 1, neutral
200971949,  ClaudioZelli, 4, 2, 2, neutral
3243854397,  Franca_Tortone, 2, 1, 1, neutral
2233502635,  ilmerdone, 14, 3, 11, no
278156769,  rougeBLN, 9, 3, 6, no
895467806,  giuseppesoro, 2, 1, 1, neutral
1055601199,  svergognate, 2, 1, 1, neutral
272065406,  Marylena_88, 2, 1, 1, neutral
1161230660,  jiennense81, 2, 1, 1, neutral
2424685421,  leveque_louis, 2, 1, 1, neutral
1037244210,  supervimer68ann, 2, 1, 1, neutral
50091606,  __Yuki, 2, 1, 1, neutral
309660237,  Roberta_Toce, 2, 1, 1, neutral
732270119167119364,  martinasant8r, 5, 1, 4, no
6532332,  binarioloco, 13, 1, 12, no
598450688,  OfficialMike96, 2, 1, 1, neutral
83420146,  amysteron, 2, 1, 1, neutral
75113071,  vontrotta, 3, 1, 2, no
2301509469,  Daguethd, 2, 1, 1, neutral
3293835401,  LaurianeTroise, 2, 1, 1, neutral
4736046826,  AntiEU2, 2, 1, 1, neutral
2750787818,  politique__FR, 2, 1, 1, neutral
464607293,  maIikseyes, 2, 1, 1, neutral
2412802144,  suvrrealism, 2, 1, 1, neutral
189473791,  vespgs, 2, 1, 1, neutral
2807284487,  2Lamare, 2, 1, 1, neutral
3555745761,  VigilantCitoyen, 2, 1, 1, neutral
991475617,  xalmostfearless, 2, 1, 1, neutral
2789274177,  istandbyzain, 2, 1, 1, neutral
2785392735,  RTID95, 2, 1, 1, neutral
730850159597371394,  amarupactoo, 2, 1, 1, neutral
74464980,  scodelarjo, 2, 1, 1, neutral
276103905,  belleasario, 2, 1, 1, neutral
892592580,  piu_rivolta, 2, 1, 1, neutral
114219469,  CoralineJawns, 2, 1, 1, neutral
4381865057,  interisti_faotw, 20, 10, 10, neutral
137678092,  patgia, 2, 1, 1, neutral
501775506,  Sary8686, 7, 5, 2, yes
221108664,  Asdfghjklgron, 2, 1, 1, neutral
2780466756,  lascallons, 11, 5, 6, no
3261651495,  AngeloAquilante, 3, 2, 1, yes
352308407,  la_stordita, 3, 1, 2, no
935064852,  yorogenewara, 2, 1, 1, neutral
2203060653,  briankinneyy, 2, 1, 1, neutral
631191906,  maynegeek, 2, 1, 1, neutral
274014013,  MariaNwitty, 2, 1, 1, neutral
2979665872,  CiaoRetweet, 2, 1, 1, neutral
266716563,  charlesusantene, 2, 1, 1, neutral
719771713,  nhoranseyes, 2, 1, 1, neutral
770873928357142528,  LeNomDeLaRose1, 2, 1, 1, neutral
3402352203,  CaroKarocaraco, 2, 1, 1, neutral
796067168135872513,  Tintin_au_Congo, 2, 1, 1, neutral
448757832,  MMarracino, 2, 1, 1, neutral
447399561,  Tempsavenir, 2, 1, 1, neutral
2882893959,  SatcitStefano, 2, 1, 1, neutral
486558341,  Cla_Interista23, 2, 1, 1, neutral
708673285526003712,  patriziagallo9, 2, 1, 1, neutral
418205094,  fede_chic, 4, 2, 2, neutral
2759766535,  tsukkimei, 2, 1, 1, neutral
742756630530527232,  DocEmRu, 2, 1, 1, neutral
406995185,  profondisospiri, 2, 1, 1, neutral
720518351160766465,  Cesar1kenobi, 2, 1, 1, neutral
36730956,  yokainokami, 2, 1, 1, neutral
805620493306970114,  vodnoistrane, 2, 1, 1, neutral
773957047,  Mecdedroite, 2, 1, 1, neutral
1349467232,  Je_Scotti, 2, 1, 1, neutral
465974369,  se_semy, 2, 1, 1, neutral
485667605,  yellowmengo, 3, 2, 1, yes
269221313,  CarloOneto, 3, 1, 2, no
167711502,  welfera, 4, 2, 2, neutral
2511071489,  languagegeek64, 2, 1, 1, neutral
1318997617,  GuerreraMartina, 2, 1, 1, neutral
2576702326,  Bleavch, 2, 1, 1, neutral
802553881523785729,  AliceinBerry, 2, 1, 1, neutral
3096894040,  brianstringimii, 4, 2, 2, neutral
252708684,  trickytree2, 2, 1, 1, neutral
704824110,  marcoghilo, 2, 1, 1, neutral
473864520,  NorgePrivacy, 2, 1, 1, neutral
2589004001,  jimmyscotloyal, 2, 1, 1, neutral
49403532,  JulietFredster, 2, 1, 1, neutral
22617135,  mask13, 8, 5, 3, yes
193709635,  hermionesbrain, 2, 1, 1, neutral
2732346654,  Dieumeo, 2, 1, 1, neutral
1044718873,  fermatimondo, 2, 1, 1, neutral
3423566421,  legouge_chantal, 2, 1, 1, neutral
740822193463001088,  AntoineServes, 2, 1, 1, neutral
406516558,  Sbonini51, 4, 2, 2, neutral
754054364675837952,  jonathanleduc3, 2, 1, 1, neutral
3026284298,  Pirichello, 2, 1, 1, neutral
100574648,  savieze, 2, 1, 1, neutral
160249410,  ellycalvino, 3, 2, 1, yes
787818033792319488,  TchetcheMse, 2, 1, 1, neutral
373384107,  daeneryswift, 2, 1, 1, neutral
3385908647,  Eric_Essonne, 2, 1, 1, neutral
1553353790,  PFousduroi, 2, 1, 1, neutral
198428547,  __dolceparanoia, 2, 1, 1, neutral
1230533647,  giovanschi, 2, 1, 1, neutral
2961675897,  stilinkswift, 2, 1, 1, neutral
1001652342,  BetNadia, 4, 3, 1, yes
518938648,  FrancoiseFr, 2, 1, 1, neutral
779441478754066432,  monto_no_grazie, 2, 1, 1, neutral
2865915155,  Sdc77Sd, 2, 1, 1, neutral
129524640,  taylorscandy, 2, 1, 1, neutral
2476006158,  PatrioteAvecMLP, 2, 1, 1, neutral
3026533353,  hopexdisease, 3, 2, 1, yes
1601215584,  taylorslaugh13, 2, 1, 1, neutral
1453931582,  Justins_cake, 2, 1, 1, neutral
797831247552741377,  gustafsson_bo, 2, 1, 1, neutral
816169412,  likearunaway, 2, 1, 1, neutral
443262320,  SalviMassimo, 3, 2, 1, yes
1904491862,  AcropoliAndrea, 2, 1, 1, neutral
3224857906,  LeforetVincent, 2, 1, 1, neutral
830673488,  Biancacr7, 2, 1, 1, neutral
776361332417363968,  cyranoge, 2, 1, 1, neutral
799252800295337984,  simonardecchia1, 2, 1, 1, neutral
2346624322,  holyvirtute, 3, 1, 2, no
560575395,  NicholasBoano, 2, 1, 1, neutral
742837576738975744,  WarAgainstElite, 2, 1, 1, neutral
4831023773,  rakk_g, 23, 13, 10, yes
1150683211,  scombussolata, 2, 1, 1, neutral
1365384444,  EnricoAnzuini, 3, 1, 2, no
925649047,  nicdemuro, 8, 4, 4, neutral
182718421,  stefaniaconti, 2, 1, 1, neutral
420198152,  untizio, 2, 1, 1, neutral
2283720636,  DituccioNatalia, 4, 2, 2, neutral
1320734106,  CriPe78, 3, 2, 1, yes
624903,  vittoriopasteris, 3, 1, 2, no
1042128265,  TeoGardelli, 2, 1, 1, neutral
182839403,  amotalbrezza, 2, 1, 1, neutral
234083279,  Neko_PLS, 2, 1, 1, neutral
140574541,  ilpestifero, 2, 1, 1, neutral
37010284,  abc3d, 2, 1, 1, neutral
380121816,  statonero, 2, 1, 1, neutral
119851176,  licha74, 2, 1, 1, neutral
128030995,  calvalais, 2, 1, 1, neutral
1002209329,  moudubulbe, 2, 1, 1, neutral
4054402138,  VBAntwerpen, 2, 1, 1, neutral
570942587,  muggleswift, 2, 1, 1, neutral
4876178589,  gameofstronz, 2, 1, 1, neutral
186579391,  sheisntamuggle, 4, 2, 2, neutral
4210408893,  gamjef, 2, 1, 1, neutral
331211590,  Optioignons, 6, 3, 3, neutral
4767821596,  Patajkowski, 2, 1, 1, neutral
1350188071,  Pierre_Aliotti, 2, 1, 1, neutral
43668981,  Rede_Freiheit, 2, 1, 1, neutral
95727438,  xhysteria, 2, 1, 1, neutral
3248658963,  2LaRocheJaquel1, 2, 1, 1, neutral
381986062,  SabJORET, 2, 1, 1, neutral
204700178,  Jispe42, 2, 1, 1, neutral
1302109832,  E02062010, 2, 1, 1, neutral
477647280,  RougeAnton, 2, 1, 1, neutral
709488378601938945,  AndreaBarcaroli, 4, 2, 2, neutral
4846328158,  letteratto, 2, 1, 1, neutral
24026780,  Simone_1985, 3, 1, 2, no
1104139692,  FrankZanata, 7, 6, 1, yes
728344128,  ayradw, 3, 1, 2, no
1954450338,  ninolofaro, 12, 2, 10, no
470505630,  _JWOOW_, 2, 1, 1, neutral
426738122,  iscaramuzzi, 2, 1, 1, neutral
621823364,  cucinapergioco, 9, 4, 5, no
589283111,  CorkScrew12, 2, 1, 1, neutral
2704308742,  AngeloMaggioni3, 7, 1, 6, no
246772500,  holdmetay, 3, 2, 1, yes
2209980606,  BronzeAgePerv, 2, 1, 1, neutral
369481356,  TheBanale, 3, 1, 2, no
4471649477,  Patriavox1, 2, 1, 1, neutral
971590585,  FAVARIOSTEPHANE, 2, 1, 1, neutral
3028675941,  MiriamMiriam95, 2, 1, 1, neutral
550095169,  SilvaVeeronica, 2, 1, 1, neutral
317290072,  drewshug, 2, 1, 1, neutral
522235357,  PennysWorlds, 2, 1, 1, neutral
1638697916,  the1975sforce, 2, 1, 1, neutral
56181278,  _hedaleksa, 2, 1, 1, neutral
2370990638,  Giulia_Ruga, 4, 2, 2, neutral
2175600064,  UtenteRafa, 2, 1, 1, neutral
866989236,  manraino_manila, 2, 1, 1, neutral
1104861216,  ygrittebardot, 5, 3, 2, yes
707242997772115968,  Fottesega2, 3, 2, 1, yes
458273458,  ohgillovny, 2, 1, 1, neutral
411540072,  klaineismydrug, 2, 1, 1, neutral
472933655,  KazeGaFuite, 2, 1, 1, neutral
1389760255,  marrymejleto, 2, 1, 1, neutral
464742784,  ssimelime, 2, 1, 1, neutral
103372549,  eclipsam, 2, 1, 1, neutral
448805388,  lilacjuls, 2, 1, 1, neutral
174975279,  heresclaudia, 2, 1, 1, neutral
2238936648,  ehygleecast, 2, 1, 1, neutral
871599601,  sine_injuria, 4, 2, 2, neutral
878470657,  stringimimiley, 2, 1, 1, neutral
462904107,  fabydep, 2, 1, 1, neutral
3339570563,  latuavitaintera, 2, 1, 1, neutral
354780315,  massoriso, 2, 1, 1, neutral
1941482832,  lieawakeatnight, 2, 1, 1, neutral
2407966115,  emanuele_pala, 2, 1, 1, neutral
2178104040,  PakamamaniRenew, 4, 2, 2, neutral
566273326,  StandUpWhiteMan, 2, 1, 1, neutral
144544732,  Thomas_NJR, 2, 1, 1, neutral
18038480,  zamajama, 2, 1, 1, neutral
48503866,  micheleriso, 2, 1, 1, neutral
735856962299002880,  pononzu, 2, 1, 1, neutral
712318816940892161,  dnelson9411, 2, 1, 1, neutral
336185185,  yuweile, 2, 1, 1, neutral
1399994942,  InfosFrance_, 2, 1, 1, neutral
3309232338,  EmilyEldritch, 2, 1, 1, neutral
737191122947182593,  looping13008, 2, 1, 1, neutral
4910769383,  KevinPoncin1, 2, 1, 1, neutral
1072827031,  BladeEngelhart, 2, 1, 1, neutral
2874782554,  Beyoncekrs, 2, 1, 1, neutral
4475060655,  57938Droite, 2, 1, 1, neutral
2802525209,  BeyonceTopItaly, 2, 1, 1, neutral
2890485383,  PerfezioneYonce, 2, 1, 1, neutral
2890459491,  FamigliaKnowles, 2, 1, 1, neutral
341380445,  glspisso, 3, 2, 1, yes
459598831,  Het421, 2, 1, 1, neutral
70028005,  Napoleonien, 4, 2, 2, neutral
3159889551,  BeyonceMagnetic, 2, 1, 1, neutral
4783839862,  Beyoncesempre1, 2, 1, 1, neutral
3118951852,  OnTheRunWorld, 2, 1, 1, neutral
3118852569,  ForEverYoungB1, 2, 1, 1, neutral
261300530,  MichaelScalia30, 2, 1, 1, neutral
2591260712,  CapuPatriote, 3, 1, 2, no
1308806863,  tecnopools, 2, 1, 1, neutral
938764705,  renatobamonte, 4, 2, 2, neutral
301341405,  pescajr93, 2, 1, 1, neutral
798770750614179841,  nonhocapito_, 2, 1, 1, neutral
193209316,  superki20, 2, 1, 1, neutral
75144085,  Olty86, 2, 1, 1, neutral
148051169,  xgoldenlight, 2, 1, 1, neutral
524757836,  unocomete, 2, 1, 1, neutral
464826623,  Florian_Famchon, 2, 1, 1, neutral
1718681611,  PPaolapratic, 2, 1, 1, neutral
697913625516843008,  L3g3nDarYyYy, 4, 3, 1, yes
767019520355696640,  john_darkangel, 2, 1, 1, neutral
2753206624,  matteobisce, 2, 1, 1, neutral
630926258,  wenderped, 2, 1, 1, neutral
3087599830,  M_HURTADOS, 2, 1, 1, neutral
2508134754,  ManganoFlavia, 2, 1, 1, neutral
3416046153,  SYuliaSalazar, 5, 4, 1, yes
41802500,  kinpatu, 4, 2, 2, neutral
798776363679301632,  romuluscaesar, 2, 1, 1, neutral
14168372,  Shabbosgoy, 2, 1, 1, neutral
3299164115,  BmAstrom, 2, 1, 1, neutral
616343678,  _likealondoner, 4, 2, 2, neutral
3289859705,  PatrioteFRA, 2, 1, 1, neutral
3732499037,  bengie_barin, 2, 1, 1, neutral
8882322,  periucs, 4, 2, 2, neutral
4265370202,  EarlGreyIsLife, 2, 1, 1, neutral
2999912092,  Minvielle732, 2, 1, 1, neutral
3312841702,  sopadepa, 3, 1, 2, no
95953453,  uLuvMySwagga, 2, 1, 1, neutral
389631640,  fragerist, 2, 1, 1, neutral
139228624,  KevinDav, 2, 1, 1, neutral
4828934602,  jeromeLnG, 2, 1, 1, neutral
112614146,  EscapeVelo, 2, 1, 1, neutral
2438022373,  SZYCH1, 2, 1, 1, neutral
3651369075,  RadiceAndrea, 4, 2, 2, neutral
751527727623180292,  franck_parisi, 2, 1, 1, neutral
4753982776,  LeMontlherien, 2, 1, 1, neutral
4718930295,  AntreduPatriote, 2, 1, 1, neutral
2855083180,  Dormez_Dormez, 2, 1, 1, neutral
75386921,  CampagnaEric, 2, 1, 1, neutral
821581256,  Frenk4ever, 2, 1, 1, neutral
741690938683215874,  nuvolinatw, 7, 3, 4, no
3612539669,  NadiaMol24, 2, 1, 1, neutral
2795420974,  PSbelgeEuroparl, 2, 1, 1, neutral
50692934,  joemalloz, 2, 1, 1, neutral
581963098,  Ossessivante, 2, 1, 1, neutral
47778217,  SaxicaiaMolotov, 2, 1, 1, neutral
768585707812249602,  SigBrambo, 4, 2, 2, neutral
525063058,  rouzierc, 2, 1, 1, neutral
2632275819,  paladigm, 2, 1, 1, neutral
3361208621,  CLotirchio, 3, 1, 2, no
2497173595,  dlt_mf, 2, 1, 1, neutral
858023484,  helerrie, 2, 1, 1, neutral
394757811,  __iaia, 2, 1, 1, neutral
377535786,  __ouutoftime, 2, 1, 1, neutral
1364516803,  francibonazz, 5, 4, 1, yes
100866799,  I_am_so_yammy, 3, 2, 1, yes
329273246,  mrogai, 2, 1, 1, neutral
227747116,  herondaele, 12, 6, 6, neutral
761405641,  AkealaLeu, 3, 1, 2, no
1117368404,  blvankspace, 4, 2, 2, neutral
1347013046,  heronsvtairs, 2, 1, 1, neutral
125361086,  fabiohi010, 2, 1, 1, neutral
65605218,  __dems, 2, 1, 1, neutral
272999536,  climbinguphill, 2, 1, 1, neutral
405336045,  RdeMontauban, 2, 1, 1, neutral
2744831692,  Hillary_luke, 2, 1, 1, neutral
2749097397,  angelever999, 4, 2, 2, neutral
337113817,  _InsaneforKaty, 2, 1, 1, neutral
2779103913,  hidethebone74, 3, 1, 2, no
574784216,  fandebleu, 2, 1, 1, neutral
3606563476,  patrick_le_fur, 2, 1, 1, neutral
749945237267775488,  PrinceRegards, 2, 1, 1, neutral
747084291910287360,  SpainBrexit, 3, 1, 2, no
2283682018,  KURTCOVBAIN, 2, 1, 1, neutral
975016903,  Assodispada, 4, 2, 2, neutral
402364870,  stefanobellelli, 2, 1, 1, neutral
701509209372938240,  g_alo87, 2, 1, 1, neutral
462298361,  davids7683, 8, 1, 7, no
1943373336,  ziocca, 4, 2, 2, neutral
2884059647,  ddwwbananaH, 2, 1, 1, neutral
4471814843,  helloitsferre, 2, 1, 1, neutral
555071417,  hopingjannah, 2, 1, 1, neutral
2563652370,  Francesca_grf, 2, 1, 1, neutral
365580871,  2fabs4u, 2, 1, 1, neutral
452188444,  domibis69, 2, 1, 1, neutral
3157278766,  enigmharry, 2, 1, 1, neutral
718184199908421632,  alessandrop543, 4, 2, 2, neutral
550989469,  xtwentyonebeans, 2, 1, 1, neutral
4902342166,  rosaria74733, 21, 1, 20, no
584167435,  imymat, 2, 1, 1, neutral
549017302,  Santuz15, 2, 1, 1, neutral
2903730303,  riccardopaier, 2, 1, 1, neutral
417250524,  ClaudiaSTArt, 2, 1, 1, neutral
2999816867,  JacopoCairoli, 5, 1, 4, no
517829387,  lizziescrown, 4, 2, 2, neutral
2746506610,  foggia_angelo, 2, 1, 1, neutral
804994692001755136,  comitejeanne88, 2, 1, 1, neutral
2289550287,  sam_dharma, 2, 1, 1, neutral
73390007,  marcyse26, 2, 1, 1, neutral
1274373458,  cristinaiarussi, 11, 6, 5, yes
616449313,  SpeclalOrdesySr, 2, 1, 1, neutral
552159417,  dyopamina, 2, 1, 1, neutral
3419514238,  DecimusSaxon, 2, 1, 1, neutral
3111742566,  PatrickMcMeekin, 2, 1, 1, neutral
4185742553,  moniquefrancoi2, 2, 1, 1, neutral
1117768854,  WilsonR_FNJ, 2, 1, 1, neutral
803979599210233856,  alerota1126, 16, 6, 10, no
448091207,  OrnellaCostanzo, 3, 1, 2, no
30585852,  danielelombardi, 3, 2, 1, yes
4812987399,  avvlerose, 3, 2, 1, yes
2866342738,  cartabon, 2, 1, 1, neutral
1493705738,  antoniotuveri, 2, 1, 1, neutral
945602516,  patrunoladige, 5, 4, 1, yes
184436023,  lamarty_twi, 2, 1, 1, neutral
200583728,  agalli79, 2, 1, 1, neutral
776898032,  filippo_aletti, 2, 1, 1, neutral
626507265,  PaulCheeks1, 2, 1, 1, neutral
1658568734,  Dtam81, 2, 1, 1, neutral
880663495,  Di_Lorenzo_D, 2, 1, 1, neutral
3126467891,  ShinyWingsLives, 2, 1, 1, neutral
454298153,  stefanofloriani, 3, 2, 1, yes
2516438067,  Charliee273, 2, 1, 1, neutral
492072949,  78Andreapinna, 4, 2, 2, neutral
2393135499,  eestlezzlemyniz, 2, 1, 1, neutral
235254856,  xSha97, 2, 1, 1, neutral
158045268,  heartbbeatles, 2, 1, 1, neutral
225413045,  halfshellgirl, 2, 1, 1, neutral
162417963,  swagistheway_, 2, 1, 1, neutral
69261007,  MarcoFigura86, 2, 1, 1, neutral
1357953734,  DomaniLoFaccio, 2, 1, 1, neutral
379070175,  vlb1964, 2, 1, 1, neutral
4860386050,  RobertaCagliani, 2, 1, 1, neutral
1226124266,  lorypil66, 3, 2, 1, yes
1967427518,  wishingspelI, 2, 1, 1, neutral
1267905607,  sunyakuza, 2, 1, 1, neutral
330001423,  Lu5174n14nD3m0n, 2, 1, 1, neutral
34747554,  abiraghi, 2, 1, 1, neutral
1652598498,  xavier0000000, 2, 1, 1, neutral
120106830,  Natureauxpommes, 2, 1, 1, neutral
227078040,  herondaler, 2, 1, 1, neutral
747062107636637697,  IvanDellaRocca1, 28, 9, 19, no
120807934,  ratliffsbear, 2, 1, 1, neutral
794308291,  _AssassinPanda, 2, 1, 1, neutral
995017814,  valentinalupia, 2, 1, 1, neutral
1901680303,  louserss, 2, 1, 1, neutral
715186946616725504,  minpiper, 5, 1, 4, no
1715694210,  _lifthrasir, 2, 1, 1, neutral
29500667,  BLACKMAGE90, 2, 1, 1, neutral
252070368,  QueenAntigona, 2, 1, 1, neutral
621177503,  Pinkman_inWhite, 2, 1, 1, neutral
1238832624,  ChibiAnto96, 2, 1, 1, neutral
956265056,  Lamad801, 2, 1, 1, neutral
554260599,  Giovanni2392, 2, 1, 1, neutral
3013948526,  clax_mar, 2, 1, 1, neutral
398052407,  JonnyVioni, 2, 1, 1, neutral
561992546,  pierre_1er, 2, 1, 1, neutral
922613564,  mightyguy1357, 10, 1, 9, no
2212154793,  DONATOGiaffred1, 2, 1, 1, neutral
109545003,  Lampis93, 2, 1, 1, neutral
354188080,  marshcaps, 2, 1, 1, neutral
795940967547371520,  The_Actuator, 2, 1, 1, neutral
2922134615,  pellesegraren, 2, 1, 1, neutral
451224111,  Ruhr_Poet, 2, 1, 1, neutral
890819750,  Leonesidiventa, 6, 3, 3, neutral
94567726,  unFabbioAcaso, 2, 1, 1, neutral
96233686,  HELY91, 31, 2, 29, no
108617789,  giacomocorsetti, 2, 1, 1, neutral
728275910382759936,  rollingntheweed, 2, 1, 1, neutral
84307195,  neurocaos, 4, 1, 3, no
2939616575,  tabacchi23, 2, 1, 1, neutral
479674519,  arthasastra85, 2, 1, 1, neutral
517628785,  tiptouis, 2, 1, 1, neutral
111341568,  RobRianna, 4, 2, 2, neutral
47099943,  Anfitrite_s, 2, 1, 1, neutral
2820362326,  AgtAlesii, 5, 2, 3, no
328467683,  MrsGenes, 2, 1, 1, neutral
179385678,  Dadavaldeger, 5, 3, 2, yes
871789964,  irenetta, 3, 1, 2, no
3099096688,  TaszuC, 2, 1, 1, neutral
1095354780,  massimogara, 3, 1, 2, no
792455432765894656,  MikiDarnel, 5, 2, 3, no
2970015723,  MariaGiuliaDelf, 9, 4, 5, no
212168721,  ENZOPOLLIO, 2, 1, 1, neutral
2203727552,  neribrixia, 9, 4, 5, no
2508115583,  filmartinelli, 2, 1, 1, neutral
3169786348,  gloriapoch72, 2, 1, 1, neutral
4857021047,  AnnaLoick, 2, 1, 1, neutral
829500602,  G0rille, 2, 1, 1, neutral
724954252590899204,  BarbaraMazieres, 2, 1, 1, neutral
197558355,  elizbethbennet, 2, 1, 1, neutral
3294739884,  sonja__v, 2, 1, 1, neutral
1080939919,  Kwonfident__, 2, 1, 1, neutral
156514846,  more1535ad, 2, 1, 1, neutral
1577448744,  ARTISYOURWEAPON, 2, 1, 1, neutral
372941306,  scorpion496, 2, 1, 1, neutral
2364035605,  marcoferrari65, 3, 2, 1, yes
89413278,  katia_1988, 2, 1, 1, neutral
1596726240,  petraziaa, 2, 1, 1, neutral
415664629,  lookafterjouis, 4, 2, 2, neutral
2240344787,  Emilio_Fish, 2, 1, 1, neutral
787131799226966016,  ColinMc07529254, 2, 1, 1, neutral
3317634244,  SpudFNVPN, 3, 1, 2, no
2307190207,  Blondienella, 2, 1, 1, neutral
746511403318652928,  Distrust_Snek, 2, 1, 1, neutral
421370158,  maxfalletta, 6, 5, 1, yes
789968486,  ashappyaslarryy, 3, 2, 1, yes
84827943,  teuzzo78, 2, 1, 1, neutral
84323407,  barrendero, 2, 1, 1, neutral
40354809,  maplewhite1912, 5, 1, 4, no
16585163,  robertlover, 4, 2, 2, neutral
2322318698,  Savelli_Antonio, 4, 2, 2, neutral
118905925,  Budoia2005, 3, 1, 2, no
42394660,  givenchealy, 2, 1, 1, neutral
91854812,  Neestore, 4, 3, 1, yes
2841102357,  glafkopis, 3, 2, 1, yes
15880918,  ginodb, 2, 1, 1, neutral
311414428,  albza, 2, 1, 1, neutral
2958660693,  algol6555, 8, 4, 4, neutral
273549470,  cipix81, 2, 1, 1, neutral
4646013268,  FnMulhouse, 4, 2, 2, neutral
439147800,  caterinabert, 2, 1, 1, neutral
3694467856,  tepeepa, 4, 2, 2, neutral
492206430,  DomenicoZappone, 4, 2, 2, neutral
370828082,  johnnyaddict, 2, 1, 1, neutral
35503245,  lafracasse, 2, 1, 1, neutral
726283597,  ellielsx, 2, 1, 1, neutral
3131324031,  dearlights, 2, 1, 1, neutral
247749765,  B_asseur, 2, 1, 1, neutral
2305196953,  MrZeman1, 2, 1, 1, neutral
154122731,  undermoonphases, 2, 1, 1, neutral
2842490193,  LenaSomewhere, 2, 1, 1, neutral
490213783,  MariaZollo, 2, 1, 1, neutral
2807410572,  _madsness, 2, 1, 1, neutral
791341431625490432,  paolozuni, 2, 1, 1, neutral
997143709,  Radio_Amore, 2, 1, 1, neutral
149477026,  0101OSX, 2, 1, 1, neutral
3997079128,  giuliarosania, 2, 1, 1, neutral
503388013,  JimmySmr14, 2, 1, 1, neutral
940908529,  giacomur, 2, 1, 1, neutral
403618249,  MikaelCareo, 2, 1, 1, neutral
4827286889,  caval4283, 2, 1, 1, neutral
777533982019846144,  CNamaratha, 2, 1, 1, neutral
563726420,  Ororo_Pride, 2, 1, 1, neutral
713317918344224768,  realBasedFroggy, 2, 1, 1, neutral
1745292709,  Stan_fr01, 2, 1, 1, neutral
742926393600839680,  Milhous_vanH, 2, 1, 1, neutral
750005202913226752,  jokrgray, 3, 2, 1, yes
107614352,  xmalfoyswand, 2, 1, 1, neutral
87484016,  daisyinthewind, 2, 1, 1, neutral
1598457606,  NinboTobybonin, 2, 1, 1, neutral
744506482390147072,  bianchifrance14, 2, 1, 1, neutral
162247081,  ocarlosbernardo, 2, 1, 1, neutral
279872903,  StefanVersac, 2, 1, 1, neutral
698281146749091844,  ultra2062, 2, 1, 1, neutral
142041283,  alex_a66, 2, 1, 1, neutral
805587481320194048,  IgnoranzaDelNo, 15, 6, 9, no
22442522,  rustie9, 2, 1, 1, neutral
601729374,  LiamGallagher79, 2, 1, 1, neutral
1165732290,  maiunagloria, 2, 1, 1, neutral
740363588293001216,  ElusFNlimoges, 2, 1, 1, neutral
437890779,  _thewoodwoman, 2, 1, 1, neutral
565629669,  Tatiana_Rainbow, 2, 1, 1, neutral
905857526,  VeroticaSoler, 2, 1, 1, neutral
2558870687,  callevaleria7, 5, 1, 4, no
803609276493234176,  io_mallen, 2, 1, 1, neutral
2440665049,  Leggitore, 2, 1, 1, neutral
2979063580,  BlogAncien1, 3, 1, 2, no
44360307,  Diablo_2, 2, 1, 1, neutral
25265895,  zarkoh, 3, 1, 2, no
1849472767,  chessa72, 2, 1, 1, neutral
618161458,  Umberto_Garbini, 2, 1, 1, neutral
790268524690374656,  fn_laseyne, 2, 1, 1, neutral
280848678,  Salosso, 2, 1, 1, neutral
742468442595463168,  Younger_X_, 2, 1, 1, neutral
489369284,  LeeJames40, 2, 1, 1, neutral
209274991,  PinkBelgium, 2, 1, 1, neutral
624245528,  Jaygeta, 2, 1, 1, neutral
183401276,  DoctorRock87, 2, 1, 1, neutral
246417264,  daddacasula, 4, 1, 3, no
737104639078727680,  Durthain725, 2, 1, 1, neutral
978184280,  DamienRieu, 2, 1, 1, neutral
1156602380,  EnarpeeSvcs1, 2, 1, 1, neutral
4858427991,  hogan_p24, 2, 1, 1, neutral
304547610,  jassogne, 2, 1, 1, neutral
293721781,  NozNewz_com, 2, 1, 1, neutral
198594923,  kingkeyworth, 2, 1, 1, neutral
2716765703,  EshayAsFuck, 2, 1, 1, neutral
3039914459,  MEDIATIONS99, 2, 1, 1, neutral
2504620164,  krietischoog, 2, 1, 1, neutral
4691102114,  shekeljewlu, 2, 1, 1, neutral
743186109258141696,  NeutralMate, 2, 1, 1, neutral
261190096,  giuglia_g, 2, 1, 1, neutral
1951626373,  Dan_Auguste, 2, 1, 1, neutral
703082196706447360,  AmericanoVero, 2, 1, 1, neutral
921283669,  mannie132, 2, 1, 1, neutral
429301006,  GianpieroMarron, 3, 1, 2, no
585743372,  AntonioStrati, 2, 1, 1, neutral
555022598,  danydavoli, 2, 1, 1, neutral
829401716,  SteLannister87, 2, 1, 1, neutral
379321213,  davideterrile, 2, 1, 1, neutral
802557165949124608,  rigarigap, 3, 2, 1, yes
70969794,  domenicogatto, 5, 1, 4, no
2895052918,  2fab4ulouis, 8, 4, 4, neutral
3939678677,  Brunelli32, 3, 2, 1, yes
1339415130,  silmariellion, 2, 1, 1, neutral
261222906,  puremmorning, 2, 1, 1, neutral
8456532,  LorenzoGuerini, 2, 1, 1, neutral
96342800,  baronehx, 2, 1, 1, neutral
369404604,  chc_el, 3, 2, 1, yes
795601396091514880,  juanmanuellago7, 2, 1, 1, neutral
1145616823,  paolo_calosso, 7, 3, 4, no
748983667033251840,  Silent88Storm, 2, 1, 1, neutral
745472610,  BianchiAlby, 2, 1, 1, neutral
1020502986,  MichelottiMarco, 4, 2, 2, neutral
2998173538,  Manon_Bouquin, 2, 1, 1, neutral
314213206,  eros751229, 2, 1, 1, neutral
805735227930869760,  2allaterza1, 2, 1, 1, neutral
3891498863,  chiara_zr, 2, 1, 1, neutral
1697296957,  Ale80178, 7, 1, 6, no
4441408335,  vulindulela, 2, 1, 1, neutral
2394573401,  gaetanmarzo, 2, 1, 1, neutral
2657310359,  G_Parmentier, 2, 1, 1, neutral
34597895,  enrcasto, 3, 2, 1, yes
3417705226,  Delenaheart3, 2, 1, 1, neutral
1712604876,  BornetPhilippe, 2, 1, 1, neutral
218571835,  itsbrokenarrow, 2, 1, 1, neutral
3012976091,  patriotedumuy, 2, 1, 1, neutral
2951362894,  ladylou77414280, 2, 1, 1, neutral
291063176,  acupofantea, 2, 1, 1, neutral
543249993,  giudittagorreri, 2, 1, 1, neutral
512445330,  Rosalba470, 2, 1, 1, neutral
2169145898,  tobelaidee, 2, 1, 1, neutral
266187852,  itsiaiam, 2, 1, 1, neutral
3730828101,  nicola_ven65, 2, 1, 1, neutral
597492087,  cangelmar, 3, 1, 2, no
815088254,  ciaguida, 2, 1, 1, neutral
3198039994,  PinaPeppi, 3, 2, 1, yes
2530551944,  1Frenchpatriot, 2, 1, 1, neutral
537122343,  CosimoLopes, 2, 1, 1, neutral
330252561,  Vetriolo_, 4, 1, 3, no
1649996461,  rrossanaglm, 2, 1, 1, neutral
4643902636,  STR4NGEN, 4, 2, 2, neutral
1248957733,  SSegneri, 2, 1, 1, neutral
908047632,  LeaFrct, 2, 1, 1, neutral
790246284452061184,  424531J, 2, 1, 1, neutral
2489744155,  92LeavesOfGrass, 2, 1, 1, neutral
607392044,  Marsouins95130, 2, 1, 1, neutral
496881403,  Sanson538, 5, 3, 2, yes
141851917,  Thib63, 2, 1, 1, neutral
1520467537,  Scottdale_Wales, 2, 1, 1, neutral
584741992,  K_Betesh, 2, 1, 1, neutral
2850543058,  spiritogiusto, 2, 1, 1, neutral
2332651824,  PresMoratti, 2, 1, 1, neutral
539024606,  fraperruolo, 2, 1, 1, neutral
271446644,  lifeisaconcert, 2, 1, 1, neutral
4861944965,  Monica87608773, 2, 1, 1, neutral
289389588,  kcobainsvoice, 3, 2, 1, yes
1723165159,  eccoda, 2, 1, 1, neutral
3298871634,  stewloui, 2, 1, 1, neutral
47942188,  Teo85, 2, 1, 1, neutral
2173343885,  mamiedoux29, 2, 1, 1, neutral
608232130,  adroitetoutes01, 2, 1, 1, neutral
152756069,  MattiaGiovi, 2, 1, 1, neutral
235519831,  chiabante, 2, 1, 1, neutral
128753624,  Ukrayan, 2, 1, 1, neutral
526653195,  martyisnt96, 5, 4, 1, yes
968976661,  TarryNot, 2, 1, 1, neutral
2228252341,  zelakon, 2, 1, 1, neutral
1376315006,  PalisadesKid, 2, 1, 1, neutral
755440353667387396,  patriotismefn, 2, 1, 1, neutral
57979992,  Buzzissimo, 2, 1, 1, neutral
856177945,  LucaEltiem, 2, 1, 1, neutral
757957623882940416,  16Cendrillon, 2, 1, 1, neutral
1316416861,  adiosu46, 5, 1, 4, no
4445862023,  jnodari27, 2, 1, 1, neutral
546969164,  Komeroshvi, 2, 1, 1, neutral
3431793190,  BertugliAle, 2, 1, 1, neutral
1899538592,  1ALbane2e, 2, 1, 1, neutral
3410824053,  bananafish_fish, 2, 1, 1, neutral
538327861,  klossyalmighty, 2, 1, 1, neutral
873936596,  amonrouis, 3, 2, 1, yes
431929631,  ultimolettore, 2, 1, 1, neutral
398689228,  Capt__Eric, 2, 1, 1, neutral
545918446,  weedcaluvm, 2, 1, 1, neutral
160152464,  LukeMcCoy66, 2, 1, 1, neutral
774641216457732096,  lady_amERIKA, 2, 1, 1, neutral
771746798654386176,  corsica_lena, 2, 1, 1, neutral
441059645,  marcelus_75, 2, 1, 1, neutral
2407010399,  politik1correct, 2, 1, 1, neutral
3291426967,  ramon_s_bento, 2, 1, 1, neutral
387910823,  zaysarts, 2, 1, 1, neutral
740232343227670532,  thierry_TRO, 2, 1, 1, neutral
3113248858,  ClaudeRECLOUX, 2, 1, 1, neutral
955629762,  addictiall, 2, 1, 1, neutral
791439367994617857,  ironsights4545, 2, 1, 1, neutral
324546517,  ffedepi, 2, 1, 1, neutral
360292046,  marc_paquet, 2, 1, 1, neutral
477910347,  IAmMilyFlash, 2, 1, 1, neutral
1427364492,  Shyzzen, 2, 1, 1, neutral
796274996255592449,  __itsJesss, 2, 1, 1, neutral
2849996488,  D4mnD, 2, 1, 1, neutral
194113330,  daniele_cos, 2, 1, 1, neutral
1109715696,  Dariaiai, 2, 1, 1, neutral
156377258,  KDSLatvia, 2, 1, 1, neutral
753715123500515329,  anne_gorguet, 2, 1, 1, neutral
454349258,  ritalxp, 3, 1, 2, no
285832608,  Mainagioiaaa, 4, 2, 2, neutral
22601538,  britishongaku, 2, 1, 1, neutral
4621722087,  kellydsntcare, 6, 3, 3, neutral
3196146159,  an3sdej315, 2, 1, 1, neutral
2898313353,  Rubrub0, 2, 1, 1, neutral
512591252,  echelonbrother, 4, 1, 3, no
2241302364,  ANDREAESCIT, 3, 1, 2, no
85827368,  camstiel, 4, 2, 2, neutral
1933981711,  bellasideralia, 2, 1, 1, neutral
518582923,  Ale_Passu, 2, 1, 1, neutral
222224368,  giovy1967, 19, 6, 13, no
1728799644,  MeazziMarcello, 3, 2, 1, yes
278418434,  PrincipeKamar, 2, 1, 1, neutral
547841720,  screaminsiIence, 2, 1, 1, neutral
390067665,  fiorplunk, 2, 1, 1, neutral
1283444665,  timfowler7_tim, 2, 1, 1, neutral
635689685,  StefanoTrabalza, 3, 1, 2, no
805746946602336260,  MyleneWunsch, 2, 1, 1, neutral
202698449,  Nowhrbutup, 2, 1, 1, neutral
419617449,  Stevlena, 2, 1, 1, neutral
479469924,  LucaCianca1, 3, 2, 1, yes
112799591,  SanMarino_RTV, 6, 4, 2, yes
805031871902023681,  gubellom, 2, 1, 1, neutral
753941420801683456,  BelgedeSoucheII, 2, 1, 1, neutral
783010206552846336,  AJA1960, 2, 1, 1, neutral
2955345107,  pallina_22, 2, 1, 1, neutral
570780870,  AstonBeb, 2, 1, 1, neutral
704970032997113856,  FrontNational58, 2, 1, 1, neutral
717773702016942081,  V_G_Richard, 2, 1, 1, neutral
1377660199,  SEEL_Robert, 2, 1, 1, neutral
362391310,  ornsteat, 2, 1, 1, neutral
329682712,  mermaidbaek, 2, 1, 1, neutral
726840615099600897,  sinnerstown, 2, 1, 1, neutral
2860637732,  elizaschvyler, 2, 1, 1, neutral
118072089,  clarrkeent, 3, 1, 2, no
1119860160,  martypieri, 2, 1, 1, neutral
310909426,  Martucci_Giu, 2, 1, 1, neutral
102837827,  alotlikelife, 2, 1, 1, neutral
339224161,  pazzorikka, 2, 1, 1, neutral
418261517,  andreafasoli79, 3, 2, 1, yes
3555967877,  ivrivs, 4, 2, 2, neutral
184101181,  hoengrey, 2, 1, 1, neutral
89777464,  monchaelin, 2, 1, 1, neutral
817620290,  marcobobo89, 3, 1, 2, no
325448320,  AlmightyGDYB, 2, 1, 1, neutral
202672225,  lovetosaydada, 2, 1, 1, neutral
54779428,  Lu_kein, 3, 2, 1, yes
96295783,  Dubitatif71, 2, 1, 1, neutral
747315708762062848,  0Independance0, 2, 1, 1, neutral
482699435,  tony71230, 2, 1, 1, neutral
2592781686,  Dolomitstein, 2, 1, 1, neutral
3424592986,  periondegaula, 2, 1, 1, neutral
2256287230,  FLampunio, 6, 2, 4, no
228484503,  EricMauboussin, 2, 1, 1, neutral
2754985382,  dursogiacinto, 3, 1, 2, no
1046350843,  Mimi946Michel, 2, 1, 1, neutral
554485198,  _Stalker_69_, 2, 1, 1, neutral
256471924,  glowsred, 2, 1, 1, neutral
372238164,  lellone_, 6, 2, 4, no
3410528027,  eleon96_, 2, 1, 1, neutral
553446904,  dardennejulien, 2, 1, 1, neutral
4866118989,  gianluca171280, 2, 1, 1, neutral
1617713462,  sarfatisvoice, 4, 2, 2, neutral
1053228506,  stylinsten, 2, 1, 1, neutral
2416058143,  myrtille751, 5, 4, 1, yes
750049404,  AngeloRobert54, 2, 1, 1, neutral
1417917962,  Clodia94x, 2, 1, 1, neutral
100071422,  arthdevitton, 2, 1, 1, neutral
480693048,  NicoTormena19, 2, 1, 1, neutral
702741846,  jpclos1, 2, 1, 1, neutral
2361163792,  elena8418, 2, 1, 1, neutral
2299203717,  20RueduCirque, 2, 1, 1, neutral
2163518865,  JoRetra, 2, 1, 1, neutral
2896137460,  pierremiral, 2, 1, 1, neutral
118360232,  deliRyoum, 2, 1, 1, neutral
4889623209,  thehollowgirl, 2, 1, 1, neutral
237230989,  Sarci72, 2, 1, 1, neutral
735645005079928832,  realKyleOlbert, 2, 1, 1, neutral
3331551052,  SophieFreyja, 2, 1, 1, neutral
435313395,  ros95able, 2, 1, 1, neutral
408086130,  61ennepi, 2, 1, 1, neutral
1420722031,  mod_moonie, 3, 1, 2, no
731014922784673792,  BestKanar, 2, 1, 1, neutral
2939248977,  rougelias, 2, 1, 1, neutral
784073584453021696,  hranol_mario, 2, 1, 1, neutral
756135654627479552,  LauraBragazzi, 2, 1, 1, neutral
457387356,  VittorioBotti, 6, 5, 1, yes
3166059777,  caminadella, 2, 1, 1, neutral
4148028263,  Superman5Stelle, 3, 1, 2, no
4053878974,  M5S_IX, 3, 1, 2, no
4577525308,  GRILLI_STELLARI, 3, 2, 1, yes
2295866084,  MattHappies, 4, 2, 2, neutral
199923959,  MarPiColl, 19, 3, 16, no
367195342,  brasil_65, 7, 5, 2, yes
3041527646,  4lreadyTaken, 4, 3, 1, yes
442662989,  elettraglide, 2, 1, 1, neutral
804068008515764225,  Venanzi53812398, 2, 1, 1, neutral
3888190043,  smarts_24, 5, 1, 4, no
153424108,  domdu80, 2, 1, 1, neutral
701439340807905280,  meg_bandini, 4, 2, 2, neutral
150699335,  Paves8, 2, 1, 1, neutral
489540781,  Simona65Simona, 2, 1, 1, neutral
292756618,  Samuel_Bertozzi, 2, 1, 1, neutral
722093177923059712,  48donato, 2, 1, 1, neutral
203768804,  SandraLoPresti, 4, 3, 1, yes
150172108,  antonella17162, 5, 2, 3, no
380526746,  mrcllznn, 10, 4, 6, no
4133772051,  littleovetto, 3, 1, 2, no
717118902145261568,  BrunoLaMontagna, 3, 2, 1, yes
270894808,  MassimoE69, 2, 1, 1, neutral
2392107573,  MeHugIdols, 2, 1, 1, neutral
1066758002,  stephan29000912, 2, 1, 1, neutral
3148293489,  YanMaes, 2, 1, 1, neutral
293129112,  minasmazar, 3, 2, 1, yes
2920076253,  PmVerdiere, 2, 1, 1, neutral
3227618211,  MaisonPpl, 2, 1, 1, neutral
2295417636,  giorgiolope, 2, 1, 1, neutral
1646030030,  valenteilaria, 2, 1, 1, neutral
2274697020,  Cultur0, 2, 1, 1, neutral
1537543237,  fernandosfjr, 2, 1, 1, neutral
452021768,  Fabio_p4c, 3, 2, 1, yes
2966618765,  fasanoserena1, 2, 1, 1, neutral
2394069525,  Flory_Infantino, 2, 1, 1, neutral
1070434340,  solebastardo, 2, 1, 1, neutral
3000102892,  lellaluxRenold, 2, 1, 1, neutral
4084630696,  RiscattoNaz, 2, 1, 1, neutral
797791544182972416,  JSSIBUT, 2, 1, 1, neutral
4162970259,  mario_edelmann, 2, 1, 1, neutral
83923896,  martisaggg, 2, 1, 1, neutral
2318444406,  digecla, 4, 2, 2, neutral
2270277205,  Estikatzi, 2, 1, 1, neutral
1192065962,  foscolo9, 2, 1, 1, neutral
2394671973,  fmnonno, 2, 1, 1, neutral
38856509,  Sandro082, 2, 1, 1, neutral
3226046643,  hyqzplB9WaXHbAQ, 2, 1, 1, neutral
620824335,  DavideStastino, 2, 1, 1, neutral
3144802491,  APurpari, 2, 1, 1, neutral
739917955383889920,  gaveabreak, 3, 2, 1, yes
289857619,  zbruvi, 2, 1, 1, neutral
111728066,  gray_and_random, 4, 2, 2, neutral
4904659217,  paolino2016, 3, 2, 1, yes
1116320838,  SPAFFETTI, 7, 6, 1, yes
833471496,  erminiottone79, 2, 1, 1, neutral
2154514886,  LiberaDestra, 15, 0, 15, no
264652421,  robobot1999, 1, 0, 1, no
450639758,  Stevu75, 3, 0, 3, no
3155718400,  salvatore_dovi, 1, 0, 1, no
3136185147,  enzomedda62, 1, 0, 1, no
218246478,  gianpollano, 1, 0, 1, no
3007673747,  paolagott62, 6, 0, 6, no
221351837,  miyamotodan, 1, 0, 1, no
456508187,  laurauras, 10, 0, 10, no
538885766,  ScaramuzzaMiky, 4, 1, 3, no
2341941243,  ollilud, 2, 0, 2, no
523185127,  Matt_Orlandi, 4, 2, 2, neutral
415401236,  corradoserrenti, 1, 0, 1, no
4031602695,  catatimpano, 5, 0, 5, no
544319967,  EmanueleG1972, 1, 0, 1, no
373040181,  antolipari, 1, 0, 1, no
624454857,  AlessandroSusa1, 2, 0, 2, no
2234800475,  Alfodifi97, 1, 0, 1, no
2296120900,  EmanueleRaimon2, 1, 0, 1, no
1341410430,  FlagiellAlfredo, 2, 0, 2, no
1492135807,  nefelef, 5, 1, 4, no
1830959977,  damiano_tozzi, 1, 0, 1, no
858113870,  BartoloMeotti, 4, 1, 3, no
3149527702,  hevi_dilara, 1, 0, 1, no
2817019830,  ideadestra_, 4, 0, 4, no
427357728,  tagliocentrale, 9, 0, 9, no
326693198,  MicheleBottaro, 1, 0, 1, no
1375116127,  PaoloZobolip, 2, 0, 2, no
1091619487,  Mauri_Massari, 1, 0, 1, no
2172441530,  AlesCardone, 1, 0, 1, no
16476536,  ultimenotizie, 3, 0, 3, no
254554605,  ultima_ora, 3, 0, 3, no
4894384605,  AzioneNazTriest, 4, 0, 4, no
4794325156,  AzioneNazBari, 4, 0, 4, no
3017305876,  ClaudioM87, 4, 0, 4, no
543426963,  MazzittiRosella, 1, 0, 1, no
1325375234,  stefimilan74, 1, 0, 1, no
4164611393,  AMelito86, 1, 0, 1, no
798854842785546240,  garpnat, 1, 0, 1, no
4587842841,  FriuliVG_AN, 4, 0, 4, no
4588321522,  puglia_an, 4, 0, 4, no
796684829014245376,  LiberaDestraPug, 4, 0, 4, no
794484184979017728,  droitfuturista, 1, 0, 1, no
2327387029,  ncd_liberopensi, 2, 0, 2, no
2469173094,  GiuseppeBiond14, 1, 0, 1, no
553638765,  RobertoCuman, 1, 0, 1, no
405095429,  ClaudioTerni, 1, 0, 1, no
803112131793219584,  Andrea28696938, 1, 0, 1, no
429063865,  strescino, 2, 0, 2, no
394798713,  lanfrancoorland, 2, 0, 2, no
1254184530,  Peppe_Borrata, 3, 1, 2, no
1091721907,  38salpri, 1, 0, 1, no
464894684,  GenSangiuliano, 2, 0, 2, no
187238066,  mbc87, 2, 0, 2, no
2375818687,  Gianluc75932250, 1, 0, 1, no
1080986425,  eliodanna2, 2, 0, 2, no
87650574,  notiziepolitica, 2, 0, 2, no
391562318,  andrea_gardin, 1, 0, 1, no
3141952751,  luciopatalano63, 1, 0, 1, no
139055024,  antoniopascuzzo, 6, 0, 6, no
712710953503170560,  MicheleFurlan9, 5, 0, 5, no
224619251,  mathwess, 1, 0, 1, no
468410833,  giorgiogaias92, 2, 1, 1, neutral
552242067,  RobertoRanucci, 2, 0, 2, no
2416435813,  agst1977, 3, 2, 1, yes
338600797,  russoivan, 2, 1, 1, neutral
2779138041,  monica_ghelardi, 1, 0, 1, no
3201479849,  Gian_Sparascio, 5, 0, 5, no
282752093,  Italpress, 1, 0, 1, no
2856356531,  70Castaldi, 2, 0, 2, no
4818340347,  mov_ideaToscana, 11, 2, 9, no
38405320,  DODO_from_roma, 2, 0, 2, no
796449951643529216,  glucairish743, 3, 0, 3, no
996823994,  MarcoDeStefano_, 1, 0, 1, no
424281659,  giovaniperlalib, 1, 0, 1, no
989129461,  MarcoMFrisone, 1, 0, 1, no
464561589,  AntonioFiore68, 1, 0, 1, no
2216876508,  zzazzye, 3, 3, 0, yes
49420439,  marcellokurtz, 3, 3, 0, yes
151004376,  FinestraLibera, 4, 3, 1, yes
540343409,  BettiBetti2, 4, 4, 0, yes
4186339396,  dupont627, 3, 3, 0, yes
2892454897,  loevaa1, 3, 3, 0, yes
756546140644974596,  gdarm55, 20, 0, 20, no
475254497,  monica_tacchini, 19, 4, 15, no
386471970,  danieleocchi, 2, 0, 2, no
417230292,  gianluca_fabi, 10, 2, 8, no
194768449,  andreacecconi84, 4, 0, 4, no
440684594,  gherbitz, 2, 0, 2, no
82138891,  Bernaud21, 8, 1, 7, no
2504062057,  404tornosubito, 8, 6, 2, yes
2710647804,  diegodalboni, 3, 0, 3, no
17439787,  AndreaTj, 26, 1, 25, no
56473208,  alessandro613, 8, 0, 8, no
549936262,  Mork81cesarini, 2, 0, 2, no
745410799,  mmpbowen, 3, 0, 3, no
345698303,  GervasoLaPorta, 6, 0, 6, no
3405224997,  rossana306, 5, 0, 5, no
1239921037,  amich_carlo, 2, 1, 1, neutral
1002177384,  marisadapelo, 2, 1, 1, neutral
3065904687,  logos_kosmos, 3, 1, 2, no
193261391,  lucianodarda, 18, 6, 12, no
2528196035,  ItaliaValentino, 1, 1, 0, yes
236843404,  ctancpalm, 3, 2, 1, yes
9925862,  ilmiotg, 1, 0, 1, no
489199735,  alessandro_cant, 9, 4, 5, no
575688660,  livello5, 3, 0, 3, no
2514776575,  SelmiMary, 1, 0, 1, no
1092927026,  tordos57, 2, 0, 2, no
429242244,  ildernano, 2, 0, 2, no
97650801,  Michele_Potenza, 5, 1, 4, no
390642467,  Triwu, 1, 0, 1, no
2961401357,  VMozzato, 1, 0, 1, no
27992407,  RoccoCipriano, 38, 1, 37, no
782645175327739904,  Gianfrancobel16, 1, 0, 1, no
1114933988,  Dock32M, 5, 1, 4, no
2608189724,  OmarFerrari1991, 8, 0, 8, no
748035974647648257,  ggagliardi59, 7, 0, 7, no
1160257783,  Derrik_l, 2, 1, 1, neutral
1137933350,  santomik1, 1, 0, 1, no
84193474,  ivanl1987, 1, 0, 1, no
1371698587,  DonatoMola, 4, 2, 2, neutral
3032263864,  AlessiAnicca, 2, 0, 2, no
796742250961268741,  JFP_11, 2, 0, 2, no
154488615,  micheletarantin, 1, 0, 1, no
3232694020,  bora_carla, 2, 0, 2, no
92472734,  filippodini, 2, 1, 1, neutral
23315720,  guadagnalavita, 4, 2, 2, neutral
462129103,  massimiliano_ri, 1, 0, 1, no
269856706,  bas5stelle, 5, 0, 5, no
221153691,  fDY026, 3, 0, 3, no
44370691,  DiegoDeLorenzis, 11, 1, 10, no
137388733,  CVR74GRANATA, 3, 0, 3, no
466841459,  andperro74, 1, 0, 1, no
2930584301,  zabulaghi, 1, 0, 1, no
2207330516,  Andy_Cortese, 7, 0, 7, no
61703985,  unozerozer0, 10, 2, 8, no
4720868602,  disabilitainmov, 2, 0, 2, no
1249848746,  73Orlando73, 4, 0, 4, no
737633633356369921,  Cesare24900199, 1, 0, 1, no
37507247,  Riccardo_Nuti, 3, 0, 3, no
370200598,  variselli, 1, 0, 1, no
719515530001063937,  LeggieriM5S, 5, 0, 5, no
1269390866,  _corona1973, 4, 0, 4, no
1088929189,  Deth74, 2, 1, 1, neutral
267824934,  ioioeio, 5, 0, 5, no
448677905,  maxangeletti, 4, 2, 2, neutral
3121989501,  30b59cc2fc574f7, 1, 0, 1, no
501691674,  cinziabfc, 14, 1, 13, no
755281777,  liviomaretti, 5, 0, 5, no
2237570059,  mimiartino, 5, 1, 4, no
485408545,  AntoniaDartizio, 1, 0, 1, no
72621572,  antimpostium, 2, 1, 1, neutral
1035238824,  DavideRicci1973, 5, 1, 4, no
2239964759,  renemonf, 12, 0, 12, no
723150361112903680,  dbonfanti1341, 1, 0, 1, no
1326890640,  BlackcatMB, 1, 0, 1, no
3439290718,  tretretre333, 13, 3, 10, no
244451947,  BritishInside_, 2, 0, 2, no
2879971325,  SalPanaia, 2, 0, 2, no
2165533154,  davidedinoia, 2, 0, 2, no
318371203,  ludurdelfe, 7, 3, 4, no
192948690,  MysteryMiki, 2, 0, 2, no
4461052161,  EmanuelaBarrano, 6, 1, 5, no
531260671,  renatozanello, 3, 1, 2, no
2611745579,  MTrentini, 1, 0, 1, no
2865595678,  waliva1957, 18, 0, 18, no
13284492,  marcoscialdone, 2, 0, 2, no
805145682063589380,  mlchrr, 19, 0, 19, no
200313023,  Maria_Roberti_, 1, 0, 1, no
713698855032905728,  Michela73592286, 3, 0, 3, no
3077112633,  marty0576, 3, 0, 3, no
3355724674,  Carl6y6, 16, 7, 9, no
1119456882,  ferdisantoro, 3, 0, 3, no
1219049394,  LawViceconte, 1, 0, 1, no
839050856,  adrianvagnozzi, 4, 0, 4, no
483132641,  Marcopalmaxv, 13, 2, 11, no
462876561,  romabertone, 6, 0, 6, no
546658485,  giacomopenati, 5, 1, 4, no
46879002,  BitterStinger, 6, 0, 6, no
475134082,  JulesKemper, 20, 0, 20, no
188057072,  assenzio65, 2, 0, 2, no
2860212599,  Blu_Cad, 6, 1, 5, no
754269921949937665,  Muoviti66, 55, 0, 55, no
805663974431850496,  fabrizio1973f, 3, 0, 3, no
2311589125,  Piero1612, 2, 0, 2, no
1273356337,  menokk, 2, 0, 2, no
4592599288,  vinsci78, 2, 0, 2, no
423612077,  antonio_tursi, 2, 1, 1, neutral
1329503420,  Fieraspartana, 8, 5, 3, yes
3785335761,  MU5SsmarcoinL, 8, 0, 8, no
783587469744803840,  Notech_Store, 2, 0, 2, no
604613783,  logobenvenuto, 4, 0, 4, no
397897565,  massy11gsxr, 7, 0, 7, no
2349128023,  fabcolasanti, 2, 0, 2, no
950543234,  grlomo, 10, 0, 10, no
583877210,  apaschetti, 13, 1, 12, no
76768352,  charing89, 3, 0, 3, no
892912476,  RosGianluigi, 9, 3, 6, no
785731753700761600,  carmelomura1, 2, 0, 2, no
1219850648,  sidewayseye, 2, 0, 2, no
3517606996,  marcelolissand1, 2, 0, 2, no
3050315554,  stecco27, 3, 0, 3, no
1825976557,  Fioreadriano50, 2, 0, 2, no
1314002262,  RaffaeleManca2, 8, 0, 8, no
2568980217,  zed1684, 2, 0, 2, no
2819926689,  CarbonaraIng, 2, 0, 2, no
158949892,  iL3nia27, 5, 0, 5, no
2891108139,  lauraestatusquo, 10, 0, 10, no
497390214,  PetulaBrafa, 1, 0, 1, no
4728590782,  verdecar, 3, 0, 3, no
469254466,  borriroberto, 7, 0, 7, no
56064083,  stulimpetti, 4, 1, 3, no
784315996370722818,  rivadestract, 1, 0, 1, no
2467489015,  le12querce, 8, 6, 2, yes
3425973148,  GMoncelsi, 4, 1, 3, no
358835137,  MassimoAndretta, 3, 0, 3, no
540605500,  DEABRAIDA, 1, 0, 1, no
1166480390,  mirkomignolli, 2, 0, 2, no
3360851079,  donaturtle1, 3, 1, 2, no
395803614,  PTrivi, 2, 0, 2, no
560260712,  dariodanti77, 1, 1, 0, yes
1051271480,  AnarcoNingia, 2, 2, 0, yes
325028943,  EricssonItalia, 1, 1, 0, yes
4691207605,  crossi63, 2, 2, 0, yes
747048616859176960,  giansnow10, 1, 1, 0, yes
2779173779,  kcri_roberta, 1, 1, 0, yes
13106252,  GiovanniCocconi, 3, 3, 0, yes
355905384,  nancyb70, 2, 1, 1, neutral
232090588,  paolopalcubo, 4, 3, 1, yes
10281812,  fresta_angelo, 3, 2, 1, yes
50970568,  SerenettaMonti, 4, 3, 1, yes
2603850468,  Antigiornalista, 23, 4, 19, no
146215790,  giovannix78, 3, 3, 0, yes
2751787899,  golightlychiara, 2, 2, 0, yes
159546644,  Stefano_Berti, 8, 8, 0, yes
957760032,  PasqualeP83, 1, 1, 0, yes
555304578,  nives68, 1, 1, 0, yes
144996917,  giovannimaiello, 1, 1, 0, yes
71326041,  Critwitte, 3, 2, 1, yes
202970414,  mauriziobonanno, 1, 1, 0, yes
997613971,  olgaiarussi, 1, 1, 0, yes
290652162,  frricci, 1, 1, 0, yes
829449325,  GPeterlana, 6, 5, 1, yes
302127556,  GabrielePerino, 2, 1, 1, neutral
177514135,  fabfurnari, 1, 1, 0, yes
112840433,  laviticolalo, 2, 2, 0, yes
4221615226,  ViroMancino, 1, 1, 0, yes
278982651,  giac1974, 6, 3, 3, neutral
490085795,  BrunoZambardino, 1, 1, 0, yes
1323234602,  PizzutiL, 2, 2, 0, yes
73598124,  flinx15, 3, 1, 2, no
4870755754,  grvrnn, 1, 1, 0, yes
4170374679,  MarcoDRM61, 1, 1, 0, yes
15453624,  this_is_jp, 1, 1, 0, yes
2746107033,  SondrioFederica, 4, 1, 3, no
2799355986,  ariannarubino3, 5, 4, 1, yes
440977656,  maccpepp, 11, 6, 5, yes
3155345943,  froccasecca, 1, 1, 0, yes
21402138,  jeffersonhoward, 2, 1, 1, neutral
528480384,  uandarin, 7, 4, 3, yes
562522191,  oss5s, 7, 2, 5, no
1224876152,  PiccolaPap, 3, 1, 2, no
323702564,  salv60, 4, 3, 1, yes
163395780,  marcodauria, 1, 1, 0, yes
749325100718100480,  Giampie52857665, 12, 9, 3, yes
2558784496,  CalcagnoCaluma, 1, 1, 0, yes
4218365097,  Vincenza_Lab, 1, 1, 0, yes
144199196,  SilvestroPistis, 2, 2, 0, yes
971404916,  porceddu54, 1, 1, 0, yes
3874001362,  siamotuttipoeti, 13, 6, 7, no
517869996,  AldoLoprete, 1, 1, 0, yes
4000802387,  alphx2, 1, 1, 0, yes
2304164031,  AndreaSaggini, 2, 1, 1, neutral
4164928408,  AlebottAlessan, 6, 2, 4, no
2209239575,  chanik05, 2, 2, 0, yes
1065415488,  davide_vasile, 1, 1, 0, yes
988443992,  plrgcc, 1, 1, 0, yes
371154850,  FuocoMarco, 2, 0, 2, no
2776126551,  LaMombelli, 11, 0, 11, no
560997857,  francesco_scoma, 1, 0, 1, no
1125370914,  arcobalenoclub, 2, 0, 2, no
1246689782,  PetrucciAlfredo, 1, 0, 1, no
411011613,  CommFuturo, 7, 1, 6, no
1303161607,  1massiminimo, 1, 0, 1, no
3037110123,  carrozzini74, 2, 0, 2, no
2336516311,  fdarivagrechi, 2, 0, 2, no
705120695173390336,  FIRovato, 9, 0, 9, no
3169141887,  attiliof2, 1, 0, 1, no
474180138,  FraMariaRegina, 1, 0, 1, no
1139902766,  loskiavo, 2, 1, 1, neutral
798660060,  ZioSandrigno, 3, 2, 1, yes
481552150,  GiovanniFirrito, 1, 0, 1, no
2882593798,  bertonid51, 1, 0, 1, no
4125963802,  franco49522481, 1, 0, 1, no
2310609029,  duduiani, 22, 1, 21, no
130134758,  MCTOGNINI, 1, 0, 1, no
373893572,  diego_jejo, 1, 0, 1, no
2356457670,  GiovanniLaMonic, 9, 0, 9, no
476224016,  CattozziRoberto, 2, 0, 2, no
587805027,  lauraravetto, 11, 1, 10, no
945145027,  maxnannoni, 3, 0, 3, no
724192261,  AProfCelli, 1, 0, 1, no
1427233322,  gaccervia, 8, 1, 7, no
468751102,  MirkoGhidini, 1, 0, 1, no
716989892954296320,  6ae86058d91f487, 2, 0, 2, no
1166191856,  ForzaAcqui, 2, 0, 2, no
2541176620,  john89930, 3, 1, 2, no
1257819193,  liquorigiovanni, 1, 0, 1, no
2443200701,  angela_galeone, 1, 0, 1, no
759087284356575233,  ritanuvola1955, 1, 0, 1, no
3058851983,  stevemcorin, 12, 0, 12, no
1142895247,  EnricoNardiTw, 4, 0, 4, no
2717296943,  AndreDelorenzi, 4, 0, 4, no
416309230,  pistelligoffr, 3, 1, 2, no
1087029078,  gianpaolomartel, 2, 0, 2, no
382238648,  SalvatoreMerlo, 2, 0, 2, no
19779684,  orkydea, 3, 0, 3, no
50975033,  fabriziomossino, 2, 2, 0, yes
460200677,  PinoCorva, 1, 1, 0, yes
1028678899,  simoni_elisa, 4, 4, 0, yes
735276903624380416,  bgus1234, 1, 1, 0, yes
2880084795,  75simonetta, 14, 8, 6, yes
510806915,  ElenaMurelli1, 2, 2, 0, yes
106699882,  AffInt, 4, 4, 0, yes
198562810,  NickysBooks, 1, 1, 0, yes
2200551363,  AngeloNozza, 7, 7, 0, yes
1005116281,  Mirosa_Ros, 2, 1, 1, neutral
2520000468,  StefanodocSM, 1, 1, 0, yes
364241111,  wildehorse68, 1, 1, 0, yes
2554792633,  Ginger_Ale_Marz, 2, 1, 1, neutral
2002721,  dasar, 6, 2, 4, no
455110305,  Digiovanpaolo, 1, 1, 0, yes
260876844,  fabrizioporcu, 2, 1, 1, neutral
79019842,  maxdantoni, 2, 2, 0, yes
50587165,  b_muvis, 1, 1, 0, yes
1385164772,  annaascionefoto, 3, 3, 0, yes
222599415,  balzaa, 1, 1, 0, yes
439252014,  CristianoBazzo, 1, 1, 0, yes
2305829379,  giancola72, 6, 5, 1, yes
541915851,  emiliapatta, 1, 1, 0, yes
974656363,  CarlaGhizzani, 1, 1, 0, yes
729787922644381697,  BellezzaLaura05, 2, 0, 2, no
369080317,  StefaanSmekens, 1, 1, 0, yes
427575546,  mauriziocornaro, 1, 1, 0, yes
734001366507610112,  AndreaPesenti84, 1, 1, 0, yes
2430152420,  MipaafSocial, 11, 11, 0, yes
787665727234990080,  pasqualeoliva6, 2, 2, 0, yes
2486874688,  J_Elise10, 1, 1, 0, yes
1493670800,  i_lucilla, 1, 1, 0, yes
113361100,  BancoAlimentare, 2, 1, 1, neutral
1215545569,  GiulioPalamara, 1, 1, 0, yes
2477738290,  lukesltzman, 1, 1, 0, yes
867757766,  MarcoadrianoA, 1, 1, 0, yes
3244583369,  Biodistretti, 1, 1, 0, yes
3077650311,  danielegrigi, 2, 2, 0, yes
702750694,  ferra59, 2, 2, 0, yes
99290096,  ERGAGIO, 1, 1, 0, yes
704411642432495618,  Maldini_Mian_3, 1, 1, 0, yes
1130378564,  fabrinonfibra, 2, 1, 1, neutral
724361451108990976,  tweetsfromSPA, 3, 2, 1, yes
749166817730527233,  donnedelvino, 1, 1, 0, yes
71210114,  zamv7, 1, 1, 0, yes
136198914,  Unionbirrai, 2, 2, 0, yes
2976379107,  IosueLuca, 4, 3, 1, yes
447385871,  ele771, 1, 1, 0, yes
775257919210258432,  _agroalimentare, 1, 1, 0, yes
730066756107161600,  CopagriNazional, 1, 1, 0, yes
1482223236,  webagwriter, 7, 6, 1, yes
727132221056897024,  SyngentaItalia, 1, 1, 0, yes
132191455,  tersarsa, 1, 1, 0, yes
2942619196,  faneluca, 2, 2, 0, yes
3214326549,  liber_vineyard, 3, 3, 0, yes
303768164,  fedcons, 1, 1, 0, yes
2155788958,  maiochetti, 1, 1, 0, yes
2931893501,  SameleMontagna, 1, 1, 0, yes
990581779,  LucaSani65, 7, 7, 0, yes
3334414073,  ViniVenetiDOC, 1, 1, 0, yes
574872653,  PietroVirtuani, 2, 2, 0, yes
3154263946,  chiarazonzin, 1, 1, 0, yes
2358221164,  ChiaBri90, 1, 1, 0, yes
307976751,  AgriculturaIT, 1, 1, 0, yes
130209798,  GigiPadovani, 2, 2, 0, yes
2710381470,  massbalde, 1, 1, 0, yes
288929015,  fabiomarcarell, 1, 1, 0, yes
402180936,  Mtheberserk, 1, 1, 0, yes
2510749124,  carolinatana83, 1, 1, 0, yes
2853445535,  6400milliards, 1, 1, 0, yes
780993615392825344,  psrmolise, 2, 2, 0, yes
147166182,  ilyvip, 1, 1, 0, yes
241016268,  Testadichicco, 1, 1, 0, yes
321394308,  gplfde, 2, 2, 0, yes
430016999,  GustolabInst, 1, 1, 0, yes
146652400,  claudiatartani, 1, 1, 0, yes
455678403,  AMartinangelo, 1, 1, 0, yes
57052200,  ilGamberoRosso, 1, 1, 0, yes
195926930,  NiccoClairmonts, 1, 1, 0, yes
3372243827,  ConfcoopFerrara, 1, 1, 0, yes
298031152,  BFrancesconi, 1, 1, 0, yes
106688111,  vignolimatteo, 1, 1, 0, yes
2436142487,  cedric__burns, 1, 1, 0, yes
149096219,  INformaCIBO, 3, 3, 0, yes
602922136,  chia_anna, 1, 1, 0, yes
2179568746,  TeresaAnastasi2, 4, 4, 0, yes
322857506,  StewieGarifo, 3, 3, 0, yes
176201555,  Roxy0871, 1, 1, 0, yes
1377704858,  startzai, 6, 6, 0, yes
3298492639,  grizzo_silva, 1, 1, 0, yes
2755562078,  bealucarella, 1, 1, 0, yes
593519995,  caselli_s, 5, 5, 0, yes
3128950269,  ColdirettiC, 1, 1, 0, yes
2813995582,  CooperativeAgro, 1, 1, 0, yes
2876888039,  USeConsul, 1, 1, 0, yes
527574803,  miriamcominelli, 2, 2, 0, yes
270318483,  freewinenet, 1, 1, 0, yes
392800981,  Federico_Corona, 2, 2, 0, yes
3131164973,  giulio_1991, 3, 3, 0, yes
2863616699,  MartiAmb, 2, 2, 0, yes
103334447,  Gruppo_Grigi, 2, 2, 0, yes
3079727565,  labaldabaldina, 1, 1, 0, yes
557350890,  APastouret, 1, 1, 0, yes
594553608,  StellaAlvaro, 1, 1, 0, yes
422177795,  aledenicola, 2, 1, 1, neutral
22248391,  asan74, 1, 1, 0, yes
265557557,  domelaurenda, 6, 5, 1, yes
72331470,  CarloGiacometto, 2, 1, 1, neutral
4471751355,  ester_caimo, 3, 3, 0, yes
791274585090039808,  PESimathia, 1, 1, 0, yes
1512887341,  UlfBergstrom, 1, 1, 0, yes
276158412,  Jeohlin, 1, 1, 0, yes
445566718,  RuggieriAngelo, 2, 1, 1, neutral
10688252,  CaponeRoberta, 2, 2, 0, yes
2848439650,  pappaterramimmo, 2, 2, 0, yes
561553494,  PDBruxelles, 1, 1, 0, yes
38618180,  fcerasani, 1, 1, 0, yes
759977138,  skabenny, 2, 2, 0, yes
273109835,  MMunizdeurquiza, 1, 1, 0, yes
399898930,  La_Dedo, 1, 1, 0, yes
2483728100,  MAFlumero, 4, 4, 0, yes
1020287744,  bonfamat, 2, 2, 0, yes
319518186,  AgniRatz, 1, 1, 0, yes
565599725,  EryCale, 1, 1, 0, yes
233955771,  cristinascarfia, 3, 2, 1, yes
108033964,  giuseppedannait, 1, 1, 0, yes
1191081025,  FrancoFurcas, 8, 3, 5, no
2254246042,  FedericoLioy, 2, 2, 0, yes
192332877,  MarkosBolaris, 1, 1, 0, yes
808508772,  iaichka, 1, 1, 0, yes
398726169,  amendolaenzo, 1, 1, 0, yes
325493263,  Dianthus67, 1, 1, 0, yes
199586005,  PenZatore, 1, 1, 0, yes
61032141,  gombacci, 1, 1, 0, yes
595366113,  lreluigi, 1, 1, 0, yes
793863735555321856,  simo_disegni, 2, 1, 1, neutral
548688275,  francesco_panie, 2, 2, 0, yes
14387157,  michelemas, 1, 1, 0, yes
567180681,  ChiaraBell89, 1, 1, 0, yes
468273735,  giorobortella, 1, 1, 0, yes
2468218964,  GabrieleBort, 2, 2, 0, yes
22027420,  verocrok, 1, 1, 0, yes
2485905968,  PalombellaBXL, 1, 1, 0, yes
112722445,  JosefKappa, 1, 1, 0, yes
288151881,  LRobustelli, 2, 2, 0, yes
949341888,  AgencEurope, 1, 1, 0, yes
1121566423,  rolizzio, 1, 1, 0, yes
75057200,  rapeka, 1, 1, 0, yes
22021332,  aronimar, 1, 1, 0, yes
498887386,  F_Scary, 1, 1, 0, yes
435962018,  OrnellaTrotta1, 2, 2, 0, yes
2543955497,  alvisemarzo, 8, 6, 2, yes
51727942,  giannalecce, 1, 1, 0, yes
2781366593,  nariucciopetra1, 6, 2, 4, no
268901363,  alelanter, 1, 1, 0, yes
111819859,  giomia71, 1, 1, 0, yes
3624418467,  simone_tonon, 2, 2, 0, yes
2860061009,  GVMDonato, 1, 1, 0, yes
3004078451,  mustandpartners, 1, 1, 0, yes
104267806,  aliceborutti, 2, 2, 0, yes
547958421,  FrancescoPorfir, 2, 2, 0, yes
23346817,  gianniorlandi, 1, 1, 0, yes
67332005,  Tamal01, 1, 1, 0, yes
103152299,  gualtierieurope, 4, 4, 0, yes
111316371,  AndreaPira, 1, 1, 0, yes
96220595,  giu_dimu, 3, 3, 0, yes
38269888,  gaiagf, 1, 1, 0, yes
2786772542,  Labdempuglia, 1, 1, 0, yes
1325379427,  MChiaraPiazza, 1, 1, 0, yes
904542290,  galante_p, 2, 2, 0, yes
1264769958,  MickFenneck, 1, 1, 0, yes
482861607,  AntonioCipullo1, 1, 1, 0, yes
3130657370,  pd_montemario, 1, 1, 0, yes
1427236458,  AleRullo74, 1, 1, 0, yes
398108618,  gladtoberight, 6, 6, 0, yes
2322829857,  mg54c, 1, 1, 0, yes
1099384200,  RenzoDiSabatino, 1, 1, 0, yes
544218009,  DonatoRobilotta, 3, 1, 2, no
377278958,  eusebiofg, 1, 1, 0, yes
709753801268453376,  FedericaCarmi, 1, 1, 0, yes
389472811,  EleonoraVedderP, 1, 1, 0, yes
1119130543,  frpettinato, 4, 3, 1, yes
50696721,  ErnestodiGio, 2, 2, 0, yes
2523038491,  kelito_lopez, 1, 1, 0, yes
2853507520,  luigi_morgano, 1, 1, 0, yes
409288328,  Fraskuzza, 1, 1, 0, yes
132058820,  TrendsRoma, 2, 1, 1, neutral
415432396,  GmrVolpe, 2, 2, 0, yes
2896043008,  Francesco_Rss, 1, 1, 0, yes
825563846,  MauroAliano, 2, 1, 1, neutral
120758619,  Gianpybas, 1, 1, 0, yes
324097989,  RubenGiovannoni, 1, 1, 0, yes
409228977,  martorellaf, 1, 1, 0, yes
719887612648022016,  Gius_Taurino, 1, 1, 0, yes
3343429930,  danigui78, 3, 3, 0, yes
522443817,  massimilianof20, 1, 1, 0, yes
2244783936,  MehLeonRoss, 1, 1, 0, yes
2163743881,  peppalonge, 1, 1, 0, yes
29478533,  pisquik, 2, 1, 1, neutral
416624840,  AlessiaCoraddu, 2, 1, 1, neutral
193913196,  TrendsItalia, 1, 1, 0, yes
140133595,  ckyenge, 7, 7, 0, yes
2199379837,  nannidanzi, 6, 2, 4, no
401917602,  marottavito, 1, 1, 0, yes
1927542277,  DRMario99, 1, 1, 0, yes
594855477,  DarioProietti1, 1, 1, 0, yes
110992490,  _Diaspro_, 1, 1, 0, yes
2498064278,  consoli81, 1, 1, 0, yes
160318761,  exmaestra, 4, 4, 0, yes
31101629,  Celikso, 1, 1, 0, yes
2171331383,  massimodada, 1, 1, 0, yes
50597132,  vins82, 3, 3, 0, yes
313210260,  psandmc, 1, 1, 0, yes
801090468301914114,  marco_ferruglio, 1, 1, 0, yes
2482426529,  audreyzuck265, 1, 1, 0, yes
2436946924,  Crestwo0dConst, 1, 1, 0, yes
1256636192,  PES_Berlin, 1, 1, 0, yes
269349550,  marcobittau, 1, 1, 0, yes
4077950386,  internazlucana, 2, 1, 1, neutral
712986674729500672,  maria_cuccarese, 4, 4, 0, yes
619339531,  ateadrinkerudo, 1, 1, 0, yes
1026771830,  gs18215, 2, 1, 1, neutral
2870975610,  Antonella842019, 1, 1, 0, yes
551428995,  n_kraljevic, 3, 0, 3, no
25189236,  logu70, 1, 1, 0, yes
237254613,  eugeniosal, 1, 1, 0, yes
531484567,  sbetelli, 4, 4, 0, yes
115955798,  foxyvol, 1, 1, 0, yes
61147687,  morningstarbis, 1, 1, 0, yes
585943804,  300562elena, 4, 4, 0, yes
415030933,  co_ma78, 3, 3, 0, yes
239505380,  STEVECATTANEO, 2, 2, 0, yes
747064355682910208,  snoopysoni, 2, 2, 0, yes
1041470562,  nonvotatexMonti, 3, 1, 2, no
2200374792,  afonsckij2010, 1, 1, 0, yes
2252744105,  FaustaSbaraini, 1, 1, 0, yes
1070621486,  luisatadini, 1, 1, 0, yes
2576621143,  marinasalamon1, 1, 1, 0, yes
464780621,  CristinaPepe1, 1, 1, 0, yes
407102473,  PScibetta, 1, 1, 0, yes
1676653410,  amb_boschi, 2, 2, 0, yes
3260889384,  MvitaliVitali, 1, 1, 0, yes
2323933241,  mdemarco55, 3, 1, 2, no
2730971417,  emilio150971, 1, 1, 0, yes
216654596,  fabriziobenzoni, 1, 1, 0, yes
3319758209,  rittyron67_rita, 1, 1, 0, yes
803599010363822080,  OP_Director1, 1, 1, 0, yes
2481656687,  lauparodi5, 2, 2, 0, yes
2473269790,  AlessiaPenati, 1, 1, 0, yes
412938122,  Lully979, 1, 1, 0, yes
151481755,  idapaola, 1, 1, 0, yes
428349357,  GiacomoAngeloni, 3, 3, 0, yes
103235958,  kacioepepe, 1, 1, 0, yes
2213917227,  lacuradeltempo, 1, 1, 0, yes
2872502326,  ComunediBergamo, 9, 9, 0, yes
229189488,  naha19, 1, 1, 0, yes
489276214,  GiadaMelocchi, 2, 2, 0, yes
486513387,  edwinbattistini, 1, 1, 0, yes
455167030,  dandyora, 2, 2, 0, yes
727243326869655552,  PierreUilm, 1, 1, 0, yes
54853399,  andreagambi, 3, 3, 0, yes
1144028347,  GelmiGelmi, 1, 1, 0, yes
1024992674,  SixInTheStable, 4, 1, 3, no
3108726160,  GiusPigo, 1, 1, 0, yes
501674305,  alfredapples, 1, 1, 0, yes
212923650,  MatteoPedrosi, 1, 1, 0, yes
3860845528,  Noctulablu, 1, 1, 0, yes
399684331,  SimoneCaroli, 1, 1, 0, yes
2489927044,  demlleahay, 1, 1, 0, yes
2341649206,  NicolodiDaria, 1, 1, 0, yes
409145118,  nadiolinda, 1, 1, 0, yes
486712575,  glm_73, 1, 1, 0, yes
457395367,  EgidioF, 2, 2, 0, yes
71361061,  GianTurcato, 1, 1, 0, yes
1011101666,  RSeminati, 2, 2, 0, yes
2581933774,  GiusiErri, 1, 1, 0, yes
53909153,  mlbrena, 2, 2, 0, yes
56747423,  paolobarbieri, 1, 1, 0, yes
393617100,  ivanpololi, 1, 1, 0, yes
2314104034,  FrancescoNavoni, 5, 5, 0, yes
71187111,  vitcarl, 1, 1, 0, yes
2682909786,  paolomeli1, 1, 1, 0, yes
417993565,  AldoRossi8, 1, 1, 0, yes
96332109,  mastroif, 2, 2, 0, yes
554271657,  NicolaCalabres2, 1, 1, 0, yes
540124091,  paolettaif, 2, 2, 0, yes
168623825,  adicorbetta, 5, 5, 0, yes
510867895,  RosettiValeria, 1, 1, 0, yes
257553023,  FenixRalf, 1, 1, 0, yes
746974202243256320,  elisa24102, 1, 1, 0, yes
1028562564,  harusameya, 1, 1, 0, yes
231702460,  fabiom61, 1, 1, 0, yes
564353788,  enrarienti, 1, 1, 0, yes
2365306980,  danielaqua4, 2, 2, 0, yes
3142790127,  leutelmonte2, 1, 1, 0, yes
429009063,  MelaniaGiglio1, 1, 1, 0, yes
312661898,  FZanalda, 5, 5, 0, yes
367878143,  ilFrad2, 1, 1, 0, yes
575446781,  valerapelli, 1, 1, 0, yes
995611016,  alessandrafogaz, 1, 1, 0, yes
546247610,  filipbiz, 1, 1, 0, yes
255107842,  seppjoe, 1, 1, 0, yes
986653196,  PianiDaniela, 1, 1, 0, yes
383091099,  giuppi65, 2, 2, 0, yes
17705943,  chiara85, 1, 1, 0, yes
852579139,  biagiotti_b, 1, 1, 0, yes
206165773,  dbresc, 2, 2, 0, yes
585439502,  enricocolosimo, 2, 1, 1, neutral
166949118,  LauryeMal, 1, 1, 0, yes
774249195456831488,  Lilithina, 2, 2, 0, yes
487576880,  Manste78, 1, 1, 0, yes
191254467,  domenicomarock, 2, 2, 0, yes
1047826945,  lapierpierina, 1, 1, 0, yes
482897816,  mattiafeltri, 2, 1, 1, neutral
1214739008,  paolo69edge, 5, 1, 4, no
309610370,  mardesimoni, 1, 1, 0, yes
1031180762,  paola_tacca, 1, 1, 0, yes
457582089,  vjlapenna, 1, 1, 0, yes
3040734333,  LMeloscia, 1, 1, 0, yes
17018429,  giorgiocappozzo, 1, 1, 0, yes
464123632,  mviass, 1, 1, 0, yes
740624677,  Bemyfirefly_, 2, 2, 0, yes
855967868,  Agazzi09, 3, 3, 0, yes
353617422,  serenatatti, 1, 1, 0, yes
1114327278,  pattriva, 1, 1, 0, yes
2985256906,  simonechiav, 3, 1, 2, no
66378035,  maurofilippini, 6, 1, 5, no
727493346806124544,  barbara7b7, 1, 1, 0, yes
710046420821286912,  IlCarmi73, 9, 3, 6, no
2184861378,  marycallea, 7, 6, 1, yes
489436391,  WGuai, 1, 1, 0, yes
136294036,  trsmastrandrea, 2, 1, 1, neutral
40432671,  Torracas, 2, 2, 0, yes
522131370,  DanieleBg91, 1, 1, 0, yes
3026489927,  FeGiulio, 1, 1, 0, yes
714586803500662784,  MilesiGraziana, 1, 1, 0, yes
54314372,  StefanoAM, 3, 3, 0, yes
485546674,  Biagio960, 1, 1, 0, yes
782726,  simoneturco, 1, 1, 0, yes
396824911,  erme_cip, 1, 1, 0, yes
111853685,  andrea_menalli, 1, 1, 0, yes
2886845566,  romina_provenzi, 1, 1, 0, yes
279557700,  millyjana, 5, 5, 0, yes
2270307124,  gipitz, 1, 1, 0, yes
2537410802,  Samu_Mara, 1, 1, 0, yes
2177615174,  feelsomax, 2, 2, 0, yes
2907774178,  Zabov73, 2, 2, 0, yes
350235658,  orientamentibla, 1, 1, 0, yes
453295053,  thomasgagliard1, 2, 1, 1, neutral
426120196,  eliolivari, 1, 1, 0, yes
157375033,  FlaviaItaly, 2, 2, 0, yes
460201816,  fedepizzoglio, 1, 1, 0, yes
471229424,  valeonetti, 2, 2, 0, yes
221531806,  enrinic, 3, 1, 2, no
509261085,  PALuceri, 1, 1, 0, yes
54903017,  Fenoil, 2, 1, 1, neutral
2210459317,  StefanGhezzi, 1, 1, 0, yes
458695439,  FlaviaQuarto, 1, 1, 0, yes
1087141352,  dredsuil, 2, 1, 1, neutral
8694702,  Peppi_Nocera, 1, 1, 0, yes
85300634,  luigissimo, 2, 1, 1, neutral
65873428,  monelisab, 2, 2, 0, yes
353780336,  giuseppetrimarc, 1, 1, 0, yes
421121877,  Silvia_Parma, 1, 1, 0, yes
1050548238,  PasqualeConte, 1, 1, 0, yes
470625015,  LindaLindino, 1, 1, 0, yes
3297867930,  associazioneFVB, 1, 1, 0, yes
322207188,  nina_mau, 1, 1, 0, yes
1667190788,  MarcoPaoloPina, 2, 2, 0, yes
782171126168481792,  egidio_gialdini, 1, 1, 0, yes
847437589,  ESNBergamo, 1, 1, 0, yes
296778555,  Daniela_Liotti, 6, 1, 5, no
615793623,  ryanres55, 2, 2, 0, yes
2898953543,  ingmardizzone, 2, 2, 0, yes
2262100917,  ti_pagano, 1, 1, 0, yes
493919122,  matteotaramelli, 1, 1, 0, yes
273072683,  livio_beshir, 1, 1, 0, yes
2394909651,  ORuzzini, 2, 2, 0, yes
398848980,  MinnettiMassimo, 2, 2, 0, yes
574414160,  fva1965, 1, 1, 0, yes
402002278,  marco__holmes, 1, 1, 0, yes
2483198189,  dtripllne, 1, 1, 0, yes
2486454226,  iii__pastena, 1, 1, 0, yes
513538759,  strap1501, 1, 1, 0, yes
417807769,  danielastazi, 1, 1, 0, yes
875347244,  davidrodino, 8, 3, 5, no
3621950242,  FerranteSandro, 9, 0, 9, no
4735498517,  Antonio89806538, 1, 0, 1, no
424216485,  barbarajerkov, 3, 0, 3, no
703551569,  dario_balconi, 3, 0, 3, no
750313888344895488,  M__Guerrieri, 2, 0, 2, no
739855069110259712,  mgstudiografico, 2, 1, 1, neutral
394059966,  poltronaggio, 4, 0, 4, no
239996328,  agoingenito, 1, 0, 1, no
1353939044,  Mattiagiaco92, 1, 0, 1, no
631061599,  dissezione, 1, 0, 1, no
1389944444,  AndreaOlma, 3, 1, 2, no
427789815,  PAnnicchino, 8, 0, 8, no
3760553777,  Azizzamri2, 9, 0, 9, no
237878540,  giannisgarbi, 3, 0, 3, no
22621566,  Walentina, 1, 0, 1, no
350236337,  nickgiannelli, 1, 0, 1, no
602729119,  france_melo, 1, 0, 1, no
2288707520,  Harlock7777, 2, 1, 1, neutral
988343473,  editta_fazzi, 2, 0, 2, no
1662392210,  giovagi1, 1, 0, 1, no
233611005,  lumiazy, 1, 0, 1, no
803354984440020993,  Gidema79, 1, 0, 1, no
509044457,  caniobrando, 3, 0, 3, no
36626879,  FedeBridge, 1, 0, 1, no
2545761557,  aenigmatica_, 1, 0, 1, no
2217779195,  mortariaq, 6, 0, 6, no
772532983219847168,  AntonioDesiena1, 3, 2, 1, yes
2415768917,  Walter_Mauriel, 3, 0, 3, no
436255240,  ForteFlavio, 1, 0, 1, no
428166307,  GiochCecconi, 1, 0, 1, no
185108209,  paolomadron, 2, 1, 1, neutral
118035662,  presidentegio, 1, 0, 1, no
511778772,  emanuelemoraldi, 1, 0, 1, no
871931652,  antopirolo, 11, 2, 9, no
349043533,  Simone_Dela, 10, 0, 10, no
2181109997,  b_baolo, 6, 2, 4, no
317278701,  affinitomichele, 1, 0, 1, no
1344040164,  ClaudioTocco87, 1, 0, 1, no
46065438,  Frakrt89, 1, 0, 1, no
374168159,  fulvioponte, 7, 4, 3, yes
574402395,  DellarossaFede, 3, 2, 1, yes
66145870,  1riky1987, 2, 1, 1, neutral
2682728206,  CSignorotto, 2, 0, 2, no
121689573,  VittorioCurro, 2, 1, 1, neutral
207939445,  galietti82, 1, 0, 1, no
1367163644,  gaetano_amato, 1, 0, 1, no
31395684,  marcorubino, 2, 1, 1, neutral
58797291,  mariasiano, 1, 0, 1, no
40436213,  malabruzzi, 3, 1, 2, no
132526509,  AntonioMatto, 3, 0, 3, no
726842542722023424,  pippo_bassi, 1, 0, 1, no
2454559204,  simonegraziosi2, 4, 2, 2, neutral
1015313437,  PetrolioGrezzo, 3, 0, 3, no
106378808,  ROBIX1, 1, 0, 1, no
800779578,  dburani83, 3, 1, 2, no
102674438,  FiordellisiFran, 4, 2, 2, neutral
335249305,  GLFurano, 3, 1, 2, no
417252855,  patriziafiori, 3, 1, 2, no
586037920,  Fornaro62, 6, 0, 6, no
871317662,  DZoggia, 3, 0, 3, no
88203349,  n_iacono, 2, 0, 2, no
122976053,  tiziodesio, 3, 0, 3, no
1654874078,  CollesanoGMario, 10, 1, 9, no
3005113455,  gianfrac57, 6, 1, 5, no
254704627,  remo_ricchetti, 2, 0, 2, no
957666146,  GiusRober, 7, 4, 3, yes
3028285828,  ytali_, 1, 1, 0, yes
1681307029,  tesacro_, 2, 2, 0, yes
2442953699,  ScanuGabriela, 4, 4, 0, yes
56111212,  lanzigiuseppe, 7, 7, 0, yes
494217990,  Filippeschi, 2, 2, 0, yes
507405357,  LegambienteLomb, 1, 1, 0, yes
104446922,  sisifosrl, 9, 9, 0, yes
3128619046,  RighiniDiego, 2, 2, 0, yes
585072407,  BarbaraMeggetto, 6, 6, 0, yes
2458230818,  Brebey, 2, 2, 0, yes
288229813,  egazette1, 3, 3, 0, yes
124839328,  levygeralte, 1, 1, 0, yes
614902537,  NlckRogerss, 1, 1, 0, yes
1904124758,  umberto_mott, 1, 1, 0, yes
419316234,  FranFerrante, 12, 11, 1, yes
248143211,  13doule, 7, 7, 0, yes
164630659,  bdg_vi, 7, 7, 0, yes
3022820703,  Bio4Expo, 8, 8, 0, yes
145238837,  bio4xp, 7, 7, 0, yes
145267280,  allattamento, 7, 7, 0, yes
386433700,  chiaraperte, 7, 7, 0, yes
284448107,  bioplastiche, 7, 7, 0, yes
258861176,  ecocloe, 7, 7, 0, yes
163793190,  comunebassano, 7, 7, 0, yes
1389403092,  FIMAit, 7, 7, 0, yes
375324341,  Ecosofista, 7, 7, 0, yes
1425076423,  FonteComune, 7, 7, 0, yes
164636499,  ecozema, 5, 5, 0, yes
248146860,  FarmaciaGreen, 7, 7, 0, yes
145979928,  ecoallestimenti, 7, 7, 0, yes
577236541,  GrissBicocca, 7, 7, 0, yes
995411196,  Ecozema_IT, 7, 7, 0, yes
291645099,  Gruppo8Marzo, 7, 7, 0, yes
4427473216,  GITbassano, 1, 1, 0, yes
901918932,  i_Charge, 7, 7, 0, yes
196662571,  livecoop, 7, 7, 0, yes
77183970,  LivecomOnlus, 4, 4, 0, yes
248145175,  Jusfincom, 7, 7, 0, yes
1711937208,  MariellaMaffini, 7, 7, 0, yes
142411196,  materbi, 7, 7, 0, yes
242327193,  sacchetico, 6, 6, 0, yes
1553409380,  sisifoitalia, 7, 7, 0, yes
273885892,  ReteComuniSIN, 7, 7, 0, yes
743853432793079808,  MaterBi_it, 8, 8, 0, yes
116439174,  SinnovaIT, 7, 7, 0, yes
142444312,  sarvexit, 7, 7, 0, yes
3246313708,  polycartspa, 9, 9, 0, yes
248140300,  Mediaweblife, 7, 7, 0, yes
1192994562,  SMediaGreen, 7, 7, 0, yes
248137375,  Weblifemedia, 7, 7, 0, yes
248142160,  parlattando, 7, 7, 0, yes
323846215,  Vitasostenibile, 7, 7, 0, yes
107057461,  ValoreSociale, 6, 6, 0, yes
1426083355,  Melogranocs, 7, 7, 0, yes
95209458,  antoniomunarini, 2, 2, 0, yes
252580188,  Kyoto_Club, 2, 1, 1, neutral
875644892,  MarcoRamanzini, 1, 1, 0, yes
2154741814,  titti1956, 3, 3, 0, yes
2242298685,  MiconoSimone, 6, 6, 0, yes
740059218351382529,  gaetanopriori2, 1, 1, 0, yes
1150449175,  PoloAutomotive, 2, 2, 0, yes
14064966,  ermanno, 4, 4, 0, yes
393281187,  Valcaram, 1, 1, 0, yes
1068928062,  usckok, 6, 2, 4, no
3306279131,  cinzia_francia, 2, 2, 0, yes
191013892,  ecocom, 5, 5, 0, yes
964424065,  resilientemente, 5, 5, 0, yes
515870436,  AlbertoCari, 3, 3, 0, yes
294529592,  blueconomia, 6, 6, 0, yes
3909479494,  ParkInnovazione, 2, 2, 0, yes
65004657,  monia_fresiello, 3, 3, 0, yes
2155570437,  costanzapratesi, 1, 1, 0, yes
3086329875,  Orizzontiverdi, 5, 5, 0, yes
1152079687,  Dirittoambiente, 2, 1, 1, neutral
966123451,  NonTiRifiuto, 6, 6, 0, yes
4067402866,  ClimateItalia, 1, 1, 0, yes
4350748833,  pagnozzicarmine, 7, 7, 0, yes
1134651691,  Rocco_larocca, 1, 1, 0, yes
706803356,  maestrale53, 4, 1, 3, no
427509320,  lalutre, 1, 1, 0, yes
4274299756,  4_environment, 2, 2, 0, yes
418863047,  SymbolaFondazio, 10, 10, 0, yes
1003602980,  AlfyDF, 1, 1, 0, yes
2809959047,  planbee_bz, 1, 1, 0, yes
278440052,  3CULTURAS, 1, 1, 0, yes
2502606786,  _macmike, 2, 2, 0, yes
613452196,  BeDifferent_xXx, 4, 1, 3, no
782507640811315200,  arduinobrambil2, 2, 1, 1, neutral
3369262985,  ArmanoElio, 4, 3, 1, yes
932443237,  ZaffAntonio, 5, 0, 5, no
796061968486502400,  PietroLePera26, 5, 0, 5, no
205327727,  EBattestini, 4, 0, 4, no
423376068,  nicorigi, 3, 0, 3, no
413337087,  Enzo_Riontino, 3, 0, 3, no
3095660203,  FIGiovaniVeneto, 3, 0, 3, no
4529531674,  pierogeremia, 3, 0, 3, no
426076826,  FI_Giovani, 7, 0, 7, no
1441064498,  MoscatoDario, 3, 0, 3, no
2976611614,  FIgiovaniMolise, 3, 0, 3, no
372280583,  Federico_Menna, 21, 2, 19, no
1024040808,  AndreaPace92, 3, 0, 3, no
1269885642,  figsardegna, 3, 0, 3, no
4818686225,  ca_giovani_fi, 3, 0, 3, no
15719088,  PpCassoni, 3, 0, 3, no
747008536102699009,  figtortoliOG, 4, 0, 4, no
747011427270017024,  figmamoiadaNU, 4, 0, 4, no
4734022421,  figolbiatempio, 4, 0, 4, no
798275720,  FigiovaniNuoro, 3, 0, 3, no
3172830191,  FIGiovaniPn, 3, 0, 3, no
473718857,  AndriSerio, 3, 0, 3, no
1001820151,  CabMassi, 3, 0, 3, no
332346345,  UldericoDL, 3, 0, 3, no
2851471793,  fig_roma, 6, 0, 6, no
3345310611,  alexmarino824, 3, 0, 3, no
906269360,  tripodimaria, 8, 0, 8, no
2422714453,  ChriChiumera, 3, 0, 3, no
2971664825,  marziaspagnuol1, 3, 0, 3, no
2800353611,  AbruzzoFIGiov, 3, 0, 3, no
78334750,  adalonzo, 3, 0, 3, no
780698798473359361,  figiovanipe, 3, 0, 3, no
2343344779,  FIAbruzzo, 4, 0, 4, no
314839768,  alepontecorvo, 3, 0, 3, no
1228581132,  pirotz, 4, 0, 4, no
706945040149561352,  pillolo3, 3, 1, 2, no
4288995452,  7Vanessa8, 3, 0, 3, no
2896572294,  liciaoleando92, 3, 0, 3, no
434135494,  OlleiaValentina, 4, 0, 4, no
2427964266,  FISRemo, 21, 3, 18, no
2771181483,  PanoramadItalia, 12, 12, 0, yes
2889010597,  lucrezia68lvely, 1, 1, 0, yes
3183261832,  davilorenz, 3, 2, 1, yes
490373752,  DAgostinoSandro, 2, 2, 0, yes
565547576,  simonecellamare, 2, 1, 1, neutral
930537542,  Rizzoa2, 2, 1, 1, neutral
1163239069,  dantegeber23, 6, 3, 3, neutral
3430446029,  daniela39962388, 5, 5, 0, yes
23582145,  dacasati, 1, 0, 1, no
764395460,  SimbaGio, 1, 0, 1, no
458719075,  guidoolimpio, 1, 0, 1, no
491617371,  ErmannoArkam1, 1, 0, 1, no
2878366108,  Giuss_Calcio, 1, 0, 1, no
2761804163,  coimbraazevedo, 1, 0, 1, no
4546813439,  MrMojoRisin_27, 1, 0, 1, no
3256585139,  lucaf_1980, 1, 0, 1, no
4249515683,  lucadg75, 2, 0, 2, no
1299394213,  M5S_No_Grazie, 11, 1, 10, no
743579496574492673,  Lollowitz, 1, 0, 1, no
3296476839,  antf80, 1, 0, 1, no
334157137,  MattiaGiusto, 1, 0, 1, no
144581129,  Conte_Stefan, 1, 0, 1, no
487722575,  AbatiAl11, 8, 1, 7, no
182087936,  IlPaoloGiordano, 1, 0, 1, no
159528333,  DMassimiliano, 1, 0, 1, no
223986815,  MalkoPink, 1, 0, 1, no
3384217258,  Nicoloimmesir, 1, 0, 1, no
25373528,  Polichic79, 1, 0, 1, no
3080949119,  Infofatti, 7, 0, 7, no
702599188324941826,  GlovesQueen, 1, 0, 1, no
2609643615,  brumma_c, 3, 0, 3, no
454730135,  marcomontagna95, 4, 0, 4, no
2609773355,  cabiria1974, 3, 2, 1, yes
2839630066,  StranieroAngela, 7, 0, 7, no
14073125,  Robbetta, 3, 1, 2, no
409500620,  LaZanzaraR24, 3, 0, 3, no
424102462,  pezzodiferro, 2, 0, 2, no
482349619,  LucaNameiswolf, 1, 0, 1, no
3862648197,  It_biasutti, 2, 1, 1, neutral
537241066,  RossettiCinzia, 1, 0, 1, no
4867474714,  Huffindogpost, 1, 0, 1, no
789256274,  RossiAnnachiara, 1, 0, 1, no
2862789144,  angelo_debiasio, 2, 1, 1, neutral
410960872,  Griso3, 3, 1, 2, no
105090713,  cauz_, 1, 0, 1, no
212163360,  danielelozzi, 3, 0, 3, no
315914335,  Dan33lo, 1, 0, 1, no
3907730538,  VVundabar, 3, 1, 2, no
660823,  biagio, 1, 0, 1, no
792638720486825984,  manueldipaolo99, 2, 0, 2, no
157409984,  Treklu, 1, 0, 1, no
1482475178,  CaroneTweet, 1, 0, 1, no
89455780,  alfredobini75, 1, 0, 1, no
132600522,  Ssalvatore13, 1, 0, 1, no
2249088026,  fradipiazza, 1, 0, 1, no
568519738,  Psss_Psss, 1, 0, 1, no
602637632,  enzofilia, 1, 0, 1, no
1427359140,  ApuntoD, 1, 0, 1, no
722130030,  PaoloPorcellum, 8, 3, 5, no
3302759115,  AlexItaliaTweet, 4, 0, 4, no
1001641908,  Giulio__Mariani, 3, 0, 3, no
1702340275,  RugnaChiara, 1, 0, 1, no
63709165,  Videleo, 5, 3, 2, yes
2754596762,  GiuliaS07, 1, 0, 1, no
3002109657,  monicaelucky, 1, 0, 1, no
3001111939,  nadiamartines58, 1, 0, 1, no
390778324,  francescocat89, 1, 0, 1, no
1975677404,  gostanel, 1, 0, 1, no
575746752,  gianni_matteo, 1, 0, 1, no
549331011,  ABinotto, 1, 0, 1, no
209645583,  Z3uSXp, 1, 0, 1, no
4208700496,  GiubyLeo, 1, 0, 1, no
413181958,  F4Fake1, 1, 0, 1, no
426642251,  94Gregorio, 1, 0, 1, no
598697094,  andreacarianni, 4, 1, 3, no
2167053595,  GioMatrella86, 3, 0, 3, no
541695689,  swordsmanlight, 4, 1, 3, no
755471173308276736,  il_Mirmidone, 2, 0, 2, no
150591923,  mRaccu, 1, 0, 1, no
4894984156,  PaoloCoc92, 1, 0, 1, no
796348634027753472,  albondilblond, 1, 0, 1, no
774270867014574080,  AlfPnz, 2, 0, 2, no
251192598,  stefanodeiuliis, 2, 0, 2, no
1416465541,  prof_giuseppe, 5, 1, 4, no
99997947,  willy6123, 1, 0, 1, no
426478566,  TizianoMosa, 1, 0, 1, no
432451617,  pigrof, 1, 0, 1, no
3504091637,  Chopin_Hauer_, 1, 0, 1, no
534425432,  francescafagnan, 4, 1, 3, no
4349538382,  mariuccienrico1, 1, 0, 1, no
3111223163,  fcalzia, 1, 0, 1, no
2221430782,  IlCeretti, 2, 0, 2, no
709471830,  EmilioERCaranti, 1, 0, 1, no
3569280136,  telecronacatrap, 1, 0, 1, no
757596839688466432,  Salvo94_, 2, 0, 2, no
126693711,  GG_995, 1, 0, 1, no
110409975,  MassimoMelis, 2, 0, 2, no
710594448728723456,  alesio1982, 1, 0, 1, no
2908475859,  ReRalf75, 1, 0, 1, no
762951852283617280,  NicoQuaranta9, 2, 0, 2, no
803183834003083264,  andreadabatini, 1, 0, 1, no
474764300,  drewscop, 1, 0, 1, no
400958605,  RobertoBortoli1, 1, 0, 1, no
331886813,  Gaetano_Longo, 3, 2, 1, yes
978934117,  1_starrynight, 3, 0, 3, no
18600275,  orsobianco, 1, 0, 1, no
790133846,  CatalanoSanto, 1, 0, 1, no
81229368,  jimihendrix1980, 2, 1, 1, neutral
223504287,  TommasoBalliera, 2, 0, 2, no
381742265,  GiorgioVelardi, 1, 0, 1, no
280548207,  fanfulla53, 1, 0, 1, no
281134776,  onlysimo, 2, 1, 1, neutral
181949906,  mic_tod, 2, 0, 2, no
2259128423,  gioTebaldi, 1, 0, 1, no
2791966276,  ClodoGiannini, 1, 0, 1, no
1934968448,  AlbertoArtico, 4, 0, 4, no
384823761,  michelepolizzi, 1, 0, 1, no
770534999158317056,  simone_lt, 1, 0, 1, no
248669645,  gion1974, 1, 0, 1, no
2504987971,  ValeDDR, 6, 0, 6, no
1726058940,  lisogena, 2, 0, 2, no
477992458,  MariaVarranca, 2, 0, 2, no
1606375039,  AlbertoBonici, 2, 0, 2, no
2354818038,  giagaz007, 8, 0, 8, no
518305107,  mirko8925, 2, 0, 2, no
33725783,  1nessuno100k, 1, 0, 1, no
2407607705,  pasqametrano, 2, 0, 2, no
28085918,  ale_futuro, 1, 0, 1, no
884424342,  ilsensocritico, 4, 3, 1, yes
315901933,  lmercogliano, 1, 0, 1, no
1026894067,  ArsenaleKappa, 1, 0, 1, no
1341448514,  Olem_Rac, 1, 0, 1, no
2725517289,  vitodet, 2, 0, 2, no
765904821262151681,  grandealex1, 1, 0, 1, no
3014273699,  Fawn__Effe, 3, 1, 2, no
732098609336991744,  TrustThaProcess, 1, 0, 1, no
2508091577,  RaffaeleRicci10, 1, 0, 1, no
2258424567,  Miriam_dn1995, 4, 1, 3, no
179486797,  chiusin88, 1, 0, 1, no
343940079,  S89Tommy, 2, 0, 2, no
81670783,  RickyBauscia, 5, 1, 4, no
551690279,  foglioverde, 5, 0, 5, no
52063355,  ilcacciatore1, 4, 0, 4, no
2979813760,  PaolaSmoking, 7, 0, 7, no
702759586328137728,  SimoneBerto98, 2, 0, 2, no
781392022800306176,  Marty_Loca80, 1, 0, 1, no
496193538,  FrancescoLibe, 3, 1, 2, no
2540965137,  mattia_mariotti, 1, 0, 1, no
425739679,  GPalombelli, 1, 1, 0, yes
1012949180,  0404Michi, 1, 1, 0, yes
1065499118,  GTrangoni, 4, 3, 1, yes
70110877,  _marcosforza, 2, 2, 0, yes
1053181256,  EricaMottola1, 1, 1, 0, yes
883730372,  tlalegname, 7, 0, 7, no
2469570907,  ElidaCrosara, 12, 0, 12, no
463938365,  tuttototo, 3, 0, 3, no
2949178589,  MischiFrancesca, 3, 0, 3, no
230117459,  Francescamanca8, 1, 0, 1, no
4593044481,  taizgem, 2, 0, 2, no
2392450085,  Djdariodimauro, 2, 0, 2, no
203422096,  dcavedon, 1, 0, 1, no
2736523546,  PerryPoletti, 14, 0, 14, no
304308840,  Flavio_MfM, 1, 0, 1, no
140130394,  JESS_3093, 1, 0, 1, no
300390026,  Onofrio_Greco, 1, 0, 1, no
155623600,  andtwet, 1, 0, 1, no
1392155702,  WendellGee1985, 2, 0, 2, no
4833575914,  Mimma240770, 8, 1, 7, no
513745663,  Emanuele676, 1, 0, 1, no
289541478,  adrianapian, 7, 0, 7, no
477208895,  Tgianni77T, 3, 2, 1, yes
223115007,  The_Real_Toto, 1, 0, 1, no
2187901177,  GaetanoBellitto, 7, 0, 7, no
4193719577,  valerio19366025, 1, 0, 1, no
3060280966,  SilentlyFlowers, 4, 2, 2, neutral
1300746456,  JeanPierSabagh, 1, 0, 1, no
441123748,  nappiluciano1, 1, 0, 1, no
1019759222,  MauroMolari, 2, 0, 2, no
490426715,  MARCANTESAVERIO, 17, 0, 17, no
232798646,  _juhan, 1, 0, 1, no
1239391705,  aviopene, 3, 0, 3, no
723515103530852352,  Necxiuspuntodue, 9, 1, 8, no
2810932438,  Nunzia5Stelle, 1, 0, 1, no
1049036017,  AraannFive, 1, 0, 1, no
773793565851942912,  mario_granozio, 8, 1, 7, no
2317777141,  FabrizioBander1, 6, 1, 5, no
473107684,  DalilaNesci, 5, 0, 5, no
371174340,  mikeja2, 8, 0, 8, no
802792437479575552,  BernardoPizzit, 3, 0, 3, no
1123071420,  viviana06743560, 5, 0, 5, no
99361454,  emmazanni, 14, 5, 9, no
417951504,  MarcoRattoLIBRI, 3, 0, 3, no
983131412,  MassimoLiveIt, 2, 0, 2, no
476857175,  arutav, 16, 0, 16, no
723584112586530817,  BorghiArianna, 2, 0, 2, no
974102796,  MirkoBusto, 1, 0, 1, no
727775762074488832,  1studioradi1, 1, 0, 1, no
2802157801,  leo_leo75, 3, 1, 2, no
754269659998855168,  Nikoklark, 3, 0, 3, no
517517175,  loredan28293976, 3, 0, 3, no
3750084076,  SestoCalendeM5s, 5, 0, 5, no
3148025625,  RemolinoGae, 5, 1, 4, no
2281231953,  MaxFaber58, 15, 0, 15, no
1907538607,  MaydaBucci, 5, 0, 5, no
344843714,  Pixicu, 2, 1, 1, neutral
773517618187730944,  Franniebb77, 1, 0, 1, no
624734124,  NuovOrdine, 2, 0, 2, no
4383831976,  Graziamamma4, 2, 0, 2, no
522542520,  AndreD81, 3, 1, 2, no
3056320343,  He_ismyhero, 2, 0, 2, no
1668102216,  xsuggomez, 1, 0, 1, no
366233317,  OrnellaLaviano, 1, 0, 1, no
479054996,  robfratt, 4, 0, 4, no
1454075227,  cotti5stelle, 3, 2, 1, yes
150856099,  LeoOlivera26, 5, 0, 5, no
876085555,  FrancisLafra, 20, 0, 20, no
982667311,  MarioSpinazzola, 3, 1, 2, no
309920258,  justinssollg, 1, 0, 1, no
4892696093,  GiampieroBoni, 1, 0, 1, no
787295659074387968,  matteonardisail, 4, 0, 4, no
715980910118772736,  UrlatoreFi, 2, 1, 1, neutral
1342578204,  Nico_2910, 2, 1, 1, neutral
2921313147,  Giada_Paron, 1, 0, 1, no
2978470539,  moonvjharry, 1, 0, 1, no
386162082,  andriguez, 1, 0, 1, no
805711764868440064,  lvcyblue, 1, 0, 1, no
462768170,  _den89_, 1, 0, 1, no
1366431756,  CerbiMarco, 2, 1, 1, neutral
252499114,  Lucia2713, 3, 0, 3, no
332940060,  peppears, 1, 0, 1, no
445424014,  vam237, 12, 1, 11, no
1151527296,  nuzzolo51, 8, 0, 8, no
2211353832,  GarauSilvana, 22, 1, 21, no
444099350,  ErikaPissarello, 1, 0, 1, no
1419010075,  niko6958, 11, 0, 11, no
983253218,  UnoNemoNessuno, 12, 0, 12, no
1071451754,  pesceregina, 7, 0, 7, no
418253203,  LucaCellamare, 10, 1, 9, no
365633533,  ___John_Smith__, 2, 1, 1, neutral
142034488,  PeterDelleAlpi, 7, 1, 6, no
206671784,  fabryxfg, 11, 5, 6, no
2198397882,  guair1_guair, 3, 0, 3, no
351750061,  pinco9, 6, 0, 6, no
419131342,  gloriastolfo, 5, 2, 3, no
950796283,  GaetanoGorgoni, 3, 0, 3, no
910243676,  archipep, 3, 0, 3, no
1262704657,  GMettifogo, 6, 0, 6, no
940100618,  federicadieni, 1, 0, 1, no
936533587,  giovannafadda4, 16, 2, 14, no
402061124,  Jacob1__, 2, 1, 1, neutral
766676178556125184,  AlbertoTalamo, 2, 2, 0, yes
117729029,  mattepv, 1, 1, 0, yes
1398322412,  AntonioFelaco81, 1, 1, 0, yes
230849160,  IottiMassimo1, 7, 7, 0, yes
2757116931,  perazzelli_anna, 7, 7, 0, yes
184616635,  MatteoGozzoli, 1, 1, 0, yes
847373431,  F_R_Frieri, 5, 5, 0, yes
502195018,  RenatoLavezzi, 1, 1, 0, yes
112490350,  gparuolo, 1, 1, 0, yes
2805302900,  ChiaraBerti86, 1, 1, 0, yes
529424484,  taddeocico, 1, 1, 0, yes
329562118,  DanielaIsetti1, 2, 2, 0, yes
254031201,  eugenio_burani, 1, 1, 0, yes
216798636,  Sdigsa, 2, 1, 1, neutral
364767834,  BeppeGiaccardi, 1, 1, 0, yes
265597067,  sibarilli, 1, 1, 0, yes
4876992285,  Ciacono86, 2, 2, 0, yes
61227039,  Stradiottomarco, 1, 1, 0, yes
2545730562,  marinabale1, 6, 3, 3, neutral
3394538309,  ConsorzioCinsa, 1, 1, 0, yes
595396259,  Davide_bro, 2, 1, 1, neutral
31380861,  lacoonte, 1, 1, 0, yes
404236943,  MauroTedeschini, 1, 1, 0, yes
1038332136,  MargheDeserti, 2, 2, 0, yes
2438727459,  A58Anna, 4, 1, 3, no
45314390,  rem81, 2, 2, 0, yes
29468782,  _McNella, 1, 1, 0, yes
77743085,  _lexismart, 1, 1, 0, yes
599265753,  sergioventuribo, 1, 1, 0, yes
587958135,  v_albi, 2, 2, 0, yes
988846494,  giildagio, 2, 2, 0, yes
471766041,  tommasopasaqua, 1, 1, 0, yes
278558842,  Lou_Bennet, 1, 1, 0, yes
280494789,  GiusBosc, 1, 1, 0, yes
2447235848,  criDarrigo, 1, 1, 0, yes
60608418,  RegioneER, 9, 9, 0, yes
390670890,  filelia, 1, 1, 0, yes
30002429,  paperone84, 1, 1, 0, yes
2250887606,  014pelletterie, 1, 1, 0, yes
22038827,  randomromeo, 1, 1, 0, yes
2236180256,  IWonderPictures, 1, 1, 0, yes
1379031211,  gabrielesalvat, 1, 1, 0, yes
1369438861,  GGarulli, 2, 2, 0, yes
951353780,  MarcoIachetta, 1, 1, 0, yes
334823484,  cimomedici, 1, 1, 0, yes
255535890,  egidiocarbonari, 1, 1, 0, yes
410749879,  giuseppegiuccio, 1, 1, 0, yes
50318881,  bermau, 1, 1, 0, yes
98434065,  MarselParadigmi, 1, 1, 0, yes
2956589752,  riccione2015, 1, 1, 0, yes
283990132,  TweetRiccione, 1, 1, 0, yes
418604474,  MacriMas, 4, 4, 0, yes
81604089,  LadymiaMicky, 1, 1, 0, yes
2494752635,  brighetti70, 1, 1, 0, yes
3224072860,  bepperuggeri, 1, 1, 0, yes
135461887,  mfrittella, 2, 1, 1, neutral
602863531,  Virgiliotweet, 2, 2, 0, yes
43074989,  andreaquarantae, 1, 1, 0, yes
51032068,  maurovanetti, 2, 2, 0, yes
255580876,  lukapg1977, 1, 1, 0, yes
264117723,  Biberkopf76, 6, 1, 5, no
57573467,  aborgnino, 1, 1, 0, yes
540021330,  chiaraviggiani, 1, 1, 0, yes
1287977064,  abrambilla2, 1, 1, 0, yes
2986125545,  SerseMagnone, 2, 2, 0, yes
242490259,  maurovecchietti, 15, 4, 11, no
1063944884,  dorinileonardo, 5, 4, 1, yes
3028103830,  giovmaraglino, 6, 2, 4, no
2299647769,  SIMONA0197124, 1, 1, 0, yes
1650508177,  dallasta61, 1, 1, 0, yes
548467598,  MariaTeresaFant, 2, 2, 0, yes
3378624910,  Ste_Caliandro, 2, 2, 0, yes
256664042,  saroversi, 1, 1, 0, yes
1401719329,  DaFiorenzad, 1, 1, 0, yes
376640823,  cristinamasut, 3, 3, 0, yes
481271925,  LuanaPlessi, 2, 2, 0, yes
1348698072,  fehlpolitik, 1, 1, 0, yes
1260526052,  sabrina_galizzi, 1, 1, 0, yes
581236902,  angelo_fanara, 1, 1, 0, yes
521680063,  JacopoVasta, 1, 1, 0, yes
825588972,  AndreaMa55ari, 1, 1, 0, yes
14386362,  maurosandrini, 2, 1, 1, neutral
417370434,  mattia_mat, 7, 3, 4, no
613878603,  BankruptcyWorid, 1, 1, 0, yes
3842035588,  lucia_mirti, 2, 2, 0, yes
3046618084,  LaRadioNeParla, 5, 5, 0, yes
482073054,  GianlucaZanfi, 1, 1, 0, yes
475086960,  ProvinciadiRE, 2, 2, 0, yes
1038366410,  TheHuom, 3, 0, 3, no
720297033651863552,  ScoziaC, 8, 0, 8, no
1061259396,  Margelletti, 2, 0, 2, no
263582790,  CentroStudiInt, 1, 0, 1, no
336975968,  antoniomisiani, 2, 1, 1, neutral
430718992,  2ndDemocracy, 4, 1, 3, no
2149265671,  pdsicilia, 4, 4, 0, yes
30631198,  fioborel, 13, 0, 13, no
863094259,  trottap66, 4, 2, 2, neutral
334655254,  coppolina1, 1, 1, 0, yes
16896617,  CCarlutti, 2, 1, 1, neutral
2780465290,  valeriapernice, 1, 1, 0, yes
348392216,  GColaiacomo, 2, 2, 0, yes
424493075,  drewtdse, 1, 1, 0, yes
931856754,  GenniTortora17, 1, 1, 0, yes
107014817,  g_broccolo, 1, 1, 0, yes
44690064,  danworks, 1, 1, 0, yes
1212034646,  PinkFreud009, 12, 1, 11, no
129441965,  bluorgone, 1, 1, 0, yes
334841817,  ArturoBardelli, 1, 1, 0, yes
814957531,  Lorenzo_Parisse, 1, 1, 0, yes
292850268,  milkozanini, 4, 3, 1, yes
84032074,  Libo82, 1, 1, 0, yes
769582584401629184,  nclbaldini, 1, 1, 0, yes
3646464681,  fabiokavaz, 4, 4, 0, yes
322180328,  PaoloGerardini, 1, 1, 0, yes
537384133,  PierpaoloPoggia, 1, 1, 0, yes
3365672806,  es06jack, 2, 2, 0, yes
1227975163,  mttcpp75, 1, 1, 0, yes
332361219,  _Alessandro__, 1, 1, 0, yes
412366752,  mariagraziaiole, 2, 2, 0, yes
340614513,  Mar_venx, 3, 1, 2, no
96159448,  luca_lani, 1, 1, 0, yes
1361372586,  e_eus, 2, 2, 0, yes
633656184,  Cescolumi, 1, 1, 0, yes
342280480,  alebi69, 2, 1, 1, neutral
294059097,  Andrea_Terragin, 1, 1, 0, yes
796051246394339328,  annabellabrind2, 1, 1, 0, yes
272460455,  giocss, 2, 2, 0, yes
39722579,  toocoolftp, 1, 1, 0, yes
207479643,  Besa_82, 1, 1, 0, yes
751820450,  che_fidel2, 4, 1, 3, no
17515524,  michele_vencato, 1, 1, 0, yes
4419241582,  scaldasalviette, 1, 1, 0, yes
422617988,  coideos, 1, 1, 0, yes
36915978,  paologhilardi, 4, 4, 0, yes
224752847,  ApprendistaGeek, 1, 1, 0, yes
183737765,  vittoleo, 1, 1, 0, yes
3378127936,  irastadilarsson, 1, 1, 0, yes
2982617513,  Cobretti_80, 1, 1, 0, yes
425902454,  marcoimarisio, 1, 1, 0, yes
65992396,  Glam__Angel, 1, 1, 0, yes
2391536484,  gildobroggi, 1, 1, 0, yes
235752861,  gerryspinelli, 1, 1, 0, yes
240661496,  _wonderwalls, 1, 1, 0, yes
46940431,  tramontichimici, 1, 1, 0, yes
753014750,  areweloststars, 2, 1, 1, neutral
4734014421,  dvcaradonna, 2, 1, 1, neutral
162694919,  La_Vanda, 1, 1, 0, yes
2957445641,  grazian_sara, 1, 1, 0, yes
621058999,  ottagiann, 2, 2, 0, yes
22030478,  giuligiuls, 1, 1, 0, yes
49014600,  elchime, 3, 2, 1, yes
632213506,  gianni557, 1, 1, 0, yes
531817743,  rabert82, 1, 1, 0, yes
761631509614891010,  grangiax, 1, 1, 0, yes
491814146,  ValeBianco88, 2, 1, 1, neutral
341974169,  LDisperati, 1, 1, 0, yes
772359038243930112,  Marisa98983563, 1, 1, 0, yes
427377125,  g1210andrea, 1, 1, 0, yes
3195217666,  lulucastadiva, 2, 1, 1, neutral
226490271,  cincirillo, 1, 1, 0, yes
712117249,  entrechatquatre, 1, 1, 0, yes
1096476931,  GLucaButta, 1, 1, 0, yes
109638595,  dany1703, 2, 2, 0, yes
514257250,  unadeficiente, 1, 1, 0, yes
352651265,  Albex_mdw, 1, 1, 0, yes
508679616,  DavidOlivetti, 4, 2, 2, neutral
941841775,  Diabolink80, 1, 1, 0, yes
192961717,  _stairway, 1, 1, 0, yes
1365357391,  la_zilli, 1, 1, 0, yes
514374051,  uncosoacaso, 1, 1, 0, yes
16088660,  lupodorato, 2, 1, 1, neutral
426079148,  presidealfieri, 2, 1, 1, neutral
3663145393,  mama_non_mama_, 1, 1, 0, yes
1065726312,  lorenzo884, 1, 1, 0, yes
707845461743378432,  Alice_ecc_ecc, 1, 1, 0, yes
2368910456,  ale_marrino, 1, 1, 0, yes
1233824197,  RaffaeleDino, 5, 2, 3, no
4864943680,  lorenzofanali, 1, 1, 0, yes
2149366851,  alexmarzorati, 1, 1, 0, yes
97681471,  MagdaMinni, 3, 3, 0, yes
2428783470,  BobRock63, 1, 1, 0, yes
3343111983,  EnricoBertacci1, 1, 1, 0, yes
259356623,  lauragent_, 3, 2, 1, yes
460453540,  LucaMillia, 1, 1, 0, yes
470511664,  laud_ita, 2, 2, 0, yes
1032404179,  Fabbri_Ale, 4, 4, 0, yes
525552852,  piercethesinner, 1, 1, 0, yes
428239354,  Giaguarama, 1, 1, 0, yes
425234585,  Fmela24, 5, 3, 2, yes
749264927983079424,  Verytte_, 1, 1, 0, yes
131607625,  GiangiMitidieri, 1, 1, 0, yes
770340031286407173,  ClumpsyGio, 1, 1, 0, yes
195915981,  francix_27, 1, 1, 0, yes
14507975,  andrearosiello, 1, 1, 0, yes
388232529,  paggiu87, 1, 1, 0, yes
497201068,  FlaGu52, 3, 3, 0, yes
417353270,  giammariofiori, 2, 2, 0, yes
1127949558,  SaraTiraboschi, 2, 2, 0, yes
42997971,  Osmin__, 2, 1, 1, neutral
82840318,  albertoturrini, 3, 2, 1, yes
31401992,  ilBENZO, 1, 1, 0, yes
3233872114,  sergiodelpero1, 4, 3, 1, yes
479912945,  Andrea75Stefani, 1, 1, 0, yes
4624123577,  chiarabubs, 1, 1, 0, yes
238084771,  AndSpa87, 1, 1, 0, yes
2687351537,  albim87, 1, 1, 0, yes
111603032,  Alex_Ciasullo, 1, 1, 0, yes
433418060,  paolomoderato, 1, 1, 0, yes
440966841,  MarcoVisita, 1, 1, 0, yes
97172428,  FabioMassi, 2, 1, 1, neutral
438309820,  pelessi, 1, 1, 0, yes
523435005,  tommaso_caselli, 1, 1, 0, yes
3391899365,  angelo_basile, 1, 1, 0, yes
434995522,  AlbeBecks, 1, 1, 0, yes
271124380,  follettoonip, 1, 1, 0, yes
286543,  abragad, 1, 1, 0, yes
348552467,  zuodi_, 1, 1, 0, yes
585571018,  massilecce, 1, 1, 0, yes
96119595,  ladoriana65, 1, 1, 0, yes
74159038,  Portaloffreedom, 1, 1, 0, yes
1619874793,  ArmandoRVolpe, 8, 7, 1, yes
881940818,  mauriziofiori25, 1, 1, 0, yes
11870412,  cperfetto, 1, 1, 0, yes
366183223,  Fili190381, 1, 1, 0, yes
3296986435,  GingiCarroll, 1, 1, 0, yes
128695226,  flavs88, 1, 1, 0, yes
1156454910,  LudoOrlando, 1, 1, 0, yes
468457103,  GiuSette7, 1, 1, 0, yes
8556542,  pipcoman, 16, 7, 9, no
3297837127,  LaskaJuventus, 13, 3, 10, no
129168873,  _Introducing_me, 2, 2, 0, yes
211878814,  Zava_SW, 1, 1, 0, yes
1628508252,  alesiro31, 1, 1, 0, yes
194979957,  nonmipare, 1, 1, 0, yes
265640630,  Cordins01, 1, 1, 0, yes
51419546,  lucabbo, 2, 2, 0, yes
1928044562,  AndreaBrik, 1, 1, 0, yes
3019942630,  MaestroYoda81, 4, 2, 2, neutral
41451946,  SkydAnc3R, 1, 1, 0, yes
630606499,  il_lidl, 1, 1, 0, yes
4759144253,  andrea_falivene, 5, 5, 0, yes
2721094846,  SteveZisou, 1, 1, 0, yes
721766834815549441,  gabrielebar1, 3, 1, 2, no
382861362,  FeldeFra, 2, 1, 1, neutral
444685660,  tomguidoz, 1, 1, 0, yes
3842098000,  StaggiaraBXL, 4, 3, 1, yes
77551265,  Ventnoir, 1, 1, 0, yes
438372617,  LucaDoldi, 1, 1, 0, yes
3005280669,  Emanueleuri, 1, 1, 0, yes
1036523390,  a_baraglia, 1, 1, 0, yes
523365399,  NanniPresti, 1, 1, 0, yes
1470221892,  enryandre82, 1, 1, 0, yes
2402987302,  morenorun1412, 1, 1, 0, yes
347183816,  giacomoboffi, 1, 1, 0, yes
3095107277,  demodiable, 1, 1, 0, yes
1040328571,  IoTifoSpread, 1, 1, 0, yes
343616866,  twitdella, 2, 2, 0, yes
451662773,  murmurevasto, 2, 1, 1, neutral
484231425,  dorabenassi, 1, 1, 0, yes
2394803132,  unbreakangel, 1, 1, 0, yes
3037822119,  lyristria, 1, 1, 0, yes
495869416,  russo_vito, 2, 2, 0, yes
2677950102,  lollo_papi, 1, 1, 0, yes
2748927413,  CRIsenzafuturo, 2, 2, 0, yes
15282047,  marcoguada, 1, 1, 0, yes
203681809,  PagineRoma, 3, 2, 1, yes
1480601564,  fasolflavio, 3, 3, 0, yes
111860113,  ufantigrossi, 1, 1, 0, yes
804929901237272576,  TheAmazonBlog, 1, 1, 0, yes
466750334,  BeaMatri, 1, 1, 0, yes
375773693,  irene_soave, 1, 1, 0, yes
448164890,  emilianosodano, 1, 1, 0, yes
719894458230272000,  ferdus13, 1, 1, 0, yes
142227794,  MadCow78, 5, 2, 3, no
749911474496217088,  ste_FUN_otis, 3, 3, 0, yes
4170991971,  Frances86415898, 1, 1, 0, yes
953712781,  boldrini_paola, 1, 1, 0, yes
3243394143,  fraioli1948, 1, 1, 0, yes
100991438,  massitognetti, 11, 0, 11, no
587492925,  DadaFonta, 2, 0, 2, no
743075984350543873,  LauraPrinz2, 1, 0, 1, no
2884438281,  flashmaticgun, 2, 1, 1, neutral
242092114,  rockorizzo, 3, 0, 3, no
2948657619,  CitoCinzia, 1, 0, 1, no
801539266597814272,  raia_vittorio, 2, 0, 2, no
621033928,  PaoloMartone, 1, 0, 1, no
389602747,  malapunta, 1, 0, 1, no
55186493,  kimeracineclub, 1, 0, 1, no
1055870916,  NadiaValente2, 1, 0, 1, no
2489572129,  patriziap52, 1, 0, 1, no
2878091469,  user9870, 6, 4, 2, yes
704275570000064513,  chiarasmar, 1, 0, 1, no
1160208637,  giocogio1, 2, 0, 2, no
1930484058,  manupioppo, 1, 0, 1, no
882039175,  ORNELLAFEDELI, 1, 0, 1, no
758661601797046272,  ElisabethPiro, 1, 0, 1, no
3585095897,  piercirogianni, 2, 0, 2, no
2301647622,  FabiolaMilioni, 1, 0, 1, no
706918990543790080,  emess_90, 1, 0, 1, no
20278277,  solortravels, 1, 0, 1, no
2576727319,  SasaLieto, 2, 0, 2, no
217023602,  EssereVivi, 1, 0, 1, no
440842714,  MMontiglione, 2, 0, 2, no
1112031457,  mcristinatambur, 1, 0, 1, no
448036732,  antonio_davino, 1, 0, 1, no
945454573,  Sabrinamontuori, 1, 0, 1, no
448389529,  carmine_riccio, 1, 0, 1, no
952590944,  giaffredaa, 1, 0, 1, no
3378796144,  WweElisabeth, 1, 0, 1, no
1713152299,  danibona1, 2, 1, 1, neutral
780171107018088452,  mimmonero56, 1, 0, 1, no
800867623177228288,  UboldiPaolo1, 1, 0, 1, no
1627306938,  domenico743, 1, 0, 1, no
3446437582,  dettoripA, 1, 0, 1, no
787452075244449792,  FranceNa966, 2, 0, 2, no
376224033,  pvittorio81, 1, 0, 1, no
3156185302,  info_micropedia, 1, 0, 1, no
733224884,  NicolettaMilett, 1, 0, 1, no
1472981390,  Lucadeflorentis, 1, 0, 1, no
2193116548,  criscuolo1955, 1, 0, 1, no
4078539741,  Rosalba_Salzano, 7, 0, 7, no
2208690588,  vitnicalt, 1, 0, 1, no
1252378069,  LGiunti, 1, 0, 1, no
2158847927,  antonellaze, 1, 0, 1, no
926231262,  concettatorlett, 1, 0, 1, no
3214370294,  AriannaMonica1, 1, 0, 1, no
98369303,  frateAndrea, 1, 0, 1, no
801133353126756356,  Riccardoc16, 1, 0, 1, no
799719119213895680,  CharlySailor, 1, 0, 1, no
4319725823,  rosaria1925ll4, 4, 0, 4, no
805893299923984384,  ermanno_pastore, 1, 0, 1, no
470917159,  MircoRigari, 1, 0, 1, no
1250016204,  FiorileChiara, 12, 0, 12, no
433207635,  GSilingardi, 5, 1, 4, no
1283360828,  cristiancaloni, 1, 0, 1, no
294675329,  AldoSkoda, 1, 0, 1, no
133644326,  Galaxiam, 1, 0, 1, no
16041612,  FabioA, 2, 0, 2, no
563585325,  musto_mario, 1, 0, 1, no
710379738,  LiberIdeAle, 2, 0, 2, no
743218418032218112,  dimauropas, 2, 0, 2, no
278907226,  busettodavide, 1, 0, 1, no
1149263083,  carmencita_DR, 1, 0, 1, no
432874982,  mussivanacore, 1, 0, 1, no
815756892,  PieroCoutinho, 1, 0, 1, no
863031162,  nelpaeseit, 3, 0, 3, no
100453216,  EoloRob, 1, 0, 1, no
803976818038571008,  Federico_Dema, 1, 0, 1, no
1556702114,  VincenzoP86, 4, 0, 4, no
2382081974,  CityNews_it, 9, 6, 3, yes
497829386,  reowyn_, 1, 0, 1, no
788487071304482816,  AnnaMtima, 2, 0, 2, no
533604015,  allatatina, 1, 0, 1, no
290020510,  lascialfari, 1, 0, 1, no
57698379,  LucaMaglione, 1, 0, 1, no
369989109,  vincenzogargiu3, 1, 0, 1, no
143426592,  AntonioMusella, 1, 0, 1, no
2929672425,  edoardo_go, 2, 0, 2, no
585805278,  sergioscognas, 1, 0, 1, no
497298464,  VNobil, 7, 0, 7, no
49064205,  faber1980, 1, 0, 1, no
355158846,  manuelparlato, 1, 0, 1, no
93193032,  joepocket, 1, 0, 1, no
1675709983,  DUVAFerdinando, 5, 0, 5, no
374200554,  gianlucafava, 1, 0, 1, no
513116263,  GalantoMassimo, 3, 0, 3, no
327861190,  imascolo, 1, 0, 1, no
997977180,  enrico_perna, 1, 0, 1, no
425210961,  francescodifalc, 4, 3, 1, yes
734385926240112641,  G1adaross1, 2, 0, 2, no
2933917370,  Blumeide09, 48, 0, 48, no
886453284,  HOMO_REUS, 1, 0, 1, no
405477731,  dompePrignon, 2, 0, 2, no
852610201,  gabriellapeluso, 5, 3, 2, yes
502118586,  BenniN1, 1, 0, 1, no
1317253111,  acoppeto, 1, 0, 1, no
253265973,  raf_ambrosino, 1, 0, 1, no
149167222,  mmaritato, 2, 0, 2, no
802563684992249856,  marcogaleota, 1, 0, 1, no
2789385720,  Orlowski_MSZ, 2, 0, 2, no
8286932,  santopaolo, 1, 0, 1, no
483990953,  nello_pastore, 1, 0, 1, no
418169040,  AnnaMariaBova, 3, 0, 3, no
1921317079,  marini_adele, 1, 0, 1, no
98125196,  gun60, 3, 0, 3, no
2987918104,  antlucig, 2, 0, 2, no
439110992,  Sasyarm, 1, 0, 1, no
15677686,  VinceDOnofrio, 1, 0, 1, no
164225784,  corrmezzogiorno, 5, 0, 5, no
596711664,  cevagrimaldi, 1, 0, 1, no
2351925668,  DPartenopeo, 1, 0, 1, no
131591161,  maucanna, 1, 0, 1, no
1926686792,  gigi_rai, 1, 0, 1, no
1168618789,  Angelnigro, 4, 1, 3, no
379800904,  ziaemanu, 1, 0, 1, no
492639680,  Rossi335635xxxx, 1, 0, 1, no
934200967,  VeroVernetti, 1, 0, 1, no
2295598174,  Ilbiondo73, 2, 0, 2, no
119674844,  lellosomma, 1, 0, 1, no
532609427,  brikkoncella, 1, 0, 1, no
700397967262556162,  Mambo974, 2, 0, 2, no
795323216159997952,  VITTORI84320258, 2, 0, 2, no
554272894,  PasqualeBellott, 1, 0, 1, no
272756812,  gennydimare, 1, 0, 1, no
3040413968,  AlessiaGallo54, 1, 0, 1, no
794913233769549828,  ScaleNapoli, 1, 0, 1, no
24919799,  Marzius67, 3, 0, 3, no
1015801046,  gigitodino, 1, 0, 1, no
716857591738015744,  StefiCara77, 7, 5, 2, yes
1927514694,  meroni_mauro, 19, 0, 19, no
1097904109,  framasashige, 13, 0, 13, no
195005069,  Graziella1128, 7, 2, 5, no
3298910494,  AbraminiAlberto, 1, 0, 1, no
3164958129,  DesilvestrisS, 1, 0, 1, no
784079540373118976,  lozito_leonardo, 2, 0, 2, no
787924963802148864,  cla00001, 1, 0, 1, no
1327803948,  gloriakoan, 14, 3, 11, no
293372970,  FancelloAdriano, 12, 2, 10, no
2242729885,  percivalgull, 14, 0, 14, no
3027236165,  Rossyf04, 1, 0, 1, no
332678373,  orsoperso, 10, 1, 9, no
354867767,  MartaCompagnone, 3, 0, 3, no
776388048561078272,  anna_muoio1, 4, 1, 3, no
1273237951,  giorgio_zu, 1, 0, 1, no
4714411054,  graziafiore67, 4, 2, 2, neutral
3086983167,  GiuppyAlb, 1, 0, 1, no
1015743302,  rominamoser2, 2, 0, 2, no
2535282981,  martaranucci, 3, 0, 3, no
483727150,  fabioboss_g, 2, 1, 1, neutral
408429579,  Saretta_big, 1, 0, 1, no
533959367,  bcarosini1, 5, 1, 4, no
798284445581266945,  CarloVergnano, 2, 0, 2, no
771827116627275776,  Tyrannosauros78, 2, 2, 0, yes
406909407,  FabioPitone, 2, 2, 0, yes
31367770,  vittorio69, 3, 3, 0, yes
730498917176061953,  vincenzocorra48, 4, 0, 4, no
2302034329,  FI_Campania, 22, 0, 22, no
756456006331297792,  CampaniaPerilNo, 3, 0, 3, no
2302070180,  DomenicoDeSiano, 10, 0, 10, no
44120419,  p_right, 4, 0, 4, no
778559501213560832,  ilsudperlitalia, 3, 0, 3, no
1026144254,  NazarioPagano, 4, 0, 4, no
791376904221814784,  NonMaisSabas, 1, 0, 1, no
349374311,  bikenewsPhoto, 1, 0, 1, no
109659461,  StefanoCaldoro, 5, 1, 4, no
558746401,  RonghiSalvatore, 1, 0, 1, no
1455940584,  mistibis, 2, 0, 2, no
256595208,  INVIDIO, 9, 2, 7, no
2666051378,  severino_nappi, 12, 0, 12, no
13047402,  MusicTvOfficial, 1, 0, 1, no
1415054761,  semisrl, 3, 0, 3, no
238298324,  liliusm, 1, 0, 1, no
431100290,  PaoloTerrile, 1, 0, 1, no
696831186820329473,  SodduGiovanna, 2, 0, 2, no
803659890967318534,  Antonio54173054, 1, 0, 1, no
1687856598,  BelvisiBattista, 1, 0, 1, no
2405206161,  Cesaro_FI, 8, 0, 8, no
4784064865,  ForzaItalia_Mel, 10, 0, 10, no
2482442108,  MafaldaAmente80, 7, 0, 7, no
383140351,  Mauro_di_Roma, 1, 0, 1, no
3198806519,  morrisbattist, 1, 0, 1, no
1205970120,  zamlap, 2, 1, 1, neutral
715947181652451328,  Giusepp61982271, 7, 0, 7, no
2903619039,  FIG_Campania, 9, 0, 9, no
467736340,  Allesmarke14, 1, 0, 1, no
3354137837,  fi_regcampania, 6, 0, 6, no
712223648,  max_strippoli77, 1, 0, 1, no
1259556817,  ManuelApeddu, 1, 0, 1, no
2729449693,  BulantiValter, 1, 0, 1, no
431736458,  Mcpaders, 2, 0, 2, no
476264118,  RiccardoLefons, 2, 1, 1, neutral
2373453494,  mariliven, 1, 0, 1, no
3984178583,  krcuel, 6, 0, 6, no
1704844459,  AnnaAdamo24, 15, 0, 15, no
128960061,  Davide_4444, 1, 0, 1, no
585661410,  splitalia, 5, 0, 5, no
373947833,  FrassinettiP, 1, 0, 1, no
1374146521,  PentangeloA, 9, 0, 9, no
266189786,  armandocesaro, 15, 0, 15, no
796293348340408320,  addeopaolo2853, 1, 0, 1, no
4806902709,  realmarcodemo, 1, 0, 1, no
455178157,  GViglietta, 1, 0, 1, no
4264670643,  FIcalimera, 1, 0, 1, no
1086628860,  bern1972, 3, 0, 3, no
1394582718,  Uglpuglia, 72, 2, 70, no
2902379002,  FI_Prov_Napoli, 6, 0, 6, no
3296210343,  PasqualePrisco5, 3, 1, 2, no
2707601247,  villovale, 3, 0, 3, no
510553990,  andreadifra, 1, 0, 1, no
71797055,  DamascelliD, 11, 1, 10, no
2862441234,  cla_cly88, 3, 0, 3, no
719872797103824896,  fi_bari, 1, 0, 1, no
2665954830,  ForzaItaBaiano, 3, 1, 2, no
2389245857,  sarapalermini, 2, 0, 2, no
772778458845941760,  pasqu27, 4, 0, 4, no
794520564866154496,  lin_kalinda, 1, 0, 1, no
1010779513,  MarcoFIORelly, 1, 0, 1, no
4078806327,  _SaBrInA92_, 1, 0, 1, no
3347777716,  renatoguaglian1, 2, 0, 2, no
1707145292,  massimoomar, 1, 0, 1, no
309554233,  clubfpanico, 6, 0, 6, no
2149138327,  nespoli50, 27, 0, 27, no
3093504958,  TittyRomeo, 6, 0, 6, no
1615106850,  AleCampigli, 4, 0, 4, no
363616037,  peppe_federico, 5, 0, 5, no
4635341237,  nappovincenzo7, 1, 0, 1, no
452612282,  Marco_Fattorini, 1, 0, 1, no
2791419194,  DilettaRossi80, 4, 0, 4, no
396535606,  nildigna, 3, 1, 2, no
2815614626,  FIgiovaniOR, 3, 2, 1, yes
2996879087,  JJR1789, 1, 0, 1, no
364138262,  vincentfanini, 4, 0, 4, no
417287720,  MussoFilippo, 1, 0, 1, no
61458514,  domenicotrombi, 2, 1, 1, neutral
2297690535,  Leogixxer, 1, 0, 1, no
2872053178,  FIG_Marche, 1, 0, 1, no
516680545,  ezanna2011, 2, 0, 2, no
802828276481847297,  AbateCapitano, 1, 0, 1, no
400608432,  PittoreGiovanni, 1, 0, 1, no
2739082443,  BChiabotto, 2, 0, 2, no
717637263,  ubi_ubaldo, 1, 0, 1, no
2387583082,  gengalas, 5, 2, 3, no
1043319710,  chrimip, 1, 0, 1, no
4846484643,  giuli1001, 4, 3, 1, yes
397059204,  GiovanniGiuli, 1, 0, 1, no
3203361705,  eddacavedoni, 1, 0, 1, no
184677819,  SgangadaTRE, 1, 0, 1, no
4258635879,  BSevergnegne, 2, 0, 2, no
3559416569,  Mario_221047, 1, 0, 1, no
730751401194860544,  _gaetanocimmino, 5, 0, 5, no
857921246,  robertoaiello63, 4, 0, 4, no
3929709202,  drgianluigi, 8, 4, 4, neutral
447484344,  FioreFyore, 3, 0, 3, no
71108187,  PALUROMA, 1, 0, 1, no
321973192,  MaurizioBarbero, 1, 0, 1, no
1346887926,  ElyUGL, 3, 0, 3, no
2788974663,  adriano_scanu, 1, 0, 1, no
264845229,  MafeGutierrezCo, 1, 0, 1, no
1254951806,  nino_losa, 1, 0, 1, no
65617191,  paolosantin, 1, 0, 1, no
2183181957,  elibettyboni, 1, 0, 1, no
345341203,  2011er74, 2, 1, 1, neutral
453379084,  caligola1974, 2, 0, 2, no
407844018,  mariolinacioppi, 1, 0, 1, no
2502574254,  GaldiAnt, 2, 0, 2, no
332092446,  Giuggiola_81, 3, 0, 3, no
484980283,  TVizziello, 1, 0, 1, no
3246732970,  angelicaniola, 1, 0, 1, no
27259807,  albertfinz, 1, 0, 1, no
2547906484,  mariabelvisi3, 2, 0, 2, no
327334660,  radio_milano, 3, 1, 2, no
1063397041,  AntonioMiele10, 6, 0, 6, no
135842886,  iannuz86, 1, 0, 1, no
1055240222,  reavincedomrea, 5, 0, 5, no
156900346,  teocom91, 1, 0, 1, no
2406348895,  Rob_Persiani, 1, 0, 1, no
401536744,  stfrance60, 1, 0, 1, no
54621250,  bedotwit, 1, 0, 1, no
556228078,  AlfredoMelita, 1, 0, 1, no
565467907,  WhitewolfGori, 5, 4, 1, yes
573049351,  mauroparodi3, 5, 0, 5, no
124717385,  giulia__990, 4, 3, 1, yes
46245160,  erpy83, 2, 0, 2, no
151815328,  doudeelle, 3, 1, 2, no
2363546506,  CusmaiAntonella, 1, 0, 1, no
3253906285,  franceschinian2, 1, 0, 1, no
188704744,  daju29ro, 1, 0, 1, no
2203274991,  Giovi_Torresin, 1, 0, 1, no
409277280,  mdmford, 2, 0, 2, no
1183100450,  NaldoneJake, 1, 0, 1, no
327606075,  claudioiezzim, 1, 0, 1, no
2265734054,  RobertoBonac, 1, 0, 1, no
2778113365,  anto19331445, 1, 0, 1, no
4483387102,  EcletticaDance, 6, 0, 6, no
3710766262,  Nicoooo82, 5, 0, 5, no
118468298,  apro31, 1, 0, 1, no
4160702363,  antoniopisani17, 1, 0, 1, no
493235188,  ferdinantripodi, 2, 0, 2, no
602704576,  ManlioNeri, 3, 1, 2, no
192580291,  setterediroma, 2, 0, 2, no
416970995,  CarnovaleNicola, 1, 0, 1, no
559478963,  maredoggy, 1, 0, 1, no
485685744,  elvirasavino, 3, 0, 3, no
511705621,  albatrosday, 1, 0, 1, no
476290271,  LorLiga, 8, 0, 8, no
2409004844,  Salernitano_63, 1, 0, 1, no
1032249271,  VergognAtac, 2, 0, 2, no
752821878453141504,  Napoleone_III, 14, 0, 14, no
2905245363,  cesarep59, 12, 0, 12, no
543377842,  AtzeniAlex, 5, 0, 5, no
739208580360986625,  alessandralat10, 5, 4, 1, yes
2283623906,  sabrinadiella, 2, 1, 1, neutral
41914935,  SandraColombino, 4, 0, 4, no
769978369903566848,  Antonella121119, 1, 0, 1, no
1637909371,  broggalf, 1, 0, 1, no
453405593,  elisabettadom, 2, 1, 1, neutral
708438713852891136,  MarcoRocco17, 2, 0, 2, no
1040432420,  GVaregliano, 1, 0, 1, no
259813792,  DSiracusano, 1, 0, 1, no
339173161,  61_sissi, 6, 2, 4, no
391338911,  CimbroEleonora, 1, 0, 1, no
101349228,  megalarmsicurez, 1, 0, 1, no
379347952,  FuffaForte, 24, 0, 24, no
489694873,  francesco_botti, 1, 0, 1, no
3031199740,  FloresMontem, 1, 0, 1, no
1593869209,  MaurProietto, 1, 0, 1, no
2609786247,  bugsytwenty, 1, 0, 1, no
742800361614934018,  tophtw, 1, 0, 1, no
425204698,  MauroCedarmas, 2, 0, 2, no
3434229274,  PdSegreteria, 3, 0, 3, no
3295067231,  PdSinistra, 4, 0, 4, no
716881918323765248,  genxcambas, 16, 0, 16, no
434256410,  DeliaOrsillo, 1, 0, 1, no
295535267,  LaPresse_news, 4, 0, 4, no
474941612,  LapoPiero, 8, 5, 3, yes
534534709,  Alessio_rouge, 1, 0, 1, no
1213656799,  vincenzotav53, 1, 0, 1, no
601118618,  papinus64, 2, 0, 2, no
2338374654,  Margherita_ol, 1, 0, 1, no
1037049708,  francesca_effe_, 1, 0, 1, no
1251629106,  rossidav81, 3, 0, 3, no
1552953278,  cato_edu, 1, 0, 1, no
722475496831901697,  Capponi4Fabio, 1, 0, 1, no
2776213765,  CristofariMarco, 1, 0, 1, no
463649801,  coliandro73, 3, 0, 3, no
805327474766839808,  LeoneZero, 1, 0, 1, no
2936070221,  giordanodorti1, 7, 2, 5, no
3067658783,  roby_vet, 3, 2, 1, yes
412993265,  FabrizioMercuri, 1, 0, 1, no
1222231279,  SBESSINA, 10, 0, 10, no
143051153,  nicoladelduce, 3, 0, 3, no
374984254,  codadilupo81, 1, 0, 1, no
398832307,  CarloDess, 2, 0, 2, no
485985971,  MariangelaBrind, 12, 0, 12, no
1941448963,  Claaaaaaudiooo, 3, 0, 3, no
3587858295,  FredMockingbird, 2, 0, 2, no
113622523,  palumb67, 2, 0, 2, no
709890005158772740,  EddiPavan, 1, 0, 1, no
889585220,  olipepe63, 1, 0, 1, no
227855396,  rosmontes, 1, 0, 1, no
1581655399,  ComodoEgidio, 6, 1, 5, no
742029848982491136,  TeodoroLascella, 11, 0, 11, no
327379455,  IvanTaverniti, 5, 1, 4, no
1285829190,  Ilferocecabaret, 5, 0, 5, no
252586553,  BeatriceLioi, 2, 0, 2, no
434150529,  Dcaminiti69, 2, 0, 2, no
237177428,  lacqui80, 2, 0, 2, no
396835780,  andreazoup, 3, 1, 2, no
1109576202,  Nino_1954, 1, 0, 1, no
453264684,  mareclaru88, 1, 0, 1, no
306921218,  ernestodelnible, 3, 0, 3, no
135082456,  williamsverta, 2, 0, 2, no
420335251,  LuisaBlive, 1, 0, 1, no
752957312072093696,  nicola_lecci, 1, 0, 1, no
2564287481,  pellicioli60, 1, 0, 1, no
1084226922,  CicconeNadia, 2, 0, 2, no
2321069222,  FedericaZaino, 1, 0, 1, no
2317508289,  CGMeloni, 2, 0, 2, no
2341734769,  massimo09421979, 1, 0, 1, no
81599206,  BeppeArlia, 3, 2, 1, yes
721768316130430978,  Toty_Cx, 2, 0, 2, no
2330252382,  mimmoocapone, 2, 0, 2, no
745231964488237056,  NeroWolf9, 5, 0, 5, no
421678899,  antonioromiti, 1, 0, 1, no
839635759,  digiacomodonato, 1, 0, 1, no
805780793515769857,  Giulio54029688, 2, 0, 2, no
1563980484,  lorena_barbieri, 3, 0, 3, no
843380563,  jobmeteo, 2, 0, 2, no
1061527033,  agiulix, 2, 0, 2, no
25368436,  biugo, 2, 0, 2, no
2610976925,  patrj73, 1, 0, 1, no
15182465,  eraclito, 3, 0, 3, no
3027347596,  girucc, 2, 0, 2, no
821561744,  donatellabarus, 1, 0, 1, no
887224824,  mariowurz, 1, 0, 1, no
292651184,  ChiaraValerioti, 1, 0, 1, no
132500352,  rewindlive84, 3, 0, 3, no
2716757798,  tamburel63, 1, 0, 1, no
222629836,  LucaCaricato, 1, 0, 1, no
731934821988093952,  A_Noja76, 1, 1, 0, yes
731780445399097344,  veronicabosi83, 1, 1, 0, yes
2191248370,  mmauripd, 2, 2, 0, yes
763318811961483264,  Francoviola11, 3, 0, 3, no
3589159876,  aimar17582, 9, 1, 8, no
164787954,  mirna_fusaro, 4, 0, 4, no
2153653584,  AsinoTw, 6, 1, 5, no
1256404992,  valepulcia, 1, 1, 0, yes
398710212,  marcotod, 2, 2, 0, yes
2231246244,  pagina_99, 1, 1, 0, yes
444159760,  RobertoRho, 1, 1, 0, yes
138007135,  CesareCallegari, 1, 1, 0, yes
473725724,  MoroEleonora, 1, 1, 0, yes
230849793,  PervencheBeres, 2, 2, 0, yes
800365267008094208,  kateria376, 1, 1, 0, yes
2480041390,  manda2763, 1, 1, 0, yes
2487377913,  HeyAndiHeyAndl, 1, 1, 0, yes
2436424545,  bzaykolrala, 1, 1, 0, yes
252039915,  ItalianNavy, 8, 8, 0, yes
2896346633,  CTA102CentroStu, 1, 1, 0, yes
481861216,  fabio_celletti, 1, 1, 0, yes
452127175,  paginebraiche, 2, 2, 0, yes
88800509,  gherardip, 1, 1, 0, yes
1036930460,  elenap70, 1, 1, 0, yes
1050994172,  PaolaHeureux, 1, 1, 0, yes
2773398125,  ESteinfl, 1, 1, 0, yes
500122102,  andreaciccarel, 1, 1, 0, yes
457355807,  homeopaticgirl, 1, 1, 0, yes
3297923315,  FabioAgostini20, 4, 4, 0, yes
2519497019,  VerganiSara, 1, 1, 0, yes
3022012884,  francescom_talo, 1, 1, 0, yes
1332750025,  beretta_g, 1, 1, 0, yes
110413216,  FabrizioPadua, 1, 1, 0, yes
880981915,  giovannilaverd, 3, 1, 2, no
629637359,  AssociazioneAqu, 1, 1, 0, yes
2322610277,  robertorug80, 4, 4, 0, yes
2788453788,  CatiDina, 2, 2, 0, yes
2962002417,  1946Martinelli, 1, 1, 0, yes
191869585,  esajas1, 2, 1, 1, neutral
119902223,  lucamdl, 1, 1, 0, yes
1007144863,  Luisaquaini, 1, 1, 0, yes
365982731,  PClemente68, 2, 2, 0, yes
380353988,  AndreaCostanti, 2, 2, 0, yes
2965811733,  _Carabinieri_, 4, 4, 0, yes
1160647381,  carlettimarzio, 1, 1, 0, yes
1689223752,  MatthiasPlkn, 1, 1, 0, yes
1608160309,  LucaBonofiglio, 1, 1, 0, yes
797506008474152960,  Pasqual34572884, 1, 1, 0, yes
27260996,  andreabettini, 2, 2, 0, yes
181345571,  veleropo, 1, 1, 0, yes
1265141706,  LuigiGesmini, 1, 1, 0, yes
968757018,  antodifabri, 1, 1, 0, yes
458323834,  nardi_michele, 1, 1, 0, yes
1912039406,  pedwardsshea, 2, 2, 0, yes
422511634,  giancarlocarpin, 1, 1, 0, yes
727069597833289728,  SalvatoreFaval1, 1, 1, 0, yes
89492611,  Aulogelio, 1, 1, 0, yes
558532120,  iuribologna, 1, 1, 0, yes
1684975140,  poteredonna, 1, 1, 0, yes
2714942648,  VOCEETICA, 1, 1, 0, yes
510953616,  Mac5313, 1, 1, 0, yes
447400795,  DeborahRotelli, 1, 1, 0, yes
555195323,  PLaFaina, 4, 2, 2, neutral
785830353978044416,  OssMilex, 1, 1, 0, yes
970232540,  ValleCaterina, 1, 1, 0, yes
2715973487,  marisapasto, 1, 1, 0, yes
37616894,  nickomoni, 1, 0, 1, no
2342507018,  tonyarpino, 1, 0, 1, no
4713876442,  PaolotheBeatles, 4, 1, 3, no
554724544,  nikolay012, 2, 0, 2, no
98174343,  CEDPONTACCIO12, 2, 0, 2, no
526379568,  teresaciternesi, 8, 0, 8, no
1002201066,  Massimo5stelle, 10, 0, 10, no
76694254,  AlessMazzanti, 1, 0, 1, no
439245001,  streghina62, 7, 0, 7, no
878503224,  trentino5stelle, 22, 0, 22, no
539917130,  AAngiolella, 2, 1, 1, neutral
436978029,  Ioballodasola, 4, 3, 1, yes
447981049,  tex973, 10, 4, 6, no
152179876,  crisbo69, 3, 0, 3, no
342077520,  twicram, 9, 0, 9, no
723392517081718784,  0e876a478ac743c, 7, 1, 6, no
477025365,  IolandaNanni, 8, 0, 8, no
967938882,  palmalasi, 7, 0, 7, no
822200874,  insomniac39012, 3, 0, 3, no
483660718,  FrancescoDonMax, 1, 0, 1, no
1037579658,  andrearossiba, 6, 0, 6, no
2405656973,  Karm3nB, 5, 0, 5, no
974896261,  giancarlopinto2, 1, 0, 1, no
4229455444,  MyraFrida, 2, 0, 2, no
1219848883,  BastianCuntraiu, 15, 2, 13, no
164205065,  AndreaViviani, 11, 2, 9, no
3295211331,  Antonio_Cufari, 1, 0, 1, no
423726669,  margaart, 1, 0, 1, no
505805390,  LuisaPensabene, 1, 0, 1, no
1345401194,  Nicola_Mercurio, 2, 0, 2, no
4850499688,  salaris97, 1, 0, 1, no
523613502,  iena46, 21, 3, 18, no
474720885,  Diegos53, 2, 0, 2, no
461254969,  A33ROSSI, 2, 0, 2, no
553392203,  RomyHellas, 17, 2, 15, no
1183448389,  VPensabene, 7, 3, 4, no
391034680,  EugenioGangale, 6, 0, 6, no
1251322195,  maxcamerata, 29, 1, 28, no
2420640549,  FabioBellissimo, 3, 0, 3, no
62024752,  vincearma, 2, 0, 2, no
208197262,  elettricor, 1, 0, 1, no
2413327976,  Rodi1893, 4, 1, 3, no
430033517,  benedettademori, 10, 0, 10, no
405432607,  bartpatgrillo, 2, 0, 2, no
484133390,  giampieromarti1, 9, 0, 9, no
105538883,  glamourino, 11, 2, 9, no
374145405,  Btigerish, 2, 0, 2, no
612633942,  LivioOrtombina, 5, 1, 4, no
1177010244,  m_pe7, 2, 0, 2, no
3131316279,  DottVignolo, 15, 0, 15, no
570178300,  simone0781, 2, 0, 2, no
264686296,  luigipixel, 3, 0, 3, no
185120890,  RaymondoM, 1, 0, 1, no
1859667852,  _whenom_, 14, 1, 13, no
1228441892,  CVergato, 1, 0, 1, no
2884770762,  latinila1, 1, 0, 1, no
1238691594,  CarolcleaCarola, 6, 0, 6, no
1852433868,  kostasusi, 9, 0, 9, no
521298763,  Excalibur57X, 2, 1, 1, neutral
1008326401,  amicaxamica, 4, 0, 4, no
2467422972,  enzo26maggio, 6, 0, 6, no
539865019,  PierluigiPauli, 5, 0, 5, no
912491316,  dani_giancarlo, 3, 2, 1, yes
108273678,  LupusInFabula83, 1, 0, 1, no
280617318,  Billygun83, 3, 0, 3, no
1219792052,  tannico72, 3, 0, 3, no
2997728404,  odoanto1, 3, 0, 3, no
979279446,  bruttocoso, 21, 0, 21, no
559265836,  EnzoSulWeb, 5, 4, 1, yes
798910302,  gi_pavanello, 1, 0, 1, no
1215433375,  gegenluc, 3, 0, 3, no
3224620169,  rockysal1979, 1, 0, 1, no
2238971784,  Antonio14663, 1, 0, 1, no
1017105506,  JaqIrene, 2, 0, 2, no
317951602,  scichi, 12, 5, 7, no
542573422,  MagicoPaola, 2, 0, 2, no
2438340445,  giuroby, 13, 0, 13, no
397358182,  GiQadro, 4, 1, 3, no
257884666,  silviafossiblog, 5, 0, 5, no
2244779704,  perrero_s, 2, 0, 2, no
200794803,  PPColasanti, 3, 0, 3, no
583687484,  eltheus, 3, 0, 3, no
799170605945942016,  giustodeigiusti, 1, 0, 1, no
1517691259,  LeoDende83, 9, 0, 9, no
564492621,  nadia26552904, 2, 0, 2, no
2896345199,  TheFabrizious, 19, 0, 19, no
510080672,  CarloCiccio, 1, 0, 1, no
785123317858590720,  extremexxx78, 2, 0, 2, no
2198111423,  SunjaSan, 1, 0, 1, no
2342104352,  banjopeloso, 18, 5, 13, no
1320078122,  marirosmari, 9, 0, 9, no
1419216668,  Alezphotowine, 2, 1, 1, neutral
2815160163,  gigicozzo, 2, 0, 2, no
2865791827,  olindasilvagni, 5, 1, 4, no
116863508,  nicolamarzia, 2, 0, 2, no
387745397,  oriama1969, 2, 0, 2, no
798416925466521601,  biste71, 10, 0, 10, no
2442530351,  DiMauloEleonora, 1, 0, 1, no
112790908,  iLoveSaraJean, 4, 0, 4, no
2734425083,  mei_fabrizio, 1, 0, 1, no
1071485604,  il_Ghisa, 47, 0, 47, no
1506815232,  apollore62, 7, 1, 6, no
10100482,  PaoloZardi, 1, 0, 1, no
340911437,  Floiudice, 1, 0, 1, no
3387963069,  grace_vielle, 2, 0, 2, no
715828512,  EVerzotti, 13, 1, 12, no
1476164527,  fed_naz, 1, 0, 1, no
4786768821,  LaMorte_Nera, 3, 2, 1, yes
53126023,  andrein1982, 1, 0, 1, no
400959041,  doratempesta, 4, 0, 4, no
3110219361,  PozziJessica, 1, 0, 1, no
1684754797,  redbear201165, 1, 0, 1, no
2196650893,  steal61, 10, 2, 8, no
819650503,  carlozeuli, 1, 0, 1, no
81230879,  fiordinotte, 9, 0, 9, no
1540545835,  LuigiCelli1988, 4, 1, 3, no
576472472,  davegattopardo, 2, 1, 1, neutral
425584732,  EnricoReboscio, 1, 0, 1, no
3346629027,  f4fad58cff11498, 6, 0, 6, no
1215238064,  MaddPagin, 1, 0, 1, no
223214082,  tuotrading, 5, 0, 5, no
717020986764165120,  RicardoAylin, 1, 0, 1, no
593547387,  xamlab, 2, 0, 2, no
3938197216,  samueleg849, 2, 0, 2, no
783760924649947137,  MikidiTreviso, 4, 1, 3, no
29066634,  alecola66, 1, 0, 1, no
2650978150,  michelelanzo, 27, 2, 25, no
1086481526,  IzzoRos, 4, 2, 2, neutral
2331189472,  Frak83, 1, 0, 1, no
452174282,  salvatorericci8, 2, 0, 2, no
23930852,  kaufmannbruno, 2, 0, 2, no
795600271762198528,  Contrastattore, 2, 1, 1, neutral
795355429798891521,  Puzzipa, 2, 0, 2, no
2383579672,  francescamir48, 1, 0, 1, no
1337403674,  gimaggioni, 6, 2, 4, no
749384694219800576,  Marco44981294, 16, 0, 16, no
148771890,  philpal79, 3, 0, 3, no
481944150,  CarloMarrone, 9, 1, 8, no
852980726,  Luka__76, 15, 4, 11, no
487914485,  milkoscaglione, 11, 1, 10, no
1187298426,  fulviamarisa, 1, 1, 0, yes
1023109254,  GNarduolo, 3, 3, 0, yes
592127497,  VitoGulli, 10, 0, 10, no
272858172,  Pgrecoit, 6, 5, 1, yes
3270703668,  visionholy1, 7, 6, 1, yes
122363556,  DonnaManuela, 3, 3, 0, yes
361985955,  CarloRapezzano, 4, 4, 0, yes
472170881,  Gaetano_twit, 10, 4, 6, no
306985813,  Vudoppio, 2, 2, 0, yes
540994558,  toraldina, 1, 0, 1, no
925871864,  Frastabile70, 5, 0, 5, no
168513045,  selv4x, 1, 0, 1, no
1363019598,  AlexTheLondoner, 1, 0, 1, no
109361238,  andreadrus, 2, 0, 2, no
290992864,  LucaCimo, 15, 0, 15, no
3490660817,  BiTperMinute, 2, 0, 2, no
598942493,  enzafanelli, 1, 0, 1, no
2340302399,  tutto1altro, 2, 0, 2, no
17688757,  didaclopez, 2, 0, 2, no
182859208,  DeborahDirani, 2, 0, 2, no
135084834,  RickyTR74, 1, 0, 1, no
2782670885,  ulisse7555, 1, 0, 1, no
1600253772,  palmiericar, 2, 0, 2, no
504778376,  giuseppecampis6, 1, 0, 1, no
306343284,  errex2008, 1, 0, 1, no
2510778660,  katzetony, 8, 1, 7, no
2725677691,  AssiaPat, 1, 0, 1, no
261146261,  Falcomichele, 1, 0, 1, no
60928211,  MassimoLupi, 1, 0, 1, no
2980882067,  maldida_suerte, 1, 0, 1, no
254625981,  akexjoao, 24, 0, 24, no
490692382,  pasqua57, 1, 0, 1, no
186977143,  Queerrilla, 3, 1, 2, no
621916117,  Salnashmartelli, 1, 0, 1, no
384391965,  Nellopoint, 1, 0, 1, no
394119695,  ElSabrosoDJ, 1, 0, 1, no
242707729,  AnSignorini, 1, 0, 1, no
268811761,  panterarosa_113, 5, 1, 4, no
109823487,  the_kodes, 1, 0, 1, no
595001996,  MarioCappell8, 3, 0, 3, no
425915941,  ElysabettaM66, 3, 0, 3, no
2193063386,  Macondo977, 3, 2, 1, yes
787001238579740672,  marianogiardin6, 5, 0, 5, no
4899492155,  DomenicoSimon15, 8, 0, 8, no
330602048,  tito_m5s, 3, 2, 1, yes
3761998763,  RobediGianchi, 2, 0, 2, no
2868084261,  CanteleRoberta, 5, 0, 5, no
405382064,  Milla_58, 2, 0, 2, no
961283478,  Talktowind, 38, 1, 37, no
3027820086,  DamianoLiguori, 9, 0, 9, no
727087787506319360,  StefanoIncocci2, 3, 0, 3, no
2868065162,  TobyPablo85, 2, 1, 1, neutral
537538390,  alevarriale78, 12, 1, 11, no
378056903,  elisa_1967, 3, 0, 3, no
70681623,  MejoBarone, 2, 0, 2, no
581948637,  Winnieprue, 2, 0, 2, no
437396261,  GiorgettoFelici, 1, 0, 1, no
49940464,  milotrombin, 1, 0, 1, no
61216272,  Jpbluesinger, 1, 0, 1, no
597277298,  stefanonatalin1, 1, 0, 1, no
4903865757,  raimonda2016, 1, 0, 1, no
742226059265859584,  M5Matteo, 1, 0, 1, no
80040362,  cmnit, 5, 0, 5, no
448838002,  SorMichele, 1, 0, 1, no
2366108005,  70_avelino, 6, 0, 6, no
64692701,  AlbertoKrebel, 3, 0, 3, no
2524571118,  LimongelliPaolo, 7, 0, 7, no
3630722294,  Xabat77, 15, 0, 15, no
112544526,  vfrangipane, 2, 0, 2, no
330392789,  G__G46, 6, 1, 5, no
255199851,  amicoFaralla, 1, 0, 1, no
2247433494,  5stelletv, 27, 0, 27, no
1974968564,  Fabozzi84Vince, 4, 0, 4, no
335544532,  indie_louise, 1, 0, 1, no
749668349605515264,  Gianluc59816521, 17, 0, 17, no
2692140600,  kalmapiatta, 4, 0, 4, no
459664582,  bartthechef, 5, 0, 5, no
124765553,  passionanime, 3, 0, 3, no
701732204,  cardipasse, 3, 0, 3, no
2931182735,  VotorioA, 1, 0, 1, no
272521191,  taberlet, 2, 0, 2, no
42020911,  caretta_caretta, 2, 0, 2, no
735827949107171328,  mauroallianz, 1, 0, 1, no
713748288,  NMocanu, 3, 0, 3, no
2816273194,  mauriziogetuli, 15, 2, 13, no
168732280,  marcopiumi, 3, 0, 3, no
21750761,  BeamaBeorg, 10, 2, 8, no
2527227066,  Arjuna5s, 19, 0, 19, no
171159516,  Vinnie972, 3, 2, 1, yes
740069666106802176,  elenambelli4, 2, 0, 2, no
1061905068,  isolu44, 4, 0, 4, no
1064151775,  ErasmoGiammaria, 5, 0, 5, no
2741066872,  rigoletto1955, 1, 0, 1, no
2862624867,  CriCrices, 1, 0, 1, no
802252735668219904,  halberome1979, 1, 0, 1, no
1326609169,  MinnucciGian, 4, 1, 3, no
1040072863,  archbasso, 2, 1, 1, neutral
2294999142,  michelegolinno, 1, 0, 1, no
776002390428266497,  Armandox1234x, 1, 0, 1, no
1647932094,  Ginorad, 1, 0, 1, no
545207960,  maurotomasina, 4, 2, 2, neutral
352976610,  andrew_diver, 2, 0, 2, no
455279517,  AScarfogliero, 1, 0, 1, no
3093445126,  giordlain, 31, 0, 31, no
428447147,  tarabbo, 9, 0, 9, no
4734101189,  francesco4733, 5, 2, 3, no
326271326,  1976TA, 5, 0, 5, no
1036575512,  elisabe89376579, 9, 0, 9, no
85049014,  antoniogiocondo, 1, 0, 1, no
289218172,  BBnetlog, 1, 0, 1, no
3049025107,  dadasara_daiana, 1, 0, 1, no
2514019774,  NildeArcangeli, 1, 0, 1, no
2550102229,  madfily, 1, 0, 1, no
545845140,  BuongovernoMPS, 3, 2, 1, yes
3959228235,  ulissearte, 1, 0, 1, no
2465900299,  cristin36558432, 6, 0, 6, no
758935701698191361,  enju186, 21, 7, 14, no
1370688006,  assemblerboot, 1, 0, 1, no
2326306186,  a83961129, 2, 1, 1, neutral
448937526,  sandroantonini1, 3, 0, 3, no
1389805699,  Ribemore, 8, 0, 8, no
701451907441827840,  beste4k, 6, 0, 6, no
1222888213,  CFenudi, 5, 0, 5, no
853635661,  incazzatissimo1, 17, 2, 15, no
846230053,  ImInhuman_, 3, 0, 3, no
2188197909,  GCiarlone, 1, 0, 1, no
1135851289,  fiorano623, 2, 0, 2, no
536639916,  MagnanoDanilo, 1, 0, 1, no
2166961182,  dnl4531, 1, 0, 1, no
804317201260052480,  byblu71, 2, 0, 2, no
394274603,  senesedoc79, 2, 1, 1, neutral
1261505730,  DPanadisi, 1, 0, 1, no
1058536814,  MaxBellotto73, 2, 0, 2, no
776771798,  m5sScandicci, 4, 0, 4, no
4871354697,  Zuxon2, 1, 0, 1, no
133019285,  nicky0461, 5, 0, 5, no
2286400352,  crivarof, 1, 0, 1, no
2173149525,  hathor1968, 7, 0, 7, no
4300445913,  spigolos, 2, 0, 2, no
22018222,  giorted, 1, 0, 1, no
2202860345,  dariofmorgante, 3, 1, 2, no
1226086274,  l_b74, 1, 0, 1, no
425479495,  giovannifederi2, 6, 0, 6, no
2958716921,  gennarolanni9, 1, 0, 1, no
329920477,  Tonyskie, 1, 0, 1, no
332492607,  ikatsuja, 2, 0, 2, no
2523337780,  ForenzaAnna, 3, 0, 3, no
403507902,  ziofranky5, 5, 0, 5, no
1195933742,  jaco_pa62, 3, 0, 3, no
3115342936,  ae7ded6150e24fe, 8, 0, 8, no
1225720460,  ermenegigio, 2, 0, 2, no
465771339,  chamazzoleni, 10, 0, 10, no
2302978596,  giannipettineo, 6, 5, 1, yes
552015376,  stellamagica07, 1, 0, 1, no
1030992019,  Mario_Giannetta, 16, 5, 11, no
456702091,  patriziaiusco, 1, 0, 1, no
130111210,  lorenzo1940, 7, 2, 5, no
354364814,  gioseffina, 2, 0, 2, no
113050066,  Bodyguard45, 9, 1, 8, no
3500694082,  teddan2008, 1, 0, 1, no
2909622107,  dricadigiulio, 6, 1, 5, no
462313463,  luca_battaglini, 3, 0, 3, no
455284882,  antimofra, 5, 5, 0, yes
2363193428,  francy290772, 6, 6, 0, yes
500763650,  pisano_michele, 1, 0, 1, no
2350177590,  rosso_ciliegia, 1, 1, 0, yes
368219944,  ElisaPan4, 1, 1, 0, yes
2558652622,  GraviliFulvia, 3, 2, 1, yes
457608453,  giulielle16, 3, 3, 0, yes
773602742,  lasciatemisolaa, 29, 1, 28, no
1067019276,  MarsilioLaura, 4, 0, 4, no
2846620537,  ominodellaluce, 1, 1, 0, yes
716685743515680768,  pasqualesann, 1, 1, 0, yes
1089499380,  AreaRivista, 13, 0, 13, no
833640918,  r_bertollini, 1, 0, 1, no
133641733,  gfcomputer, 1, 1, 0, yes
629583176,  Mr_Rocker70, 4, 2, 2, neutral
476764757,  FCasabella, 2, 1, 1, neutral
779350232052142080,  RomaVotaNo, 4, 1, 3, no
3182809755,  _ANNADEBBY_, 4, 1, 3, no
753178402497044480,  Sott_lazapp, 6, 1, 5, no
1277350656,  TolomeoAntonio, 8, 2, 6, no
2435140633,  antonel82984126, 4, 1, 3, no
221840484,  TinaGrazioli, 9, 1, 8, no
778883788575236096,  Casella_Chris77, 5, 1, 4, no
720232920653434883,  Sellitti_MR, 4, 1, 3, no
2969519381,  _elbonito_, 2, 1, 1, neutral
554260599,  Gianni2392, 2, 1, 1, neutral
237860479,  giulia_crivelli, 2, 1, 1, neutral
801911337211281408,  gianmarco_lori, 4, 1, 3, no
1341242756,  gian_lori, 4, 1, 3, no
4442436082,  05Wendy72, 2, 1, 1, neutral
980594448,  carlo992010, 2, 1, 1, neutral
794943746508984320,  Eleonor66294831, 4, 1, 3, no
711220906987757568,  Rizzocrats, 4, 1, 3, no
398036674,  vincenzogiampi, 3, 1, 2, no
2256124088,  LucaNatural70, 14, 2, 12, no
719239360521117697,  MicheleFavullo2, 2, 1, 1, neutral
1239873638,  leoguidobaldi, 2, 1, 1, neutral
4895916273,  RudyCalcagni, 2, 1, 1, neutral
767119569899155456,  ManunzaTonio, 4, 1, 3, no
3067708121,  umbertopm1, 2, 1, 1, neutral
65077794,  rumba_magica, 7, 2, 5, no
803336895820341249,  RevolutionITA17, 3, 1, 2, no
801457403808088064,  BrunoBilli67, 7, 5, 2, yes
2350818704,  maumau6666, 3, 2, 1, yes
696473558990614528,  marcella_pompei, 3, 1, 2, no
987640627,  marcop1it, 15, 7, 8, no
964372705,  MarkGio1, 2, 1, 1, neutral
2653512165,  cortesi59, 3, 2, 1, yes
947954232,  derbatt61, 2, 1, 1, neutral
2376999684,  alabembo, 3, 2, 1, yes
4900612293,  sellox2, 3, 2, 1, yes
1247142956,  CristianFusi1, 2, 1, 1, neutral
1443633074,  raffaele_58, 2, 1, 1, neutral
3372345406,  _LinGualoca, 2, 1, 1, neutral
730429652,  Hartmann_TWT, 5, 4, 1, yes
2430808297,  pier2856, 4, 1, 3, no
501084838,  AxSrm, 5, 1, 4, no
2696347350,  deerharold, 4, 2, 2, neutral
154487155,  Steve_Gary, 2, 1, 1, neutral
805751485552361472,  666mietitore, 2, 1, 1, neutral
911062003,  alessandro01a, 2, 1, 1, neutral
2300074578,  fildifranco, 4, 2, 2, neutral
1061027394,  MassimoMicheli4, 25, 24, 1, yes
259869205,  EmanuKant, 5, 1, 4, no
4278503961,  RoyalPorto, 2, 1, 1, neutral
241244667,  Furbetta84, 2, 1, 1, neutral
2943633160,  riccardo56p, 2, 1, 1, neutral
1344866701,  bisatto1, 2, 1, 1, neutral
796967169808592896,  jovablacksoluti, 2, 1, 1, neutral
1101847890,  iamodioo, 3, 1, 2, no
1146441836,  intraprenSocial, 4, 1, 3, no
773903945391538176,  enzo_64fusco, 6, 5, 1, yes
634629867,  ManuMunerato, 5, 3, 2, yes
480453928,  brumainardi, 10, 3, 7, no
1251862548,  FabioFratiniRA, 6, 2, 4, no
29694342,  QwertyDante, 2, 1, 1, neutral
786836131,  MarcellaTambure, 2, 1, 1, neutral
118126297,  MariangelaPira, 2, 1, 1, neutral
368264486,  pazzini_99, 2, 1, 1, neutral
2988152434,  AntonellaEmme63, 2, 1, 1, neutral
1320032450,  Gughi14Mary, 2, 1, 1, neutral
2365586229,  4dac0c802f8d4f6, 2, 1, 1, neutral
2599643154,  em_tw1, 2, 1, 1, neutral
1068604638,  maurizio_sole, 14, 6, 8, no
2169534491,  mlmorini49, 5, 2, 3, no
4504836677,  dharmajago, 8, 2, 6, no
490777586,  a_putrino, 2, 1, 1, neutral
1427377026,  lakystef, 3, 1, 2, no
4007831482,  leda021055, 8, 2, 6, no
1934584232,  masetti_andrea, 6, 3, 3, neutral
729704804868599810,  faregiovani, 6, 5, 1, yes
1052927598,  GioSallusti, 3, 1, 2, no
4008290355,  rabbiaeterna, 10, 3, 7, no
184567403,  EnricoSalminiS, 4, 2, 2, neutral
38964269,  presvallelunga, 3, 1, 2, no
513356824,  paogpi, 4, 1, 3, no
980852744,  queenduck2, 2, 1, 1, neutral
1204076264,  RaiDue, 2, 1, 1, neutral
777600540444389376,  cespazio, 2, 1, 1, neutral
84416696,  peppez87, 3, 1, 2, no
755745950,  LittlePigo, 5, 2, 3, no
93937195,  mannyzone, 5, 1, 4, no
821669178,  MASSIMOPANZERI2, 4, 2, 2, neutral
517846120,  FPennacc, 6, 1, 5, no
774285142760325122,  Frances43938577, 2, 1, 1, neutral
1367914478,  vercingetorice1, 4, 1, 3, no
1653235658,  gabbo10000, 2, 1, 1, neutral
712622503307423745,  alexfenice, 2, 1, 1, neutral
945604388,  SBazzoffia, 4, 2, 2, neutral
2384025086,  vale1052007, 4, 3, 1, yes
4342920694,  davide_schroeer, 2, 1, 1, neutral
4798473051,  marcojuventus21, 4, 1, 3, no
53659160,  woland23, 6, 3, 3, neutral
55202918,  sossioc, 3, 1, 2, no
537508352,  simona_cimino, 2, 1, 1, neutral
1684079311,  giudice_p, 3, 1, 2, no
267446195,  _Al_Pancino, 2, 1, 1, neutral
496258522,  Pinel7711, 2, 1, 1, neutral
600066593,  ReteVeneta, 2, 1, 1, neutral
2942241411,  mazzara26, 2, 1, 1, neutral
249318832,  Pasqui_semou, 4, 2, 2, neutral
999371760,  FronteAntiRenzi, 5, 2, 3, no
752944386472865792,  ComNOgrazie, 4, 1, 3, no
756916144838176768,  Annaeddj, 5, 1, 4, no
961095302,  DuranteDamiano, 2, 1, 1, neutral
4774998749,  fatina909, 6, 5, 1, yes
391034014,  Elcento82, 4, 1, 3, no
411657903,  ronconimaurizi, 6, 2, 4, no
519217736,  ibcerr, 5, 1, 4, no
724208475572715520,  fede_pezzotta, 2, 1, 1, neutral
436567183,  GIOURSO, 5, 4, 1, yes
3230326396,  gattusdom, 3, 1, 2, no
346723006,  Babs_cat33, 2, 1, 1, neutral
48053946,  giaccari, 3, 1, 2, no
1515550466,  boietti, 2, 1, 1, neutral
288206319,  valarmorghulish, 3, 2, 1, yes
619453795,  rclienti, 2, 1, 1, neutral
1639913586,  frank_castagna1, 2, 1, 1, neutral
3155475373,  antoniobiondo12, 4, 1, 3, no
470063815,  MCarolina_Izzo, 3, 1, 2, no
2949441737,  FlavioTosiTW, 3, 2, 1, yes
459308081,  67Titty, 3, 1, 2, no
2518413287,  ChiaraF59849310, 3, 2, 1, yes
52387663,  Comunardo, 14, 7, 7, neutral
2887357012,  luca_russomando, 5, 1, 4, no
506170223,  ANTONINORABOTTI, 3, 1, 2, no
2407662107,  Koc34Fatma, 2, 1, 1, neutral
4251035097,  anis_epis, 12, 5, 7, no
1322551362,  Acidelius, 20, 5, 15, no
728282841054851072,  LucianoDelgran1, 7, 4, 3, yes
761948351172583425,  stocazzotutti, 2, 1, 1, neutral
797131449321345024,  SmallTemptation, 2, 1, 1, neutral
1122335881,  _isolatedSys, 2, 1, 1, neutral
363786842,  GilCelletti, 2, 1, 1, neutral
3429159119,  alessandroyori, 2, 1, 1, neutral
258599279,  Pinto_Nick, 4, 2, 2, neutral
2376453195,  jpbon34, 2, 1, 1, neutral
2275643739,  8redLars8, 2, 1, 1, neutral
757054681,  yarlaim, 3, 2, 1, yes
184390072,  silbai64, 4, 3, 1, yes
218610523,  Cazzimiei_, 4, 2, 2, neutral
2342864812,  vyacheslav_greb, 2, 1, 1, neutral
3208883674,  f631b769d99f4ed, 3, 1, 2, no
999889903,  ftribotti, 5, 1, 4, no
785492767342489604,  PetitChatondu75, 2, 1, 1, neutral
4294176503,  sir_denis_rf, 2, 1, 1, neutral
745130481931288581,  SvDgig, 2, 1, 1, neutral
178816546,  Matt_DL, 2, 1, 1, neutral
1334978426,  berzin78, 6, 1, 5, no
790526114573742080,  giorgio_gatto_, 4, 2, 2, neutral
1941612414,  DaniOrabasta, 3, 1, 2, no
3007938557,  alexpisapi, 3, 1, 2, no
3096539158,  sabella_thinkin, 2, 1, 1, neutral
2348924190,  zanpa1473, 2, 1, 1, neutral
3678021317,  Luana45486112, 3, 1, 2, no
239784688,  redazioneiene, 5, 2, 3, no
331614853,  MaiteVarasOrtiz, 2, 1, 1, neutral
50406956,  pinosuriano, 2, 1, 1, neutral
114725372,  _rilesblue, 2, 1, 1, neutral
3085902740,  AlessandroAima1, 4, 1, 3, no
4053837041,  fierardi799, 3, 1, 2, no
374792968,  marry_rn, 3, 1, 2, no
1234446558,  stedistefano, 5, 2, 3, no
45095700,  bauscione, 2, 1, 1, neutral
154638502,  yamunin, 3, 2, 1, yes
564872887,  ChiaraErre, 2, 1, 1, neutral
248412930,  salvo_vinci, 3, 1, 2, no
400301199,  JackMusso, 2, 1, 1, neutral
87037377,  valeriafioranti, 3, 2, 1, yes
170227516,  lejandro97, 2, 1, 1, neutral
61160450,  edorixi, 4, 1, 3, no
62456552,  crozzle, 2, 1, 1, neutral
749254721307873281,  FrancescoPorce5, 2, 1, 1, neutral
415663461,  marziatonnini, 2, 1, 1, neutral
442759558,  macillo73, 3, 2, 1, yes
808738393,  elvivalerio, 4, 2, 2, neutral
465821727,  Il_Paradroide, 3, 2, 1, yes
825649532,  ealloraNO, 2, 1, 1, neutral
803367854888329219,  Megavattnik1, 3, 2, 1, yes
827721282,  sonotrasparente, 2, 1, 1, neutral
469176737,  Michele_DiMita, 2, 1, 1, neutral
192602067,  GianlucaBoari, 4, 2, 2, neutral
339618344,  AlekCrn, 5, 3, 2, yes
3970594469,  fsinrossii, 2, 1, 1, neutral
2291480669,  calimero132, 3, 1, 2, no
328589565,  ZanozaYa_, 4, 2, 2, neutral
2510389357,  Fedora_kov, 2, 1, 1, neutral
2721117566,  Michail3729015, 2, 1, 1, neutral
733613508663906304,  tori959, 2, 1, 1, neutral
751908572796227584,  TradingOnLineIT, 2, 1, 1, neutral
162132290,  Mirkus57, 3, 2, 1, yes
1122091063,  ari_colabianchi, 3, 2, 1, yes
557607196,  bajraktari_eu, 6, 4, 2, yes
2905182705,  Bosa76, 2, 1, 1, neutral
155938369,  bajrak, 6, 4, 2, yes
773278801459568640,  NancyUltra, 4, 2, 2, neutral
3003054298,  edoventu97, 3, 1, 2, no
1467633571,  anpzob1, 2, 1, 1, neutral
3103929401,  _000pz, 6, 3, 3, neutral
29220705,  nicola1999, 3, 2, 1, yes
261644814,  Le_Baron__Rouge, 4, 2, 2, neutral
2436883562,  Lancier1812, 3, 2, 1, yes
54890247,  Fedechino, 5, 2, 3, no
23921022,  sonnycole, 2, 1, 1, neutral
755384253442121728,  bovoliluciano, 3, 2, 1, yes
2780048603,  icone50, 3, 1, 2, no
779041092847202304,  Giovanni2406195, 3, 2, 1, yes
3424394020,  AuxilioGiulia, 2, 1, 1, neutral
1901541684,  BolzoniE, 3, 2, 1, yes
548443351,  pinatoti, 2, 1, 1, neutral
86775879,  NeuroneXXL, 1, 1, 0, yes
1578400826,  islysophie, 1, 1, 0, yes
751414388,  giuseppe_masala, 2, 2, 0, yes
774541927463157761,  MariaGrazMilaur, 4, 1, 3, no
752569567105445888,  ivanello70, 1, 1, 0, yes
379166924,  cdifi, 1, 1, 0, yes
1052907786,  GiorgioD_Amico, 1, 1, 0, yes
4142775568,  danilodexo, 1, 1, 0, yes
2367130649,  EmanueleZenobi, 2, 0, 2, no
259610484,  miciamiaoo, 4, 3, 1, yes
2226850327,  moas_eu, 1, 1, 0, yes
91971468,  alebiag, 1, 1, 0, yes
919975040,  javier_e_br, 4, 2, 2, neutral
730087390719713281,  moas_it, 1, 1, 0, yes
85113254,  flancini, 2, 2, 0, yes
793390472110739456,  Alexa415, 1, 1, 0, yes
700422149132185600,  MastroAnnaMary, 1, 1, 0, yes
3301832783,  valegiannotta, 1, 1, 0, yes
429628157,  FGarbarino, 2, 2, 0, yes
60143566,  giulioenrico, 2, 2, 0, yes
122329808,  FEEMit, 3, 3, 0, yes
358242321,  flamulamaria, 1, 1, 0, yes
21584701,  frapac71, 1, 1, 0, yes
4180753079,  al322andro, 1, 1, 0, yes
365968511,  gbrauzzi, 4, 4, 0, yes
4817118855,  _savsa, 1, 1, 0, yes
1433958451,  mg1066mary, 1, 1, 0, yes
414253436,  olegumn, 1, 1, 0, yes
504877529,  vannuccidavide, 1, 1, 0, yes
443910842,  LucianoBonazzi, 4, 3, 1, yes
1277126388,  gabriArc, 1, 1, 0, yes
800673423198257152,  MediMareNeo, 1, 1, 0, yes
621937390,  MrSpock75, 6, 0, 6, no
1524985099,  FBonavero, 2, 0, 2, no
799538381294338048,  medialabunipi6, 2, 1, 1, neutral
756028559823605760,  bolognadicesi, 2, 2, 0, yes
435122106,  scoppe64, 1, 1, 0, yes
2766070438,  IBruccini, 1, 1, 0, yes
2695313896,  catia_rocchi, 7, 6, 1, yes
3279077915,  robycen59, 1, 1, 0, yes
1013979008,  mcristinabenett, 2, 1, 1, neutral
798918553462337536,  petrashenkona, 1, 1, 0, yes
241092944,  Feel986, 1, 1, 0, yes
804959867085721600,  Luigi53280936, 1, 1, 0, yes
503373734,  RamaversusAsura, 1, 1, 0, yes
298488325,  lorenzoens, 2, 2, 0, yes
432265899,  Gladiatore1955, 4, 3, 1, yes
326962678,  marcosalis1205, 3, 3, 0, yes
704600360791498752,  gcnazionale, 1, 1, 0, yes
435621753,  emanuelespo, 1, 1, 0, yes
2264779285,  VariazioniG, 2, 2, 0, yes
3078227318,  cicco_angelo, 1, 1, 0, yes
113478906,  galdor83, 1, 1, 0, yes
2312718366,  desius1, 3, 3, 0, yes
2776351895,  P0iana, 2, 2, 0, yes
100276253,  gabrieleiannu, 1, 1, 0, yes
793930842,  GiuseppeAru1, 2, 2, 0, yes
721981741473361920,  DettoNonCome, 2, 2, 0, yes
90470099,  jakotweet, 1, 1, 0, yes
702781585,  il_Doctor, 1, 1, 0, yes
243170289,  JosephAppleseed, 2, 2, 0, yes
477540924,  MarcoVeronesi, 2, 2, 0, yes
271306726,  petrosino73, 3, 1, 2, no
3368334621,  Snaffer78, 4, 1, 3, no
513006044,  FabioPresenza, 1, 1, 0, yes
109063442,  ff0rt, 1, 1, 0, yes
1241155386,  GaiaGabriella, 1, 1, 0, yes
22122962,  fedepeanuts, 1, 1, 0, yes
1401878311,  marcomammolo1, 3, 3, 0, yes
4517354433,  EnnioCattabiani, 1, 1, 0, yes
2295072613,  Matteolnz, 1, 1, 0, yes
486503505,  NatLella, 2, 2, 0, yes
479740301,  GianniMalito, 1, 1, 0, yes
796057575485820928,  6662Mark, 2, 2, 0, yes
2320167047,  StorinoAntonio, 1, 1, 0, yes
1133795917,  Rob_Negri, 1, 1, 0, yes
47205692,  aventura71, 1, 1, 0, yes
448151015,  paolagaMb, 1, 1, 0, yes
70518491,  francescohope, 2, 2, 0, yes
2826070541,  contedimonte, 1, 1, 0, yes
417937026,  Sidarge, 2, 2, 0, yes
573016883,  PrincipeNero7, 3, 2, 1, yes
477977300,  filde1ne, 4, 2, 2, neutral
418587866,  lelelimpido, 1, 1, 0, yes
825247129,  violarotolo, 1, 1, 0, yes
494371618,  ludopav, 1, 1, 0, yes
2872423355,  farmaciaalbane1, 1, 1, 0, yes
418786570,  AldoBenin85, 3, 3, 0, yes
498075479,  effe7effe, 1, 1, 0, yes
76709532,  menomm, 1, 1, 0, yes
408310502,  niccord88, 1, 1, 0, yes
1586905838,  MassiMessi78, 10, 9, 1, yes
433545543,  ANDIHILA, 1, 1, 0, yes
9327112,  DTesoroTess, 2, 2, 0, yes
806077381509255168,  AleBhoo, 1, 1, 0, yes
1223309749,  GuzzardoB, 4, 1, 3, no
3073753196,  shamyvalchyhiry, 1, 1, 0, yes
184701836,  reimada, 1, 1, 0, yes
4839515446,  MaddaFriz, 1, 1, 0, yes
466850530,  olivettivive, 1, 1, 0, yes
136335723,  Pso_Cisa, 2, 2, 0, yes
805561276831334401,  CiaoneBis, 2, 2, 0, yes
278558804,  Cristian_Cuna, 1, 1, 0, yes
294214172,  paolodonzelli, 1, 1, 0, yes
89253972,  mbaldi79, 5, 2, 3, no
2355108967,  s_darrigo, 1, 1, 0, yes
414067799,  andygn69, 1, 1, 0, yes
2873752059,  luckyglnFI, 2, 1, 1, neutral
1218912944,  GhiePal, 1, 1, 0, yes
260163476,  spaghettidba, 1, 1, 0, yes
2193033043,  GuidoRusticoni, 3, 2, 1, yes
4774975307,  Mariagra19, 2, 2, 0, yes
1221343388,  BrambiMk, 2, 2, 0, yes
131636321,  guidocosta, 1, 1, 0, yes
1367897778,  GabrieleSpadafo, 1, 1, 0, yes
484053469,  GiorgioVendra, 1, 1, 0, yes
398739728,  StefanoeDaniela, 4, 1, 3, no
588257570,  FrancescoBiragl, 1, 1, 0, yes
1036719662,  Vincent_Moro, 1, 1, 0, yes
331566258,  Marco_Conti91, 1, 1, 0, yes
2209536761,  AngyArashi, 1, 1, 0, yes
1454967481,  uguntanu, 3, 2, 1, yes
18024141,  _antoniofalcone, 2, 2, 0, yes
176110303,  Giulioooooo, 1, 1, 0, yes
727981114887909376,  giovameletti74, 1, 1, 0, yes
4394314654,  DelleLuigi, 2, 2, 0, yes
60267273,  cfpiantedosi11, 1, 1, 0, yes
448074511,  bigsur63, 1, 1, 0, yes
2574363767,  FerrariEsse, 1, 1, 0, yes
418898360,  MicPalo, 1, 1, 0, yes
3187963155,  SgambatiGennaro, 1, 1, 0, yes
53339135,  raistlin84, 2, 2, 0, yes
278223849,  Tintimilla, 2, 1, 1, neutral
2997773242,  marcu_sardu, 1, 1, 0, yes
1443327252,  gabbosgue, 1, 1, 0, yes
2252341345,  EduardoDanzet, 2, 1, 1, neutral
80542245,  LuanaGarofalo, 1, 1, 0, yes
40042562,  morfeo66, 1, 1, 0, yes
805522275973873664,  andrea_lc2412, 1, 1, 0, yes
30452110,  fveneziali, 1, 1, 0, yes
796375469394460672,  GraziellaMarc14, 2, 2, 0, yes
19531637,  GiusMelillo, 4, 4, 0, yes
364885481,  Giaesistente, 2, 2, 0, yes
194153835,  lucasiles, 1, 1, 0, yes
533215636,  AnnaDiCrescenzo, 2, 1, 1, neutral
96189729,  davedragno, 1, 1, 0, yes
1477508138,  marcomarcos11, 1, 1, 0, yes
4242110961,  wanish_, 1, 1, 0, yes
274152077,  nevesottile, 4, 4, 0, yes
409196974,  CosimoBacci, 1, 1, 0, yes
394364545,  valentinacontix, 3, 2, 1, yes
1255397948,  giannimilano911, 1, 1, 0, yes
2890462785,  gabgab_persiani, 1, 1, 0, yes
405408635,  AkVarriale, 1, 1, 0, yes
805538449986097152,  David60113182, 1, 1, 0, yes
407202586,  AlessioRamacc, 1, 1, 0, yes
1281352873,  SovillaDino, 1, 1, 0, yes
2306867816,  AlbertoSguerso, 1, 1, 0, yes
843216710,  steeldead, 3, 3, 0, yes
14401794,  unoemezzo, 3, 2, 1, yes
3373614915,  tara_riva, 1, 1, 0, yes
3037451333,  madame_HPB, 2, 2, 0, yes
166108635,  alonsita81, 2, 2, 0, yes
715992854196314113,  roggeri_laura, 2, 1, 1, neutral
3024886026,  Terrone_Pover, 1, 1, 0, yes
160108824,  Mondorama, 2, 2, 0, yes
137765047,  sinistra2021, 1, 1, 0, yes
604303964,  glukauff, 1, 1, 0, yes
137732158,  lucatime, 1, 1, 0, yes
2240262750,  francesco_iac, 1, 1, 0, yes
560540704,  LivAlice11, 7, 1, 6, no
1601298356,  SaittaMarta, 2, 2, 0, yes
2361554278,  RizzutoMax, 2, 2, 0, yes
386181206,  alexforfun85, 1, 1, 0, yes
97221744,  mistermazza, 2, 2, 0, yes
51437413,  _sociopatica, 1, 1, 0, yes
2357134366,  LoddoAlessio, 1, 1, 0, yes
2288536843,  enrico_zerbo, 1, 1, 0, yes
306971482,  marcomanera81, 3, 2, 1, yes
915591458,  Bananas_Italia, 1, 1, 0, yes
760080068798455808,  MrAdamsty, 3, 3, 0, yes
42056051,  hellobidda, 1, 1, 0, yes
51574450,  ffornara, 1, 1, 0, yes
377576138,  RobesSimon, 2, 2, 0, yes
2800525820,  RennyTitan23, 1, 1, 0, yes
443555553,  sydbarret62, 1, 1, 0, yes
1367549730,  Mirkoanto86, 1, 1, 0, yes
3035186549,  the_omegab, 1, 1, 0, yes
284191529,  Fabio_Casu, 1, 1, 0, yes
796249140531445760,  nicobaroneanxa, 1, 1, 0, yes
114422783,  nocetta, 1, 1, 0, yes
1036813752,  lorenzoborseti, 1, 1, 0, yes
795010190,  mickys982, 1, 1, 0, yes
525214773,  NicoFuccaro, 1, 1, 0, yes
413911524,  MicelliTW, 1, 1, 0, yes
300473436,  EnzoColetta, 1, 1, 0, yes
746285283931467776,  _lindbergh, 1, 1, 0, yes
1260163501,  vittolenza, 1, 1, 0, yes
841750536,  michelanarcisa, 1, 1, 0, yes
780876566335193088,  PonteSuStretto, 1, 1, 0, yes
3345254313,  MarcoMalez, 1, 1, 0, yes
480408730,  yayamallory, 2, 2, 0, yes
3025403273,  DavGatto, 1, 1, 0, yes
119023648,  Vykos86, 1, 1, 0, yes
22628539,  renzocampanella, 2, 2, 0, yes
719993335579086849,  FabriFerraro86, 1, 1, 0, yes
805547024850518016,  stefanoossurol, 3, 3, 0, yes
14546006,  fabiolic78, 1, 1, 0, yes
489671344,  FabioZizi, 1, 1, 0, yes
51040896,  enzo1950, 2, 2, 0, yes
459208308,  FabrizioGians, 1, 1, 0, yes
84857270,  lanerimar, 1, 1, 0, yes
149609062,  lolasdomgwtfafk, 1, 1, 0, yes
2960208089,  giuseppecolo95, 1, 1, 0, yes
2412397158,  107alim, 1, 1, 0, yes
3246110115,  Artcalabrese, 1, 1, 0, yes
226155486,  MarcoPenazzi, 1, 1, 0, yes
484002893,  nickurt14, 1, 1, 0, yes
476150450,  GiTagliamonte, 1, 1, 0, yes
884141802,  bettalastrega, 2, 2, 0, yes
486806675,  CalvaniG, 1, 1, 0, yes
317660741,  repi69, 3, 3, 0, yes
408834813,  AlessioGoggiano, 2, 2, 0, yes
226694051,  Giordy19, 1, 1, 0, yes
1393107217,  davbonaduce, 1, 1, 0, yes
327609918,  marianoaliberti, 1, 1, 0, yes
3259550685,  e6b37f83db9d4af, 1, 1, 0, yes
763371659793461249,  ArabaFenice696, 1, 1, 0, yes
132579955,  Manilo57, 1, 1, 0, yes
785810776040755200,  gigiotto63, 1, 1, 0, yes
428275687,  GiuseppeAlvaro1, 3, 3, 0, yes
326086941,  GabrieleBoeris, 1, 1, 0, yes
2555128562,  di0nix, 1, 1, 0, yes
384955104,  marcosolinas1, 1, 1, 0, yes
1065108000,  marcocrs91, 1, 1, 0, yes
17482936,  Mr_Zed, 1, 1, 0, yes
2284856064,  MarianoDErmo, 1, 1, 0, yes
470935070,  NicolaDibbari, 1, 1, 0, yes
2370615744,  JohnTrotter19, 2, 2, 0, yes
45105641,  gigizza, 1, 1, 0, yes
1261453891,  MarisaNaccarato, 2, 1, 1, neutral
450578649,  GuidoRipoli, 1, 1, 0, yes
871346808,  Ermanncy, 3, 3, 0, yes
2767368676,  domenicobruno75, 1, 1, 0, yes
2787077909,  StefanMaffu, 1, 1, 0, yes
475177175,  AntonioBelluomo, 2, 2, 0, yes
288788899,  mattiatwitt85, 3, 2, 1, yes
178854619,  MirkoVenturi, 3, 3, 0, yes
718484300786724864,  fuanu76, 1, 1, 0, yes
3009818987,  LevantinoSalvo, 1, 1, 0, yes
380816821,  francisallenby, 1, 1, 0, yes
353582458,  demenzialmente, 3, 2, 1, yes
4150121573,  Amatru2emanuele, 1, 1, 0, yes
150357753,  987mies, 1, 1, 0, yes
461056671,  R_Duke01, 1, 1, 0, yes
1397205259,  simoney73, 1, 1, 0, yes
1063089361,  lucacasarotti, 1, 1, 0, yes
1077925266,  AmaryllisRouge, 5, 2, 3, no
2382393696,  MichaelKlashDj, 2, 2, 0, yes
454952181,  yarizanella, 3, 2, 1, yes
755821556,  claudiom5s, 2, 1, 1, neutral
86599770,  NeuroRevolution, 1, 1, 0, yes
420327718,  ziamarcella, 1, 1, 0, yes
241621221,  LampoNero, 1, 1, 0, yes
4853876043,  pozziemanuela, 1, 1, 0, yes
870249523,  PaoloMissiroli, 1, 1, 0, yes
789436957,  Frenk_rada, 1, 1, 0, yes
432412468,  IvanFalanga, 1, 1, 0, yes
1169338080,  rw_claudia, 2, 2, 0, yes
420495514,  Gianluk13, 1, 1, 0, yes
314284217,  fortevanessa, 1, 1, 0, yes
1272629420,  PaolaBombelli, 1, 1, 0, yes
2207647423,  Blasio1992, 2, 2, 0, yes
390479095,  Erdosain77, 1, 1, 0, yes
418257066,  mercuriau, 1, 1, 0, yes
1078066964,  cortmic, 1, 1, 0, yes
136580991,  Carzan78, 3, 3, 0, yes
213243317,  vittoriofaraoni, 1, 1, 0, yes
149935554,  houseklan, 3, 2, 1, yes
1480077403,  PUL18121978, 1, 1, 0, yes
345931188,  sciuppo, 1, 1, 0, yes
406323135,  FP4Corde, 1, 1, 0, yes
89167874,  and84carl, 1, 1, 0, yes
790151106005442561,  Alexmio17, 1, 1, 0, yes
755043060,  DidimoChiericoX, 1, 1, 0, yes
4274472382,  isLordVader, 1, 1, 0, yes
470102068,  DarioColombano1, 1, 1, 0, yes
784387910971887617,  bartolottabrun, 1, 1, 0, yes
324299037,  santillana63, 1, 1, 0, yes
968859552,  stefanoqa, 2, 2, 0, yes
756132907530481666,  meronigigi2, 2, 2, 0, yes
222970082,  mirkisceddu, 1, 1, 0, yes
498041388,  AliceBottamedi, 1, 1, 0, yes
982363262,  PiQQio, 1, 1, 0, yes
49577539,  felipe1973, 1, 1, 0, yes
2532906189,  MarioCampanell9, 1, 1, 0, yes
100478960,  mesosbrodleto, 6, 2, 4, no
1690800408,  BarbaPinazza, 2, 2, 0, yes
1737574513,  mikgallo, 3, 2, 1, yes
297433623,  Jupe68, 1, 1, 0, yes
278689818,  D_AmbRose22, 1, 1, 0, yes
721747692855144448,  _francolupo_, 1, 1, 0, yes
792103363,  Tancredi__, 1, 1, 0, yes
430055311,  Prappy8, 1, 1, 0, yes
1131709830,  JohnnyBoyMilan, 1, 1, 0, yes
164341598,  MarcoCarpentie, 1, 1, 0, yes
2890496489,  riccardo_durso, 1, 1, 0, yes
85066223,  GrouchoMac, 1, 1, 0, yes
2354592853,  Voci_Memoria, 2, 2, 0, yes
133434325,  simonevalitutto, 1, 1, 0, yes
4211706467,  URBY65_, 6, 2, 4, no
337377041,  BinettiGiuseppe, 3, 1, 2, no
463779538,  ladydada_, 1, 1, 0, yes
1339790558,  taurimachia, 2, 1, 1, neutral
291850925,  andreadigio, 14, 11, 3, yes
3302049556,  lucacar8, 1, 1, 0, yes
139488223,  LUIGIMICONI, 1, 1, 0, yes
906520728,  Shardana_81, 1, 1, 0, yes
1361573503,  DarkoDalmata, 2, 2, 0, yes
2369800291,  alessiofox1989, 1, 1, 0, yes
1303976360,  sergiomurroni1, 2, 1, 1, neutral
3312031637,  lonegan61, 1, 1, 0, yes
3135832318,  Renalomb, 1, 1, 0, yes
362687660,  antoniosalamon1, 1, 1, 0, yes
2294245283,  vincenzo_punzi, 5, 5, 0, yes
492050077,  RLoscialpo, 5, 2, 3, no
1118032579,  claudioarmandi, 1, 1, 0, yes
437883452,  navida79, 3, 3, 0, yes
352557566,  inesiannotti, 1, 1, 0, yes
253246255,  geronimo232, 2, 2, 0, yes
174718343,  Mishima16, 3, 1, 2, no
751755712796196864,  andrearomuali, 1, 1, 0, yes
731465648,  cri_milan68, 1, 1, 0, yes
334829206,  Bongio79, 1, 1, 0, yes
948693666,  bobnaccarella, 1, 1, 0, yes
875336480,  AlfonsoDArienzo, 2, 2, 0, yes
568602718,  ItalicoRomanico, 1, 1, 0, yes
339758338,  umbertodl, 1, 1, 0, yes
3051410383,  CroceSerafina, 1, 1, 0, yes
89426611,  eugenioscola, 1, 1, 0, yes
591223507,  esculapio47, 1, 1, 0, yes
2388969988,  spaziprovvisori, 9, 6, 3, yes
4786931445,  Fubeeo16, 1, 1, 0, yes
2310567543,  MauroNinniri, 2, 1, 1, neutral
15620704,  ironxt, 1, 1, 0, yes
307557675,  robertoscro, 1, 1, 0, yes
428215684,  GiuseppeSessa, 1, 1, 0, yes
499113771,  raffaellopetti, 1, 1, 0, yes
1922980620,  lautocc, 1, 1, 0, yes
3396871882,  3101_ross, 2, 2, 0, yes
414756787,  riccardopa, 1, 1, 0, yes
453516464,  cantorobe, 1, 1, 0, yes
542483774,  vannitu, 1, 1, 0, yes
500200019,  dellanto2, 1, 1, 0, yes
1293251905,  ColarossiMarco, 1, 1, 0, yes
495443476,  Andreac16100, 3, 3, 0, yes
492367064,  cavallottodavid, 1, 1, 0, yes
801522283923865605,  MrSlightlyFly, 2, 2, 0, yes
393432788,  MauroLaMantia, 1, 1, 0, yes
490848316,  cicciomascali, 1, 1, 0, yes
191814957,  AntonioForina, 1, 1, 0, yes
1013002394,  rocchinglese, 1, 1, 0, yes
198098477,  elyna309, 1, 1, 0, yes
448375797,  francescomirab5, 2, 2, 0, yes
306345320,  cmagistrelli, 1, 1, 0, yes
96851401,  pierstefano, 1, 1, 0, yes
2778021089,  domedil78, 1, 1, 0, yes
633577541,  Bale_PwC, 4, 3, 1, yes
62692786,  allanozzolo, 1, 1, 0, yes
293089347,  MostardAlex, 1, 1, 0, yes
497996910,  errikrock, 20, 1, 19, no
426143060,  LuongoMattia, 2, 2, 0, yes
2696622467,  alberto_Ricca, 1, 1, 0, yes
141616114,  dalcapi, 1, 1, 0, yes
330055714,  licomati, 1, 1, 0, yes
477114953,  LCopersini, 1, 1, 0, yes
481250150,  fraguida, 1, 1, 0, yes
2355540180,  filippo_crippa, 1, 1, 0, yes
933680802,  AndreaMastrotot, 1, 1, 0, yes
371957516,  LHirondelles, 1, 1, 0, yes
701781527,  PVaglieri, 5, 3, 2, yes
263882239,  Dundu92, 3, 1, 2, no
298514068,  poggio1975, 2, 2, 0, yes
2957342117,  GiuseppeViglio3, 2, 1, 1, neutral
881122356,  Ferdi_Elia, 1, 1, 0, yes
851551892,  s_nocente, 1, 1, 0, yes
931207789,  palombott8, 1, 1, 0, yes
706884388966043648,  GAlserio, 1, 1, 0, yes
4765095501,  cyberpunktrade, 3, 1, 2, no
397110672,  RinoCascone, 1, 1, 0, yes
736753802,  Kate_Pryde, 1, 1, 0, yes
1673019140,  matrix00844, 1, 1, 0, yes
4315954457,  ilbenfe, 1, 1, 0, yes
2353492261,  Serulla92, 1, 1, 0, yes
4071013493,  Lisiski, 1, 1, 0, yes
1700317555,  19vito81, 1, 1, 0, yes
236154283,  isha0086, 1, 1, 0, yes
608338694,  AlbertoSpadoni3, 1, 1, 0, yes
805687949161562112,  dieci_p, 1, 1, 0, yes
2534557611,  car_elia92, 1, 1, 0, yes
412954559,  SodanoArmando, 1, 1, 0, yes
101524356,  SimoTinteri, 1, 1, 0, yes
251642183,  bomberini24, 1, 1, 0, yes
455897879,  MarcoSerraino1, 1, 1, 0, yes
419590321,  luca_piscopo, 1, 1, 0, yes
1133962944,  robky69, 1, 1, 0, yes
3378800667,  CiccoaleStark, 1, 1, 0, yes
305806711,  _Hairetikos_, 1, 1, 0, yes
1510942236,  giovannacalia, 1, 1, 0, yes
93029564,  Gigggio87, 1, 1, 0, yes
790922811061702657,  donato_martano, 1, 1, 0, yes
18977113,  AntoBlueberry, 1, 1, 0, yes
566511257,  prendorosy, 1, 1, 0, yes
378203301,  marianofaenza, 1, 1, 0, yes
319764127,  camikiddo, 1, 1, 0, yes
3001891881,  Frizzoispanico, 1, 1, 0, yes
260727057,  Gnulio, 1, 1, 0, yes
1692192416,  ni111111111, 1, 1, 0, yes
792752280063864832,  andrea_dascanio, 1, 1, 0, yes
445597047,  matteo_schiavo, 1, 1, 0, yes
4834951047,  EttoreDettori, 1, 1, 0, yes
618071453,  gdeluca86, 1, 1, 0, yes
1729630027,  31ISL, 1, 1, 0, yes
18627825,  ilbarbaro, 2, 1, 1, neutral
268516112,  beppe_grullo, 1, 1, 0, yes
2184627463,  rina_fava, 1, 1, 0, yes
388323734,  StefanoStrazza, 1, 1, 0, yes
352604302,  Massistuta86, 3, 2, 1, yes
2261595209,  moroni_alessio, 31, 17, 14, yes
74489551,  RobertoRettura, 4, 1, 3, no
271888997,  GiacBar, 1, 1, 0, yes
3088538206,  francobruni7, 1, 1, 0, yes
757264643232559104,  Mot_OnBoard, 1, 1, 0, yes
3172191113,  brutgian, 2, 2, 0, yes
169441983,  alphonsoot, 1, 1, 0, yes
4243924102,  capretwitti, 1, 1, 0, yes
1050722125,  Barcaioli_Fabio, 3, 2, 1, yes
504275560,  simonialessio, 1, 1, 0, yes
730485418404270080,  NunzioFini, 2, 2, 0, yes
1211906816,  claudiozisa, 6, 2, 4, no
853119354,  mattderricoblog, 1, 1, 0, yes
501700431,  ale_arbo, 1, 1, 0, yes
2902692352,  mariadesireh, 8, 6, 2, yes
2353257175,  gioggsan, 2, 1, 1, neutral
195592165,  DarthInsight, 1, 1, 0, yes
428303369,  salpirrone, 1, 1, 0, yes
874129596,  LucaFilippi5, 4, 4, 0, yes
2677701624,  F4BIO85, 1, 1, 0, yes
259697629,  fabioattadio, 1, 1, 0, yes
757282853596106752,  elettro_orso, 1, 1, 0, yes
76353590,  spasqualato, 1, 1, 0, yes
551156716,  DGermy, 1, 1, 0, yes
420675994,  MarcoStorgato, 2, 2, 0, yes
2182425995,  MarcoAscoli, 1, 1, 0, yes
915039631,  Locandadeglielf, 1, 1, 0, yes
538315990,  dl_jb_inmyheart, 4, 4, 0, yes
733951265554726913,  JEScalabria, 1, 1, 0, yes
112699371,  Ilari_I, 1, 1, 0, yes
20683548,  ventotene, 1, 1, 0, yes
2880129663,  giuseppesposi12, 1, 1, 0, yes
731569869360115712,  CaimeBaldo, 1, 1, 0, yes
739891026136039424,  PaolaFoglia6, 1, 1, 0, yes
977137188,  andramoieepemus, 2, 2, 0, yes
305808737,  delgiudicevince, 1, 1, 0, yes
167845063,  mammarinu, 16, 4, 12, no
3311717032,  Amaccagno66Anna, 1, 1, 0, yes
755095664149798917,  jumperbobcat, 1, 1, 0, yes
3873918947,  anna55fazio, 2, 2, 0, yes
769167220396220416,  GiNucera, 3, 2, 1, yes
740178750822854656,  max27cz, 1, 1, 0, yes
342684653,  IZ8GUM, 2, 2, 0, yes
2472118309,  terry70rompi, 1, 1, 0, yes
2235330226,  GiulianoK40, 2, 2, 0, yes
3000542902,  konrad_zancle, 5, 3, 2, yes
390325154,  roberto150251, 1, 1, 0, yes
2813547793,  frizzypazzy1981, 1, 1, 0, yes
135434989,  Luke19992000, 3, 2, 1, yes
3005861171,  BaldiUgo, 1, 1, 0, yes
487804173,  marisilovi3, 1, 1, 0, yes
1327953938,  CGiobba, 1, 1, 0, yes
153748622,  edohermano, 1, 1, 0, yes
2440196774,  Luigidismail, 1, 1, 0, yes
2474101159,  JohnDoe_KS, 2, 2, 0, yes
3109843485,  maurizioemul, 1, 1, 0, yes
1342706840,  natalinagermi, 2, 1, 1, neutral
1229651126,  DemitriRei, 7, 7, 0, yes
965239081,  nonvotoilpd, 14, 1, 13, no
952522788,  camilocienfue11, 1, 1, 0, yes
2411779897,  nuccio10750691, 1, 1, 0, yes
484170638,  givarts, 5, 2, 3, no
772840526840270848,  luixiv, 3, 1, 2, no
310875127,  nobianconero, 1, 1, 0, yes
510743720,  JillianPotent, 1, 1, 0, yes
629531659,  gabrieleferra13, 3, 3, 0, yes
148483413,  Geremniak, 2, 2, 0, yes
2850169402,  fuorigregge, 1, 1, 0, yes
1030737445,  giordedo, 1, 1, 0, yes
392694342,  AnnamariaGrazi1, 1, 1, 0, yes
2569507486,  SalvatoreForti2, 3, 3, 0, yes
723521787359825924,  gladis69856428, 1, 1, 0, yes
1006338463,  Aleteia____, 1, 1, 0, yes
494358540,  the_bullet_xxx, 1, 1, 0, yes
2729394118,  paola_p23, 1, 1, 0, yes
944403318,  famigas73, 1, 1, 0, yes
437848357,  CompagnoMonti, 1, 1, 0, yes
468454344,  SilvioTirelli, 3, 1, 2, no
50294717,  yellowflate, 2, 2, 0, yes
409951584,  NiccolGiacchett, 1, 1, 0, yes
390978339,  AntonioValiante, 8, 1, 7, no
1065733735,  MVicardi, 2, 2, 0, yes
751720869278445568,  teresa_vico, 15, 15, 0, yes
513581855,  HodenouAugu95, 1, 1, 0, yes
2378654494,  albar_aldo, 5, 4, 1, yes
1036722421,  Ciscorosi, 1, 1, 0, yes
2874561177,  zag_mar, 6, 6, 0, yes
133000879,  SigmaUnit, 1, 1, 0, yes
2460371842,  EmanueleSardu, 1, 1, 0, yes
1961276468,  renato66_renato, 1, 1, 0, yes
330342815,  erFabius, 7, 2, 5, no
363650198,  marengom, 2, 2, 0, yes
2325500930,  danielerazzoli, 1, 1, 0, yes
476171757,  laura_palomba, 2, 2, 0, yes
541649368,  DaniloMalquori, 1, 1, 0, yes
4211120805,  HenryBatasuna, 1, 1, 0, yes
705379890279923712,  AntSantor, 1, 1, 0, yes
483726821,  AndreaDElia9, 1, 1, 0, yes
1524944288,  EneaTrapani, 1, 1, 0, yes
1895089818,  SilviaPiccinin9, 2, 1, 1, neutral
3031581923,  bravotango03, 1, 1, 0, yes
318900321,  CasalnuovoAUT, 1, 1, 0, yes
3052854105,  mamba2015, 7, 1, 6, no
41115564,  Naima_G, 2, 2, 0, yes
475170910,  LGentilomo, 3, 2, 1, yes
2740720654,  RCacherano, 1, 1, 0, yes
1065111427,  MaccMacchia, 1, 1, 0, yes
162734561,  OnYourTurntable, 1, 1, 0, yes
777789093640040448,  frankcastlePark, 4, 3, 1, yes
438361416,  MariaLuisaBrero, 3, 3, 0, yes
2303222014,  deiana_william, 3, 3, 0, yes
1911152329,  simzed, 1, 1, 0, yes
421590820,  AnnaStramigioli, 2, 2, 0, yes
482137874,  LucianoLupreg, 1, 1, 0, yes
603105108,  NONLIVOGLIOpiu, 2, 1, 1, neutral
2213627417,  maryannax11, 3, 3, 0, yes
431792986,  MrLattice, 1, 1, 0, yes
776009506035736577,  ErikaMarti95, 5, 4, 1, yes
96368721,  Davs84, 1, 1, 0, yes
237055198,  danilofesta, 1, 1, 0, yes
481536243,  erminiapinto, 1, 1, 0, yes
338244382,  ValerioC84, 1, 1, 0, yes
1251605058,  pameladiverona, 2, 2, 0, yes
118032176,  vitaaisogni, 2, 2, 0, yes
593658156,  bea_cuni, 1, 1, 0, yes
789963982476050432,  MoonLuchy, 1, 1, 0, yes
1208570911,  AttolicoCarmelo, 2, 2, 0, yes
442212404,  StregatoCS, 2, 1, 1, neutral
790468974110773248,  hastaverdad, 1, 1, 0, yes
796076036299571205,  Antonio10324094, 4, 4, 0, yes
1976027126,  mplongano, 7, 7, 0, yes
1883710946,  EcatombeEuro, 2, 1, 1, neutral
286264255,  Joeledix, 1, 1, 0, yes
138191701,  giovannistinco, 3, 3, 0, yes
614668368,  soflcarrea, 1, 1, 0, yes
2475300957,  madrldeyara, 1, 1, 0, yes
2477173781,  MissNikki119, 1, 1, 0, yes
2485271111,  BrownsBoutlq, 1, 1, 0, yes
608408495,  Chico_daSilva47, 1, 1, 0, yes
613608614,  KlmMartinComp, 1, 1, 0, yes
738103298855731200,  movieinvww, 2, 2, 0, yes
411011344,  cristinaguidoni, 1, 1, 0, yes
745681007488176128,  macacobeachh, 2, 2, 0, yes
4898012151,  bolognany, 2, 2, 0, yes
3399406084,  abfinevintage, 2, 2, 0, yes
748853650970251264,  BolognaFiere123, 1, 1, 0, yes
616080977,  analogcreatlve, 1, 1, 0, yes
4909449202,  jeanjeannyc, 3, 3, 0, yes
47091121,  albyg77, 1, 1, 0, yes
3534312448,  carmengenovese2, 2, 2, 0, yes
3911482575,  VotaSpartaco, 12, 6, 6, neutral
415118084,  __keiske, 5, 4, 1, yes
376298468,  RobertoRedSox, 2, 2, 0, yes
49022982,  viewfinderHD, 3, 3, 0, yes
472791930,  rb0638, 4, 2, 2, neutral
1438313617,  sara80_ms, 1, 1, 0, yes
23574816,  donmimi, 2, 2, 0, yes
1909434692,  PBergaminiEU, 1, 1, 0, yes
4704034514,  DidonAbandonnee, 1, 1, 0, yes
2992335411,  UNISTRAPG, 2, 2, 0, yes
255928261,  bendellavedova, 9, 9, 0, yes
420384749,  SilviaChiave, 1, 1, 0, yes
41480658,  gianner, 7, 5, 2, yes
20804538,  bonuck, 1, 1, 0, yes
276814283,  ICCSingapore, 2, 2, 0, yes
2814755454,  UeTunisie, 1, 1, 0, yes
799517654746800128,  medialabunipi1, 3, 1, 2, no
526126151,  valemantua, 1, 1, 0, yes
181518797,  fabdibenedetto, 1, 1, 0, yes
516647086,  antonluca_cuoco, 4, 2, 2, neutral
380266107,  pacillovin, 1, 1, 0, yes
2785214645,  RaiStudio24, 10, 2, 8, no
2808479699,  alftab3, 1, 1, 0, yes
740270661147451392,  tunisia_2020, 1, 1, 0, yes
2886866969,  mauro_mtoffetti, 1, 1, 0, yes
12165222,  ilario82, 1, 1, 0, yes
529792091,  EnnahdhaParty, 1, 1, 0, yes
595396304,  ItalyinTunisia, 1, 1, 0, yes
799529137648107520,  medialabunipi4, 3, 2, 1, yes
1228742550,  GiancarloCantel, 4, 0, 4, no
123963892,  VictorFuentesT, 2, 0, 2, no
83580827,  AleCostanzo, 2, 0, 2, no
300616972,  daoandrea, 1, 0, 1, no
577287680,  SerinoSerena, 1, 0, 1, no
476154614,  alpalfa, 1, 0, 1, no
1380510872,  GassmanGassmann, 5, 0, 5, no
3337540222,  sca_loredana, 3, 2, 1, yes
407675976,  lucioconsiglio, 1, 0, 1, no
2987441667,  ertappetaro, 2, 0, 2, no
388768139,  ilariallegro, 1, 0, 1, no
802944388825513984,  Erika645911341, 1, 0, 1, no
413992630,  LiborioNatali, 1, 0, 1, no
1560982220,  NestolaLucia, 1, 0, 1, no
4274769735,  QUS67, 2, 0, 2, no
495243061,  anna_foglietta, 5, 0, 5, no
3169486113,  TeatroEliseo, 3, 0, 3, no
2710954486,  Fmeuamorzinho, 1, 0, 1, no
2846820109,  AndreaTrupia01, 1, 0, 1, no
185716948,  add_editore, 1, 0, 1, no
453340945,  rossbrescia, 1, 0, 1, no
2852352323,  carlabettoni1, 2, 0, 2, no
340128358,  destefanoaless, 1, 0, 1, no
455673855,  paolasquarcia, 2, 0, 2, no
108024320,  spl884, 1, 0, 1, no
384885948,  preponismywife, 1, 0, 1, no
2242442758,  Angelenepj, 1, 0, 1, no
1166582510,  mictar1, 1, 0, 1, no
363124652,  VirmanCusenza, 1, 1, 0, yes
309632005,  ThatBoyAmro, 1, 1, 0, yes
345343668,  peppewii, 1, 1, 0, yes
113299873,  univca, 1, 1, 0, yes
3318915569,  tonimancuso, 11, 2, 9, no
1080855186,  maria0780, 2, 0, 2, no
14569308,  alessiamosca, 1, 1, 0, yes
2500855031,  FLatelli, 1, 1, 0, yes
126677638,  Radio24_news, 6, 4, 2, yes
3404088759,  StopTTIP_Albano, 16, 16, 0, yes
384466578,  RiccardaZ, 1, 1, 0, yes
785954323729571840,  quantumsatis507, 2, 2, 0, yes
458533247,  Iloveujb4everr, 1, 0, 1, no
703974865859117056,  camionforever, 1, 0, 1, no
426542237,  KohlManu, 1, 0, 1, no
97911351,  s6carlo, 7, 0, 7, no
407077433,  brunieradino, 1, 0, 1, no
1175727986,  bybica1, 52, 0, 52, no
574543006,  il_populista, 10, 0, 10, no
392056373,  V1pra, 6, 0, 6, no
2248023058,  jaxmax1680, 16, 5, 11, no
244749771,  Minzoparade, 2, 1, 1, neutral
370750024,  compietro, 1, 1, 0, yes
948112501,  Anthy96Orlandi, 1, 1, 0, yes
4829445388,  cyber__affairs, 3, 3, 0, yes
4613838695,  annamariagazza5, 2, 1, 1, neutral
786559574,  norupies, 3, 2, 1, yes
175127426,  KenartsTheKing, 6, 2, 4, no
752910174277537792,  rosguarn, 3, 3, 0, yes
1020763140,  LDiaferio, 1, 1, 0, yes
632814671,  alesmari8, 2, 2, 0, yes
378741753,  ramilla62, 7, 3, 4, no
2465224970,  ChiaraZn, 1, 1, 0, yes
2446212983,  Bartolomeo_83, 2, 1, 1, neutral
810839833,  esse_ff, 3, 3, 0, yes
413883500,  Petiziol, 3, 2, 1, yes
462336529,  Berlusconipresi, 8, 0, 8, no
3356662759,  MrPoliglot, 12, 2, 10, no
546077690,  GieffeGrandi, 2, 1, 1, neutral
197793098,  poissonbordeaux, 3, 2, 1, yes
1978165356,  Stredni_trida, 2, 1, 1, neutral
42084305,  for_ma, 4, 1, 3, no
217718888,  ilSesta, 3, 3, 0, yes
2454877798,  _if_you_ever_, 1, 1, 0, yes
457843889,  Netcherit, 1, 1, 0, yes
1357199719,  AriannaMo__, 1, 1, 0, yes
14281831,  thePulpit, 1, 1, 0, yes
372150748,  pattypepp3rmint, 1, 1, 0, yes
53937129,  SignorinaLave, 1, 1, 0, yes
625923,  malapuella, 4, 4, 0, yes
990685159,  Spongenergy, 1, 1, 0, yes
2880844661,  Mofodix, 1, 1, 0, yes
14077086,  stefy1986, 1, 1, 0, yes
602836025,  facciaDcastagna, 2, 2, 0, yes
9065482,  LaMirus, 1, 1, 0, yes
157042531,  BonnieLaCozza, 2, 2, 0, yes
532235560,  cavstairs, 1, 1, 0, yes
1180026866,  AnNaKanK1, 1, 1, 0, yes
315156705,  LorenzoBises, 1, 1, 0, yes
29473841,  mpietropoli, 1, 1, 0, yes
21210455,  monicapapagna, 3, 3, 0, yes
16329521,  pieromod, 2, 1, 1, neutral
2264082369,  mairrrs, 1, 1, 0, yes
24530443,  giovane_albert, 2, 1, 1, neutral
449654063,  mar21_g, 1, 1, 0, yes
165706304,  IlMist, 5, 5, 0, yes
410879335,  nunziagrieco, 1, 1, 0, yes
1115451206,  Serena_Principe, 1, 1, 0, yes
561307154,  DenverCartoons, 3, 2, 1, yes
800991,  Gioxx, 1, 1, 0, yes
14494559,  Ze_Beps, 1, 1, 0, yes
417735149,  MeryBri, 1, 1, 0, yes
149458590,  susdw_, 1, 1, 0, yes
85317271,  ariarioh, 1, 1, 0, yes
234082042,  elliissc, 1, 1, 0, yes
993340376,  olle_cram, 1, 1, 0, yes
506062047,  AnnalisaLospi, 1, 1, 0, yes
2968347849,  elisa_occhiali, 1, 1, 0, yes
4020349911,  lavinia_slvtr, 1, 1, 0, yes
194768728,  CesareRas, 1, 1, 0, yes
771711951353307137,  FabioBustinto, 1, 1, 0, yes
64862714,  mariolina76, 1, 1, 0, yes
45937678,  CherryPicss, 2, 2, 0, yes
2939523809,  FitfulInside, 1, 1, 0, yes
310877599,  greatpuppeteer, 1, 1, 0, yes
1540896884,  Tenebrella, 1, 1, 0, yes
116777260,  mgiacomello, 2, 2, 0, yes
52785928,  ziArachele, 1, 1, 0, yes
303326553,  tilitsbrightout, 1, 1, 0, yes
193827502,  IrisTinunin, 1, 1, 0, yes
826892666,  suxior, 1, 1, 0, yes
3373669295,  doctorezechiele, 1, 1, 0, yes
18166052,  lospado, 1, 1, 0, yes
284610483,  FlorianaOrlando, 1, 1, 0, yes
2407974422,  CloserToCris, 1, 1, 0, yes
2210950918,  MaxMangione, 1, 1, 0, yes
372829478,  Nancahabyar, 1, 1, 0, yes
493164552,  _Mario91_, 1, 1, 0, yes
1387644800,  buzza_tweet, 1, 1, 0, yes
1920133764,  sisinetta, 1, 1, 0, yes
196614800,  Mugaverosa, 1, 1, 0, yes
60890380,  DomenicoLope, 1, 1, 0, yes
151536511,  Davidethebrain, 1, 1, 0, yes
2171244177,  Style_Sheets, 1, 1, 0, yes
91551818,  caaaaaarmen, 1, 1, 0, yes
417866479,  elisabettaerba, 3, 2, 1, yes
16823857,  grossiro1, 1, 1, 0, yes
136320273,  AndreaMatta23, 2, 2, 0, yes
197137385,  francysolaz, 1, 1, 0, yes
3083649262,  borghigiana, 4, 3, 1, yes
305739479,  Berga9, 1, 1, 0, yes
127899399,  fabiocfavaloro, 1, 1, 0, yes
22542619,  andysal74, 1, 1, 0, yes
2697637670,  simovale91, 1, 1, 0, yes
443456626,  bread4love, 1, 1, 0, yes
137281706,  achillecorea, 1, 1, 0, yes
56454487,  MarCiscoDentro, 1, 1, 0, yes
489592160,  LaGiovinco, 2, 2, 0, yes
201897058,  Sonicale, 3, 3, 0, yes
259312932,  samuelafinn, 1, 1, 0, yes
2999765214,  sirenastonata, 1, 1, 0, yes
502240910,  AntCatinella, 1, 1, 0, yes
2824408020,  fancymistake, 3, 3, 0, yes
3295600515,  waiting_for_gio, 1, 1, 0, yes
58562618,  maxx_78, 1, 1, 0, yes
232218042,  runthevoo, 1, 1, 0, yes
2887946273,  besafi96, 1, 1, 0, yes
563993100,  ffracnesca, 1, 1, 0, yes
7332612,  morenamenegatti, 3, 3, 0, yes
1332514261,  ipiermario, 1, 1, 0, yes
10178372,  VanHelgen, 1, 1, 0, yes
2893587951,  Marco_nrd, 1, 1, 0, yes
608152223,  valebianconero1, 1, 1, 0, yes
3158815840,  ilPortinaio, 1, 1, 0, yes
469351700,  Dfherz, 1, 1, 0, yes
165789892,  AzzetaZeta, 2, 2, 0, yes
1066782674,  ldeeper, 2, 1, 1, neutral
514380298,  _BiBeep, 1, 1, 0, yes
76042887,  sononera, 1, 1, 0, yes
14390755,  zioedo, 2, 1, 1, neutral
3430000359,  t4r4ll0, 2, 1, 1, neutral
2956953249,  laurettab66, 1, 1, 0, yes
219358782,  xsmoulder, 1, 1, 0, yes
235623530,  doppioflash, 3, 1, 2, no
140500878,  Iaminsect, 2, 1, 1, neutral
10692902,  simonamelani, 2, 2, 0, yes
2373918432,  CollSanCaterina, 1, 1, 0, yes
1693764404,  Morning_Coat, 2, 0, 2, no
491524623,  caesargasp, 2, 0, 2, no
4268381662,  Spicchia94, 2, 1, 1, neutral
289858783,  IvanTirrito, 3, 0, 3, no
775935410841071616,  Vincenz71636853, 5, 0, 5, no
3288126430,  corrattini, 2, 0, 2, no
610079443,  Maria_Lucia_Dip, 1, 0, 1, no
383887742,  brix975, 1, 0, 1, no
360779424,  AlessiaNigro1, 1, 0, 1, no
705038728302092288,  littlerobe1, 1, 0, 1, no
3395317595,  BlackWhitePanth, 1, 0, 1, no
397287735,  MauroNicastro, 1, 0, 1, no
1073285989,  PARTIDAQUI, 21, 2, 19, no
869416494,  smeschis, 5, 0, 5, no
866681863,  fercinTw, 2, 1, 1, neutral
1158214129,  SanTenChan, 8, 0, 8, no
802141581662941184,  rubini89912, 3, 0, 3, no
2328781484,  Lodi_73, 2, 0, 2, no
507545031,  Angelacoco3, 2, 0, 2, no
477813810,  EnzoDICARMINE, 3, 0, 3, no
56657613,  _Lotus_3, 2, 0, 2, no
768816467676717057,  romapiupulita, 2, 0, 2, no
891964664,  ATom_4979, 2, 0, 2, no
51285035,  Antoxs, 6, 2, 4, no
60898263,  9granieri, 2, 0, 2, no
144840782,  LARRYDJ82, 1, 0, 1, no
291624735,  MegaSpaziale, 5, 0, 5, no
1402879052,  M5SBarletta, 3, 0, 3, no
2369854366,  GuerriRolando, 3, 0, 3, no
765933168,  DarioMaura, 9, 0, 9, no
1270664520,  KapaMarci, 8, 0, 8, no
740973386499825664,  ghiani_massimo, 3, 1, 2, no
2467758148,  GandolfoMariu, 1, 0, 1, no
384516505,  amangela75, 3, 0, 3, no
549964088,  micheilucia, 1, 0, 1, no
461297042,  FantasticoD, 5, 0, 5, no
6835912,  futuro5stelle, 6, 0, 6, no
4182246959,  manucalucci, 1, 0, 1, no
267894166,  gracco63, 7, 0, 7, no
593752362,  Ketty247, 1, 0, 1, no
723594761488228354,  latinaolimpalus, 4, 0, 4, no
432302964,  GiaomoSoppelsa, 1, 0, 1, no
2174187752,  krlunk, 2, 0, 2, no
191490413,  bravimabasta, 6, 0, 6, no
729861715970658308,  EmyRoyaleagle, 5, 0, 5, no
398172550,  MarcoMurari, 1, 0, 1, no
2480179630,  rdern8, 1, 0, 1, no
2282472413,  LonigroEmanuele, 7, 0, 7, no
728029848,  riccardovici, 1, 0, 1, no
4353321141,  clagreste2015, 3, 0, 3, no
433565657,  Didos73, 2, 0, 2, no
404380686,  Gio_589, 4, 0, 4, no
420253558,  branstock, 1, 0, 1, no
31405544,  natrpn, 1, 0, 1, no
319095713,  ricciomarino, 4, 0, 4, no
3444171,  debe, 2, 0, 2, no
146040638,  Ainely88, 1, 0, 1, no
435314449,  randy3est, 6, 0, 6, no
2526968245,  politicMemory, 15, 1, 14, no
2352371168,  mattfish1089, 4, 0, 4, no
1039563697,  giangrifasi, 9, 0, 9, no
97925608,  terminator6719, 9, 0, 9, no
179193344,  zorc1978, 1, 0, 1, no
91573724,  AlemannoCosimo, 5, 0, 5, no
1277296867,  CampoEnrico1, 12, 0, 12, no
1614878936,  andreaprogetti7, 1, 0, 1, no
1385237533,  E_Scagliusi, 1, 0, 1, no
805557852744118277,  EmPodda, 1, 0, 1, no
784265755508420608,  MichelaBarattu1, 20, 0, 20, no
3438128289,  Woodcut1944, 2, 1, 1, neutral
31137106,  nexus2019, 1, 0, 1, no
2363110486,  EmiFo83, 3, 2, 1, yes
612456796,  silvia_megara, 4, 0, 4, no
4755949588,  Mariamaryjb, 20, 0, 20, no
1142481625,  carbonarim5s, 3, 0, 3, no
1370176568,  sonoioarc, 3, 1, 2, no
581792033,  aldopadovano, 2, 0, 2, no
2317316210,  pa_nogaro, 2, 0, 2, no
274157896,  parlantiandrea, 1, 0, 1, no
3852711633,  alberto_olivari, 12, 6, 6, neutral
411775601,  mesancheno, 3, 0, 3, no
101535431,  lucaptrainer, 3, 0, 3, no
476650928,  LalaPoops, 2, 0, 2, no
1104728414,  sarabesna, 1, 0, 1, no
550870326,  SDebbia, 6, 1, 5, no
1189814130,  Darkenmass, 1, 0, 1, no
253975868,  albertcampailla, 1, 0, 1, no
163165271,  paulengelhard, 1, 0, 1, no
2404016685,  borgoste, 2, 0, 2, no
2519577459,  gomez__claudia, 2, 0, 2, no
3813052822,  MauroTognoli, 2, 0, 2, no
1315379233,  LaisoLuca, 2, 0, 2, no
2359694207,  bizzarri_paolo, 2, 0, 2, no
376130704,  ilrezzo, 2, 0, 2, no
1059877728,  gyomax8, 1, 0, 1, no
2788727236,  deborahmenna, 1, 0, 1, no
417887820,  SONOSOPHIA, 5, 1, 4, no
29723197,  stevedivemaster, 3, 0, 3, no
768460411628838912,  avv_moretti, 1, 0, 1, no
2281925530,  PaoloMoles, 8, 0, 8, no
738997137820811264,  ElioDAmore, 3, 0, 3, no
304449851,  carlopagliani, 5, 0, 5, no
778556999118286848,  Luigiandreozzi5, 1, 0, 1, no
619418274,  rgmz44, 1, 0, 1, no
1049009424,  PaceGiusy, 6, 0, 6, no
792751011861594113,  piroddiavvant, 1, 0, 1, no
395179479,  MoniaZurria, 1, 0, 1, no
13065292,  matteodallosso, 6, 0, 6, no
524807407,  satrapox, 5, 0, 5, no
3822033796,  ZizzaMichele, 1, 0, 1, no
407079267,  GCagnino, 9, 3, 6, no
335292394,  MatteoSelva1, 9, 0, 9, no
1055367092,  dopiot, 14, 1, 13, no
330205544,  NaimaV, 3, 0, 3, no
1163789540,  NuzziR, 1, 0, 1, no
718396521390194688,  Lugixxo, 1, 0, 1, no
406906451,  annaantonini1, 1, 0, 1, no
743412865948860420,  Michele77109967, 3, 0, 3, no
597499565,  molise5stelle, 2, 1, 1, neutral
2951442201,  mirasolecarlo91, 15, 1, 14, no
491225607,  giovo77, 11, 2, 9, no
3069973995,  lama_che, 1, 0, 1, no
787056705188356096,  marilena6475, 6, 0, 6, no
3065887655,  noveidsr, 1, 0, 1, no
130861875,  michelecama, 3, 0, 3, no
799585803739496449,  _automobili_it, 1, 0, 1, no
558975152,  umbertograglia, 6, 2, 4, no
390339077,  PPaolo1963, 2, 0, 2, no
775245163346165760,  DanielaMondorff, 2, 0, 2, no
2272854847,  CVergini1972, 5, 0, 5, no
2915603344,  Nazzare68291189, 2, 0, 2, no
3349425513,  AgostinoCosma, 4, 1, 3, no
498308143,  amrosignoli, 2, 1, 1, neutral
478803640,  caminotta, 3, 0, 3, no
874311997,  per_piacere, 3, 0, 3, no
435973196,  dlacara, 3, 0, 3, no
188066910,  cloud1055, 1, 0, 1, no
833158471,  myanalconda, 2, 1, 1, neutral
1375249574,  mindo_le, 2, 1, 1, neutral
3341739995,  lorenzorausa1, 7, 0, 7, no
796416761126158336,  Valeria15043257, 1, 0, 1, no
380314015,  haldoc, 2, 0, 2, no
108396613,  marioasroma, 1, 0, 1, no
72283097,  pietrogarzione, 2, 0, 2, no
503366650,  McpaniPani, 6, 0, 6, no
390575090,  tiziano5481, 1, 0, 1, no
719552036136738816,  PpPietrogrande, 1, 0, 1, no
390887380,  AlbertoLembo, 1, 0, 1, no
381611850,  PaoloParentela, 2, 0, 2, no
14273179,  Coinquilina2000, 3, 0, 3, no
1465195916,  gufogufato, 8, 2, 6, no
2809827694,  giuliasword72, 5, 0, 5, no
435943823,  rizzfede1970, 1, 0, 1, no
731884829642493952,  Lambiaseanna1, 2, 0, 2, no
3143255746,  ChiaraHookii, 1, 0, 1, no
786809592,  ForumFamigliePO, 7, 6, 1, yes
2764987058,  RimEgil, 1, 0, 1, no
2409273144,  silvanaparolisi, 18, 1, 17, no
552924569,  explosivebells, 1, 0, 1, no
1259494134,  katia8318, 7, 1, 6, no
560086917,  ThePRagno88, 7, 0, 7, no
503670941,  cribabirc, 13, 5, 8, no
4539264436,  thankyou0103, 1, 0, 1, no
2465918593,  Nasca64, 1, 0, 1, no
84554567,  umbertomagni, 4, 0, 4, no
395775680,  Federico10_87, 3, 2, 1, yes
469750828,  franziosef, 16, 0, 16, no
1611267908,  6annapia, 1, 0, 1, no
2984075727,  abe_norifumi, 1, 0, 1, no
448343412,  annagrossi3, 11, 3, 8, no
708649686,  blackpanther4y9, 1, 0, 1, no
428436187,  stefaniapuntoni, 8, 5, 3, yes
634887537,  Oscar57Cotta, 2, 0, 2, no
73855053,  cannelli, 3, 0, 3, no
719828254371106816,  Giusepp01920730, 3, 0, 3, no
2158689967,  gleescovers, 1, 0, 1, no
283111349,  jooranieri, 1, 0, 1, no
1002649244,  RFaloci, 2, 0, 2, no
111357858,  AleSans1, 2, 0, 2, no
4846321492,  motusanimae, 1, 0, 1, no
2637040723,  katy_purpose, 1, 0, 1, no
715889187,  AmbraMaioli, 1, 0, 1, no
4046597542,  lauraa_garau, 2, 0, 2, no
55556322,  sarah_corna, 2, 0, 2, no
2239529617,  somerhaldeyes, 1, 0, 1, no
2581628565,  GiammarcoFer, 1, 0, 1, no
38481918,  The_profundis, 1, 0, 1, no
499782176,  stefanofares, 1, 0, 1, no
574674189,  Luna_Corvonero, 1, 0, 1, no
217611854,  Dungueli_Bonbon, 1, 0, 1, no
367139151,  bemyian8, 1, 0, 1, no
22813056,  aannibal, 5, 0, 5, no
4904009595,  8614lukino, 1, 0, 1, no
280738990,  marcosabait, 3, 0, 3, no
1226957078,  giacomomanto, 3, 0, 3, no
407629213,  isadesimio, 1, 0, 1, no
1039429350,  MarioCardone73, 2, 0, 2, no
3070745903,  MollerAlberto, 1, 0, 1, no
1161058597,  mattei_manu, 3, 0, 3, no
209820549,  Naglio999, 3, 1, 2, no
572128310,  CatalfoNunzia, 1, 0, 1, no
370342943,  oneenrico, 7, 0, 7, no
796749112100134920,  Giusepp30729870, 6, 0, 6, no
3148116022,  chiarakomm, 5, 0, 5, no
801526123851055105,  polemicamente5, 3, 0, 3, no
216884788,  Byrorossa, 5, 0, 5, no
2515047351,  RobyRoby2210, 6, 0, 6, no
129257660,  smascherai, 1, 0, 1, no
781449420281876480,  nigertweet, 3, 0, 3, no
347707519,  Tramy2011, 3, 1, 2, no
2698481416,  audrey201170, 1, 1, 0, yes
2297414524,  agne0608, 2, 1, 1, neutral
1316984629,  marco_java, 1, 1, 0, yes
272354189,  Ljuba2000, 3, 1, 2, no
63388759,  ElisaOrlandotti, 1, 1, 0, yes
24866247,  serenamadhouse, 3, 2, 1, yes
3920761768,  tagliento80, 1, 1, 0, yes
405869845,  RoyZacapa, 2, 2, 0, yes
777269299299938304,  LuciaAgostini2, 4, 2, 2, neutral
106183442,  SURINOMO, 1, 1, 0, yes
1069116288,  SereGamby, 4, 1, 3, no
233597865,  Pietrobas, 1, 1, 0, yes
369014375,  Alberto_Cucca, 1, 1, 0, yes
286934289,  ChiaraTomaini, 1, 1, 0, yes
1638911868,  LavTreviso, 1, 1, 0, yes
2544266245,  fabyanaxxx, 1, 1, 0, yes
1259100200,  fra_occhipinti, 3, 2, 1, yes
2835948227,  rossa_bodi, 1, 1, 0, yes
628128010,  MarisaBorla, 1, 1, 0, yes
1335905778,  Barbaga3Gaetano, 2, 2, 0, yes
2650932528,  QuiNewsCecina, 2, 2, 0, yes
3973489109,  savesammezzano, 1, 1, 0, yes
310911893,  ALEFAVARIN, 1, 1, 0, yes
491512067,  DonatoCapotorto, 1, 1, 0, yes
336996257,  RosannaMarani, 2, 1, 1, neutral
3065752161,  marysotta1, 1, 1, 0, yes
2281439973,  AMagliocchi, 1, 1, 0, yes
1316667145,  mariangelapani, 6, 5, 1, yes
744167896985767936,  calibano12, 1, 1, 0, yes
785989636938235904,  Enry2j, 2, 2, 0, yes
3345732245,  cmiceli7824, 2, 1, 1, neutral
4885205133,  pozzigio, 3, 3, 0, yes
825529146,  giorgia_pcsn, 7, 6, 1, yes
97646474,  ChristianBuzz, 1, 1, 0, yes
271702209,  miguelxx87, 3, 3, 0, yes
403409845,  LotrekAgency, 1, 1, 0, yes
786814848269164544,  InOtherNewsNotO, 1, 1, 0, yes
805076650866180096,  Andreardaniele, 1, 1, 0, yes
4841540824,  giulialeoni07, 1, 1, 0, yes
1625005778,  musicasoxigen, 1, 1, 0, yes
2746176545,  FinaliLaura_17, 1, 1, 0, yes
791770640,  MargheritaAnsel, 1, 1, 0, yes
2881788614,  Acquadiggio, 5, 4, 1, yes
1430722891,  stefania_fantin, 3, 3, 0, yes
239734640,  ostroghoff, 4, 1, 3, no
54941475,  Saruppa, 1, 1, 0, yes
2466135006,  giocastelletti, 2, 2, 0, yes
60333531,  LupoNolberto, 2, 2, 0, yes
3082030787,  giacomozt, 12, 12, 0, yes
451353863,  FrancescoRoma28, 1, 1, 0, yes
1594109935,  SFliop, 2, 2, 0, yes
1324830925,  RealLifeJMT, 1, 1, 0, yes
2745045699,  maraspago, 1, 1, 0, yes
734286883182813188,  MacchiaIl, 5, 5, 0, yes
1373902572,  fontanazza1966, 2, 2, 0, yes
705134710104723456,  barbaramazzant9, 2, 1, 1, neutral
157529661,  giuliagambino, 1, 1, 0, yes
122389904,  JustDJunior, 1, 1, 0, yes
806305806,  EnricoAncillott, 6, 3, 3, neutral
906601957,  DottorSilvestri, 1, 1, 0, yes
1018001742,  ortelius1979, 2, 2, 0, yes
3083996278,  Anna9Ann, 2, 2, 0, yes
169649919,  NoExcuses68, 8, 3, 5, no
3381083531,  lagazzaladragi1, 1, 1, 0, yes
1008565081,  46Oliver, 9, 1, 8, no
2435906219,  TrevisaniBruno, 3, 3, 0, yes
2366954805,  vincenzinopapa, 6, 6, 0, yes
3290443968,  mikashumilty, 1, 1, 0, yes
2711454266,  SoLonelyAlone, 1, 1, 0, yes
851631829,  smater69, 1, 1, 0, yes
706082320005140480,  MikasAlwaysLate, 1, 1, 0, yes
3759731007,  Carfagna_Luca, 1, 1, 0, yes
515638711,  LucianoLavecchi, 9, 1, 8, no
782521290,  nonsoloezio, 2, 1, 1, neutral
2822929792,  FreeChicoForti, 7, 7, 0, yes
85355134,  CarlitosFerrari, 2, 1, 1, neutral
355265834,  MichaelSalTato, 3, 3, 0, yes
2422164068,  scire79, 6, 1, 5, no
319537863,  PLWilds, 1, 1, 0, yes
399553357,  M1kM3n, 1, 1, 0, yes
525581980,  sptinteggiature, 1, 1, 0, yes
1541921473,  fiorivalentina, 1, 1, 0, yes
795653017362202624,  Si_OrcoeSoana, 2, 2, 0, yes
2338466394,  Il_Fornaio99, 1, 1, 0, yes
800804086358556673,  StellaStarSere, 2, 2, 0, yes
626501000,  loop_us, 3, 2, 1, yes
1566641239,  twinspectre, 2, 2, 0, yes
407163369,  missfontaine84, 3, 2, 1, yes
4820995677,  anna_marchetto_, 2, 1, 1, neutral
486018960,  minieradisale, 1, 1, 0, yes
1867212703,  AtoBorr, 3, 1, 2, no
760023416200134657,  renato_twins, 1, 1, 0, yes
460504033,  AlfonsoCelotto, 1, 1, 0, yes
1055076127,  MurenuG, 4, 3, 1, yes
794173347106000896,  SalvatoreRipos5, 1, 1, 0, yes
533526676,  angelo_acanfora, 1, 1, 0, yes
2211437562,  KabriLele, 1, 1, 0, yes
4786498851,  casciavit6, 1, 1, 0, yes
2729415801,  ty_fiorentino, 11, 2, 9, no
2784487658,  IlCaccia82, 2, 2, 0, yes
556658329,  ClaudiaDUlisse, 3, 1, 2, no
455266102,  artiolim, 4, 1, 3, no
354312822,  1981cuba, 1, 1, 0, yes
401607101,  laurazaccheo, 2, 2, 0, yes
29025632,  andarepermare, 1, 1, 0, yes
3256208777,  AvvScarnera, 4, 3, 1, yes
566150054,  Arena_Anto, 7, 2, 5, no
1016270622,  LNeliana, 3, 3, 0, yes
970440781,  LemGiuseppe, 1, 1, 0, yes
193825374,  Diabolikart, 1, 1, 0, yes
802227674001326081,  1989Yanez, 3, 1, 2, no
3637594996,  7548e49f4743480, 1, 1, 0, yes
2323995158,  LucaTerzaroli, 6, 2, 4, no
491468452,  AleQuattrone, 2, 2, 0, yes
2288208282,  ventu1959, 1, 1, 0, yes
4572197355,  THEDREAMER7171, 1, 1, 0, yes
783319162550644736,  Possibile_KR, 18, 1, 17, no
311662324,  fpresot, 2, 2, 0, yes
1201461085,  ighi_inc, 1, 1, 0, yes
3345161205,  ArezzoPossibile, 134, 1, 133, no
62863270,  AMEDEONYC, 2, 2, 0, yes
1055797022,  GRonchieri, 6, 1, 5, no
794909393615814657,  elissssa84, 1, 1, 0, yes
2151127567,  gabrielececcat1, 1, 1, 0, yes
934962619,  Alesmi68, 2, 2, 0, yes
2467973393,  GiosyVitale, 1, 1, 0, yes
2726127843,  nikilismosenile, 1, 1, 0, yes
4583225809,  BeatoBartoloL, 4, 3, 1, yes
3044765553,  nicoraivano, 1, 1, 0, yes
402976667,  FioreLiborio, 4, 3, 1, yes
776825645183664129,  fabio_ristori, 1, 1, 0, yes
187478124,  il_font, 1, 1, 0, yes
724548091400097793,  unex_viktorija, 1, 1, 0, yes
1314549691,  passionescatto, 11, 6, 5, yes
414934760,  claudiascara, 1, 1, 0, yes
4121342697,  darwinpollo1, 3, 1, 2, no
40302122,  titofaraci, 2, 1, 1, neutral
416618561,  PaoloRomor, 4, 4, 0, yes
780047945311907840,  STE_COLA1, 1, 1, 0, yes
464973973,  urlucon, 1, 1, 0, yes
802518957215334400,  michelelosardo, 2, 2, 0, yes
2748504147,  sorbolik21, 3, 3, 0, yes
703981214269644804,  piccolofuretto, 1, 1, 0, yes
828554936,  Renzo_Lucente, 1, 1, 0, yes
348988851,  heliandros, 1, 1, 0, yes
4060804359,  Carlantonio55, 2, 1, 1, neutral
383359173,  mmastrapasqua, 7, 3, 4, no
3387018627,  Salvo_P0, 2, 2, 0, yes
636035398,  mazzon_ste, 6, 2, 4, no
590239086,  solenero3, 1, 1, 0, yes
172081386,  giannagaleano, 1, 1, 0, yes
3036589275,  CLimiroli, 3, 3, 0, yes
424939728,  gigivagnozzi, 1, 1, 0, yes
799339712464814080,  osnyeom, 1, 1, 0, yes
2366464163,  feli_pauli, 2, 2, 0, yes
745535971270103042,  Fedelcri, 4, 4, 0, yes
3445653437,  chey25879, 1, 1, 0, yes
3510030675,  paolopuglisi50, 2, 2, 0, yes
45105010,  costantinosqueo, 2, 1, 1, neutral
710500851270492161,  annagraziaq4, 11, 9, 2, yes
343306128,  LucaBBBalestri, 3, 2, 1, yes
2441701478,  Francesco_Seph, 1, 1, 0, yes
97872646,  pdmonza, 1, 1, 0, yes
417800042,  VecTeo, 1, 1, 0, yes
2256151688,  RossanoArpebe, 1, 1, 0, yes
3289975816,  ziacarlacar, 5, 1, 4, no
384773089,  feder1313, 1, 1, 0, yes
1234660638,  TonFusco, 2, 2, 0, yes
1645224056,  grandi41, 3, 3, 0, yes
406276067,  LeuciLeonardo, 3, 3, 0, yes
51445321,  ANDREAFERRAIOLO, 1, 1, 0, yes
777067584327917568,  de_desiervo, 2, 2, 0, yes
2272715355,  paolo_arcaro, 1, 1, 0, yes
306262577,  monicapapini, 1, 1, 0, yes
469186831,  IlarioCaserta, 4, 1, 3, no
2574413150,  PaoloCriscuoli1, 1, 1, 0, yes
486968011,  NunziaFalanga1, 1, 1, 0, yes
67645062,  Giamma1981, 1, 1, 0, yes
400352386,  FRoatti, 1, 1, 0, yes
2225750595,  FonteGiorgio, 3, 3, 0, yes
560599897,  GuidoTurreni, 1, 1, 0, yes
2788127629,  alexanco07, 5, 1, 4, no
2845007506,  DavideCM5S, 5, 1, 4, no
1290097460,  StefanoAndriano, 2, 2, 0, yes
537477082,  EnricoPoliFi, 1, 1, 0, yes
902588736,  FraLeoncini, 2, 1, 1, neutral
4624496368,  MorrisCeron, 4, 4, 0, yes
1334038333,  ClusterLeoni, 1, 1, 0, yes
32170251,  thevelvetant, 1, 1, 0, yes
260119817,  mirkoambro, 5, 2, 3, no
3589137856,  SedInvicta, 1, 1, 0, yes
1255053170,  80ila, 3, 3, 0, yes
4267295321,  DonatellaMacar1, 3, 3, 0, yes
3021861723,  raffa_raffamac, 1, 1, 0, yes
974615749,  Lndc_Sa, 1, 1, 0, yes
479458968,  VELOSPORT1960, 1, 1, 0, yes
4811997677,  abertasi82, 2, 2, 0, yes
787168283623583744,  srgcnns7715, 1, 1, 0, yes
366742560,  enricamagri, 1, 1, 0, yes
781923797679112192,  GencoSalvatore, 1, 1, 0, yes
79190097,  marinamuolo, 3, 2, 1, yes
7475252,  fransart, 1, 1, 0, yes
128879888,  30mewl, 1, 1, 0, yes
3129371745,  MilleSud, 1, 1, 0, yes
1065585522,  MinioDiego, 3, 2, 1, yes
2430727480,  Francesco00099, 2, 2, 0, yes
1662035850,  MarcofaniVg, 1, 1, 0, yes
697617213579141121,  PedManes, 2, 2, 0, yes
312032777,  danarossa, 2, 1, 1, neutral
363938347,  udcandrano, 1, 1, 0, yes
251044638,  alfredoretucci, 1, 1, 0, yes
68129410,  briscolina, 1, 1, 0, yes
365477889,  Tizia_Fisic, 1, 1, 0, yes
2172960626,  dariomig81, 1, 1, 0, yes
1286628300,  ilbue63, 1, 1, 0, yes
4512281667,  Valenz1985, 3, 3, 0, yes
4016076567,  enzomelillo1, 1, 1, 0, yes
796287775549034496,  BusyBee137, 4, 1, 3, no
466594672,  Aramcheck76, 2, 1, 1, neutral
416476067,  luisatalassano, 2, 1, 1, neutral
1448576671,  helena9k, 1, 1, 0, yes
145580644,  matteocervi, 2, 2, 0, yes
1328926860,  ValeBu2, 1, 1, 0, yes
413457774,  misunisun, 1, 1, 0, yes
721539847790465024,  chootandfrolova, 1, 1, 0, yes
724722046740127744,  frances6590, 5, 4, 1, yes
1125544152,  deli972R, 1, 1, 0, yes
984212430,  dalsavio, 3, 2, 1, yes
242695991,  LiguriaOnLine, 2, 1, 1, neutral
41182770,  Antonioerred, 2, 1, 1, neutral
341480420,  alfredofaieta, 1, 1, 0, yes
171995592,  LucaMestrone, 4, 2, 2, neutral
505611609,  DomenicoAlessi, 3, 3, 0, yes
998008975,  VierinE, 1, 1, 0, yes
3646408874,  patriotairrever, 1, 1, 0, yes
69598685,  michelemercuri, 4, 3, 1, yes
2305994433,  GiannuzziTony, 1, 1, 0, yes
1852450694,  ciwainside, 41, 4, 37, no
1725431600,  clarissa_gmai, 5, 2, 3, no
787227720094736384,  civico21, 3, 2, 1, yes
2923849113,  Enrica29851777, 1, 1, 0, yes
274548046,  Ni83kla, 1, 1, 0, yes
341405408,  FrancescoDonat, 1, 1, 0, yes
395993825,  lelevup, 1, 1, 0, yes
2150407082,  SimoTaboga, 3, 2, 1, yes
2362666795,  venis_spa, 1, 1, 0, yes
303404949,  StefSpA_, 3, 2, 1, yes
591323175,  natascia725, 3, 2, 1, yes
4902022042,  BurattiniFabio, 1, 1, 0, yes
538278016,  Da_ny75, 1, 1, 0, yes
14792524,  jacko83, 2, 2, 0, yes
630930507,  dona_min, 1, 1, 0, yes
990706111,  NicMessere, 1, 1, 0, yes
268855149,  BBMelizio, 2, 2, 0, yes
2751935938,  Rossi5Gianni, 1, 1, 0, yes
81306899,  davidmilletti, 1, 1, 0, yes
723033640544907264,  anohin_contho, 1, 1, 0, yes
795374988849270786,  Raffa_BRA, 2, 2, 0, yes
104651157,  silvanhoe, 20, 7, 13, no
339571753,  FrankStoppa, 1, 1, 0, yes
54975036,  publio71, 3, 3, 0, yes
724009561242345473,  ArchAleRev, 4, 3, 1, yes
2564205321,  margoliberti, 2, 1, 1, neutral
2543316675,  Imnotnormalokay, 1, 1, 0, yes
414198874,  Gianfrazzo, 1, 1, 0, yes
1037936886,  Acexx13, 1, 1, 0, yes
36991673,  LuigiRicci, 2, 1, 1, neutral
510211493,  MikeBelingheri, 1, 1, 0, yes
854501780,  ElezioniLazio, 1, 1, 0, yes
244995106,  GiorgyD, 1, 1, 0, yes
483846892,  sdeid, 2, 1, 1, neutral
1408827164,  quaranta_vito, 3, 1, 2, no
805394197494857728,  friondolino, 2, 2, 0, yes
339232486,  JuaSabra, 3, 2, 1, yes
1487687390,  ElisabettaPolet, 2, 2, 0, yes
793365255724343296,  Stefano198383, 1, 1, 0, yes
14742750,  Carlo3stars, 1, 1, 0, yes
2200636678,  stoccheropaolo, 2, 1, 1, neutral
804965440594255872,  Catallu1, 1, 1, 0, yes
3426637595,  fabmilitello, 1, 1, 0, yes
796749199983394816,  terrapiattista, 4, 4, 0, yes
1132037359,  S_Arosio, 1, 1, 0, yes
756921578,  gadda_filippo, 1, 1, 0, yes
2898881230,  lauragarruba, 1, 1, 0, yes
471995227,  MonicaContaldo, 9, 7, 2, yes
1104732752,  rosSsa101, 10, 1, 9, no
2982531436,  WorldstyleA, 1, 1, 0, yes
29059869,  carlodigre, 1, 1, 0, yes
185419324,  novadelphilibri, 1, 1, 0, yes
3111881513,  aldaabbondanza, 1, 1, 0, yes
1020639037,  AnnaBartoli4, 1, 1, 0, yes
3302866678,  gaiasanfratello, 1, 1, 0, yes
3014266700,  RenzoPuccetti, 1, 1, 0, yes
2962798601,  MarcoScorza82, 2, 1, 1, neutral
744907338776215553,  Barlassinaxilsi, 1, 1, 0, yes
748026254746591232,  Nicola47013827, 2, 2, 0, yes
809434112,  Goldstein_84, 13, 9, 4, yes
2262728705,  b1ancan3ve63, 4, 3, 1, yes
866416776,  Fammistarezitto, 1, 1, 0, yes
712640136081776640,  Fabio_1103, 14, 3, 11, no
254264630,  marco_to66, 1, 1, 0, yes
305557889,  Perry83A, 1, 1, 0, yes
1591590127,  littlebitofmika, 1, 1, 0, yes
203936186,  johanbeuckelaer, 1, 1, 0, yes
4798362376,  social_observ, 6, 5, 1, yes
3093110545,  BibbiPb, 2, 2, 0, yes
1231654387,  SilvioRossi64, 1, 1, 0, yes
439115535,  SimoneFalasca, 2, 1, 1, neutral
440137166,  MarekNapoli, 1, 1, 0, yes
256982601,  xfile06, 1, 1, 0, yes
75030804,  oldclockend, 1, 1, 0, yes
1047497299,  marti_magfly, 1, 1, 0, yes
2198515964,  LaComt, 1, 1, 0, yes
85574127,  andreeacimino, 1, 1, 0, yes
395970571,  MenicaBersani, 1, 1, 0, yes
45420793,  ilarialisa, 1, 1, 0, yes
4284240269,  noitaliani2, 1, 1, 0, yes
792757569139924994,  Pasqualerog, 1, 1, 0, yes
3449826197,  PdCarini, 5, 5, 0, yes
77547900,  bistrottissimo, 4, 1, 3, no
744585152,  titobabao3, 1, 1, 0, yes
403444270,  LuigiSaccoccio, 2, 2, 0, yes
2758663251,  fulviodeangeli1, 1, 1, 0, yes
1602771703,  SimoneBonzanini, 7, 5, 2, yes
1349514043,  giocammello, 3, 2, 1, yes
2610968998,  BrunoVeronikab, 1, 1, 0, yes
116654942,  Luca_Bellomo_mi, 1, 1, 0, yes
1192479834,  nicoviola83, 6, 6, 0, yes
4582622782,  lamigdrs, 2, 2, 0, yes
2463076201,  Bugghe, 2, 1, 1, neutral
1961227394,  KiiroiNoHi, 1, 1, 0, yes
3307889567,  ele_22599, 1, 1, 0, yes
3336934359,  laviniabnm, 1, 1, 0, yes
922080318,  AndreaCertosino, 1, 1, 0, yes
494041573,  DSpialtini, 2, 1, 1, neutral
4319736196,  sara74752263, 1, 1, 0, yes
2470644020,  sabina_bonelli, 1, 1, 0, yes
2171374147,  arcangelomarron, 2, 1, 1, neutral
761900111320457217,  MikaItalia_News, 1, 1, 0, yes
4908653747,  filoferranti, 1, 1, 0, yes
2248474104,  moneta_sovrana, 2, 2, 0, yes
771273553,  flawlessvlou, 1, 1, 0, yes
2580853616,  Malk_klaM, 3, 3, 0, yes
82968857,  ftdjsox, 1, 1, 0, yes
2850247377,  _pooh_xx, 1, 1, 0, yes
2399013592,  mengonishug, 1, 1, 0, yes
986666611,  RaimondiInfo, 2, 1, 1, neutral
1962531763,  efeso27, 1, 1, 0, yes
4548699076,  ele_cari_, 1, 1, 0, yes
701159273296961536,  frank641964, 2, 2, 0, yes
393501472,  DaniloTomassoni, 3, 1, 2, no
1254101773,  TSaccomani, 1, 1, 0, yes
4902492328,  OcaGrigia, 1, 1, 0, yes
163164686,  grazia_bxl, 1, 1, 0, yes
864323299,  SefanoMalaguti, 2, 2, 0, yes
2970695573,  machemistaiadi, 1, 1, 0, yes
950639629,  MSara_99, 1, 1, 0, yes
115350022,  gaelledallamutt, 1, 1, 0, yes
725059657295912962,  IPredicatore, 12, 9, 3, yes
1038122826,  eleonorabraile, 7, 2, 5, no
748799089567862784,  PatriotaIl, 10, 8, 2, yes
1382197603,  Cenorava, 17, 13, 4, yes
439895176,  AbusivoBrusio, 2, 2, 0, yes
1304687706,  fabio_giannotta, 1, 1, 0, yes
740290496,  NinaZucchi, 1, 1, 0, yes
702259587509043203,  Antonella1165, 1, 1, 0, yes
804422570644828161,  MarioBorioni1, 1, 1, 0, yes
316741574,  PLambrini, 2, 1, 1, neutral
754071475599147008,  frangiancovit23, 1, 1, 0, yes
2476955115,  Ricocipre1989, 1, 1, 0, yes
3049633374,  dovelitalia, 11, 8, 3, yes
494175102,  AntonioRizza3, 1, 1, 0, yes
365546202,  Tobiamorandi, 1, 1, 0, yes
987485588,  PaoloAdobati1, 3, 1, 2, no
406247064,  vmasseo, 1, 1, 0, yes
2302778172,  Janus0148, 9, 5, 4, yes
2723208401,  pleasantvjlle, 1, 1, 0, yes
2260197681,  angelofilippel2, 2, 2, 0, yes
153396694,  gimiki, 1, 1, 0, yes
3730985657,  talkabovtmeeks, 1, 1, 0, yes
1357667514,  Ellegik, 2, 2, 0, yes
338396095,  _loveyoubreathe, 1, 1, 0, yes
455987750,  46664mandela, 1, 1, 0, yes
3899808419,  __underwater__0, 1, 1, 0, yes
1675497984,  PrefumoElvio, 1, 1, 0, yes
464171932,  dpetruzzellis, 2, 2, 0, yes
760941857652301824,  AnaMari45036206, 3, 1, 2, no
3041209765,  luisa_bordato, 2, 2, 0, yes
2638975522,  FaliBouchra, 2, 2, 0, yes
51465605,  edmondo_minisci, 5, 1, 4, no
860326165,  claudiovbasten, 1, 1, 0, yes
1901543132,  ilPedro84, 1, 1, 0, yes
416346211,  carlottafree, 5, 2, 3, no
787323208752037888,  RPortas2002, 8, 1, 7, no
1257864246,  srossetti17, 1, 1, 0, yes
473340894,  mimmomazzei, 2, 2, 0, yes
1583751032,  gemini9500, 1, 1, 0, yes
323809354,  sdalpi, 2, 2, 0, yes
1264504819,  trobero40, 1, 1, 0, yes
99674674,  bertrada, 3, 3, 0, yes
841647078,  AgostinoOttavi, 4, 4, 0, yes
3446019976,  leonessadocg, 1, 1, 0, yes
574880235,  diego1962genova, 1, 1, 0, yes
2988311308,  joshuacloves, 2, 1, 1, neutral
4120227047,  SimoterrestreD, 4, 3, 1, yes
376935892,  fabiodellanno, 3, 2, 1, yes
1039571245,  SZecchinato, 1, 1, 0, yes
391936827,  sergiomariotti, 1, 1, 0, yes
577873674,  mastro13, 1, 1, 0, yes
76355344,  ellyzanzi, 1, 1, 0, yes
757926733962182657,  moniacolli75, 1, 1, 0, yes
758724504604512256,  Alessandrobar70, 1, 1, 0, yes
802372932559323136,  taiclinbestu191, 1, 1, 0, yes
88725905,  gramezzana, 16, 5, 11, no
2669059234,  nemnob, 1, 1, 0, yes
746565668846305280,  concettachiuch2, 1, 1, 0, yes
470075829,  lucarielloT72, 2, 2, 0, yes
797531588624060420,  ro5370, 1, 1, 0, yes
291141125,  andlazz, 4, 2, 2, neutral
418282786,  carlo_viano, 2, 2, 0, yes
701812518495330306,  Lucapergliamici, 2, 2, 0, yes
2987412238,  tommi531, 1, 1, 0, yes
573821701,  patriziaandreoz, 1, 1, 0, yes
786824719400050688,  Mauro91747423, 1, 1, 0, yes
2208551793,  a62357262, 1, 1, 0, yes
411699195,  omis100, 1, 1, 0, yes
3129412768,  millerandrewj, 1, 1, 0, yes
773586275903369216,  Pox_News_Italy, 1, 1, 0, yes
156340908,  Emi_Verona, 1, 1, 0, yes
253224028,  CorradoCerea, 4, 4, 0, yes
1218811038,  ACaio84, 1, 1, 0, yes
1270735285,  morris141269, 3, 1, 2, no
702206768840110081,  LauraGorgone1, 3, 3, 0, yes
2762868863,  aritamancuso, 28, 28, 0, yes
251524754,  darioruffino, 2, 1, 1, neutral
2759477819,  CalaSalva, 1, 1, 0, yes
2733451977,  roubaix591001, 1, 1, 0, yes
470242115,  assaloni, 2, 1, 1, neutral
414993289,  Carlo_Deplano, 4, 3, 1, yes
2240505794,  kink4s, 1, 1, 0, yes
1367265864,  AnnaBassanini, 1, 1, 0, yes
949743282,  AdrianoTolomio, 3, 1, 2, no
2154785800,  00nicoula_1997, 1, 1, 0, yes
462040673,  Amartino94, 1, 1, 0, yes
2754982655,  KhalfNur, 1, 1, 0, yes
468764915,  TheLipglossary, 3, 1, 2, no
59838693,  federicosisinni, 1, 1, 0, yes
1365570751,  jerrynorman34, 6, 5, 1, yes
175366986,  vincenzo81dileo, 2, 2, 0, yes
4813157055,  camerini_adele, 2, 2, 0, yes
4103703507,  Mordello, 1, 1, 0, yes
1269805640,  Toante, 1, 1, 0, yes
734683913205993472,  bastaunsiprato, 1, 1, 0, yes
714519938006982656,  biagio_valenti, 1, 1, 0, yes
2765505605,  aiace2014, 1, 1, 0, yes
235739444,  Giovanni_N0, 3, 3, 0, yes
497995758,  jacopo_iacoboni, 3, 3, 0, yes
389136117,  Cane1956, 1, 1, 0, yes
307536134,  danielaconidi, 13, 12, 1, yes
791278673529823232,  noinmine, 3, 3, 0, yes
253266441,  FCPCottafavi, 1, 1, 0, yes
2295223756,  dippi014, 1, 1, 0, yes
43083883,  fremebonda, 11, 11, 0, yes
767593587504734208,  RosannaAvella, 1, 1, 0, yes
230696135,  telemaco31, 1, 1, 0, yes
2380908872,  ugoboca, 3, 1, 2, no
3827842155,  algerie_lu, 2, 2, 0, yes
1383651726,  ArtemisiaBa, 1, 1, 0, yes
424939712,  iltosoo, 1, 1, 0, yes
4924190242,  Artudacamelot5, 5, 5, 0, yes
1575913064,  macaruzzo, 1, 1, 0, yes
2449514652,  memole861, 1, 1, 0, yes
332935524,  Rich_Spa, 1, 1, 0, yes
455076650,  alessia_bionda, 1, 1, 0, yes
634535867,  CilibertiSimone, 5, 2, 3, no
410946127,  stellaciarletta, 1, 1, 0, yes
43814969,  FerIglesias, 1, 1, 0, yes
776558718326636545,  5frodo, 1, 1, 0, yes
2652686684,  Viviana_USA, 1, 1, 0, yes
381695631,  AgildoGildao, 3, 1, 2, no
1734604128,  Tarairportmg, 1, 1, 0, yes
1215039572,  ARISTASIMONE, 1, 1, 0, yes
2231181594,  SIVeMP_Naz, 2, 2, 0, yes
456246923,  NicolaGuarnera, 1, 1, 0, yes
2396150167,  marcoparisella2, 1, 1, 0, yes
3299322807,  stella150812, 3, 3, 0, yes
743369222823239680,  Fabrizi93187683, 1, 1, 0, yes
353678923,  durante_g, 3, 2, 1, yes
1488206617,  PaolaSchintu, 2, 2, 0, yes
86997587,  radicalnik, 4, 2, 2, neutral
799203458150793216,  Htswt, 5, 3, 2, yes
1030314744,  soniasirizzotti, 5, 2, 3, no
866147862,  Nazzi_Mi, 1, 1, 0, yes
396745952,  marimonster21, 2, 2, 0, yes
711875747183521797,  Federbiologi1, 2, 2, 0, yes
1057417536,  soloperlagloria, 1, 1, 0, yes
576989733,  del_corto, 2, 1, 1, neutral
2367178591,  luigigiordano87, 2, 1, 1, neutral
745531834822336512,  ivanbego1, 1, 1, 0, yes
430811207,  AQUILANTI73, 2, 1, 1, neutral
2980425346,  DeligiaR, 1, 1, 0, yes
79959191,  lateautumntear, 1, 1, 0, yes
1331104358,  GPergolizzi, 1, 1, 0, yes
4794977182,  giusp44, 10, 10, 0, yes
72941679,  687angelo, 1, 1, 0, yes
431953324,  angelasalu, 3, 2, 1, yes
4600475613,  PrecoBaixoAgora, 3, 3, 0, yes
580232599,  filippogreco5, 23, 12, 11, yes
249724130,  BrunellaBB, 2, 1, 1, neutral
474759809,  giorgio704, 4, 2, 2, neutral
774232948136706049,  gemellile2015, 1, 1, 0, yes
72119746,  grcpql, 1, 1, 0, yes
514395905,  Barravento76, 2, 2, 0, yes
111724064,  vincatta, 2, 1, 1, neutral
710222654050066436,  ro_genaiel, 1, 1, 0, yes
382639791,  francyp75, 2, 2, 0, yes
1264880100,  RossiPatrizia7, 1, 1, 0, yes
2495992548,  PhilosopheParis, 1, 1, 0, yes
4623850761,  giovannidife59, 2, 2, 0, yes
801070456619077632,  myquorum, 3, 1, 2, no
1949252150,  lmptlr, 1, 1, 0, yes
593966072,  robreg1, 1, 1, 0, yes
416885209,  ADelliNoci, 1, 1, 0, yes
483856566,  claudio_coppi, 4, 2, 2, neutral
1135392818,  ynBRET, 1, 1, 0, yes
797016847229091840,  CammarataMirko, 1, 1, 0, yes
799698414006996992,  massy2872, 1, 1, 0, yes
2480341394,  TweetBRIEVEMENT, 1, 1, 0, yes
3651338596,  Giomattino, 1, 1, 0, yes
29236274,  Daniele_Manca, 3, 3, 0, yes
3356858639,  robertopin54, 1, 1, 0, yes
1280413848,  ch_pape, 1, 1, 0, yes
474124874,  nettechaaan631, 1, 1, 0, yes
193877941,  PierAce90, 1, 1, 0, yes
907548870,  Gio_Ioannisci, 1, 1, 0, yes
805880406797066242,  aimaemir, 1, 1, 0, yes
167446961,  PowerFlower93, 1, 1, 0, yes
130527772,  Giutes, 1, 1, 0, yes
552411252,  FChionna, 1, 1, 0, yes
486881973,  billobike, 3, 2, 1, yes
407789173,  paolobruschi, 2, 1, 1, neutral
63478646,  fandetv, 1, 1, 0, yes
2233494194,  mrmanfe, 1, 1, 0, yes
98415470,  andreagirelli_, 1, 1, 0, yes
4845389320,  roberto_secli, 1, 1, 0, yes
4835674227,  TV8it, 1, 1, 0, yes
85049785,  STARGATE94, 1, 1, 0, yes
1042732735,  vilmagaiero, 1, 1, 0, yes
2225283196,  albgatti, 1, 1, 0, yes
2507799122,  sostersiclilian, 1, 1, 0, yes
492420338,  CesaranoChiara, 1, 1, 0, yes
1395436003,  cavalier1985, 1, 1, 0, yes
1380113185,  Non_Possumus, 1, 1, 0, yes
2562622972,  freemind120, 3, 1, 2, no
452970006,  CarloPorcaro, 1, 1, 0, yes
76987068,  FurettoSawyer, 2, 2, 0, yes
1262134226,  MGoldLife, 1, 1, 0, yes
2532999106,  Andrevatel, 1, 1, 0, yes
2617093868,  iandreafc, 2, 2, 0, yes
2737323981,  agabiti17, 1, 1, 0, yes
142229682,  aledand, 4, 4, 0, yes
3369341207,  AbdelSansLeB, 1, 1, 0, yes
722304412740403200,  SandrineFranci1, 1, 1, 0, yes
1155350713,  valeincipit, 1, 1, 0, yes
510393002,  BarbaraFVicen, 1, 1, 0, yes
1175057562,  stateofmindXIII, 1, 1, 0, yes
1134217848,  vaubandaniel, 1, 1, 0, yes
438422849,  LUDOVICOpapalia, 2, 2, 0, yes
3148366444,  four4327, 1, 1, 0, yes
399666009,  elisabetta129, 1, 1, 0, yes
102142455,  IreneEhawee, 1, 1, 0, yes
161497051,  aibexint, 3, 2, 1, yes
4034391863,  biebertattovs, 1, 1, 0, yes
823596008,  michibaio, 1, 1, 0, yes
1877054737,  FranciscaOFF, 1, 1, 0, yes
741985855913512960,  la_avvelenata, 1, 1, 0, yes
4354012102,  retweetto_tutto, 1, 1, 0, yes
419878274,  pepestein76, 1, 1, 0, yes
2513417675,  FrancisMcsteven, 1, 1, 0, yes
110457196,  Valentinerome, 1, 1, 0, yes
3010691444,  DBurgarella, 1, 1, 0, yes
3035743577,  peppe_incandela, 1, 1, 0, yes
334661979,  EGatteschi, 2, 2, 0, yes
4408788677,  UgoGolino, 1, 1, 0, yes
4353818968,  ClizioPrati, 1, 1, 0, yes
4354044861,  TappoOlivia, 1, 1, 0, yes
4353366976,  benny_scarola, 1, 1, 0, yes
752940728691621888,  tarqqueeesss, 1, 1, 0, yes
4353109942,  DilettaCrobio, 1, 1, 0, yes
2200972396,  amanda_raschi, 1, 1, 0, yes
4825857856,  guardosolo, 1, 1, 0, yes
1960821662,  gabri_vella, 2, 2, 0, yes
337114179,  albertoprocacci, 1, 1, 0, yes
572081368,  feralario, 1, 1, 0, yes
704014572764708864,  CazzollaStella, 1, 1, 0, yes
786589047405834240,  carlo18072010, 1, 1, 0, yes
2619106441,  sassari68, 4, 4, 0, yes
801485466054885382,  Luciano45403403, 1, 1, 0, yes
1163801755,  OTTIMORE, 1, 1, 0, yes
2999576164,  WblokWalter, 1, 1, 0, yes
593552839,  EnricoA67, 2, 2, 0, yes
804985989508767749,  imarkisio, 2, 2, 0, yes
426611363,  CazzanigaDavide, 1, 1, 0, yes
2306887289,  santuario88, 1, 1, 0, yes
716745581205528576,  jessica0359715, 6, 5, 1, yes
884975340,  BeppeSammartino, 1, 1, 0, yes
1334815088,  elisabettanemet, 1, 1, 0, yes
1642611252,  filgia66, 1, 1, 0, yes
80314220,  filippogiuffre, 1, 1, 0, yes
2583334907,  AlborNachus, 1, 1, 0, yes
745877999262777344,  GiovaBocc, 1, 1, 0, yes
805845364985262083,  emy250305, 1, 1, 0, yes
794498506849394689,  ElaElzbietowicz, 1, 1, 0, yes
63542506,  pinguina76, 1, 1, 0, yes
1018497180,  ChristianMasper, 1, 1, 0, yes
57259020,  PanfiloTweet, 1, 1, 0, yes
3375855381,  cgn49gnn, 1, 1, 0, yes
1165836008,  consuelodefazio, 2, 2, 0, yes
312056087,  LorenzoLamperti, 4, 4, 0, yes
762618011144577024,  FrancoBracale, 3, 1, 2, no
128568030,  ehibarnes, 1, 1, 0, yes
434135287,  F_Pastore27, 2, 2, 0, yes
166528519,  ConsiglioGiovan, 3, 2, 1, yes
75520535,  angelosaracini, 2, 2, 0, yes
709095023598575616,  RitaCampomori, 2, 1, 1, neutral
549682561,  DArt_Photo, 1, 1, 0, yes
3177750687,  FrancescoBabato, 1, 1, 0, yes
139033921,  claudiocatapano, 1, 1, 0, yes
1593643915,  fenotteenragee, 1, 1, 0, yes
801740235050778624,  ogtsypova, 1, 1, 0, yes
743850585410121729,  vp1053, 4, 3, 1, yes
3545192475,  fscodeleo, 2, 2, 0, yes
2231861522,  antonio57359397, 1, 1, 0, yes
2837970855,  CatholicTweet1, 1, 1, 0, yes
755386736,  lorfatto, 1, 1, 0, yes
923060941,  roberto64russo, 6, 1, 5, no
241498548,  LovelyLapinette, 2, 1, 1, neutral
412246192,  Emaboy91, 2, 2, 0, yes
806051499457609728,  giodori87, 1, 1, 0, yes
134898882,  UTontU, 1, 1, 0, yes
399001763,  RitaCorvino, 1, 1, 0, yes
482422577,  AngelaButera, 1, 1, 0, yes
72643262,  Marco_Di_Lello, 1, 1, 0, yes
1097626686,  RolandoMonz, 2, 2, 0, yes
2424020059,  ObservingProp, 2, 1, 1, neutral
724609497210204160,  mac_o31, 1, 1, 0, yes
4594810093,  grazias175, 3, 3, 0, yes
2327693720,  gabmams, 1, 1, 0, yes
776994949,  DaniloZorro, 1, 1, 0, yes
2260579680,  GiZagamig, 1, 1, 0, yes
1052695676,  pigalfolle, 1, 1, 0, yes
800633235331895296,  Andrea14022248, 1, 1, 0, yes
827030186,  MaxKasteddu, 2, 2, 0, yes
407350188,  itacaruare1, 2, 1, 1, neutral
112510468,  Sergiunicum, 1, 1, 0, yes
791560742348750848,  Nedonedone2, 1, 1, 0, yes
71101204,  CIANELL, 1, 1, 0, yes
987470191,  marcosalvator13, 1, 1, 0, yes
862899121,  CarloFrancesca, 2, 1, 1, neutral
805828290867064833,  Magnus62432794, 1, 1, 0, yes
1137432630,  CettinaCaminiti, 2, 2, 0, yes
1019652758,  twetter7228, 1, 1, 0, yes
4886141830,  itsmorez, 1, 1, 0, yes
3336813329,  nocturnefranta, 1, 1, 0, yes
2541601227,  PasqualeChiri83, 17, 17, 0, yes
153522319,  lallymochi, 1, 1, 0, yes
728646055936589824,  poxxbb, 1, 1, 0, yes
605650478,  fabio_990, 1, 1, 0, yes
1425509077,  Sania2spasova, 1, 1, 0, yes
50249623,  nioibe, 1, 1, 0, yes
1255611302,  Emaloconti, 4, 3, 1, yes
1305690103,  danieleriggi67, 1, 1, 0, yes
2828370125,  Mancini2014, 1, 1, 0, yes
711777225222307840,  EricGentili, 1, 1, 0, yes
1593102114,  soccmell, 1, 1, 0, yes
426127657,  FabioIozzi, 2, 2, 0, yes
323966004,  andrea_brancato, 2, 1, 1, neutral
37282173,  Neverland65, 3, 1, 2, no
1968518298,  FormilliStefano, 5, 1, 4, no
1842447120,  maresanti, 1, 1, 0, yes
856718436,  NonAuMariageGay, 6, 6, 0, yes
403704169,  defilippochiara, 1, 1, 0, yes
3052470216,  sasaespo1980s, 1, 1, 0, yes
805806114373779456,  MyDummy2, 1, 1, 0, yes
431692074,  stefanosignori2, 4, 4, 0, yes
2848848250,  walkyria00, 2, 2, 0, yes
363810878,  VFarde, 2, 2, 0, yes
802639150746914816,  saraadolann, 1, 1, 0, yes
387738785,  Giusyesposito3, 3, 2, 1, yes
394729864,  eu9en10, 1, 1, 0, yes
1347431557,  CerviniFausto, 1, 1, 0, yes
72592405,  federicorighi, 2, 2, 0, yes
4350762861,  cattia23, 1, 1, 0, yes
3493531042,  Donatel70529011, 2, 1, 1, neutral
2790106535,  maddyvalerio06, 2, 1, 1, neutral
805796086552137728,  elematrik, 1, 1, 0, yes
1693811209,  MicheleScotti76, 1, 1, 0, yes
1095415531,  Paolo_Beni, 1, 1, 0, yes
2158925298,  paoloraveggi1, 1, 1, 0, yes
1035792570,  gmazzini71, 1, 1, 0, yes
801365070953545728,  Monica99225069, 6, 6, 0, yes
1286370181,  LandoCattoni, 1, 1, 0, yes
564948559,  GioiaVanessa, 1, 1, 0, yes
3035015758,  Bepu2Giorgiola, 1, 1, 0, yes
1122358856,  fengshuicris, 1, 1, 0, yes
436642108,  mitrandirr, 7, 6, 1, yes
499783780,  federica_bosco, 2, 2, 0, yes
573600313,  VeroCrippa, 1, 1, 0, yes
3035249219,  doppiaVeronica, 1, 1, 0, yes
499743631,  claudiobarsotti, 4, 3, 1, yes
4147779167,  IlBeneVincera, 1, 1, 0, yes
727431429672587264,  VespeMaria, 7, 7, 0, yes
588238264,  MarcoMugnai2, 11, 2, 9, no
513528757,  amotvvv, 1, 1, 0, yes
2373193840,  scrosella, 4, 1, 3, no
558745582,  ShamarDrg, 1, 1, 0, yes
483241829,  NickBinda, 1, 1, 0, yes
264565063,  StopMariageHomo, 6, 6, 0, yes
513555021,  Mrs_Margherita, 1, 1, 0, yes
299384410,  CorinnaRombi, 2, 2, 0, yes
3711823575,  MauroComastri, 3, 3, 0, yes
1298746268,  La_gatta_pigra, 1, 1, 0, yes
451419549,  RigoniLuigi, 3, 1, 2, no
1205482028,  luigixozza999, 14, 13, 1, yes
2292121696,  RitaFentyLM, 1, 1, 0, yes
1438872230,  Ale_furlan23, 1, 1, 0, yes
299879926,  Cheshire62, 1, 1, 0, yes
739441963733274624,  alfredinosauro, 1, 1, 0, yes
194101852,  In_consapevole, 2, 2, 0, yes
75010477,  mhawari, 1, 1, 0, yes
463824079,  alex_bissa, 1, 1, 0, yes
120846773,  rodolfoziberna, 3, 1, 2, no
1049223697,  altfch, 1, 1, 0, yes
470965532,  simonamiale, 1, 1, 0, yes
794274701484900353,  SinistraFi, 2, 2, 0, yes
1142996647,  Simone_Risoli, 5, 2, 3, no
457620281,  renatabasilico, 3, 3, 0, yes
442641618,  GiorgioLiberace, 5, 3, 2, yes
770642870470574080,  elvi0016, 1, 1, 0, yes
3120675944,  artioseaandsky, 1, 1, 0, yes
746278399056969728,  Barm79Muoio, 4, 4, 0, yes
318487854,  1OneShotOneKill, 14, 3, 11, no
742963347507810304,  CammaranoM5S, 4, 1, 3, no
55651991,  silviabragagni, 2, 2, 0, yes
204112751,  AlessioXS, 2, 2, 0, yes
2356266373,  giovannisavaris, 3, 3, 0, yes
219784110,  FrancoPisano69, 3, 2, 1, yes
719953453737492481,  Paolobonacina_, 3, 1, 2, no
1478155554,  zannacristian, 2, 1, 1, neutral
617612901,  RickOrso, 2, 1, 1, neutral
172722416,  Sandyna79, 1, 1, 0, yes
977982582,  mediomen2, 1, 1, 0, yes
3308223903,  Spacciaretweet, 3, 2, 1, yes
233648379,  123stefano, 5, 1, 4, no
319871048,  Jack_Bauer1978, 1, 1, 0, yes
137975991,  walter_pozzebon, 2, 2, 0, yes
324767880,  LiviaColonnese, 2, 1, 1, neutral
7912442,  tigella, 7, 2, 5, no
1289664930,  GiulioScotto, 2, 1, 1, neutral
1229714630,  SandraBonifazzi, 2, 2, 0, yes
787883346449801216,  com_dossetti, 3, 3, 0, yes
2962409320,  _agio_, 1, 1, 0, yes
2342688345,  peterdg68, 1, 1, 0, yes
4640789069,  ForkedT, 1, 1, 0, yes
472175554,  AntoGir79, 3, 3, 0, yes
423290810,  Sandrinodet, 1, 1, 0, yes
948668876,  MargheAngelus, 1, 1, 0, yes
742425156300181504,  Reset_Kappa, 1, 1, 0, yes
312613461,  fedeli_paolo, 19, 15, 4, yes
503135180,  rfacco76, 4, 4, 0, yes
850156152,  TommasoD83, 1, 1, 0, yes
214138422,  NicolaFinotello, 1, 1, 0, yes
218569466,  sk0d3, 1, 1, 0, yes
489222429,  MenzaPietro, 8, 1, 7, no
761915378276655104,  MassimoHergedef, 1, 1, 0, yes
1660079156,  elavale70, 1, 1, 0, yes
88213905,  Fcolopezcabello, 1, 1, 0, yes
4257296729,  Collupu, 1, 1, 0, yes
366081006,  DiegoDeLucaTwit, 12, 12, 0, yes
975101300,  FedericaItaca33, 1, 1, 0, yes
2227178944,  Tavellik, 3, 1, 2, no
4912558084,  JackAsaka, 1, 1, 0, yes
2741989390,  aribarby62, 1, 1, 0, yes
2365884684,  giorgiapacino, 1, 1, 0, yes
20465999,  gax700, 1, 1, 0, yes
3904718786,  mattheisenbergh, 2, 2, 0, yes
2766062542,  gjoegl, 13, 3, 10, no
567052536,  Maurospeck, 1, 1, 0, yes
505826561,  marcoguerra79, 1, 1, 0, yes
1719336750,  MauroPiccotti, 1, 1, 0, yes
476757702,  DiegoSperanzini, 1, 1, 0, yes
980818578,  francescopiano2, 1, 1, 0, yes
2907408035,  berti_elly, 1, 1, 0, yes
1477657056,  sil_lake, 1, 1, 0, yes
418121887,  veriandre, 1, 1, 0, yes
702497548192370688,  SkatSimo, 1, 1, 0, yes
415557591,  EddyVedovelli, 1, 1, 0, yes
84642854,  frathebestia18, 1, 1, 0, yes
2621001184,  loubiijou, 1, 1, 0, yes
206136208,  RockyKnowledge, 3, 3, 0, yes
181395697,  FiorelloFFClub, 1, 1, 0, yes
805572594909016064,  firenze980, 1, 1, 0, yes
1280874373,  beabertini77, 1, 1, 0, yes
4853293667,  AIIP_Provider, 1, 1, 0, yes
2308416027,  sheliack, 2, 2, 0, yes
3860260755,  ugo_floro, 1, 1, 0, yes
345952725,  VCeserani, 1, 1, 0, yes
1063446985,  gigidepa, 1, 1, 0, yes
713827253990334464,  DanaArnisa, 1, 1, 0, yes
1532048785,  FrancoMagrotti, 1, 1, 0, yes
1706556157,  gian_delfini, 5, 5, 0, yes
449245685,  mirkosold, 1, 1, 0, yes
2915548295,  0f74797b9c1c44d, 1, 1, 0, yes
1192735105,  adbonanni, 5, 3, 2, yes
342524146,  gobbo91ac, 1, 1, 0, yes
3179095799,  francodeandrea, 1, 1, 0, yes
196516465,  Riccardo118, 1, 1, 0, yes
705801728,  Monzaf1Marco, 1, 1, 0, yes
842234857,  super_viv, 1, 1, 0, yes
536207117,  marinoborra, 1, 1, 0, yes
118635700,  Glo9000, 1, 1, 0, yes
2895666573,  albachiara64141, 11, 1, 10, no
531321923,  cecco218, 1, 1, 0, yes
795323268660101121,  santa_selvaggio, 1, 1, 0, yes
584173480,  officialziogio, 1, 1, 0, yes
495059879,  franz_ts, 1, 1, 0, yes
1052150743,  DCatullo, 1, 1, 0, yes
1247099534,  Pietropoli_Agu, 2, 2, 0, yes
1244460240,  desmogenio, 2, 2, 0, yes
711666982299570178,  MarcoBaldi11, 1, 1, 0, yes
1374197772,  atlantide58, 1, 1, 0, yes
225468944,  guglica, 1, 1, 0, yes
1299094610,  GTommaso98, 2, 2, 0, yes
1176637908,  Bloup76, 1, 1, 0, yes
4735647376,  vincechil, 1, 1, 0, yes
84158321,  FranciGuidi, 1, 1, 0, yes
1259047908,  GiMuuuu, 2, 2, 0, yes
376810905,  chicco85v, 1, 1, 0, yes
2174731387,  RicMaster34, 1, 1, 0, yes
796272344402722816,  giusy_restuccia, 2, 2, 0, yes
474932369,  MadlyZ, 1, 1, 0, yes
218269511,  Denise_Vitali, 1, 1, 0, yes
264430603,  GP_Latina, 1, 1, 0, yes
746036919960739840,  FrancescaTulli2, 1, 1, 0, yes
4915840455,  ayatana25, 1, 1, 0, yes
491145588,  gtincani, 2, 1, 1, neutral
433125456,  murruandrea, 4, 1, 3, no
2214345845,  CiccinaLupo, 1, 1, 0, yes
490110270,  antofolgher, 1, 1, 0, yes
1623834145,  affinito_s, 1, 1, 0, yes
788326239329288192,  ila19843, 1, 1, 0, yes
1014675696,  avv_pizzulli, 1, 1, 0, yes
3047911372,  GrPuffo, 1, 1, 0, yes
1169460013,  simonavecchione, 1, 1, 0, yes
367898644,  LelysaBelle, 2, 1, 1, neutral
2277721177,  Kety55240729, 1, 1, 0, yes
400312896,  CatiusciaTiberi, 1, 1, 0, yes
550063265,  Mey_M_Burro, 1, 1, 0, yes
92285918,  MirkoGiac, 1, 1, 0, yes
2972793495,  bonazzoli_renzo, 1, 1, 0, yes
1407112212,  JessSaccone, 2, 2, 0, yes
805714682673823744,  Frances95352591, 1, 1, 0, yes
2743640789,  LPignatale, 1, 1, 0, yes
4430236162,  LDesiata, 1, 1, 0, yes
3171335378,  Steffyg80, 2, 2, 0, yes
704835215,  GubertiniMatteo, 1, 1, 0, yes
344585510,  luciogrizzo, 1, 1, 0, yes
425244402,  MauriziaMigma, 1, 1, 0, yes
187029091,  bossboykhy, 1, 1, 0, yes
1069275696,  lucaccini_carla, 3, 1, 2, no
526793164,  ealzeni, 1, 1, 0, yes
114843091,  MonicaCip, 1, 1, 0, yes
787250023121715200,  max197104, 2, 1, 1, neutral
500110521,  SVezzil, 5, 3, 2, yes
451313522,  noemispeciale, 1, 1, 0, yes
3408601559,  claudiosisisi, 1, 1, 0, yes
3093349829,  daviderizzo350, 1, 1, 0, yes
1493603834,  mina_parco, 2, 1, 1, neutral
15120398,  nellomiele, 1, 1, 0, yes
1145858365,  Franki77Cuore, 2, 2, 0, yes
1018100335,  michelecocomazz, 2, 2, 0, yes
1604094974,  lorcan1655, 2, 1, 1, neutral
976980031,  adryzambon, 1, 1, 0, yes
474331021,  MoniSetta, 1, 1, 0, yes
433193480,  ANTONIOFAVINO, 1, 1, 0, yes
744871234324799488,  RosariaAlaimo1, 3, 3, 0, yes
730294435590881280,  fraiot, 1, 1, 0, yes
230790398,  vinloren, 3, 3, 0, yes
1142592469,  MenchiStefano, 1, 1, 0, yes
428041816,  puntopuntox, 3, 2, 1, yes
83157992,  Palermer, 8, 8, 0, yes
1035743785,  Eudaimonia20, 2, 2, 0, yes
2174037362,  AnnaAmerise, 3, 3, 0, yes
3407635468,  onorevolemilaz1, 1, 1, 0, yes
106842211,  mcc43_, 7, 7, 0, yes
462348320,  DanteCarminati, 1, 1, 0, yes
745672620008476672,  RosannaParisi3, 1, 1, 0, yes
260833241,  Squarcione75, 1, 1, 0, yes
2375580923,  diegodalge, 1, 1, 0, yes
4657568061,  alessan70617102, 3, 1, 2, no
738880076230447105,  KPCP89, 1, 1, 0, yes
401523077,  ottavioz, 1, 1, 0, yes
739645052960399360,  fancd9cdmx, 1, 1, 0, yes
484164719,  CarlaartCarla, 4, 3, 1, yes
3243244427,  fc9f69153ac4452, 2, 2, 0, yes
766030495717163008,  olimpiadisalle, 1, 1, 0, yes
122769774,  marcofontanapop, 1, 1, 0, yes
1889851668,  mariangelalo33, 2, 2, 0, yes
2441402834,  Pelosaccio, 1, 1, 0, yes
467728705,  an_loi, 1, 1, 0, yes
923704572,  vito_lucio, 1, 1, 0, yes
635012145,  FuriaRiccardo, 2, 2, 0, yes
3331301680,  dottorlecther, 1, 1, 0, yes
746647026939629568,  carecavai, 2, 2, 0, yes
3359348968,  378a80051171495, 1, 1, 0, yes
1382144390,  NMarnica, 1, 1, 0, yes
1255414892,  brunelli34, 2, 1, 1, neutral
1469933792,  fulviobivona, 1, 1, 0, yes
4836438088,  BrunaMarini5, 1, 1, 0, yes
4333709903,  artu_barone, 1, 1, 0, yes
50238269,  IAmPlxmas, 1, 1, 0, yes
503508983,  Ssimonetta2012, 1, 1, 0, yes
3152337561,  Ever4L, 2, 2, 0, yes
2366187324,  Silvia07072009, 2, 2, 0, yes
3261123452,  nwakpa_gabriel, 3, 3, 0, yes
1577432971,  labandaonesti, 1, 1, 0, yes
2363961235,  ziggy73946837, 1, 1, 0, yes
3018473477,  maraleale18, 1, 1, 0, yes
2695893059,  giampierotirel1, 1, 1, 0, yes
164560443,  dodobeltrame, 4, 3, 1, yes
2226219453,  giovannifumar, 1, 1, 0, yes
2317976829,  Dagar80, 1, 1, 0, yes
1203559136,  idmac_, 2, 2, 0, yes
460161518,  paoletta71, 3, 3, 0, yes
1284276553,  AlbertoBaggini, 1, 1, 0, yes
589162889,  GoddessJay__, 1, 1, 0, yes
2358512956,  Molino643, 1, 1, 0, yes
627131845,  MauryNidielli, 1, 1, 0, yes
1355407830,  maurodeleo, 8, 6, 2, yes
3288318563,  about_big_data, 2, 1, 1, neutral
2149354589,  ffmastroeni, 1, 1, 0, yes
327859220,  robypax, 1, 1, 0, yes
38693336,  korean1977, 6, 1, 5, no
926118050,  stra_luca, 2, 2, 0, yes
503338054,  monetamarilena, 1, 1, 0, yes
235105755,  arderei_lomondo, 1, 1, 0, yes
1304896494,  danielnero12, 1, 1, 0, yes
4192743323,  votino_carmela, 1, 1, 0, yes
352642644,  MarioGuglielmi, 1, 1, 0, yes
784614624,  Daydream76_, 3, 1, 2, no
472418074,  ecavagna1, 1, 1, 0, yes
2777596289,  ConcasVeronica, 1, 1, 0, yes
3860964076,  Carmen42434791, 3, 3, 0, yes
771464957124804608,  BlogNews77, 15, 5, 10, no
939312673,  DScalvini, 1, 1, 0, yes
954228864,  patriziabruno62, 1, 1, 0, yes
805554060665516033,  TheSweet_Pi, 1, 1, 0, yes
900551972,  MassimilianaVig, 1, 1, 0, yes
760840411967590400,  lostinhisdimple, 1, 1, 0, yes
524192096,  eleriggi, 2, 2, 0, yes
415017482,  francescotorto3, 1, 1, 0, yes
344928076,  patty_starlight, 1, 1, 0, yes
198862377,  tartufona, 1, 1, 0, yes
325486245,  djsergiomauri, 1, 1, 0, yes
45815847,  silviamere, 2, 1, 1, neutral
435244556,  Taniaadidas, 1, 1, 0, yes
394018745,  serenadigioia, 4, 1, 3, no
706053256821264384,  joseholguinero, 1, 1, 0, yes
399311475,  sarettapp, 1, 1, 0, yes
891546211,  manuela_1710, 2, 2, 0, yes
2169258687,  mascaro72, 1, 1, 0, yes
784421576993345537,  ErmelindaPezze3, 2, 2, 0, yes
3338626512,  INeedCoffee6, 1, 1, 0, yes
3230823676,  vandapesce, 1, 1, 0, yes
768175139460485120,  Pierbag21312206, 1, 1, 0, yes
539203633,  paoloantonio5, 3, 2, 1, yes
2417474756,  AlexPlini, 1, 1, 0, yes
2966480939,  SaliolaR, 1, 1, 0, yes
2268415370,  stefaniabonave1, 1, 1, 0, yes
464088963,  BiondiBJ, 2, 1, 1, neutral
4684976688,  lolagatto1826, 1, 1, 0, yes
797416558951800832,  FabrizioMassar4, 1, 1, 0, yes
983154445,  fededippa, 1, 1, 0, yes
805371751349751808,  babischeggia, 1, 1, 0, yes
714495628018114564,  robertovigg69, 5, 5, 0, yes
19285928,  Alex_DeSantis, 1, 1, 0, yes
794349664267018240,  onyi_madu, 3, 3, 0, yes
470531271,  LUCIANOVELLA1, 1, 1, 0, yes
805770135193735169,  Mascia36911131, 3, 3, 0, yes
725071330861830144,  rita_migliozzi, 1, 1, 0, yes
963965773,  silviauguccioni, 1, 1, 0, yes
139161734,  gauchomatrero, 1, 1, 0, yes
791256848452227077,  Luca98747525, 1, 1, 0, yes
2855195985,  roncasaglia54, 1, 1, 0, yes
806117530439917568,  ma78_marianna, 4, 4, 0, yes
735210289784819712,  Barbara17011973, 9, 9, 0, yes
1713182292,  eiscortina, 1, 1, 0, yes
4835538599,  geramm7, 14, 13, 1, yes
1170337850,  Albertobillo72, 1, 1, 0, yes
704777492909973504,  olisticflower, 3, 2, 1, yes
22613550,  ggraceffa, 1, 1, 0, yes
4517956354,  GiuliB84, 1, 1, 0, yes
124113240,  imballoionico, 1, 1, 0, yes
186397158,  LuigiDeBiase, 1, 1, 0, yes
2745526173,  ChiapponiFlavio, 1, 1, 0, yes
545280779,  antuangreco, 1, 1, 0, yes
2172194937,  akastel, 3, 2, 1, yes
299330825,  gerardo1174, 1, 1, 0, yes
2847403906,  laura24021967, 2, 2, 0, yes
1949833747,  salvatore_canu, 1, 1, 0, yes
497257174,  danilomaggiore, 2, 1, 1, neutral
56330660,  NicoAntoniazzi, 1, 1, 0, yes
724587957995352069,  Ik5aioI, 1, 1, 0, yes
71204526,  sebha84, 1, 1, 0, yes
919964888,  lmpt35, 1, 1, 0, yes
299858910,  LuciaRaviglione, 1, 1, 0, yes
3121199032,  APassacanti, 1, 1, 0, yes
489336103,  SocciarelloCarl, 2, 2, 0, yes
785826853512622080,  impossibileit, 2, 2, 0, yes
614310258,  m_crosetti, 2, 2, 0, yes
1075871143,  PedrottiGuido, 2, 2, 0, yes
406901049,  _Passepartout_, 1, 1, 0, yes
420647354,  rocco_fiore, 3, 3, 0, yes
2425450727,  blackberry33410, 3, 2, 1, yes
484166347,  gio_dibartolo, 2, 1, 1, neutral
783232466156920832,  Gemmap49, 6, 1, 5, no
714621402,  ingfcosta, 1, 1, 0, yes
1116977016,  piace99, 1, 1, 0, yes
837753752,  emelielou, 2, 2, 0, yes
3186283616,  ProfSempre, 1, 1, 0, yes
543539492,  hamartithia, 1, 1, 0, yes
366840828,  vgaltieri, 3, 1, 2, no
784469894028988416,  antonie17944551, 1, 1, 0, yes
2332404504,  sarabissale, 2, 2, 0, yes
386189180,  SandraAliprandi, 1, 1, 0, yes
391497332,  FedericoCangian, 1, 1, 0, yes
231073683,  nina_x72, 3, 1, 2, no
805675199156944897,  cristofaros363, 1, 1, 0, yes
452296425,  ber_gat, 2, 1, 1, neutral
4861025711,  Anna27076013, 6, 6, 0, yes
450546622,  Eleleo8, 1, 1, 0, yes
1333921772,  magnagnagne, 1, 1, 0, yes
395518765,  AlexandruRotaru, 2, 2, 0, yes
409583631,  BeppeBaselice, 1, 1, 0, yes
738771303742746624,  rudemedur, 1, 1, 0, yes
3478613607,  4fd8059ce2d14b2, 1, 1, 0, yes
384821804,  MatteoBisanti, 1, 1, 0, yes
802186108801077248,  Giovann17377538, 1, 1, 0, yes
1481814764,  jinarossi, 2, 1, 1, neutral
704734346800930816,  AwakenedITA, 2, 1, 1, neutral
1037697188,  Paola_Consolo, 2, 1, 1, neutral
325790346,  AntoMariella, 3, 1, 2, no
2993961940,  recarloz, 3, 3, 0, yes
714800249756336128,  Peppe_Leggio, 1, 1, 0, yes
706164836795858944,  SandSiniFans, 3, 3, 0, yes
1022288858,  Aringoogle, 54, 14, 40, no
2568086016,  ITnewsUD, 1, 1, 0, yes
2496545125,  frankzcote, 4, 4, 0, yes
392911131,  RobertoBorgogni, 4, 4, 0, yes
718173627062083584,  smallyesbigno, 3, 1, 2, no
782506183764697088,  Efreid8, 1, 1, 0, yes
138047421,  SergioGatteschi, 3, 1, 2, no
2874163817,  donatella662, 1, 1, 0, yes
728192491929927680,  francescaromart, 1, 1, 0, yes
2925397426,  crycobra, 1, 1, 0, yes
3236330173,  barberio_c, 1, 1, 0, yes
3226465606,  patryharry82, 1, 1, 0, yes
794679268500471808,  lauraottobre195, 1, 1, 0, yes
2721059984,  nolansorion, 1, 1, 0, yes
477607199,  CurzioCav, 1, 1, 0, yes
1245607699,  SommellaRoberto, 2, 2, 0, yes
1177071931,  ellysilvester, 2, 2, 0, yes
1365806718,  RifRandall, 1, 1, 0, yes
2252247568,  lubandier, 1, 1, 0, yes
1626239239,  Cyrus70M, 1, 1, 0, yes
422744937,  pceccoli, 1, 1, 0, yes
1166130295,  Barberis888, 2, 2, 0, yes
755394279258910720,  mura_bony, 1, 1, 0, yes
4221550048,  SergioZ01, 5, 3, 2, yes
272402900,  ItSinistra, 1, 1, 0, yes
9224352,  vannisantoni, 1, 1, 0, yes
9217122,  sictwit, 1, 1, 0, yes
17704829,  danielaranieri, 1, 1, 0, yes
222115841,  Danizio76, 4, 4, 0, yes
223568896,  iovotofuorisede, 2, 2, 0, yes
4033400597,  SIndel_FN, 2, 2, 0, yes
2804548086,  SinEcoLib_BS, 1, 1, 0, yes
314845423,  Mione13, 1, 1, 0, yes
631967335,  AlbiPaolo, 1, 1, 0, yes
4518321982,  MasQue_bien, 1, 1, 0, yes
320290187,  RoRoRic, 1, 1, 0, yes
1695687517,  raggiod29976541, 1, 1, 0, yes
595680879,  alienlini, 9, 5, 4, yes
504313436,  p_savino, 1, 1, 0, yes
86065965,  frenkj6, 1, 1, 0, yes
636232833,  HomerMilanista, 2, 2, 0, yes
2470658058,  AntFolchetti, 2, 1, 1, neutral
2339947944,  Jimmy_146, 15, 2, 13, no
748244469082906624,  rufybionda, 1, 1, 0, yes
238578479,  ilFolagra, 2, 2, 0, yes
1934935309,  Giusepp88254369, 1, 1, 0, yes
895119164,  LBerrettoni, 2, 1, 1, neutral
801081193315835904,  Caterin49616437, 1, 1, 0, yes
796093229804453888,  pbalestrini08, 1, 1, 0, yes
3221453063,  lacattivamadre, 1, 1, 0, yes
1956425606,  Vinfernale, 1, 1, 0, yes
771257014240489472,  MasterUniteramo, 1, 1, 0, yes
783396508674695168,  GiuMonAv, 2, 2, 0, yes
803924572689092610,  Onesto512, 1, 1, 0, yes
796394501128519680,  momioz25, 1, 1, 0, yes
404038077,  MarcoLavaggi, 1, 1, 0, yes
289842790,  paola_taroni, 1, 1, 0, yes
3677974647,  Zeudolina, 2, 1, 1, neutral
985135417,  GianniMancini61, 1, 1, 0, yes
1254788209,  crigiunchi, 8, 4, 4, neutral
627749758,  CIAfra73, 1, 1, 0, yes
519529163,  _MagliaNera_, 2, 2, 0, yes
486966104,  radiotoscana, 1, 1, 0, yes
418849696,  ApuntoM, 2, 1, 1, neutral
4816818766,  margal2948, 1, 1, 0, yes
732642010633474048,  NapoliUgl, 1, 1, 0, yes
801175750732750852,  lerecalno1980, 1, 1, 0, yes
2610479660,  davideilardo, 1, 1, 0, yes
940138370,  libera_ale, 1, 1, 0, yes
799218675589017601,  shavtnatasha, 1, 1, 0, yes
15737548,  canablach, 1, 1, 0, yes
46920146,  GigiaPupimouse, 1, 1, 0, yes
299800009,  EmiliaMascalchi, 2, 2, 0, yes
160179878,  roscoffo, 1, 1, 0, yes
38285269,  3onFire, 2, 1, 1, neutral
2229302019,  XanderDelka, 1, 1, 0, yes
731259786893873152,  ntipopulista, 4, 2, 2, neutral
735727292526166019,  sicalabria, 3, 3, 0, yes
601829676,  kallisto61, 1, 1, 0, yes
774225717353672704,  Stella80lazio, 2, 2, 0, yes
509207236,  Strangas68, 1, 1, 0, yes
982461673,  fabridellepiane, 1, 1, 0, yes
867003139,  apdD10, 1, 1, 0, yes
749995250660282368,  Antonel88728080, 1, 1, 0, yes
399508912,  stealoia, 5, 4, 1, yes
977016020,  Luca_fivestars, 4, 3, 1, yes
777720296,  CecchiniBruno, 1, 1, 0, yes
1020734665,  Zinedine85, 2, 2, 0, yes
729730223793655808,  PaoloVale70, 1, 1, 0, yes
167329839,  federica1204, 1, 1, 0, yes
3823685553,  MarialuceMaria, 1, 1, 0, yes
742120627742593026,  Sketto7, 1, 1, 0, yes
789571062845571072,  PinoCarpanzano, 1, 1, 0, yes
729261198391259137,  ablasormin, 2, 2, 0, yes
83906632,  SergioTroisi, 1, 1, 0, yes
4916153843,  ForzaNuovaUSA, 1, 1, 0, yes
34251220,  morumbi79, 2, 1, 1, neutral
741040482285965312,  Gaetanol76, 1, 1, 0, yes
724603428496900096,  ComitatoSI_ue, 1, 1, 0, yes
2243979445,  FrancescaDelVen, 1, 1, 0, yes
1565551105,  illemeg57, 2, 2, 0, yes
2933732913,  brunorossi_368, 1, 1, 0, yes
803241948639363072,  PeppeArnautovic, 2, 2, 0, yes
283939901,  fancio_original, 17, 2, 15, no
254918613,  jocker470, 1, 1, 0, yes
1125998850,  riccardopalazz3, 1, 1, 0, yes
397482175,  PomoEkida, 1, 1, 0, yes
842406103,  GaeTerrasanta, 4, 2, 2, neutral
15701149,  ruggibrante, 1, 1, 0, yes
3543554117,  TweettoKing, 2, 1, 1, neutral
366084580,  paolosalio, 3, 1, 2, no
752621893430177793,  nascomora, 2, 1, 1, neutral
920798731,  danielecoduti, 4, 4, 0, yes
2244516079,  GilaHernn, 1, 1, 0, yes
1262459101,  OnofrioPescina, 1, 1, 0, yes
425300096,  giofontana1, 1, 1, 0, yes
423616577,  louisonlyhope, 1, 1, 0, yes
39353444,  ItaloMarcotti, 1, 1, 0, yes
2678107287,  beppelanciano, 1, 1, 0, yes
2533451441,  diavlematt, 1, 1, 0, yes
1250202577,  aIex_cat, 10, 2, 8, no
1068801092,  adriatzara, 9, 2, 7, no
104811578,  Loeb87, 1, 1, 0, yes
237262307,  Massolon, 1, 1, 0, yes
425645665,  nandoscipp, 2, 1, 1, neutral
4869439901,  MasiniFrancesco, 1, 1, 0, yes
56792625,  adryx_92, 2, 2, 0, yes
4056602793,  graziazinga1, 2, 1, 1, neutral
297607313,  LorenzoGlave, 1, 1, 0, yes
259214304,  cpwellsix, 1, 1, 0, yes
109878653,  mariellatesoro, 1, 1, 0, yes
510101438,  ALobuono, 1, 1, 0, yes
389970783,  DAMICOYago, 6, 5, 1, yes
1096419438,  Ercole1185, 4, 1, 3, no
2816446821,  gianniilsecco, 1, 1, 0, yes
462346050,  NelloSartorio, 1, 1, 0, yes
798164908865097729,  bolzano51, 1, 1, 0, yes
2246569281,  mobiagia, 1, 1, 0, yes
331059697,  mariacaprioli, 1, 1, 0, yes
2165588517,  mapris1750, 1, 1, 0, yes
513791342,  donrigon177, 4, 2, 2, neutral
375539926,  RBaldassarri, 1, 1, 0, yes
1924582736,  MoreSecci, 2, 2, 0, yes
3413291314,  WangsonAdele, 2, 2, 0, yes
1189073328,  bassi_carlo, 1, 1, 0, yes
2230254218,  rosariacassarin, 3, 3, 0, yes
4299530902,  Beatricetoni1, 1, 1, 0, yes
1324895924,  KhatyCate, 3, 2, 1, yes
714047317,  michele_padoan, 8, 1, 7, no
1061750881,  mrrosmat, 1, 1, 0, yes
117413096,  royalsforza, 1, 1, 0, yes
347387443,  PBiancucci, 2, 2, 0, yes
801732026776727553,  andrea_santos99, 1, 1, 0, yes
1148598408,  IlMutanda, 1, 1, 0, yes
538899105,  LatiniFrancesca, 2, 2, 0, yes
965139624,  AlbertoGrauso, 1, 1, 0, yes
595411616,  MaryBenM, 1, 1, 0, yes
314164598,  robycag, 1, 1, 0, yes
2279025419,  mary_ferrigno, 1, 1, 0, yes
3088529306,  LoStenografo, 1, 1, 0, yes
454081262,  MariaLonghi49, 1, 1, 0, yes
115021825,  ernesto_aloia, 1, 1, 0, yes
2247827322,  SorbelloAlfio82, 1, 1, 0, yes
509058983,  LorellaCoppo, 1, 1, 0, yes
2357363494,  mauro_ambotta, 2, 2, 0, yes
2207805180,  SakkasV, 1, 1, 0, yes
1611246091,  mh_flo, 1, 1, 0, yes
478692854,  robideale, 1, 1, 0, yes
106342448,  perspmk, 1, 1, 0, yes
3290361172,  pinocaccavaro51, 3, 1, 2, no
286722567,  VincenzoFreni, 3, 3, 0, yes
3006986143,  BellinCuriel, 1, 1, 0, yes
4242838397,  alfredoalbinoni, 3, 3, 0, yes
1475936965,  Alibaba656, 2, 1, 1, neutral
2532627856,  criret, 1, 1, 0, yes
2351348872,  BfWebnet, 1, 1, 0, yes
820134716,  andri1967, 1, 1, 0, yes
470185745,  MonicaBona, 1, 1, 0, yes
409446270,  Mettoz, 1, 1, 0, yes
4536244588,  amosdesideri, 2, 2, 0, yes
62285010,  paulmarsi, 1, 1, 0, yes
2263030717,  vesuvio2014, 1, 1, 0, yes
1403137261,  Emi70Martini, 1, 1, 0, yes
413937982,  MonicaVacchi, 1, 1, 0, yes
1025028482,  FiorenzoBasso1, 1, 1, 0, yes
798168900592631809,  ivo_nastasi, 2, 2, 0, yes
73345879,  Igot6, 1, 1, 0, yes
4321227377,  Ssimeoli63, 4, 1, 3, no
1347733026,  LMPT53, 1, 1, 0, yes
774981284938604545,  gamberograzia, 2, 1, 1, neutral
262702883,  FNMilano, 1, 1, 0, yes
98798638,  garnetyuna, 1, 1, 0, yes
38931308,  BiagioVelardi, 2, 2, 0, yes
752943641585418240,  foggylady, 1, 1, 0, yes
3089580886,  79aef70ab2b0402, 1, 1, 0, yes
2264003235,  annaritacerutti, 1, 1, 0, yes
2520833600,  GabrieleZuccar2, 2, 2, 0, yes
566534155,  terroncino_, 1, 1, 0, yes
3511343069,  RiccardoMennini, 1, 1, 0, yes
431768487,  DiegoCordisco, 1, 1, 0, yes
1878586237,  Arun1993JAIN, 1, 1, 0, yes
799467611574726656,  Mario10586793, 1, 1, 0, yes
1059761402,  persalva, 1, 1, 0, yes
464145987,  rvdovben, 1, 1, 0, yes
384198329,  davids1972, 1, 1, 0, yes
405576824,  daniber72, 1, 1, 0, yes
4878358823,  Dario31357231, 1, 1, 0, yes
520310011,  Maure64, 1, 1, 0, yes
2270706898,  FlRossi, 1, 1, 0, yes
4908738190,  FlowerNuit, 1, 1, 0, yes
634762072,  g_dannibale, 1, 1, 0, yes
439318267,  frazoe, 1, 1, 0, yes
775326159718518784,  patrons1962, 1, 1, 0, yes
2376704631,  42acdb8e990b434, 1, 1, 0, yes
782699968033394688,  Frank_il_matto, 1, 1, 0, yes
786626062239297536,  algeometra3067, 1, 1, 0, yes
2181885914,  francescadamm, 1, 1, 0, yes
3053779892,  Maluscia, 1, 1, 0, yes
462900161,  SergioAgazzi, 1, 1, 0, yes
2173329953,  CesareGallelli, 3, 3, 0, yes
2176349201,  manueghibs, 2, 1, 1, neutral
503909782,  GTimossi, 4, 2, 2, neutral
46136045,  spidLL, 1, 1, 0, yes
928287380,  vpenato, 2, 2, 0, yes
2780597242,  Fuzzyfuzzme, 9, 5, 4, yes
796081384695721986,  CerebroLazy, 1, 1, 0, yes
1926446076,  pasruz, 3, 2, 1, yes
179442802,  paki_pap, 1, 1, 0, yes
999860240,  franknwa1, 1, 1, 0, yes
1433919019,  YThedavid1972, 2, 1, 1, neutral
458490168,  bacarasi, 3, 1, 2, no
2765380206,  paul6213, 2, 2, 0, yes
706487216428687360,  il_boidi, 1, 1, 0, yes
467265498,  francodaicaveld, 1, 1, 0, yes
143486021,  SuperMariaB, 8, 8, 0, yes
570966263,  MauryMagnani, 1, 1, 0, yes
875696023,  LaManifPourTous, 1, 1, 0, yes
466385774,  matteomigoni, 1, 1, 0, yes
242306600,  dario16564, 5, 2, 3, no
2364513843,  deangelis79, 1, 1, 0, yes
4864219689,  Elisa_Buzz, 1, 1, 0, yes
967231038,  peppemongiardo, 1, 1, 0, yes
2874858882,  59pmMagri, 11, 10, 1, yes
1068918859,  renatoferuglio, 1, 1, 0, yes
61177217,  EMallus, 2, 1, 1, neutral
150993426,  robertomicheli, 4, 1, 3, no
1049923886,  SonDandelion, 5, 3, 2, yes
775337676413239297,  AntonellaBisce3, 1, 1, 0, yes
997459116,  carlo_tommasi, 1, 1, 0, yes
426602086,  chimentimattia, 1, 1, 0, yes
400221069,  gp_pellegrino, 1, 1, 0, yes
117512432,  ninfaflamenca, 1, 1, 0, yes
472275443,  spina_barny, 3, 2, 1, yes
557801943,  MorensAndrea, 2, 2, 0, yes
2847888735,  jan_khler, 2, 1, 1, neutral
1173498349,  jo19N26, 1, 1, 0, yes
720941698323476481,  ballarmino, 1, 1, 0, yes
583204041,  ERadisa, 1, 1, 0, yes
2405060832,  GabrieleBalconi, 1, 1, 0, yes
356042866,  GiuseppeMiro, 5, 3, 2, yes
1563141608,  ElenaCandini_, 1, 1, 0, yes
1065857210,  indigneraitv, 6, 4, 2, yes
533458057,  che_balle, 1, 1, 0, yes
319306930,  terramau, 1, 1, 0, yes
292508028,  JostoMaffeo, 1, 1, 0, yes
570951698,  egiuca, 3, 3, 0, yes
3833171361,  ArmyRenzi, 11, 1, 10, no
47451430,  cristian171275, 1, 1, 0, yes
704996147,  pietropasquini3, 15, 11, 4, yes
331598166,  Stevenb_SWCI, 1, 1, 0, yes
290723075,  MaurizioPinto1, 3, 2, 1, yes
3035060441,  credendo_vides_, 9, 1, 8, no
2742178024,  GranoLiana, 4, 4, 0, yes
3235420653,  Bolla_Giu, 1, 1, 0, yes
3248382417,  albertoferrac, 1, 1, 0, yes
2300876730,  ferrarodf, 1, 1, 0, yes
2980216701,  dufrandi, 1, 1, 0, yes
2600970999,  gg_gue, 7, 2, 5, no
429273541,  Petercocci, 1, 1, 0, yes
594060029,  demomas, 1, 1, 0, yes
99455994,  lucasuomi, 1, 1, 0, yes
1365386306,  mauro_sommella, 1, 1, 0, yes
789903019810979840,  EnzoV45195366, 1, 1, 0, yes
1071445298,  AlexanderLandSp, 2, 2, 0, yes
2492049317,  PierStefy, 1, 1, 0, yes
4257265342,  gerdhr1, 2, 1, 1, neutral
302538500,  federico_m99, 1, 1, 0, yes
4906320167,  Arib2003, 1, 1, 0, yes
3013216870,  iraytweet, 2, 2, 0, yes
1864679209,  elenoire_bo, 1, 1, 0, yes
2857263958,  CirenzaM, 4, 3, 1, yes
926061175,  birbo31, 1, 1, 0, yes
599516414,  elisabetta_pero, 1, 1, 0, yes
739462988365697024,  CallegariItalo, 2, 2, 0, yes
1124490590,  Gianni692, 1, 1, 0, yes
702492423562379264,  critico87k, 1, 1, 0, yes
1387126244,  BrunelloCavalli, 1, 1, 0, yes
2165345631,  normanratto, 2, 2, 0, yes
759653411965075456,  Marcello_van, 1, 1, 0, yes
1545110719,  dylettama, 10, 9, 1, yes
2362894645,  landiivana, 1, 1, 0, yes
451369571,  AndreaAffinito, 3, 2, 1, yes
4901869978,  Fpulvi, 1, 1, 0, yes
394021004,  RADIOCARCERE, 3, 1, 2, no
2476155712,  vicolodo1, 1, 1, 0, yes
3168011729,  alias16g, 16, 3, 13, no
386087766,  mauriziosor, 1, 1, 0, yes
712016676980596736,  BiceTrentadue, 1, 1, 0, yes
272634016,  doramuraca, 1, 1, 0, yes
2864913420,  FiorellaPuglia, 2, 2, 0, yes
2870562651,  arcdipalma, 1, 1, 0, yes
521408777,  BottaroRoberta, 1, 1, 0, yes
480296748,  MatteoDavanzo1, 1, 1, 0, yes
211226743,  maxixhw, 22, 3, 19, no
2320769211,  AleAscalam, 1, 1, 0, yes
999638528,  FranzMassari, 1, 1, 0, yes
121062400,  v_samuele, 1, 1, 0, yes
2855433965,  GigilongLuigi, 1, 1, 0, yes
799734010490470400,  teresaberlinge, 4, 3, 1, yes
775264659628785665,  Pietrop64247624, 1, 1, 0, yes
2301439887,  cmalass, 1, 1, 0, yes
34932457,  carlo24, 4, 1, 3, no
970032661,  EstyQaatsi, 2, 1, 1, neutral
334388390,  kaosleo, 5, 5, 0, yes
1925699017,  MIcheleTofful, 7, 4, 3, yes
972884324,  damstop83, 15, 5, 10, no
1963072460,  labellifranco, 5, 3, 2, yes
3740692935,  LupaV, 1, 1, 0, yes
248840531,  lorecrug, 1, 1, 0, yes
1854497880,  egittoanto, 1, 1, 0, yes
2427220003,  Raffy_Luciani, 1, 1, 0, yes
196527016,  aladivetro, 2, 1, 1, neutral
712346066117640192,  mariarosa2917, 1, 1, 0, yes
422603932,  carla_lucini, 1, 1, 0, yes
489374582,  angelavec69, 4, 2, 2, neutral
4184406562,  CikAtell, 28, 4, 24, no
2366997321,  sommascabis, 4, 1, 3, no
722068325161943040,  Papizia_Babel, 2, 2, 0, yes
443217478,  paolomodenesi, 1, 1, 0, yes
26309297,  lf96mn, 1, 1, 0, yes
2273512710,  FFarina1984, 3, 3, 0, yes
2625792850,  silv9907, 1, 1, 0, yes
995658620,  SperoniMartino, 1, 1, 0, yes
123856747,  dinamocorrenti, 1, 1, 0, yes
1499498576,  MarcoHassani, 1, 1, 0, yes
3322922933,  carlocasamassi1, 1, 1, 0, yes
4862143995,  dennicrein, 1, 1, 0, yes
2348543166,  mantisbat, 1, 1, 0, yes
1902810301,  nappa_stefano, 1, 1, 0, yes
800251528338513920,  kritisanon__, 1, 1, 0, yes
264883591,  toroescorpione, 2, 1, 1, neutral
786139953948426240,  GiCer81J, 1, 1, 0, yes
787330272173944832,  elena84812257, 1, 1, 0, yes
4309935400,  Arnaldo40187933, 4, 1, 3, no
885384266,  FrancesMotley, 1, 1, 0, yes
2234580853,  Side73Dark, 4, 3, 1, yes
1027003795,  GiorgioDebiasi1, 1, 1, 0, yes
439944081,  thefrouder, 1, 1, 0, yes
707484641222139904,  coccoloso85, 1, 1, 0, yes
350791461,  sim1rtp, 1, 1, 0, yes
452970398,  JokerJukebox, 2, 2, 0, yes
4581314793,  Ciarvins, 3, 1, 2, no
183036157,  giuseppebaratta, 1, 1, 0, yes
3009632313,  GattiGabri, 1, 1, 0, yes
1695629928,  Giuseppemagnoca, 1, 1, 0, yes
4550095348,  gigi_ilgrande, 3, 3, 0, yes
462910121,  GCapparella, 1, 1, 0, yes
3246816695,  8d9bc353a48347a, 1, 1, 0, yes
4352975776,  GiorgioAnzolli, 1, 1, 0, yes
4353449848,  FlavioVassoni, 1, 1, 0, yes
4408591421,  ChiosaBetto, 1, 1, 0, yes
4353451101,  RiccardoFoiba, 1, 1, 0, yes
188686556,  Jekilla41, 1, 1, 0, yes
789558621558439936,  kit_katyaa, 1, 1, 0, yes
780422259802533889,  Mikelhaus, 1, 1, 0, yes
780431262469218305,  GPolipo, 1, 1, 0, yes
780444923619340288,  HobbyDebby, 1, 1, 0, yes
494401392,  Signorelli_Fabi, 2, 1, 1, neutral
780581562341466112,  oscar_travesti, 1, 1, 0, yes
780768805513342976,  ile_ana71, 1, 1, 0, yes
782428984554450944,  viola_ceo, 1, 1, 0, yes
782601399993532416,  maya_lina69, 1, 1, 0, yes
782583694703853569,  bacidabice, 1, 1, 0, yes
932849480,  RobertaRosellin, 2, 2, 0, yes
584528289,  bassismarco, 4, 1, 3, no
782935177974734849,  ursula_poppy, 1, 1, 0, yes
784731836043956224,  SantaSubito3, 1, 1, 0, yes
2278599870,  LaNausica, 1, 1, 0, yes
1861180525,  Deniburgarella, 1, 1, 0, yes
2590072486,  AlbertoSalvoni, 1, 1, 0, yes
334640323,  valerioboing, 1, 1, 0, yes
4795069195,  omgitsniallhx, 1, 1, 0, yes
1451053746,  chivveseincula, 1, 1, 0, yes
574384278,  LpeSala, 3, 2, 1, yes
2983072780,  nocaig_walter, 1, 1, 0, yes
2756277147,  josephinemd34, 1, 1, 0, yes
2798567902,  AlbeGhirla, 1, 1, 0, yes
2797745693,  NicoPelle14, 2, 2, 0, yes
390989801,  andreacc82, 2, 2, 0, yes
2824073461,  ItalyinCam, 1, 1, 0, yes
488382658,  161BOBO, 1, 1, 0, yes
2478852059,  ci_giuseppe, 1, 1, 0, yes
608915272,  MicheleBernori, 1, 1, 0, yes
1162323121,  NMatteis, 4, 1, 3, no
422587276,  tavernafr, 1, 1, 0, yes
356795091,  Andrea_Fen, 1, 1, 0, yes
1636014708,  LSaccares, 1, 1, 0, yes
390114419,  AnielloLampo, 1, 1, 0, yes
993150505,  oriduo, 1, 1, 0, yes
495321537,  FloraCalvanese, 2, 1, 1, neutral
538382007,  galatinicola, 8, 5, 3, yes
2301111365,  massiciccio, 8, 4, 4, neutral
3335374445,  elisabettaloio1, 1, 1, 0, yes
263054498,  dav_imartins, 1, 1, 0, yes
3230321657,  QuellaPazzaRita, 1, 1, 0, yes
1323367921,  MarcoMarcop7, 2, 2, 0, yes
889154604,  IPibia, 2, 2, 0, yes
772445684343660544,  AndyFerry10, 1, 1, 0, yes
446469698,  MarcoBloom, 1, 1, 0, yes
2372922933,  estykazzy, 1, 1, 0, yes
2248923694,  camboni_michele, 1, 1, 0, yes
418163121,  MaidenVojage, 6, 3, 3, neutral
510764118,  ElianaFa80, 1, 1, 0, yes
84516727,  gchitarroni, 2, 2, 0, yes
3406933877,  CarmineIevolel1, 1, 1, 0, yes
479731303,  KlidiMatija, 1, 1, 0, yes
1015989050,  ziowalter1973, 1, 1, 0, yes
4859837003,  GiovannaBusacc2, 1, 1, 0, yes
3245003351,  GiaimoNicola, 1, 1, 0, yes
1031139054,  MaddalenaPaolo, 1, 1, 0, yes
1527982182,  freedomenico, 4, 3, 1, yes
2315062792,  PiranhaCaribe, 6, 5, 1, yes
117055267,  Luke2375, 1, 1, 0, yes
795690578084265984,  undici55, 1, 1, 0, yes
3012818477,  MarcoCandio, 1, 1, 0, yes
1369895101,  CasmiroDavideRa, 4, 2, 2, neutral
482732915,  mxbarber68, 2, 1, 1, neutral
595750802,  Carmelona5, 1, 1, 0, yes
2774278869,  AllGymnos, 1, 1, 0, yes
3035464061,  silvestrigreg, 2, 1, 1, neutral
312561272,  Da_Saz, 1, 1, 0, yes
411480461,  Frafavaro49, 1, 1, 0, yes
375888827,  DiegoPi75, 1, 1, 0, yes
2158651894,  estersalis2, 2, 2, 0, yes
1090143086,  nuela64, 1, 1, 0, yes
897043482,  markobandelli, 2, 2, 0, yes
900066948,  marialuce_b, 2, 2, 0, yes
497426257,  CarloCeccon, 3, 3, 0, yes
2276394841,  edo_assirelli, 1, 1, 0, yes
1008668900,  rega_luca, 1, 1, 0, yes
383254576,  AnnaTagliafierr, 1, 1, 0, yes
789187522106568705,  sardegna_di, 2, 1, 1, neutral
2564051176,  di_nica, 1, 1, 0, yes
456062967,  diogenespinelli, 1, 1, 0, yes
3134906134,  stefanoluzi3, 1, 1, 0, yes
2425806510,  LoryFotografie, 1, 1, 0, yes
926151210,  PotitoRoca, 1, 1, 0, yes
1395448741,  Enzo_DellAnno, 1, 1, 0, yes
2514993334,  Pin_upicierno, 2, 1, 1, neutral
805785944255250432,  DrFr_Strazzullo, 1, 1, 0, yes
2963815197,  sagri976, 1, 1, 0, yes
92375343,  etidona, 1, 1, 0, yes
702592567830028291,  gerardorenzoA, 8, 7, 1, yes
2605633743,  ClaudioAlacqua, 1, 1, 0, yes
2173735015,  NoName100560, 3, 3, 0, yes
2763948088,  ScorSigar, 1, 1, 0, yes
466366483,  Clay_46, 1, 1, 0, yes
426606498,  Rosalbauscidda1, 3, 1, 2, no
2436604883,  kelmarle3, 1, 1, 0, yes
3323471141,  SabryScc68, 2, 1, 1, neutral
1540659902,  Gosthtown, 1, 1, 0, yes
418023685,  angelo_tqm, 1, 1, 0, yes
53302071,  marchionnag, 1, 1, 0, yes
932591684,  claudiodex, 1, 1, 0, yes
2481418881,  Fordyford27, 1, 1, 0, yes
748624843780800513,  yara_argentin, 1, 1, 0, yes
806075964308488192,  Teresa06884542, 1, 1, 0, yes
2603715699,  kekkopensa, 15, 2, 13, no
27617948,  viareggiok, 1, 1, 0, yes
267825697,  GIANNIDEB, 1, 1, 0, yes
578413717,  marcecosta70, 1, 1, 0, yes
2452701214,  leone4964, 2, 1, 1, neutral
88968372,  ilariadefilippo, 1, 1, 0, yes
415509071,  zoodruf, 1, 1, 0, yes
790621009892216832,  bruna19572016, 1, 1, 0, yes
2198142374,  laurapirrone73, 2, 2, 0, yes
70741097,  lorenzlu, 1, 1, 0, yes
2345121642,  CorradoSalvati, 2, 2, 0, yes
897455300,  FrancescoGere, 1, 1, 0, yes
1457648719,  Kess5M, 2, 2, 0, yes
731212252586606592,  rosellaq955, 1, 1, 0, yes
1878922166,  alimatteoS, 1, 1, 0, yes
567391977,  GOLDRAKE_AVANTI, 6, 3, 3, neutral
72489273,  tof92130, 1, 1, 0, yes
255552313,  MarinaNoir, 1, 1, 0, yes
1528783652,  maxzonair, 4, 1, 3, no
796131837374500865,  laNellajunior, 2, 1, 1, neutral
4861152073,  David54089166, 1, 1, 0, yes
3251559435,  michelearte81, 1, 1, 0, yes
1039416606,  bacchiega_f, 2, 1, 1, neutral
809348136,  paggero, 1, 1, 0, yes
736488545926385664,  little_lord96, 1, 1, 0, yes
1076086058,  NomosCSP, 9, 9, 0, yes
742364381003034624,  Delfinoadrdelf1, 1, 1, 0, yes
2958238113,  LivioMax69, 1, 1, 0, yes
479860702,  rl_castellani, 1, 1, 0, yes
2893436740,  SBolloni, 1, 1, 0, yes
114057984,  aalfieri, 1, 1, 0, yes
4315782987,  StefaniaDurant5, 1, 1, 0, yes
342273250,  ajodai, 1, 1, 0, yes
2817735960,  FinisguerraMate, 1, 1, 0, yes
753336446547849217,  partageetvaleur, 1, 1, 0, yes
2351310618,  LRomlui45, 1, 1, 0, yes
800110649212665856,  ruggerto68, 1, 1, 0, yes
805874221876412416,  MassimoBreccia, 1, 1, 0, yes
35186461,  snacky83, 1, 1, 0, yes
707560389358305280,  loziobobby5, 3, 2, 1, yes
287662689,  AlfioTodini, 1, 1, 0, yes
540698983,  virgiliofredian, 2, 2, 0, yes
731928017564512256,  libmo4, 3, 1, 2, no
785891635460771840,  eestiquatsi, 2, 1, 1, neutral
70354988,  claudioalpalice, 1, 1, 0, yes
70231136,  FlavioMarino, 5, 1, 4, no
1937387708,  fiorellasimonaz, 6, 6, 0, yes
466400858,  federica_galli, 1, 1, 0, yes
1051325084,  DaniMoni72, 7, 6, 1, yes
751063251476242432,  Ulisse55555, 4, 4, 0, yes
56510304,  Lory_03, 1, 1, 0, yes
237813081,  emanuele_rmgnl, 1, 1, 0, yes
749317482289192960,  BirdManRm, 1, 1, 0, yes
412670404,  graziellaciccon, 8, 5, 3, yes
2177864810,  piccolojason, 5, 1, 4, no
1083125852,  emascalzo, 2, 1, 1, neutral
56161146,  marcotombesi, 5, 5, 0, yes
389066130,  gaetanoalberico, 2, 2, 0, yes
429780455,  MatteoCasanovi, 12, 12, 0, yes
2465152871,  stefanobiocca, 3, 2, 1, yes
712692752308432896,  MadyChain, 4, 4, 0, yes
126939158,  liviotedesco, 2, 1, 1, neutral
399626186,  CaSimo76, 1, 1, 0, yes
841520510,  scoser62, 1, 1, 0, yes
288365363,  aLbYlN, 1, 1, 0, yes
200289788,  jdandreamatteo, 1, 1, 0, yes
1013629652,  lucarellileo, 1, 1, 0, yes
1447157665,  tonellilisa, 2, 1, 1, neutral
129443586,  paolodune, 2, 2, 0, yes
2714350413,  catiolosco, 3, 3, 0, yes
1653466591,  Orestjoe, 1, 1, 0, yes
2561607220,  ivi1Henderson, 2, 2, 0, yes
2571018160,  contatt1305, 1, 1, 0, yes
2933613009,  albatelari2, 1, 1, 0, yes
494488032,  welmerengue, 4, 2, 2, neutral
191269424,  ExpositoFra, 1, 1, 0, yes
1096420074,  Nibbionero, 3, 2, 1, yes
1041834859,  ChioFabiana, 3, 3, 0, yes
3869622495,  alerevolution88, 1, 1, 0, yes
2218488888,  fabyhulio, 3, 3, 0, yes
374596318,  sandroiacometti, 1, 1, 0, yes
891193351,  monicaficarell1, 1, 1, 0, yes
378886735,  chiarathustra, 1, 1, 0, yes
391626604,  antonio_aleo, 1, 1, 0, yes
129847828,  Saverio___, 1, 1, 0, yes
3433982391,  MarcoMondo123, 1, 1, 0, yes
794135910791217152,  RigatoPie, 1, 1, 0, yes
485521546,  giordanapallone, 1, 1, 0, yes
604899762,  veronicaloiaco2, 7, 5, 2, yes
4884423717,  MenigildoZenga, 1, 1, 0, yes
4473473907,  BARBAPIZZ, 2, 2, 0, yes
1469353392,  proff983, 5, 4, 1, yes
138775233,  EmmaSanti_, 5, 1, 4, no
302837791,  FofoMarinangeli, 3, 3, 0, yes
344142510,  lillium10, 1, 1, 0, yes
262539190,  AnyVitale, 7, 3, 4, no
3093121402,  GiacomoSoldati, 2, 1, 1, neutral
4888543989,  aquila285, 1, 1, 0, yes
104493225,  antonio_regina, 2, 2, 0, yes
123272707,  talia_nightray, 1, 1, 0, yes
273091826,  totina71, 1, 1, 0, yes
2650228636,  pasqualina68p, 2, 1, 1, neutral
4630272508,  ottaviofabrizi3, 1, 1, 0, yes
762435750029688832,  sabrika65, 1, 1, 0, yes
3252394091,  RosaniFlavia, 1, 1, 0, yes
1712618076,  Roberto1965Rs, 1, 1, 0, yes
377931910,  Lucagrossi66, 4, 4, 0, yes
4757159967,  angelo60pass, 1, 1, 0, yes
493224817,  edoardorossi8, 2, 1, 1, neutral
1148057552,  CorradoUrgu, 1, 1, 0, yes
1306674768,  Meringa28M, 1, 1, 0, yes
299551316,  pensieroETICO, 13, 9, 4, yes
2490422221,  ITnewsAN, 1, 1, 0, yes
440031245,  60fulvio, 1, 1, 0, yes
1203563269,  RightsReporter, 1, 1, 0, yes
185215567,  RickyZuccaro, 1, 1, 0, yes
711566134,  MaryZanzottera, 1, 1, 0, yes
1350270738,  GinoStorer, 1, 1, 0, yes
273516416,  lolalalla, 1, 1, 0, yes
2309731819,  daniele12684160, 9, 6, 3, yes
3320642767,  MikeJannello, 2, 1, 1, neutral
792894176828485632,  ToreXVII, 1, 1, 0, yes
1040162287,  SHERLOCK1954, 2, 1, 1, neutral
599268299,  AndreaFrati1, 1, 1, 0, yes
540679806,  IOLANNA71, 3, 3, 0, yes
479574545,  nicholas_binda, 1, 1, 0, yes
790619251145109504,  last_rt1, 2, 2, 0, yes
2608133516,  antondepierro, 1, 1, 0, yes
1457650639,  Beatame1, 1, 1, 0, yes
2756869775,  acavallaroupg, 1, 1, 0, yes
476161307,  Gekosauro, 3, 1, 2, no
1542926724,  nicolettagrima2, 1, 1, 0, yes
1585116362,  giuseppemotta11, 1, 1, 0, yes
2529845120,  PafarmacieANPI, 2, 2, 0, yes
276924403,  CarmenOliva2, 5, 4, 1, yes
3047714690,  mauro60asr, 4, 1, 3, no
1375651812,  Foltowski, 3, 3, 0, yes
278215987,  ravogadri, 2, 1, 1, neutral
2320844457,  GughiLibero, 5, 5, 0, yes
52011449,  daytona27, 1, 1, 0, yes
1175572663,  Eudosso, 1, 1, 0, yes
422199745,  ninocortesi, 4, 2, 2, neutral
245999910,  carlorossito51, 1, 1, 0, yes
765356826,  Fabi0Magni, 2, 2, 0, yes
15317484,  angeloselvini, 2, 1, 1, neutral
307465305,  GiusiSalis, 5, 2, 3, no
2719563991,  endlessbravery, 1, 1, 0, yes
358403333,  Cloud_86, 2, 2, 0, yes
916303664,  andreabenatti0, 1, 1, 0, yes
1036864910,  spatola65, 1, 1, 0, yes
137687388,  econforti, 1, 1, 0, yes
507555986,  felicia_it, 2, 2, 0, yes
1928837743,  giselaBoezio, 2, 2, 0, yes
1154223643,  lully111, 3, 3, 0, yes
557109640,  Bijubijublu, 1, 1, 0, yes
451409301,  SalvatoreBalza2, 2, 2, 0, yes
3194234525,  PastorinoGianni, 2, 1, 1, neutral
2839391884,  crem58api, 1, 1, 0, yes
2362345730,  fabiop70, 8, 3, 5, no
142454814,  maricabru, 1, 1, 0, yes
39738523,  Michybet, 1, 1, 0, yes
456946458,  DCocciolito, 1, 1, 0, yes
781520339780116480,  Agatirso81, 3, 1, 2, no
2372023345,  RockiDave, 1, 1, 0, yes
2386014801,  acetti25, 1, 1, 0, yes
1194825259,  sghiscio77, 2, 2, 0, yes
493493351,  Arieliaghetto, 2, 2, 0, yes
1148846582,  RT_muto, 5, 5, 0, yes
209615823,  Menestrella_, 1, 1, 0, yes
465363518,  OresteNegrini, 3, 2, 1, yes
697418738220535808,  SaraLuna2016, 2, 2, 0, yes
17645693,  Emmanuela81, 1, 1, 0, yes
1400701532,  VittorioBanti, 10, 3, 7, no
2338352144,  bristowofrome, 1, 1, 0, yes
783613451587489792,  Ludo26Mktg, 1, 1, 0, yes
408021855,  italiantax, 1, 1, 0, yes
767047030996860928,  RobLattarulo, 1, 1, 0, yes
987269149,  GiudittaPapini, 2, 2, 0, yes
2350173428,  EQuarta93, 5, 5, 0, yes
227343043,  e_viegas, 1, 1, 0, yes
776151189381578752,  il_magno_, 1, 1, 0, yes
2689846621,  MaccabiItalia, 2, 2, 0, yes
14711281,  pablecito, 1, 1, 0, yes
435761951,  DanielaFilieri, 5, 5, 0, yes
717393342686961664,  L_a_r_i_l_u, 6, 6, 0, yes
715593055789826048,  guforealenapoli, 13, 5, 8, no
2787584039,  epifaniocorona, 1, 1, 0, yes
460408246,  MassiMaselli, 2, 2, 0, yes
716368613070995456,  assomister, 3, 3, 0, yes
4632511637,  Kikka_corbiz, 5, 5, 0, yes
501543830,  ArtigianiVarese, 1, 1, 0, yes
8001112,  maurobiani, 2, 2, 0, yes
2495110117,  altavilla_anna, 2, 2, 0, yes
2714607003,  nuvolarossa18, 1, 1, 0, yes
49910586,  bluendia, 1, 1, 0, yes
788112053089230848,  ZampriTm, 3, 3, 0, yes
240310965,  senisregna, 3, 1, 2, no
714282153459187713,  Niki_Ottantotto, 1, 1, 0, yes
346162937,  FridayFish73, 1, 1, 0, yes
525127209,  AnnaFado, 1, 1, 0, yes
210186173,  Eulimene, 2, 2, 0, yes
4221923775,  piccolakaty5, 1, 1, 0, yes
2808138563,  ioxTsipras, 2, 1, 1, neutral
2375448565,  SermonetaFutura, 4, 1, 3, no
4470827602,  sara16374896, 1, 1, 0, yes
3360763467,  ThyroidXed, 1, 1, 0, yes
419031847,  Luisa_Spina, 2, 2, 0, yes
1402391311,  Trismegisto17, 4, 4, 0, yes
69212533,  rossfav, 2, 2, 0, yes
770354017096589312,  JonesViky, 12, 2, 10, no
2306574587,  slash844, 1, 1, 0, yes
4704191856,  barsine78, 1, 1, 0, yes
3157537163,  malcomx64, 4, 4, 0, yes
112227564,  soveritano, 2, 2, 0, yes
74408620,  alex_reds, 1, 1, 0, yes
424888263,  SergioManca2, 1, 1, 0, yes
585409998,  adriano_56, 2, 2, 0, yes
380833512,  SCastelfranco, 1, 1, 0, yes
780019183371378688,  fra_chimica, 13, 13, 0, yes
188478072,  Nadiesdaa, 6, 3, 3, neutral
2318335197,  sofia_valenti01, 1, 1, 0, yes
470289460,  PremiumSportHD, 3, 3, 0, yes
1128641766,  zalex_13, 1, 1, 0, yes
32963395,  bittimalva, 3, 2, 1, yes
465465350,  taniacor86, 3, 2, 1, yes
766462243,  lucma66, 2, 1, 1, neutral
490640451,  AntonioRepossi, 2, 2, 0, yes
542355572,  david_colle, 2, 1, 1, neutral
1600226443,  maxbiagiola62, 1, 1, 0, yes
2961784235,  gioalbarosa, 8, 7, 1, yes
752179418102165505,  inomis93, 1, 1, 0, yes
538353375,  ElisabettaCalma, 1, 1, 0, yes
1639689480,  L_Antifascista, 6, 4, 2, yes
3148054978,  zancanaro_TFA, 1, 1, 0, yes
55560545,  LeaDiLucchio, 1, 1, 0, yes
1497611910,  endlessheo, 1, 1, 0, yes
744596911252967424,  maankhider, 1, 1, 0, yes
417372220,  GianfrancoFrago, 1, 1, 0, yes
597696640,  battistageti, 7, 1, 6, no
939230058,  BARATTIGenfrys, 1, 1, 0, yes
2151216070,  vali962, 1, 1, 0, yes
759129447022862340,  RosarioTrimarc1, 9, 1, 8, no
3081364798,  crigalliera63, 4, 4, 0, yes
957885578,  tribsportblog, 3, 3, 0, yes
1744529785,  annabelmonte50, 2, 2, 0, yes
474021846,  alfredodattorre, 5, 3, 2, yes
434933690,  MrGigi0, 1, 1, 0, yes
615969319,  sebasticulo, 3, 1, 2, no
83354169,  niccolocorsi, 1, 1, 0, yes
313857476,  Hurry93, 1, 1, 0, yes
3303744316,  keitadiogo4, 1, 1, 0, yes
1553222166,  alices_world_, 5, 5, 0, yes
369152286,  PollicinoAndrea, 1, 1, 0, yes
268183904,  sunsetodown, 2, 2, 0, yes
1068927198,  deg_giuseppe, 1, 1, 0, yes
2321398286,  SILVESTRO_74, 1, 1, 0, yes
316465930,  ivandama, 1, 1, 0, yes
412209140,  NicolaGiocondo, 4, 1, 3, no
31394223,  marctoma, 4, 4, 0, yes
781396039836241920,  sunrainbow71, 1, 1, 0, yes
396103010,  folucar, 4, 3, 1, yes
3299546625,  PossibileIt, 83, 1, 82, no
354901534,  valentinaWally, 120, 1, 119, no
2166946698,  floriana_luchar, 3, 1, 2, no
755150423586140161,  anna_zzzK, 1, 1, 0, yes
116417727,  simopieranni, 1, 1, 0, yes
53959394,  ath_alvin, 1, 1, 0, yes
470044773,  Roberta_Moi, 1, 1, 0, yes
126926417,  LcM03, 2, 2, 0, yes
87666553,  AngeloFurno, 1, 1, 0, yes
3083847341,  TittaMeucci, 1, 1, 0, yes
413278857,  innuendisoloio, 2, 2, 0, yes
800712721498968064,  laminoranza, 2, 2, 0, yes
930273956,  matteodona, 1, 1, 0, yes
2211154277,  cribep, 2, 2, 0, yes
365463230,  LuckyLuke865, 2, 2, 0, yes
142175893,  ironbuck, 1, 1, 0, yes
453275298,  magicabionda, 4, 1, 3, no
2791492995,  BFilari, 1, 1, 0, yes
1673816466,  calogerocarlisi, 1, 1, 0, yes
558892344,  silvialovesbook, 3, 3, 0, yes
395242306,  EnricaTonola, 17, 1, 16, no
3064999798,  sempreBerardone, 1, 1, 0, yes
49413521,  elna75it, 4, 4, 0, yes
2148746163,  fanema64, 3, 1, 2, no
17995753,  carloruggeri, 4, 2, 2, neutral
268001006,  francymarchet89, 3, 2, 1, yes
989035658,  MexBertoldi, 1, 1, 0, yes
418732295,  diegoIoMe, 4, 2, 2, neutral
2491960593,  luiserragi, 1, 1, 0, yes
564990448,  silviorossi6, 2, 2, 0, yes
333580051,  NamaNietzs, 1, 1, 0, yes
3438965031,  LombardoGa, 2, 2, 0, yes
618595724,  sHes__dAmaG, 1, 1, 0, yes
1617818378,  VannaRicci, 5, 2, 3, no
292635684,  jorgeluizmaceio, 1, 1, 0, yes
3027478686,  cf6f23bae125403, 9, 5, 4, yes
277409485,  MaxCallegari, 1, 1, 0, yes
3171154306,  sinupsiche, 2, 2, 0, yes
2524013649,  f_nicosia, 1, 1, 0, yes
2281281002,  domenicoformic3, 1, 1, 0, yes
2267206189,  Franeconte, 1, 1, 0, yes
721942034,  NLeonesio, 4, 4, 0, yes
411813423,  Magnacaura, 4, 3, 1, yes
2318264715,  giuliano_gg, 1, 1, 0, yes
2339087055,  fdv28kl04banana, 1, 1, 0, yes
341174683,  gomezmovie, 4, 4, 0, yes
249627047,  gioiamagazine, 1, 1, 0, yes
579652841,  DEANNALUPI1, 1, 1, 0, yes
2292045232,  raffaeledegni1, 1, 1, 0, yes
3309217965,  VanjaStar, 1, 1, 0, yes
252822331,  LiaCeli, 1, 1, 0, yes
802702284127928322,  ununosser1971, 1, 1, 0, yes
636107588,  annarobi, 1, 1, 0, yes
1575383532,  paridev68, 1, 1, 0, yes
398293985,  mgcostanzi, 1, 1, 0, yes
418268844,  MartinaDeBiase, 1, 1, 0, yes
1231087411,  MarcoBaldon, 1, 1, 0, yes
558334886,  TimaMariaLacoba, 1, 1, 0, yes
763315505910480896,  MaoNo1968, 3, 1, 2, no
97247117,  AleriusWave, 1, 1, 0, yes
386722621,  Mangorosso, 2, 2, 0, yes
2359724456,  notizienazional, 1, 1, 0, yes
4877668139,  shareef_haji, 1, 1, 0, yes
3131418863,  ragazzebelleeee, 1, 1, 0, yes
45656128,  jpoli6, 1, 1, 0, yes
714451248,  Sandro_Sartor, 7, 3, 4, no
472245527,  misbabsy, 1, 1, 0, yes
477674400,  ggiacomo2012, 2, 2, 0, yes
869531054,  pi4630, 1, 1, 0, yes
1900726448,  cumberbitch_bc, 1, 1, 0, yes
406307909,  SBarutta, 3, 2, 1, yes
2466205924,  Morfeo2punto0, 1, 1, 0, yes
805870849085599744,  MatteoTivelli, 1, 1, 0, yes
1445687856,  agerolapianillo, 1, 1, 0, yes
951236598,  davidaprea, 1, 1, 0, yes
805878942875914242,  LucaDC1990, 1, 1, 0, yes
2889925119,  maurinacch, 1, 1, 0, yes
260681094,  rublev09, 1, 1, 0, yes
274455749,  Nino_Dellisanti, 1, 1, 0, yes
774200668550758400,  anatroccolo78, 1, 1, 0, yes
358298610,  CeciliaCaciotta, 1, 1, 0, yes
362311743,  ginovecchione, 1, 1, 0, yes
1723175678,  varone9, 1, 1, 0, yes
720323265944805376,  StudioBocci, 1, 1, 0, yes
528609456,  fuckingeway, 1, 1, 0, yes
84802634,  ZioMirko, 1, 1, 0, yes
3002022753,  BulseiVincenzo, 1, 1, 0, yes
521642886,  walterino70, 1, 1, 0, yes
776536852111171584,  piccolamedusa, 1, 1, 0, yes
2447002185,  FilSava, 2, 2, 0, yes
2325863741,  GuadagnoliStefy, 1, 1, 0, yes
3166288060,  FraFcim, 1, 1, 0, yes
1219272445,  periodosabbatic, 1, 1, 0, yes
1620197834,  ValentinaTolu, 3, 3, 0, yes
800761164850335746,  ste2007, 1, 1, 0, yes
2360889808,  pierinapistola, 1, 1, 0, yes
756193521690738689,  Lucrezi03994360, 2, 2, 0, yes
3344651409,  nikymarcelli, 1, 1, 0, yes
1121940008,  Jacopomarzia, 1, 1, 0, yes
506211156,  grazialongo2, 1, 1, 0, yes
970979858,  anna_sorbi, 7, 1, 6, no
544591001,  ilirilibero, 2, 2, 0, yes
1960258021,  BandieraSarda, 1, 1, 0, yes
863720953,  Prevalito, 1, 1, 0, yes
712856090,  renatorpmi, 1, 1, 0, yes
2458741800,  pellifranz, 1, 1, 0, yes
628284261,  And95jds, 1, 1, 0, yes
704604489244872704,  54lucky54, 1, 1, 0, yes
787260047856369664,  l72ve, 1, 1, 0, yes
604610304,  annalisap64, 1, 1, 0, yes
2557983639,  PInsinnamo, 2, 2, 0, yes
3400352884,  NavaMario2, 1, 1, 0, yes
1141083709,  william_flour, 1, 1, 0, yes
205913262,  AntonioCase86, 5, 5, 0, yes
583995439,  antoniodelia7, 1, 1, 0, yes
283951277,  IlCommPorro, 1, 1, 0, yes
416234718,  andreapupo77, 4, 1, 3, no
1148128807,  florenzporn, 1, 1, 0, yes
770135945890918400,  solo_pisa, 1, 1, 0, yes
128091407,  gioman62, 1, 1, 0, yes
115551000,  AlessiaGuetti, 1, 1, 0, yes
110383397,  VoxEuropIT, 1, 1, 0, yes
310586807,  RedGiorgio81, 1, 1, 0, yes
3347078116,  CroftAndres, 2, 1, 1, neutral
3224655875,  Virginia120291, 1, 1, 0, yes
1071954936,  spa50bruno, 1, 1, 0, yes
1124738270,  conti_donatella, 1, 1, 0, yes
3082082087,  CentroStudi_EL, 3, 3, 0, yes
27927840,  StefaniaCarini, 1, 1, 0, yes
435666047,  mcastellani63, 1, 1, 0, yes
1371577741,  setto60, 1, 1, 0, yes
805847808007897089,  gfontani60, 1, 1, 0, yes
1215290216,  alexrocca87, 3, 2, 1, yes
3944546739,  ale8119890809, 2, 1, 1, neutral
48429147,  RobRiccardi, 1, 1, 0, yes
232231711,  clagres, 7, 1, 6, no
58410888,  nicolapardini, 1, 1, 0, yes
627471730,  polpettaz, 1, 1, 0, yes
783770526422560768,  severautentica, 2, 1, 1, neutral
1691470298,  f_lisi82, 1, 1, 0, yes
2199775793,  m_offredi, 1, 1, 0, yes
712789559478771712,  Esperance253, 1, 1, 0, yes
2979620307,  RichardHilton15, 1, 1, 0, yes
2715294569,  nonnaanna56, 1, 1, 0, yes
1454710987,  EBeorchia, 3, 3, 0, yes
75108301,  giofo, 2, 2, 0, yes
798581099375063042,  gioztresoldi, 4, 4, 0, yes
1202167712,  biciofab, 1, 1, 0, yes
355756492,  DonatoJames, 2, 1, 1, neutral
891372180,  snoopy_le86, 1, 1, 0, yes
3363886649,  silviamatt64, 1, 1, 0, yes
1699438579,  ga_silvestro, 2, 2, 0, yes
1957310936,  amarosilano, 1, 1, 0, yes
475341997,  ANDREAXCIANFONI, 1, 1, 0, yes
3085790838,  AvvMassarelli, 1, 1, 0, yes
2879245853,  lazzareschil, 1, 1, 0, yes
3256292296,  Angela80566351, 1, 1, 0, yes
476908940,  LauraDelSindaco, 1, 1, 0, yes
2981409279,  gori_sg, 1, 1, 0, yes
292322279,  dariadamato, 2, 2, 0, yes
3020571723,  AlaMark0ne, 4, 4, 0, yes
979165633,  soniavillazzi, 1, 1, 0, yes
3979802177,  indianlan52, 1, 1, 0, yes
1331487049,  SimonaF69, 1, 1, 0, yes
486746374,  simonegiardini1, 1, 1, 0, yes
2479844721,  mario_schembri, 1, 1, 0, yes
925807837,  MatteoMontarsol, 1, 1, 0, yes
2946540694,  Andres7u7rr, 1, 1, 0, yes
2656610021,  antonio44930134, 1, 1, 0, yes
89924333,  SilviaBerti, 1, 1, 0, yes
2301660026,  luigiparrilla96, 1, 1, 0, yes
242695768,  Zhronne, 1, 1, 0, yes
4865347498,  guidotidu, 1, 1, 0, yes
800485850299518976,  brozsilvi, 2, 2, 0, yes
1294595622,  Clauluss, 1, 1, 0, yes
2798468264,  Roxie_Van_Haver, 1, 1, 0, yes
800093575119650816,  klopos6, 3, 2, 1, yes
4753970247,  theo__94, 1, 1, 0, yes
3357327369,  marcofavaro14, 1, 1, 0, yes
2176071284,  eigenLab_Pisa, 1, 1, 0, yes
3389162981,  francomerlin8, 1, 1, 0, yes
739912741159374849,  CuccittoMatteo, 1, 1, 0, yes
1092822224,  bluejnside, 1, 1, 0, yes
39725567,  fabio4986, 1, 1, 0, yes
483785931,  GiulioMazzone, 1, 1, 0, yes
600280702,  rizzello700, 2, 1, 1, neutral
345579983,  havavtid, 1, 1, 0, yes
37460935,  wannabefre, 1, 1, 0, yes
1189770253,  cscarbolo, 1, 1, 0, yes
37409125,  scentedmayrose, 1, 1, 0, yes
478528950,  pitmun, 1, 1, 0, yes
2238342178,  e_scuderi, 1, 1, 0, yes
1047222750,  idpuglia, 1, 1, 0, yes
419826123,  rosamancini2, 5, 5, 0, yes
506007311,  Nick_IlPianista, 1, 1, 0, yes
805697444935823360,  CeccoAngiolier3, 1, 1, 0, yes
489566215,  sjcalvia, 1, 1, 0, yes
1686021440,  eccomamma, 1, 1, 0, yes
1044894660,  silvioacrigmail, 1, 1, 0, yes
2541739757,  chthonic_bear, 3, 3, 0, yes
4704683634,  atinamarinkovi1, 1, 1, 0, yes
480255676,  vincenzamignogn, 1, 1, 0, yes
617481847,  CristianDebuggi, 1, 1, 0, yes
951842702,  Vincenzoiena699, 5, 2, 3, no
1057388839,  ValentinaFred, 2, 1, 1, neutral
2360519002,  dst_ping, 3, 3, 0, yes
3303075142,  LipuCasamassima, 1, 1, 0, yes
1101448555,  vivodijuventus, 3, 3, 0, yes
196828527,  LuigiGagliardo, 1, 1, 0, yes
732146583198928897,  mammapapaebimbi, 2, 2, 0, yes
1632593443,  malafemmina54, 5, 3, 2, yes
796446786491535360,  ALI93694092, 1, 1, 0, yes
3176625754,  OrizOrizzonte, 7, 1, 6, no
2356251718,  LaraAmmendola, 24, 2, 22, no
430942269,  MMoscadelli, 1, 1, 0, yes
736212458046672897,  niccolai_maria, 1, 1, 0, yes
803775139968155648,  layw44, 1, 1, 0, yes
1108512408,  ingcolaninno, 1, 1, 0, yes
2393193913,  Martolina20, 10, 8, 2, yes
453987138,  TonyFiloni, 2, 2, 0, yes
3205764814,  Dott_Verri, 2, 2, 0, yes
354314814,  grossivan, 6, 1, 5, no
451599437,  graziacalore, 1, 1, 0, yes
506295828,  AntonioliDavide, 2, 2, 0, yes
609984521,  _FreeAndWild_, 7, 1, 6, no
2175763696,  GattaMarina, 3, 2, 1, yes
1267565059,  foresta_12, 1, 1, 0, yes
1227261115,  sararosati54, 4, 4, 0, yes
4558098045,  BalucaniMichela, 1, 1, 0, yes
822160142,  Tiziana_1967, 1, 1, 0, yes
480390700,  cantamiodiva, 6, 2, 4, no
2870908289,  GiorgioTondelli, 2, 1, 1, neutral
1697045809,  MarcoPotenza74, 2, 1, 1, neutral
986286079,  raggi_ottavio, 4, 4, 0, yes
3173902931,  DanielaCantele, 1, 1, 0, yes
291678033,  MaranAlessandro, 2, 2, 0, yes
261434292,  nerinamonti, 1, 1, 0, yes
402615571,  Riniello, 2, 1, 1, neutral
529370123,  massicampa3, 2, 2, 0, yes
100513310,  pustetto, 1, 1, 0, yes
4480669287,  DomyPk88, 2, 2, 0, yes
729393976638361600,  Cirotheowl, 1, 1, 0, yes
3631230436,  gabser17, 4, 2, 2, neutral
3058264727,  rspinazze, 1, 1, 0, yes
1045612615,  cbergamo1, 1, 1, 0, yes
2996487070,  gbiagi68, 1, 1, 0, yes
396104852,  Ricochet6It, 1, 1, 0, yes
3058567588,  carlo_curatola, 1, 1, 0, yes
904598748,  IreneMossa, 2, 1, 1, neutral
801134817836494852,  shamira2899, 1, 1, 0, yes
1273333058,  matteo_pucciani, 1, 1, 0, yes
147343659,  Petartrzz, 2, 2, 0, yes
146752258,  ruGiadaB, 5, 5, 0, yes
848211463,  CrisCometto, 2, 2, 0, yes
281904941,  arcamasilum, 4, 3, 1, yes
300482298,  thagnus, 2, 1, 1, neutral
725986621,  GuGuero64, 4, 2, 2, neutral
3007884394,  Franztrane, 1, 1, 0, yes
2391625197,  a0d4c1cd150440c, 1, 1, 0, yes
1366999759,  gagomalu, 2, 1, 1, neutral
711204723110645760,  MaggioGirolamo, 1, 1, 0, yes
1205378384,  robdalterio, 1, 1, 0, yes
3005896461,  MorolMo, 3, 2, 1, yes
608259202,  TommasoSacchi, 2, 2, 0, yes
1251907262,  a_sciammarella, 1, 1, 0, yes
410623684,  mairatira, 2, 1, 1, neutral
789049794773782532,  CancianD, 1, 1, 0, yes
2220471884,  27aculnaiG, 1, 1, 0, yes
2243950814,  carlo_kappa06, 4, 3, 1, yes
2742769243,  DanizaVoice, 2, 2, 0, yes
490251054,  PietroRun73, 1, 1, 0, yes
336454510,  NicolA5674, 1, 1, 0, yes
2288167912,  ssalerno2, 1, 1, 0, yes
743942725,  PaoloCornetti14, 1, 1, 0, yes
24504702,  rafbarberio, 4, 3, 1, yes
1040251363,  gottardistefano, 1, 1, 0, yes
500588099,  SergioDiGiorgi, 1, 1, 0, yes
3656005667,  TosiniPietro, 5, 1, 4, no
1240103790,  RadicchioAnarco, 2, 1, 1, neutral
2780496731,  _laundress, 1, 1, 0, yes
222930863,  antil105, 1, 1, 0, yes
131989358,  MarioDiLella, 1, 1, 0, yes
2798825609,  paolo_mira62, 1, 1, 0, yes
2909426781,  Willycat72Wit, 3, 2, 1, yes
2805323313,  gilardisil, 3, 3, 0, yes
732141236178587648,  waltertwin, 6, 2, 4, no
1052983992,  78Patelli, 3, 1, 2, no
2332688475,  gaaa1972, 1, 1, 0, yes
716001283824553984,  DOT_creations, 1, 1, 0, yes
4695025663,  Off0800, 1, 1, 0, yes
3892037295,  volcano_ice, 1, 1, 0, yes
3937355595,  Mart_In_Art, 1, 1, 0, yes
4830939586,  ilboiadeltweet, 1, 1, 0, yes
4794810907,  politicainmente, 1, 1, 0, yes
4857502355,  AlfredoCopriti, 1, 1, 0, yes
3299318579,  ImperaTweet, 1, 1, 0, yes
582293703,  rebuffoni_m, 2, 1, 1, neutral
2283356738,  Walter_Sobchak1, 1, 1, 0, yes
2503757771,  FrancescaRescig, 1, 1, 0, yes
619452377,  AndreaMenditto, 1, 1, 0, yes
761880624,  delliq53, 1, 1, 0, yes
770905842,  PaoloMostarda, 5, 2, 3, no
86990596,  pierdistolfo, 1, 1, 0, yes
1369607550,  lanfrancofanti, 1, 1, 0, yes
235955744,  yoghi1954, 4, 4, 0, yes
573081544,  SFrancio63, 10, 4, 6, no
3026923119,  cuore_sicilia, 1, 1, 0, yes
422105608,  longobarda1994, 1, 1, 0, yes
591459578,  lalitapetila, 4, 2, 2, neutral
15387167,  elihh3, 6, 1, 5, no
1178553782,  pompeo_volpe, 1, 1, 0, yes
2373209560,  UtoTesoro, 2, 1, 1, neutral
763817012506267648,  BA_Currenti, 4, 3, 1, yes
311111844,  RickDuFer, 1, 1, 0, yes
50591969,  lguglielmelli, 2, 2, 0, yes
4288865781,  JimmySbarbos, 1, 1, 0, yes
2368854600,  acuria2, 3, 2, 1, yes
732700977548152832,  SimoneCastaldi2, 1, 1, 0, yes
2870669794,  fabdomi, 9, 2, 7, no
104947644,  AlessandroMar, 2, 1, 1, neutral
3741476776,  LeRiformeDelWC, 2, 2, 0, yes
675873,  strelnik, 1, 1, 0, yes
103571438,  StefanoVento, 2, 1, 1, neutral
4140460517,  marigro63, 8, 8, 0, yes
4892655609,  ikigaigriernina, 1, 1, 0, yes
770334421782294528,  rossellabarbuz1, 3, 3, 0, yes
1040920220,  GianlucaPuntara, 7, 3, 4, no
3386751879,  Vincenz58270691, 2, 1, 1, neutral
2307171263,  salgiupom, 1, 1, 0, yes
744263355536392192,  arch_cmag, 5, 1, 4, no
3331127301,  ilpiccologiulio, 1, 1, 0, yes
788879371,  938103Massimo, 3, 1, 2, no
2219308648,  tcarapezza, 1, 1, 0, yes
791329531604926464,  ShihabMerza, 1, 1, 0, yes
725400013145251841,  TallaTizy, 1, 1, 0, yes
1492703724,  cattivik3000, 3, 2, 1, yes
172472233,  ariele47, 2, 2, 0, yes
745207130207170560,  RobertoLocate14, 3, 3, 0, yes
6615742,  benedettap, 1, 1, 0, yes
2353139883,  ACampanacci, 2, 1, 1, neutral
459169636,  ErikPayrings, 1, 1, 0, yes
982946526,  Dedesoloio, 1, 1, 0, yes
474785811,  tetotwit, 1, 1, 0, yes
4414197460,  mvfabbri1, 1, 1, 0, yes
36521177,  clalav, 1, 1, 0, yes
289423217,  pierotavella, 2, 2, 0, yes
3138084547,  InAnalisi, 1, 1, 0, yes
72132769,  gpoko, 4, 1, 3, no
1073356891,  CFioritoromano, 1, 1, 0, yes
470404668,  nadjacari, 2, 1, 1, neutral
858519895,  carolinabrai, 4, 4, 0, yes
3654961996,  RM_II_Possibile, 17, 2, 15, no
430330483,  DonatellaRu, 6, 6, 0, yes
3917795416,  CodigoroM5S, 2, 1, 1, neutral
784099537015173120,  _Administrator, 4, 4, 0, yes
74056173,  PaolettaSusino, 1, 1, 0, yes
1043267442,  GMarmurin, 5, 5, 0, yes
2755165522,  enzomaggio43, 1, 1, 0, yes
428360297,  mrtrecca_ros, 1, 1, 0, yes
1702836590,  FabrizioGussoni, 1, 1, 0, yes
433293009,  eziof1978, 165, 1, 164, no
407299582,  federicosarica, 1, 1, 0, yes
147290527,  marcoborderline, 1, 1, 0, yes
2359620656,  federicaolivar2, 1, 1, 0, yes
406458723,  PaoloZanghieri, 1, 1, 0, yes
2542536177,  AnninaPugliese, 1, 1, 0, yes
423363055,  GrAntforGenDe, 2, 1, 1, neutral
30864775,  rudylegh, 4, 4, 0, yes
4906280991,  bricologo, 7, 1, 6, no
3319061722,  Emidiova, 2, 1, 1, neutral
2343732192,  In_Vogue_Hair, 1, 1, 0, yes
872458585,  LucaLucentini2, 2, 1, 1, neutral
223288666,  laviniabruno, 2, 1, 1, neutral
978759398,  StefanoBallador, 1, 1, 0, yes
239450599,  paol_oliva, 2, 2, 0, yes
2163884867,  jajah_dg, 1, 1, 0, yes
2222239096,  CareCareantonio, 1, 1, 0, yes
613199311,  RuggieroSorman, 4, 3, 1, yes
947323542,  andrea_pagliai, 1, 1, 0, yes
1106912257,  ChantalTauxe, 2, 2, 0, yes
3435593188,  cnxjeeko, 7, 7, 0, yes
848045168,  AbitareFuturo, 7, 2, 5, no
231764379,  Bercla89, 1, 1, 0, yes
3297018105,  patrizia_posa, 3, 3, 0, yes
2181881732,  DCrognaletti, 1, 1, 0, yes
852687006,  Kottomano, 6, 2, 4, no
799286310699732992,  mara_car_fregna, 1, 1, 0, yes
2756338107,  CribioriG, 5, 5, 0, yes
1364974724,  empower_news, 1, 1, 0, yes
1699794571,  lostvoice75, 1, 1, 0, yes
473835738,  gennaromontana, 1, 1, 0, yes
3086955695,  luposilenzioso2, 2, 2, 0, yes
204326997,  oscar73music, 1, 1, 0, yes
452492397,  antop131, 1, 1, 0, yes
559760544,  toninopetrolo, 3, 2, 1, yes
2205756240,  leofelsineo, 2, 2, 0, yes
80609539,  quisques, 1, 1, 0, yes
415063465,  CalebVerlaine, 2, 2, 0, yes
993717145,  BraveHeart1961, 2, 2, 0, yes
1591608794,  eccosilvia, 1, 1, 0, yes
51006810,  diegob6, 3, 2, 1, yes
1111703173,  Gala_dr, 1, 1, 0, yes
381990313,  pucci_enrico, 1, 1, 0, yes
123228803,  monjkat, 1, 1, 0, yes
30732023,  eretico80, 1, 1, 0, yes
1250188950,  micheledibened8, 5, 2, 3, no
422492503,  ernestoroveda, 2, 2, 0, yes
2916948582,  lupo2214, 3, 3, 0, yes
594515731,  PalmiroAntonio, 2, 1, 1, neutral
706811280783491072,  DonnaCarmencita, 1, 1, 0, yes
510676186,  gregbucc, 2, 2, 0, yes
1172836957,  Nifa196, 1, 1, 0, yes
2408728471,  elena57327263, 2, 2, 0, yes
1719334183,  michaelbecher73, 1, 1, 0, yes
391390276,  BelloniMarco, 1, 1, 0, yes
493435272,  NiceToMatthew, 1, 1, 0, yes
747918158783201280,  MediasetTg5, 1, 1, 0, yes
1060395978,  GiambruniEmilio, 1, 1, 0, yes
2965497142,  LooisYT, 1, 1, 0, yes
420629399,  efilieri, 3, 3, 0, yes
11514672,  azulette, 4, 4, 0, yes
712357206465900545,  lunapienah, 1, 1, 0, yes
431918114,  68Anastasia, 1, 1, 0, yes
2811560459,  MauroFrassetto, 2, 2, 0, yes
1013431926,  bettinazagnoli, 3, 2, 1, yes
3954502719,  AlessioTHEnurse, 7, 2, 5, no
417183811,  CallMePollyanne, 1, 1, 0, yes
3105612117,  mariocasanova55, 1, 1, 0, yes
2183696980,  DavideFavi, 1, 1, 0, yes
392291910,  KotetsuJeegu, 3, 3, 0, yes
79279200,  Il_nulla, 4, 3, 1, yes
1065851646,  gdg_di, 5, 1, 4, no
98582591,  istarnini, 1, 1, 0, yes
3120753935,  RobertaRobertam, 2, 2, 0, yes
475345967,  CarboniArianna, 1, 1, 0, yes
319921345,  Ppr_11, 1, 1, 0, yes
187618634,  Beran50, 1, 1, 0, yes
398838520,  NJacksoniani, 3, 3, 0, yes
1387242434,  StefaniaChiale, 1, 1, 0, yes
2850961923,  salvodeb, 2, 2, 0, yes
389078155,  pierreporterr, 1, 1, 0, yes
178099622,  natanever, 1, 1, 0, yes
96313584,  cinnamologus, 2, 2, 0, yes
3309071817,  ManifBologna, 3, 3, 0, yes
323449293,  anpisarzana, 38, 3, 35, no
730462806085124096,  PecoraNera7, 2, 1, 1, neutral
407937988,  ItaloItaliano, 1, 1, 0, yes
49738224,  flatguy, 1, 1, 0, yes
734163322950582276,  ClaudioDegl, 2, 2, 0, yes
2733559859,  margiotta982, 4, 4, 0, yes
717736236,  TommasoFef, 1, 1, 0, yes
392589513,  AlessandraChia4, 2, 2, 0, yes
339100583,  krugerossi, 3, 3, 0, yes
583037362,  miri_balla, 1, 1, 0, yes
159886194,  marcomazzo, 1, 1, 0, yes
63121576,  Ice_Black, 2, 1, 1, neutral
1648974740,  Padre_Thierry, 2, 2, 0, yes
289591229,  juan_malgarini, 1, 1, 0, yes
804468945646485504,  massimogatto10, 1, 1, 0, yes
76369192,  UAAR_it, 1, 1, 0, yes
914617058,  G_Sessini, 2, 2, 0, yes
425984385,  Stefano_Bellei, 1, 1, 0, yes
468547129,  chiarasa14, 1, 1, 0, yes
253105663,  Topin057, 1, 1, 0, yes
3960600436,  Spatryx1, 1, 1, 0, yes
1048960076,  MariaFidei, 1, 1, 0, yes
430741049,  MassimoFaggioli, 2, 2, 0, yes
41221907,  opge, 1, 1, 0, yes
800360111898120192,  annacilione78, 1, 1, 0, yes
594423854,  ValeriaTomei75, 1, 1, 0, yes
3807059417,  Annamaribel4, 1, 1, 0, yes
475896735,  Fujiko_3, 1, 1, 0, yes
3366574198,  mp_piani, 1, 1, 0, yes
2472775153,  ALBACELANO, 6, 1, 5, no
726032256033284097,  nafnlauskappi, 2, 2, 0, yes
1868610571,  zaynspeluche, 1, 1, 0, yes
3163801167,  Lulli85650363, 1, 1, 0, yes
144973391,  Moltapazienza4, 1, 1, 0, yes
12790742,  sudsoundsystem, 1, 1, 0, yes
1583362254,  ivanter59, 1, 1, 0, yes
608149538,  AgostinoTuzzoli, 5, 1, 4, no
720957107437236224,  Ferdy_Marion, 1, 1, 0, yes
707554040,  alemassimo00, 2, 2, 0, yes
3035175808,  AL_Libera, 1, 1, 0, yes
795195231973085184,  10h100, 1, 1, 0, yes
293373251,  PaolaGigante62, 1, 1, 0, yes
134903944,  baglionisilvia, 1, 1, 0, yes
271370041,  Paolo_Amodeo, 1, 1, 0, yes
237969830,  gmeloni49, 3, 2, 1, yes
474298037,  SottiliL, 5, 3, 2, yes
47070346,  CalcioNews24, 1, 1, 0, yes
59450233,  ClaudioFatti, 1, 1, 0, yes
450517687,  maf6372, 11, 1, 10, no
757117740859658241,  ZisakisShalon, 1, 1, 0, yes
803022558316687361,  vogvaatealuove, 1, 1, 0, yes
756942850160459778,  RomaCalahan, 1, 1, 0, yes
756933997675044864,  delmy_geisler, 1, 1, 0, yes
756980348387557376,  tayna_mayo, 1, 1, 0, yes
756381235623198720,  deloiswolf1793, 1, 1, 0, yes
756972726011723776,  TestparizKathey, 1, 1, 0, yes
756985873556709376,  SchotzRosalyn, 1, 1, 0, yes
756971240347271168,  tammeraphelps12, 1, 1, 0, yes
803022398048104452,  sdaidlbabaev, 1, 1, 0, yes
757121454492250112,  maribel_flener, 1, 1, 0, yes
756950795854221313,  antoine_molly, 1, 1, 0, yes
756946317222486016,  lauryn_isaj, 1, 1, 0, yes
803022612251213824,  veleiburjeinck, 1, 1, 0, yes
756978675602558976,  doremus_mertie, 1, 1, 0, yes
756966592651591680,  BrigidAkimoto, 1, 1, 0, yes
757005097935273985,  lynettaschonbe2, 1, 1, 0, yes
803022704202973184,  nahdiakireeva, 1, 1, 0, yes
757116190821056512,  JamilaSchulz, 1, 1, 0, yes
756983014358384640,  WynellKirkwood, 1, 1, 0, yes
760371582338498560,  tericagalloway2, 1, 1, 0, yes
757189230342840320,  ThiSanderlin, 1, 1, 0, yes
756991026062131200,  LetitiaGastine, 1, 1, 0, yes
756938643231674368,  janeankeller221, 1, 1, 0, yes
757125143894327296,  myungmalone1995, 1, 1, 0, yes
757264840872329216,  LeeMinhlee1025, 1, 1, 0, yes
757359905602990081,  pujol_man, 1, 1, 0, yes
756983260274720769,  hettiemiller172, 1, 1, 0, yes
769509145863155712,  HawsekAlissa, 1, 1, 0, yes
756970233089429504,  anastasiatsaka3, 1, 1, 0, yes
756975575085047810,  blancajacobs511, 1, 1, 0, yes
757334450439094272,  DremaDadayan, 1, 1, 0, yes
757226241305014280,  CreesArminda, 1, 1, 0, yes
756928194108858368,  carola_coppage, 1, 1, 0, yes
756976695236845569,  PiedadDasci, 1, 1, 0, yes
756350319815196672,  nadjasagkob819, 1, 1, 0, yes
757251614851883009,  Franck1787, 1, 1, 0, yes
756973722066624514,  PatriceBisher, 1, 1, 0, yes
757325210345431041,  myrlcampbell282, 1, 1, 0, yes
756976733417537537,  bachelder_yee, 1, 1, 0, yes
764481961993834496,  johnniescott281, 1, 1, 0, yes
757450560350068736,  EthaDardis, 1, 1, 0, yes
757155688971894784,  barbaramurawsk1, 1, 1, 0, yes
756999416695889920,  MonetLandman, 1, 1, 0, yes
756965974465740800,  LeopardAlvina, 1, 1, 0, yes
756389695337234433,  DelmyChelnick, 1, 1, 0, yes
782278656622202881,  IiiTitan, 1, 1, 0, yes
757439795316621312,  audriabrown2691, 1, 1, 0, yes
781059922624675841,  Ancient_Pearlyc, 1, 1, 0, yes
757137586238459904,  rosettekermpat2, 1, 1, 0, yes
803022726768300032,  dbniwevdniwe, 1, 1, 0, yes
757119692884574209,  kasireyes26961, 1, 1, 0, yes
756938852363825152,  SprenkelRebecka, 1, 1, 0, yes
757425893677625344,  Aftonfay2718Fay, 1, 1, 0, yes
779838747777069056,  AyakoBell6, 1, 1, 0, yes
771685541259669504,  harold_shirely, 1, 1, 0, yes
757238995936014338,  freitag_peggie, 1, 1, 0, yes
756974538613727232,  MalloryAngerame, 1, 1, 0, yes
757432619659395073,  geraldinesingh6, 1, 1, 0, yes
756979603193860097,  ParmentierMarni, 1, 1, 0, yes
756975787572621312,  MavisHeissat, 1, 1, 0, yes
4794361,  robertobasso, 6, 6, 0, yes
4853174859,  AndreasDefconi, 1, 1, 0, yes
2334501166,  zorzi46, 5, 2, 3, no
3053010231,  e2d574ba3b9940f, 2, 2, 0, yes
4244953881,  Socialdem_SeD, 2, 2, 0, yes
993110552,  petrettoanto, 5, 2, 3, no
907801874,  pinopitto, 2, 2, 0, yes
392520781,  RBincoletto, 1, 1, 0, yes
514302859,  CherubinaRavasi, 1, 1, 0, yes
199231147,  elfosognatore, 1, 1, 0, yes
470215764,  sergiomarelli1, 2, 2, 0, yes
2740806982,  giuseppedona43, 4, 2, 2, neutral
303248552,  diegobonsignore, 1, 1, 0, yes
2778860314,  OrfeoGiovanna, 2, 2, 0, yes
783110,  maxkava, 1, 1, 0, yes
2300095525,  nicolacarico82, 6, 6, 0, yes
620185318,  Makamakonza, 2, 2, 0, yes
74731429,  iltirreno, 1, 1, 0, yes
483693163,  patriziafanelli, 6, 5, 1, yes
520339913,  EugeniaDiMicoli, 1, 1, 0, yes
3258049857,  mikymessina9, 1, 1, 0, yes
2943039238,  lilianabarone65, 1, 1, 0, yes
618444797,  LucaCameliPhoto, 1, 1, 0, yes
1029202296,  simodaros, 1, 1, 0, yes
128336315,  fabiopanicco, 6, 4, 2, yes
625712362,  CaressaGiovanni, 3, 3, 0, yes
1569513372,  RamoloG, 10, 2, 8, no
100226575,  blablacarIT, 1, 1, 0, yes
1392964417,  TgValleSusa, 2, 1, 1, neutral
4722153981,  4asso68, 1, 1, 0, yes
2297030603,  SteTerraneo68, 1, 1, 0, yes
195080671,  68ttino, 1, 1, 0, yes
952494133,  GabriellaGullac, 3, 2, 1, yes
19190645,  joshjmac, 2, 2, 0, yes
1120362086,  lorettere, 3, 3, 0, yes
1132188114,  danielaba28, 6, 2, 4, no
366072261,  TWdiMagda, 2, 2, 0, yes
851112127,  Melaion, 3, 2, 1, yes
70388928,  claudioriccio, 2, 1, 1, neutral
599299632,  valerio_cuccuru, 2, 1, 1, neutral
973428055,  eccomiqua1947, 1, 1, 0, yes
488775925,  davidepallanza, 1, 1, 0, yes
1543229070,  BstefanoG1971, 1, 1, 0, yes
17546069,  juanmjm, 4, 1, 3, no
2696440358,  SuperRubyTurrin, 1, 1, 0, yes
2179543892,  annamaria_cavor, 5, 5, 0, yes
925670605,  TCerusici, 2, 1, 1, neutral
253571297,  byzio66, 8, 5, 3, yes
478561355,  antonietta_db, 6, 1, 5, no
525146253,  patriziozurru1, 1, 1, 0, yes
789627405862313984,  vinilste, 1, 1, 0, yes
2860912264,  malandrino103, 1, 1, 0, yes
189834862,  delfino33_, 2, 2, 0, yes
2564653627,  CavutoFranco, 1, 1, 0, yes
533142566,  PaoloDAddario1, 1, 1, 0, yes
2587463268,  BRATTOLIFRANCES, 2, 2, 0, yes
2168141512,  taniagiordano55, 1, 1, 0, yes
429309195,  AndreaSemeraro1, 1, 1, 0, yes
708289018233036800,  ilariacanale951, 1, 1, 0, yes
635489390,  GiuseppeOcchin1, 1, 1, 0, yes
786700629053956098,  VitoChiumarulo5, 1, 1, 0, yes
2159876935,  ElioFerrari3, 1, 1, 0, yes
186388441,  Salvow, 1, 1, 0, yes
53060367,  Aryanna75, 1, 1, 0, yes
3882042485,  gianni14953, 4, 3, 1, yes
2211358579,  AliceAdele27, 5, 1, 4, no
2730607625,  giandolaera, 2, 1, 1, neutral
518382315,  andreazizola, 1, 1, 0, yes
803062046300471296,  chessreketblee1, 1, 1, 0, yes
2870829545,  Alexander88FdI, 1, 1, 0, yes
308503116,  montalvo_elena, 5, 5, 0, yes
1408457424,  MarinoArch, 3, 2, 1, yes
203969960,  cinquewit, 1, 1, 0, yes
2882933625,  saccy1985, 1, 1, 0, yes
477569509,  RiamKyrie, 1, 1, 0, yes
474997578,  Mirek86Mirko, 1, 1, 0, yes
1188924241,  supraXV, 1, 1, 0, yes
1630764446,  sandraloi2, 1, 1, 0, yes
2826337760,  occhio_d, 3, 3, 0, yes
340300921,  GMPbike, 4, 1, 3, no
3921991101,  andreacico74, 1, 1, 0, yes
390273635,  martmagorium, 4, 1, 3, no
1619961732,  peppinozola, 3, 1, 2, no
2380463039,  cris_tian76, 2, 1, 1, neutral
577186447,  ViscidoB, 1, 1, 0, yes
790258096421699584,  caiazzopegaso, 5, 5, 0, yes
2644561737,  Club_Marche, 4, 2, 2, neutral
791392103876202496,  ReporterSette, 11, 2, 9, no
4289441715,  GiorlaPatrizia, 1, 1, 0, yes
216714835,  alebruschi88, 2, 1, 1, neutral
1165420249,  iirpo, 1, 1, 0, yes
614576849,  fabiorusso1969, 1, 1, 0, yes
999361422,  Fedecruzar, 2, 1, 1, neutral
2232688633,  X_Maurizio_X, 3, 1, 2, no
2382294142,  mimma900, 3, 2, 1, yes
1409902837,  andre82tv, 2, 1, 1, neutral
452461228,  Antho_G, 1, 1, 0, yes
2416029024,  mari82xox, 7, 3, 4, no
2390989461,  BelcastroSalv, 3, 1, 2, no
1477088898,  Rossella_71, 1, 1, 0, yes
91853857,  diblar, 1, 1, 0, yes
3293435050,  FragniP, 2, 1, 1, neutral
775670407806476289,  ValentinaOstuni, 5, 5, 0, yes
373977897,  FedeAlbars, 1, 1, 0, yes
77973889,  caterita2008, 3, 3, 0, yes
3063894915,  RbBenzi, 1, 1, 0, yes
2234585143,  Ramiciano_, 5, 3, 2, yes
4752003921,  luciano73579557, 1, 1, 0, yes
230700318,  max68b, 1, 1, 0, yes
2644650894,  gse_gisi, 1, 1, 0, yes
784042481411317760,  SOLO_laserie, 1, 1, 0, yes
2800030661,  Rosa2000blue, 1, 1, 0, yes
503749592,  agneseami, 1, 1, 0, yes
1362080809,  GiorgiodiPaoli, 1, 1, 0, yes
1398976080,  perrone_d, 1, 1, 0, yes
328515345,  nonstop9981, 3, 2, 1, yes
720605283647668225,  SurveyorAnthony, 1, 1, 0, yes
263709226,  Virgola1973, 2, 1, 1, neutral
221044706,  AttilioAscani, 1, 1, 0, yes
4437553281,  umpierdue, 1, 1, 0, yes
46649886,  RiccardoGatti, 1, 1, 0, yes
291946879,  AliffiMattia, 1, 1, 0, yes
421294544,  ValentinaPetrin, 2, 2, 0, yes
28810099,  Hooting_Viv, 1, 1, 0, yes
2391937017,  spagliardis, 1, 1, 0, yes
3241021119,  SSpinaci, 1, 1, 0, yes
4503725746,  mediaset_tv, 4, 4, 0, yes
541596083,  Val_Fus, 5, 2, 3, no
4209391403,  corrierelbano, 1, 1, 0, yes
1336605439,  ale_petraglia, 3, 1, 2, no
4919187328,  salviamoricerca, 1, 1, 0, yes
4009126457,  antonella_lama, 1, 1, 0, yes
500135236,  AMontagnoli, 2, 1, 1, neutral
801885035938856963,  panruweldkat191, 1, 1, 0, yes
710265162834583552,  movcalabriasol, 10, 10, 0, yes
195919440,  Jaaak87, 1, 1, 0, yes
1972148822,  brazof666, 1, 1, 0, yes
396837476,  AlbertoFava, 2, 2, 0, yes
3772514367,  voglioridereio, 1, 1, 0, yes
234062729,  CH4RLI3BR0WN, 3, 3, 0, yes
4918698611,  michy2103, 4, 2, 2, neutral
1001320028,  baghyvr, 1, 1, 0, yes
2782963885,  francescoliva86, 1, 1, 0, yes
2971663036,  ibrahimhasso, 1, 1, 0, yes
92956054,  gspartano, 6, 2, 4, no
184799522,  aries13474, 1, 1, 0, yes
1608842990,  ugo610, 1, 1, 0, yes
785299243,  g_valentino80, 4, 4, 0, yes
456808654,  meurichard, 1, 1, 0, yes
1338839544,  FratelliRoma, 1, 1, 0, yes
957427112,  iostoconGiorgia, 1, 1, 0, yes
2970558815,  Ele_Ciarloni, 1, 1, 0, yes
1338703794,  SpartacusGladia, 1, 1, 0, yes
702623157518209024,  barbaretta_70, 10, 10, 0, yes
260395463,  marcoslkbenz, 1, 1, 0, yes
313967125,  danielamaratea, 4, 4, 0, yes
2391090577,  VaniaDelli, 4, 3, 1, yes
2164735560,  maravillalucio, 2, 1, 1, neutral
429868696,  CarmineQuercia, 4, 4, 0, yes
150774026,  infomarino, 1, 1, 0, yes
4244347072,  valezunin, 1, 1, 0, yes
351152857,  LivDm78, 1, 1, 0, yes
4839750759,  CiAnDy3, 3, 2, 1, yes
2173072229,  DoctorWho744, 2, 1, 1, neutral
2863467911,  174b821af9c5429, 1, 1, 0, yes
3166024623,  RipPatente, 1, 1, 0, yes
3479848695,  semedialbicocco, 1, 1, 0, yes
3548665523,  aaaprof, 1, 1, 0, yes
3585739636,  losportarolo, 1, 1, 0, yes
1129041192,  oiram49, 1, 1, 0, yes
418088381,  konigleo, 1, 1, 0, yes
2810341186,  TutelaVittimeFG, 1, 1, 0, yes
719782999844368384,  ADeLuca_SlcCgil, 1, 1, 0, yes
113965549,  milosuxx, 1, 1, 0, yes
390272710,  nctrng, 1, 1, 0, yes
413756995,  Lizzievongatto, 1, 1, 0, yes
940548559,  TheLadmx, 1, 1, 0, yes
703644697902911489,  GargaDani, 1, 1, 0, yes
535856364,  LeopoldoVarasi, 1, 1, 0, yes
2371187152,  AngeloPersiani, 1, 1, 0, yes
3202558180,  davsilve, 1, 1, 0, yes
605268008,  TereGop, 1, 1, 0, yes
749581630348591104,  renni1968, 1, 1, 0, yes
1244567756,  zeaaresta, 2, 1, 1, neutral
2352880366,  Giuloiacono, 2, 1, 1, neutral
220799803,  CesareLavia, 2, 1, 1, neutral
2847253456,  MauroBen55, 5, 2, 3, no
501988952,  Annaros77056965, 2, 2, 0, yes
547863350,  marinaquandoce, 1, 1, 0, yes
621194070,  M5SRoma3, 15, 1, 14, no
45128272,  emipatr, 2, 2, 0, yes
786535026288631808,  Gabrycesa, 1, 1, 0, yes
3135061,  davidemaggio, 1, 1, 0, yes
766740702982205441,  AndreaBonacalza, 3, 1, 2, no
98491122,  acerracido, 1, 1, 0, yes
798993988158111744,  Pompili70652194, 1, 1, 0, yes
617418787,  PHS_099, 1, 1, 0, yes
435319489,  tizianantonella, 2, 2, 0, yes
68361266,  Kwaaibabatjie, 4, 1, 3, no
2323989127,  Muradsalim1, 1, 1, 0, yes
4164981808,  Luca1Torelli, 4, 4, 0, yes
1642612118,  mauriziobrunel3, 1, 1, 0, yes
802617959952875524,  verdebarda1979, 1, 1, 0, yes
757430765894430720,  Melinda79803031, 1, 1, 0, yes
505066780,  dany_funari, 1, 1, 0, yes
158262409,  steppatek67, 8, 2, 6, no
738805348476260353,  StefanoLonghi2, 4, 1, 3, no
45147364,  cobRadaRt_, 1, 1, 0, yes
2454989365,  infoRepressione, 2, 2, 0, yes
364889715,  FedericoDentico, 1, 1, 0, yes
2286158081,  excrucharry, 1, 1, 0, yes
22607196,  the_marius, 1, 1, 0, yes
2168565495,  vitdean, 2, 2, 0, yes
705158956,  Paternoster85, 5, 1, 4, no
467577715,  PenzoRoberto, 4, 4, 0, yes
424168278,  Albe_Vaccari, 1, 1, 0, yes
2359320782,  germanamarzo, 8, 7, 1, yes
1239894878,  anmarus, 1, 1, 0, yes
3436618168,  1964Gisella, 1, 1, 0, yes
118358954,  livelmoro, 2, 1, 1, neutral
327250259,  iRoberto83, 1, 1, 0, yes
2169803879,  emanuelarizzo6, 1, 1, 0, yes
2726532357,  giannac247, 1, 1, 0, yes
801725296969940992,  anita950040, 1, 1, 0, yes
148394035,  WalterStafoggia, 1, 1, 0, yes
3201116973,  ChurchOfVerity, 2, 2, 0, yes
48312239,  gmerigo, 5, 3, 2, yes
235615214,  MauSwords, 3, 2, 1, yes
1044958567,  agbiuso, 4, 1, 3, no
725998603374841856,  laumau77, 1, 1, 0, yes
328531828,  AmedeoRota, 3, 1, 2, no
503172196,  ozzano1971, 8, 4, 4, neutral
1076835426,  sabrinaganzenua, 3, 3, 0, yes
1615995920,  Holga120S, 1, 1, 0, yes
2510430251,  maninblack53, 6, 1, 5, no
552949047,  elena_degre, 3, 1, 2, no
2202765129,  GhisaMarchi, 1, 1, 0, yes
3021582753,  cdpropris, 5, 1, 4, no
479878112,  ninagro64, 1, 1, 0, yes
299033380,  AndreescuRobert, 1, 1, 0, yes
62883930,  risofreddo, 1, 1, 0, yes
2220314044,  pdreggiocal, 1, 1, 0, yes
2927207759,  lupakkiotto85, 5, 1, 4, no
4224402507,  CorTaranto, 1, 1, 0, yes
9405912,  me9ki, 6, 4, 2, yes
716902085304918016,  TarantiniDoc, 1, 1, 0, yes
235185226,  portofino, 1, 1, 0, yes
1632702368,  Peace98Hippie, 1, 1, 0, yes
385098268,  scanky731, 1, 1, 0, yes
581711296,  massiprof258, 2, 1, 1, neutral
157372162,  naxos1978, 1, 1, 0, yes
2823571467,  Cristy75_, 2, 1, 1, neutral
702071622841270272,  JoyDak2010, 2, 1, 1, neutral
1405684134,  alessandro_bet, 1, 1, 0, yes
2204799296,  ArrighiStefano, 1, 1, 0, yes
579339905,  LongoaleLongo, 1, 1, 0, yes
140211957,  Trunkam, 1, 1, 0, yes
1017663187,  valeriorser, 1, 1, 0, yes
84541733,  PITOCA80, 1, 1, 0, yes
2811581,  giovanninocera, 1, 1, 0, yes
305654158,  ManoloBenassi, 2, 1, 1, neutral
550127872,  frav89, 3, 3, 0, yes
2314403526,  Vendicsolitario, 7, 1, 6, no
513400022,  Luca_Caselli, 2, 1, 1, neutral
397265650,  pgskywalker, 1, 1, 0, yes
342260528,  leonardopalla1, 1, 1, 0, yes
804445377533448192,  ABalestrieri16, 1, 1, 0, yes
1323353749,  AllRiseMyeolchy, 1, 1, 0, yes
183380416,  monica7218, 1, 1, 0, yes
597499995,  lorenzo3107, 3, 1, 2, no
302233003,  BuonSenso1, 2, 2, 0, yes
427400427,  ClaudiaJoy_, 5, 5, 0, yes
495859101,  SilviaRitrovati, 2, 1, 1, neutral
1030715161,  chiaragribaudo, 1, 1, 0, yes
2324867589,  6ndre6, 1, 1, 0, yes
4045990383,  carla_pantano, 7, 1, 6, no
500297242,  WhyNot16958299, 6, 5, 1, yes
2352132366,  val_capp, 5, 1, 4, no
2365951239,  AldoBucciante, 2, 2, 0, yes
1351201297,  mkvland, 2, 2, 0, yes
476148819,  GabrielePolastr, 1, 1, 0, yes
371710017,  ValerioComp, 1, 1, 0, yes
110729786,  SimoneDC75, 2, 2, 0, yes
3131549915,  MonicaGipsy, 2, 2, 0, yes
1060925288,  Liesbet_Me, 1, 1, 0, yes
776158961145876480,  pablitociesa, 1, 1, 0, yes
891964664,  Solon_4979, 1, 1, 0, yes
1374338539,  Marco_Franco86, 1, 1, 0, yes
56504100,  hugored, 4, 4, 0, yes
154924732,  dareus66, 1, 1, 0, yes
1389652190,  AntoCrosi, 2, 1, 1, neutral
370241298,  mrhazzastyles, 3, 3, 0, yes
73085144,  Mattweet88, 1, 1, 0, yes
63813563,  molius74, 6, 6, 0, yes
321260411,  camattiussi85, 3, 3, 0, yes
257568299,  debra_hhh, 1, 1, 0, yes
777498472287272960,  DeborahSpampin1, 2, 2, 0, yes
3085712211,  annamanicuti, 1, 1, 0, yes
771669639705219072,  BrusaRossi, 1, 1, 0, yes
488716244,  r_baiamonte, 1, 1, 0, yes
424317531,  MarioCaputo7, 1, 1, 0, yes
793572620,  MariaGraziaGrip, 3, 2, 1, yes
951786427,  Artu171, 1, 1, 0, yes
118193582,  donzauker1982, 2, 2, 0, yes
241237709,  gianlia96, 1, 1, 0, yes
139526532,  malodedo, 1, 1, 0, yes
701143665876606976,  aroccatofiore, 1, 1, 0, yes
434893793,  zoiaa, 1, 1, 0, yes
3317237277,  asktovinnie, 1, 1, 0, yes
1897403900,  kissme_hard, 1, 1, 0, yes
457703874,  inartenoemi, 1, 1, 0, yes
433270376,  RobertaArielli, 1, 1, 0, yes
710950204229476354,  Patrizia101259, 1, 1, 0, yes
424114437,  MakoBrigitte, 1, 1, 0, yes
358962542,  AdnSince1987, 1, 1, 0, yes
1944696313,  LupoGrigio1974, 1, 1, 0, yes
582868879,  alessa1944, 3, 3, 0, yes
64056797,  gpcolletti, 2, 1, 1, neutral
703236487702298624,  valcicca, 1, 1, 0, yes
2805296676,  Angelus1, 1, 1, 0, yes
2473970790,  avdoreyou, 1, 1, 0, yes
2302053231,  ACardelia, 1, 1, 0, yes
83352948,  gilbw, 1, 1, 0, yes
434326936,  meriluis1, 2, 2, 0, yes
97486124,  pietroreverberi, 1, 1, 0, yes
388145933,  Antopanariello, 1, 1, 0, yes
79967214,  Sedho, 2, 2, 0, yes
124255059,  noeliavizcarram, 1, 1, 0, yes
1227802784,  pietroras, 1, 1, 0, yes
1587045570,  RiemRoberta, 3, 2, 1, yes
1482353762,  angela_pingu, 1, 1, 0, yes
2794603189,  faustonef, 2, 2, 0, yes
384850763,  CristianoRuisi, 2, 2, 0, yes
235639028,  pitagorafargis, 2, 2, 0, yes
428839888,  sbabicio, 1, 1, 0, yes
193662042,  sblubina, 3, 2, 1, yes
764044903,  francescogrig, 1, 1, 0, yes
2977041088,  ShuGarbuglia, 1, 1, 0, yes
113930754,  Guaglia6, 1, 1, 0, yes
156727134,  fedepezz3, 1, 1, 0, yes
2497058648,  AnselmiFede26, 1, 1, 0, yes
603657965,  barbara_polito, 9, 9, 0, yes
170000827,  TanaLauT, 2, 2, 0, yes
563069007,  LUKIAME, 2, 2, 0, yes
123298770,  beenaferrando, 3, 3, 0, yes
853453536,  Eleonora_Fara, 2, 2, 0, yes
15811348,  ilCasalani, 1, 1, 0, yes
2463273777,  PilarM25, 1, 1, 0, yes
454253446,  lessandroTorri, 1, 1, 0, yes
712376322,  Acaruso3Caruso, 19, 3, 16, no
521677038,  rbanfi12, 1, 1, 0, yes
789015390332526593,  beatbii, 2, 1, 1, neutral
249600775,  anticap_, 1, 1, 0, yes
632004132,  G_Ferretto, 1, 1, 0, yes
441091917,  FrancescoPioppi, 1, 1, 0, yes
427684413,  JulienColombani, 1, 1, 0, yes
474153165,  FrancescaSch, 1, 1, 0, yes
322993469,  MrDavid_Blaine, 10, 10, 0, yes
265679140,  virtualex71, 2, 2, 0, yes
460396466,  alepinello, 2, 2, 0, yes
248821559,  MassimilScalisi, 1, 1, 0, yes
293634665,  valterdemaggio, 6, 4, 2, yes
521579991,  beatricepamio, 1, 1, 0, yes
3245134402,  PerroneElio, 9, 9, 0, yes
785908587608481792,  DecidiamoNoi_Bg, 2, 2, 0, yes
2597955914,  simo_cadoni, 1, 1, 0, yes
107775064,  lelloak, 2, 2, 0, yes
110803936,  TrueWales, 3, 3, 0, yes
719629375411527685,  Gabibi32, 4, 4, 0, yes
839404393,  Anilzip, 1, 1, 0, yes
618612546,  buonimprevisto, 1, 1, 0, yes
303750320,  jfalbertos, 1, 1, 0, yes
11512292,  Val3ri0, 1, 1, 0, yes
1352573959,  bellodari0, 2, 1, 1, neutral
7046912,  marcomassarotto, 4, 3, 1, yes
151515677,  celebrinmattia, 1, 1, 0, yes
482194343,  FacciniLuca, 1, 1, 0, yes
436213501,  cbillitteri, 3, 1, 2, no
477607572,  gianni_acm_1899, 1, 1, 0, yes
3007549852,  AlePedretti1974, 2, 2, 0, yes
629393362,  Crispino_V, 3, 2, 1, yes
702673783,  gianlucabollis, 1, 1, 0, yes
12097932,  spokstad, 1, 1, 0, yes
124242692,  LaSguh, 1, 1, 0, yes
514204715,  francescaacqua1, 1, 1, 0, yes
277497920,  adriaduarte87, 1, 1, 0, yes
628372408,  massimo_san, 2, 2, 0, yes
2544727672,  labrilvia, 1, 1, 0, yes
74772109,  martinabanelli, 1, 1, 0, yes
294525676,  Davide_Detlef_, 1, 1, 0, yes
299889291,  moulinem, 1, 1, 0, yes
1849394126,  Thepanda1291, 1, 1, 0, yes
1201353655,  SNES92, 1, 1, 0, yes
484836855,  AntonellaDolci1, 2, 2, 0, yes
459568850,  barbvent, 2, 1, 1, neutral
385085093,  manelg8, 1, 1, 0, yes
2537836649,  LAldeni, 1, 1, 0, yes
1558770456,  ross_fusco, 1, 1, 0, yes
114580848,  AriannaRavelli, 3, 3, 0, yes
1159510986,  ValeCrescenzi, 1, 1, 0, yes
254650534,  Enrico_Flu, 1, 1, 0, yes
297933170,  FbaPtt, 1, 1, 0, yes
2293425230,  Francesconali, 2, 2, 0, yes
774524852,  Romina_731, 1, 1, 0, yes
43191077,  Albertinho85, 1, 1, 0, yes
510475430,  ClaudioGaudio62, 2, 1, 1, neutral
97179381,  Paolo_Micheli, 2, 2, 0, yes
503289984,  AntonioNespoli, 1, 1, 0, yes
169190857,  B_K_FR, 1, 1, 0, yes
36078422,  Fede381, 2, 2, 0, yes
447944683,  pierogiordano1, 4, 4, 0, yes
249194539,  AnEdgeCall, 1, 1, 0, yes
1061413230,  Diego31883, 1, 1, 0, yes
2748430522,  jeanbpoquelin, 2, 2, 0, yes
2580628519,  Ozser_Oyaz_CS, 1, 1, 0, yes
168603272,  tosqui91, 1, 1, 0, yes
824043961,  cha_togo, 1, 1, 0, yes
122202777,  fapresilli, 1, 1, 0, yes
453884632,  MimmoAprile, 2, 2, 0, yes
269257847,  MariCiccol, 1, 1, 0, yes
538983806,  Ale_Coconut, 1, 1, 0, yes
390788134,  PrinCristina, 1, 1, 0, yes
121387635,  gix88, 1, 1, 0, yes
2335006874,  B__Paola, 1, 1, 0, yes
1856978456,  assuntalucenti, 1, 1, 0, yes
412145728,  clatorrisi, 1, 1, 0, yes
702819185055944704,  Hibiscus_81, 1, 1, 0, yes
3103787067,  grigbollling, 1, 1, 0, yes
365473109,  YCuccu, 1, 1, 0, yes
606769648,  AlmostMaurinho, 1, 1, 0, yes
21385150,  Aeruggie, 1, 1, 0, yes
989408796,  mauriziofiore, 2, 2, 0, yes
988588922,  annabartole, 4, 3, 1, yes
76675124,  Fra62, 2, 2, 0, yes
94801793,  pinkra, 3, 1, 2, no
149196879,  POrcaEva, 1, 1, 0, yes
461310574,  MatteoGuini, 1, 1, 0, yes
1024276404,  elias97inter, 2, 2, 0, yes
61122067,  D_Mazzoleni, 1, 1, 0, yes
1876935727,  monicalapietra, 2, 2, 0, yes
290501117,  mathildbauchard, 2, 2, 0, yes
3096639545,  GMTRADIOVE, 1, 1, 0, yes
139257565,  jorge_egren, 1, 1, 0, yes
454024891,  AleParoli, 1, 1, 0, yes
323463996,  Falk_Manr, 1, 1, 0, yes
245712276,  Duca916sp3, 1, 1, 0, yes
33870989,  ennemme, 1, 1, 0, yes
756481189897183232,  enjoydisorder, 1, 1, 0, yes
755048485,  _carlimichele, 1, 1, 0, yes
47732785,  silviaturin, 2, 2, 0, yes
156651046,  CarlottaSartori, 3, 1, 2, no
2327955038,  fallacara_g, 2, 2, 0, yes
1104632064,  MaryLucyTang, 1, 1, 0, yes
452444629,  spaglia78, 1, 1, 0, yes
341442232,  FabrizioRonga, 1, 1, 0, yes
418185559,  AutieriFlora, 1, 1, 0, yes
109611129,  ancorantonio, 1, 1, 0, yes
165071899,  osc_sm, 1, 1, 0, yes
156566286,  antoniosepa, 1, 1, 0, yes
437467869,  oilimerossi, 1, 1, 0, yes
2164751944,  JackilKebabbaro, 1, 1, 0, yes
2400294800,  atanor7, 7, 1, 6, no
532154561,  marioarmanni, 2, 2, 0, yes
2360064074,  NicolaPalakk, 1, 1, 0, yes
3233782181,  JoongWu, 8, 1, 7, no
586498147,  civisromanusTW, 19, 2, 17, no
1048545206,  lin81301, 1, 1, 0, yes
165231667,  blue_river15, 1, 1, 0, yes
85910179,  giulirob, 1, 1, 0, yes
305115964,  pppcri1, 1, 1, 0, yes
1498924656,  FefoIaco84, 1, 1, 0, yes
412648819,  paolotraso, 5, 5, 0, yes
274652511,  stefydantes78, 1, 1, 0, yes
72310257,  ljsilver71, 1, 1, 0, yes
966974378,  emmegi_b, 1, 1, 0, yes
276347998,  MassMan44, 1, 1, 0, yes
2452523081,  clifford_shines, 1, 1, 0, yes
2281712079,  phineferb98, 1, 1, 0, yes
2164036419,  annaferraro_, 1, 1, 0, yes
1399862918,  Quetzacolth, 2, 2, 0, yes
1247457384,  ilacaprera, 1, 1, 0, yes
39481779,  marcodanzi1, 2, 2, 0, yes
1964523270,  MonicaRandiRT, 1, 1, 0, yes
775381797542690816,  frullacosmico, 5, 4, 1, yes
2348837399,  sdeangelis56, 3, 1, 2, no
1480684483,  viola30364260, 1, 1, 0, yes
896174220,  elisabettastab1, 1, 1, 0, yes
2253186923,  robertoroby12, 1, 1, 0, yes
2328604034,  SabaMassy, 2, 1, 1, neutral
3242519025,  SCUOLATUTTIUNIT, 12, 2, 10, no
2958873291,  arusso1984, 1, 1, 0, yes
251772026,  purposhes, 1, 1, 0, yes
2647873162,  DanDansuxx, 3, 1, 2, no
20000505,  JanHartman, 1, 1, 0, yes
547083910,  ladycookye, 1, 1, 0, yes
1058924563,  giannini_giu, 1, 1, 0, yes
786872295092527104,  FedericoBurgio1, 2, 2, 0, yes
374723494,  apiandrea, 1, 1, 0, yes
4241475629,  cuppyofmine, 2, 2, 0, yes
1245854424,  MarcoMartu, 1, 1, 0, yes
560610117,  CLundmark, 1, 1, 0, yes
330874657,  trepois, 1, 1, 0, yes
457525389,  Robertaio74, 1, 1, 0, yes
255619193,  raniste, 1, 1, 0, yes
340448513,  rosselladiaz, 1, 1, 0, yes
282052794,  dallaven, 1, 1, 0, yes
19940520,  Gerva81, 1, 1, 0, yes
204850690,  Dedebbi, 1, 1, 0, yes
1104405600,  Wolefox, 2, 2, 0, yes
33701862,  Riccafiat, 1, 1, 0, yes
780544088407814145,  WonderTitta, 1, 1, 0, yes
512573892,  FraShorts, 2, 2, 0, yes
283037364,  RobertaFbr, 2, 2, 0, yes
280122629,  albi94RD, 2, 2, 0, yes
42607310,  Pariolino, 2, 2, 0, yes
275404354,  micastal, 3, 3, 0, yes
415060186,  FraPetillo, 2, 2, 0, yes
1704594890,  IlariaFiore5, 1, 1, 0, yes
461546996,  SimoneBrocca, 1, 1, 0, yes
373027633,  MiSsLiZard84, 1, 1, 0, yes
2173172716,  halo_reverse, 2, 2, 0, yes
48243662,  Luzaf, 1, 1, 0, yes
2727637367,  nonceparagone, 1, 1, 0, yes
2964902513,  laura_basciu, 1, 1, 0, yes
452592613,  crismutti, 1, 1, 0, yes
1023104383,  mttgrst, 1, 1, 0, yes
586697902,  ImmersoNelnulla, 1, 1, 0, yes
264407010,  pol8719, 1, 1, 0, yes
1342124510,  FiloDellePiane, 1, 1, 0, yes
1971644156,  iosimonacrl, 10, 5, 5, neutral
401528332,  CervelloD, 2, 2, 0, yes
93062393,  DesdeElJergon, 1, 1, 0, yes
1030774405,  CurnisL, 2, 2, 0, yes
789907637987147776,  osmartinos, 1, 1, 0, yes
2475492229,  Sandrocotto, 1, 1, 0, yes
466756548,  LaviniaL1982, 1, 1, 0, yes
2986041803,  MetaFiloPsico, 1, 1, 0, yes
113080051,  D_Bretodeau, 3, 2, 1, yes
446094084,  SamanthaTuzzeo, 2, 2, 0, yes
20013876,  blandinhugonnet, 1, 1, 0, yes
1131812641,  mare8861, 6, 1, 5, no
604530811,  penna_biro, 2, 2, 0, yes
2453376964,  onedopexj, 1, 1, 0, yes
3393921311,  RGigi61, 1, 1, 0, yes
1334738558,  Digimonso, 1, 1, 0, yes
594076407,  MattiaUttini, 2, 2, 0, yes
743146756037287940,  Docaparicio, 1, 1, 0, yes
2402721442,  jasmyjb, 1, 1, 0, yes
711903571223191552,  alessiabally, 1, 1, 0, yes
3137163790,  mateusderly1, 1, 1, 0, yes
3819579856,  depa681, 2, 2, 0, yes
327070445,  lillibriciola, 3, 2, 1, yes
137801552,  DonBrentino, 1, 1, 0, yes
491641386,  bbiondadentro, 1, 1, 0, yes
2820568367,  50ba986194c844d, 2, 2, 0, yes
235651997,  osky_bosky, 1, 1, 0, yes
1149172598,  luc4m4rtin, 1, 1, 0, yes
756161595731021824,  BronzettiLeo, 1, 1, 0, yes
2309009431,  Carletto975, 1, 1, 0, yes
711886078291152896,  steffanrogg, 1, 1, 0, yes
162192942,  LorenzoMoscia, 3, 1, 2, no
96127287,  Ugo_Foscolo, 1, 1, 0, yes
722049036694499329,  grazasch12121, 2, 2, 0, yes
781589653027688448,  Mirian80269415, 1, 1, 0, yes
165962443,  Banfrid, 1, 1, 0, yes
43762504,  iz1hib, 1, 1, 0, yes
760510933319970816,  GiovanniRojava, 1, 1, 0, yes
1514408528,  gabryxugino, 4, 4, 0, yes
389945583,  LilloNicola, 1, 1, 0, yes
731048593591836672,  LudoNardi1, 1, 1, 0, yes
483141541,  CPrestori, 2, 1, 1, neutral
478929871,  DavideRomelli, 1, 1, 0, yes
2183150159,  Francesca_kiki, 3, 3, 0, yes
1096323168,  Matiz58, 7, 7, 0, yes
490274780,  FilippoGianne1, 1, 1, 0, yes
3432070683,  antonioDmazzeo, 2, 2, 0, yes
429404903,  AgostinisV, 2, 1, 1, neutral
1937464244,  destinograzia, 2, 2, 0, yes
17653018,  ross78, 1, 1, 0, yes
529119371,  livia64livia, 3, 3, 0, yes
477731116,  emi_indream, 4, 1, 3, no
740234825882308608,  Rosellinamadeo1, 1, 1, 0, yes
1071257940,  AnnaMariaAnnich, 1, 1, 0, yes
1023765146,  clode1611, 3, 2, 1, yes
756496755932426241,  Aurora19Boreale, 3, 3, 0, yes
416329750,  OrnellaSarrocco, 3, 3, 0, yes
73909424,  BDamico83, 1, 1, 0, yes
132448509,  STEFANOMONALDI, 2, 2, 0, yes
1293941953,  marcohcm, 1, 1, 0, yes
2436742697,  binz61, 3, 3, 0, yes
2707573341,  ste06411, 1, 1, 0, yes
421741576,  AnnoviGiulia, 1, 1, 0, yes
501750077,  Don_Lazzara, 1, 1, 0, yes
864661074,  stevenbaiocchi, 2, 2, 0, yes
704615029572825088,  danielesps, 4, 4, 0, yes
425941801,  chiaramaramotti, 1, 1, 0, yes
1007419087,  r_corti, 1, 1, 0, yes
1683733140,  GiuliaLazzari3, 1, 1, 0, yes
2362978181,  Blasko71, 1, 1, 0, yes
596928486,  LeonardoStrusi, 2, 1, 1, neutral
1037780202,  kkonigliani, 2, 2, 0, yes
65637148,  x0rg, 1, 1, 0, yes
1026721687,  VLRLVR, 1, 1, 0, yes
493108575,  floristam, 1, 1, 0, yes
805076083,  ACastelli53, 1, 1, 0, yes
120522705,  rr_f_pc, 1, 1, 0, yes
1399652916,  Landre71, 7, 5, 2, yes
332233057,  permaflex64, 1, 1, 0, yes
4754445280,  OrlandoOrlanina, 1, 1, 0, yes
461940997,  LuigiVertucci1, 2, 2, 0, yes
445561658,  LupiniAndrea, 1, 1, 0, yes
702947473849978880,  zecca_rocco, 2, 2, 0, yes
146790404,  faustikorockit, 2, 1, 1, neutral
905584568,  CarmineSalerno3, 1, 1, 0, yes
804451546784145408,  monson_asa, 1, 1, 0, yes
769857097181769728,  Troy16601481, 1, 1, 0, yes
1690749565,  Gauchiste1, 5, 3, 2, yes
859727670,  alemanesso, 1, 1, 0, yes
768408609889869824,  Liv75494745, 1, 1, 0, yes
2375869364,  PulitiElena, 2, 2, 0, yes
3410081393,  annanamia, 4, 1, 3, no
194054636,  mattia_soravia, 1, 1, 0, yes
204838608,  frankmoran2000, 1, 1, 0, yes
22241164,  alberod, 1, 1, 0, yes
38560688,  rachetucci, 1, 1, 0, yes
479672106,  albareto5, 2, 2, 0, yes
1347185900,  GianRicu, 1, 1, 0, yes
1229377915,  AnnaMariaFonta6, 3, 3, 0, yes
978768446,  DareThink, 1, 1, 0, yes
89505539,  francescoameli, 1, 1, 0, yes
2409085213,  Raffaele_1024KB, 5, 5, 0, yes
196111881,  GrandinettiG, 1, 1, 0, yes
3298395183,  enzaronzullo62, 1, 1, 0, yes
154687209,  lucarocca72, 6, 6, 0, yes
217167883,  maguglia, 1, 1, 0, yes
4091153193,  Vittori13453995, 1, 1, 0, yes
2436959175,  PLL7liArs, 1, 1, 0, yes
445750963,  banshwolf, 1, 1, 0, yes
2460261868,  barbarabali10, 1, 1, 0, yes
514166302,  prccomo, 3, 3, 0, yes
245508557,  Apseude, 1, 1, 0, yes
313359104,  stingingbeyhive, 1, 1, 0, yes
230680774,  Illicus, 1, 1, 0, yes
786903299937239041,  luciaagatensi, 1, 1, 0, yes
273590378,  miluoTW, 1, 1, 0, yes
2320478792,  SaraSenzacca, 4, 3, 1, yes
472859188,  sergioortolano, 1, 1, 0, yes
956120414,  roxdem1978, 8, 7, 1, yes
779581916248965120,  matteoludvitali, 2, 2, 0, yes
805394916746596352,  stefaniastifan2, 1, 1, 0, yes
2360804453,  alprazolamaiosa, 1, 1, 0, yes
505228350,  Lepanto69, 2, 2, 0, yes
2220255020,  apardi63, 2, 2, 0, yes
528771794,  filippiignazio, 1, 1, 0, yes
594121221,  vincentilpirata, 1, 1, 0, yes
2243622492,  PaoloRostiri, 1, 1, 0, yes
2252104728,  MarcoBani98, 1, 1, 0, yes
1430615509,  pia442, 1, 1, 0, yes
792166831,  zoeazonzo, 1, 1, 0, yes
15062518,  cheTesta, 2, 1, 1, neutral
320213558,  estherjvallejo, 1, 1, 0, yes
234326763,  Vanderpanzer, 1, 1, 0, yes
466946952,  Sandy_SF_, 1, 1, 0, yes
448949964,  GiovZez, 1, 1, 0, yes
326766406,  E_Esposito, 1, 1, 0, yes
181293106,  elenina1971, 7, 7, 0, yes
1389317622,  prfloueh, 1, 1, 0, yes
439152986,  MarcoCiprianoRF, 1, 1, 0, yes
782535732950958080,  dona2466, 11, 5, 6, no
489184184,  ruthgferrer, 1, 1, 0, yes
130245182,  pcristofol, 1, 1, 0, yes
358843165,  NadinWonderwall, 1, 1, 0, yes
119648205,  lucavernetti, 1, 1, 0, yes
385333260,  JovaSca23, 1, 1, 0, yes
171025418,  francescomattia, 1, 1, 0, yes
12131162,  pieroclarizia, 2, 2, 0, yes
571044384,  J_GarciaMartin, 1, 1, 0, yes
518527215,  BobTdeNasi, 2, 2, 0, yes
2544654537,  FpizzutiPizzuti, 2, 1, 1, neutral
448277244,  domenicosabell1, 2, 2, 0, yes
805510531029303298,  digiacma94, 1, 1, 0, yes
536487586,  zaynsclothes, 1, 1, 0, yes
491330061,  gianvitocafaro, 2, 2, 0, yes
17776577,  ilnorbi, 1, 1, 0, yes
404196766,  ThomaisERT_RIK, 2, 2, 0, yes
471126149,  dandapittio, 1, 1, 0, yes
1651082244,  karmagddon, 1, 1, 0, yes
2748749502,  tranchitellad, 1, 1, 0, yes
330262748,  FabrizioRomano, 2, 2, 0, yes
2274953290,  Claudio__Cali, 1, 1, 0, yes
634744796,  Stefano_Calvani, 1, 1, 0, yes
329166379,  GermanoDottori, 3, 2, 1, yes
211882930,  LaraMastra, 2, 2, 0, yes
380324828,  etorboli, 1, 1, 0, yes
249348441,  lafabbri, 2, 2, 0, yes
47335824,  Ddcnews, 4, 3, 1, yes
52288847,  furettolo, 1, 1, 0, yes
428381394,  helsinky2012, 1, 1, 0, yes
255450274,  olivioromanini, 1, 1, 0, yes
3726177073,  contemascetti73, 1, 1, 0, yes
3045043101,  andreasantoro25, 11, 3, 8, no
442035429,  andrepietro_, 1, 1, 0, yes
738366522209521664,  AndreaGrazian92, 5, 4, 1, yes
154202270,  AdriaAlsina, 1, 1, 0, yes
896124414,  BeaGiroldi, 1, 1, 0, yes
169851165,  andreag_conti, 1, 1, 0, yes
1558839894,  coskabj, 5, 3, 2, yes
2350215422,  bubinoblog, 1, 1, 0, yes
2992651660,  GabrielBurdin, 1, 1, 0, yes
85094221,  marconurra, 1, 1, 0, yes
463900161,  frankragosta, 1, 1, 0, yes
486898438,  FabrizioDiMuro, 1, 1, 0, yes
455867329,  s_gio_76, 1, 1, 0, yes
144608367,  Breaking_Deb, 1, 1, 0, yes
22761381,  scoppetta87, 1, 1, 0, yes
154658686,  cecealways_, 1, 1, 0, yes
3975178637,  alexdobreslei, 1, 1, 0, yes
1006432927,  Moky_1988, 4, 2, 2, neutral
781259867810037760,  Pietro_Vetulli, 1, 1, 0, yes
2866044049,  memia18, 1, 1, 0, yes
4872958384,  4BigData, 1, 1, 0, yes
565416924,  luluclts, 1, 1, 0, yes
1330396873,  VittorioMauri, 2, 1, 1, neutral
1234080900,  rita_19_76, 6, 2, 4, no
235134810,  nikuezz, 1, 1, 0, yes
1473979718,  DonniniMario, 2, 2, 0, yes
197892227,  veber7, 1, 1, 0, yes
2799778140,  VocidiPalazzo, 5, 5, 0, yes
2911993984,  marco_vitta, 1, 1, 0, yes
2753639356,  Gadelegli, 2, 2, 0, yes
72928651,  geor97, 2, 1, 1, neutral
1022361805,  ElenaPolimadei, 1, 1, 0, yes
286584597,  GianniVenturini, 2, 1, 1, neutral
457004967,  GiannijStinson5, 2, 2, 0, yes
1147594230,  sanarciso67, 1, 1, 0, yes
109960399,  RegoliClaudia, 5, 1, 4, no
53181604,  ildaniele, 1, 1, 0, yes
801130932,  pediliggio, 3, 3, 0, yes
49656085,  maraproia, 4, 2, 2, neutral
168500366,  saratexit, 3, 2, 1, yes
412142178,  Unacanzoneperte, 1, 1, 0, yes
2359560644,  Fam_Rondinelli, 2, 1, 1, neutral
418145829,  Rakyy_, 1, 1, 0, yes
1041994945,  aleperrazzelli, 2, 2, 0, yes
47333457,  kikapress, 1, 1, 0, yes
2824869975,  herondalesbook, 1, 1, 0, yes
418980099,  luliluis, 6, 6, 0, yes
902489143,  amata_lucia, 2, 2, 0, yes
439290200,  carlopao86, 3, 1, 2, no
418602742,  PaolaMalcotti, 1, 1, 0, yes
702971213308678144,  RutaFrancesco, 3, 3, 0, yes
109578068,  fbraga0, 1, 1, 0, yes
2886098627,  CarmenBelardo, 1, 1, 0, yes
606060382,  saranesci1, 1, 1, 0, yes
202220952,  FerzanOzpetek, 11, 4, 7, no
371415996,  edosala8, 4, 1, 3, no
1660890594,  avvvitalemario, 2, 2, 0, yes
2387915210,  DavidePrandiWil, 1, 1, 0, yes
2626785886,  VitaInViaggio, 1, 1, 0, yes
87764401,  bulin_jl, 1, 1, 0, yes
986791688,  globalpub_net, 1, 1, 0, yes
349818189,  avvtoto13, 4, 3, 1, yes
762290549168701440,  VotezPoisson, 5, 5, 0, yes
2982185843,  Marahia675646, 2, 1, 1, neutral
2375820781,  MatteoMilaniNY, 2, 1, 1, neutral
3309021569,  dgsoftwa19, 1, 1, 0, yes
423368263,  Chambssy, 1, 1, 0, yes
406116425,  robytall, 3, 2, 1, yes
2970328857,  loumarti73, 1, 1, 0, yes
523683527,  DelfoFusillo, 3, 3, 0, yes
631501567,  JacopoSacVen, 3, 1, 2, no
1017039686,  eleonoraleorat1, 4, 1, 3, no
1244644430,  ilpozzoparlante, 6, 2, 4, no
1228508036,  d_costantina, 2, 1, 1, neutral
224569134,  harrehandboo, 1, 1, 0, yes
86406337,  franki_kuka, 1, 1, 0, yes
411007037,  francquisto, 1, 1, 0, yes
418664428,  PatriziaDeRub, 1, 1, 0, yes
517510801,  anna_labian, 1, 1, 0, yes
252480412,  glmannheimer, 1, 1, 0, yes
1479230898,  SaboTheClash, 1, 1, 0, yes
2722759402,  arya_hale, 3, 2, 1, yes
799682242142343168,  PasqualeFerro2, 1, 1, 0, yes
4718852476,  fra88888, 1, 1, 0, yes
248672914,  ClaudiaBoran, 1, 1, 0, yes
4604296289,  DitollaLucia, 2, 2, 0, yes
1247052342,  luca_of_oz, 1, 1, 0, yes
779627408014139393,  Michele80675343, 2, 2, 0, yes
704753347929247744,  schiavisil, 2, 2, 0, yes
724587951406100480,  giovanni_storni, 1, 1, 0, yes
3121450122,  GiuliarosaR, 1, 1, 0, yes
423559860,  Francesco_30, 1, 1, 0, yes
744666363713708032,  PPk2016, 1, 1, 0, yes
455654947,  FGoodhouse, 2, 2, 0, yes
798876490796593152,  iEnrico9, 3, 1, 2, no
782213004,  paolobelardinel, 1, 1, 0, yes
390029206,  SimoneSeymons, 1, 1, 0, yes
504969673,  GiacintoSe, 2, 2, 0, yes
72521455,  steik87, 1, 1, 0, yes
1536376814,  1973Gian, 1, 1, 0, yes
764950675885285377,  Jankinaw, 2, 1, 1, neutral
805547903473385474,  vale_coc, 1, 1, 0, yes
1223390282,  lucascrgu, 1, 1, 0, yes
351590283,  AliceGioia, 1, 1, 0, yes
791757698438205440,  zut72518793, 1, 1, 0, yes
780614438,  AlatunaSkils, 1, 1, 0, yes
3152585501,  the_bracca, 1, 1, 0, yes
3222316409,  raggedy_spacemn, 2, 2, 0, yes
479516665,  GiacomoDanda, 1, 1, 0, yes
396756052,  LucaMilesi, 1, 1, 0, yes
2887639066,  g_roncone, 2, 2, 0, yes
426561539,  diouncetesi, 1, 1, 0, yes
208164885,  maebort, 2, 2, 0, yes
8172972,  naroh, 1, 1, 0, yes
211934762,  FranEcheve, 1, 1, 0, yes
176754984,  ema_sct, 1, 1, 0, yes
29478477,  FederSerra, 2, 2, 0, yes
949435291,  FedericaCalvia, 1, 1, 0, yes
488412728,  djrenyx, 1, 1, 0, yes
807095388,  PietroMosella, 1, 1, 0, yes
4078680701,  JuRics94, 1, 1, 0, yes
980073871,  Cormon, 3, 3, 0, yes
494414224,  giancrox, 1, 1, 0, yes
199384585,  allecarioca, 1, 1, 0, yes
567490347,  MelyStern, 1, 1, 0, yes
2468168978,  michelepanno, 1, 1, 0, yes
476140459,  il_ciancio, 1, 1, 0, yes
788857343471710208,  silente98, 2, 2, 0, yes
1520170092,  edenperduto, 1, 1, 0, yes
941500664,  OrfeoMontani, 2, 2, 0, yes
4695209784,  mimmodicas, 1, 1, 0, yes
322791969,  CiroDattilo, 1, 1, 0, yes
485493017,  gianniconta72, 4, 1, 3, no
2257832343,  oissela73, 3, 1, 2, no
785474628340809728,  referippo, 1, 1, 0, yes
1871797381,  Bieber_Leonardo, 1, 1, 0, yes
782812640385110016,  gentaff, 11, 8, 3, yes
3425355099,  teozenoni, 1, 1, 0, yes
3135971501,  cin_run, 1, 1, 0, yes
802634754772402176,  mariogrz54, 1, 1, 0, yes
948241856,  Esictp, 2, 1, 1, neutral
3432900449,  marekminutski, 2, 2, 0, yes
755763726477844480,  cuffietta23, 1, 1, 0, yes
3110312266,  LucaParisi20, 1, 1, 0, yes
520263936,  AbBruCondita, 1, 1, 0, yes
340890379,  UrsulaCatenazzi, 1, 1, 0, yes
3523449201,  UmbertoCapitan1, 1, 1, 0, yes
4842729813,  Rita43643868, 2, 1, 1, neutral
3065092331,  sendi__zenda, 1, 1, 0, yes
3051247218,  Deannathelst, 1, 1, 0, yes
2849566250,  MircoSimeoni, 3, 2, 1, yes
1224013488,  giokafka, 2, 2, 0, yes
2483717565,  peteyv376, 1, 1, 0, yes
2290069009,  NCD_VdA, 1, 1, 0, yes
150592979,  EyeOfTheTiger87, 1, 1, 0, yes
1066888430,  barbonzola, 1, 1, 0, yes
701489084619997184,  PianoPatrizia, 1, 1, 0, yes
2511025017,  PeracchiaElena, 1, 1, 0, yes
312290595,  Crished, 1, 1, 0, yes
1047517555,  davide_adami, 1, 1, 0, yes
757235555541417984,  marcocolacino5, 1, 1, 0, yes
2762345533,  pieropolitano, 6, 2, 4, no
1661464812,  mattewroman, 2, 2, 0, yes
847497841,  PiLu975, 3, 2, 1, yes
297344001,  matteapollo82, 2, 1, 1, neutral
267703365,  MicheleIoffredo, 1, 1, 0, yes
234753926,  FABER130374, 3, 2, 1, yes
220950190,  diegogizzone, 1, 1, 0, yes
14460264,  kappazeta, 1, 1, 0, yes
269425726,  tinas48, 7, 2, 5, no
142201916,  cantuale, 2, 2, 0, yes
2895839315,  Gianci_63, 1, 1, 0, yes
580184701,  andrea_b92, 2, 1, 1, neutral
549110283,  1943fr, 1, 1, 0, yes
316373745,  MarcoPipolo, 2, 1, 1, neutral
3350883077,  mariamedici10, 2, 2, 0, yes
3077624915,  c_corbella, 2, 2, 0, yes
257575426,  JohnWiIl, 2, 2, 0, yes
543703916,  EmilianoSilv74, 9, 1, 8, no
3120070323,  iimerge_, 1, 1, 0, yes
161260766,  onetwit960, 1, 1, 0, yes
412967073,  MarianiGianni, 1, 1, 0, yes
794612456559669250,  adalospi, 2, 2, 0, yes
2264060948,  indigentiattent, 1, 1, 0, yes
819782228,  ArezzoperRenzi, 1, 1, 0, yes
781502896550674432,  BastaUnSiArezzo, 1, 1, 0, yes
474442199,  TommasoCurzio, 1, 1, 0, yes
489562627,  Giungato29, 22, 1, 21, no
1194465589,  Luca_Lucky67, 1, 1, 0, yes
3290073059,  NicSapi, 1, 1, 0, yes
2699111971,  sonounosonotre, 1, 1, 0, yes
1206116869,  VelmaT1, 1, 1, 0, yes
476861259,  RinaAngela1, 1, 1, 0, yes
4288719745,  causanosletiae, 1, 1, 0, yes
309745798,  Ysserly, 1, 1, 0, yes
3094835193,  michelecalia58, 7, 3, 4, no
428443141,  GFCxKING, 1, 1, 0, yes
768562848473739270,  arcuri_angelo, 1, 1, 0, yes
1682943559,  GuidoGuidi80, 2, 1, 1, neutral
3012321255,  Zia_Paa, 1, 1, 0, yes
2505767008,  giannimp2003, 1, 1, 0, yes
2350138653,  lefons_domi, 1, 1, 0, yes
2955676438,  Spartaco1976, 1, 1, 0, yes
1120047216,  symmyci, 1, 1, 0, yes
416540516,  Monicamondo, 1, 1, 0, yes
591323868,  96Mariangela, 1, 1, 0, yes
285222215,  salsaispanica, 2, 1, 1, neutral
11043652,  acasalotti, 1, 1, 0, yes
736278168500375553,  Tisembranormale, 2, 2, 0, yes
931280858,  antoniettafolch, 9, 2, 7, no
240152838,  GiulianoBuba, 1, 1, 0, yes
4019643525,  lsaccani67, 1, 1, 0, yes
1310657012,  MaxMelisMilano, 1, 1, 0, yes
287247676,  robertadatola, 1, 1, 0, yes
514104395,  Giov1947, 2, 2, 0, yes
163377972,  ANDREACAVEZZA, 2, 2, 0, yes
401258888,  Thomas_cas, 7, 1, 6, no
448259280,  petitearnican, 1, 1, 0, yes
1361864550,  mauro_mpa, 1, 1, 0, yes
588200416,  meb, 1, 1, 0, yes
804905671825227776,  giorgioautista8, 1, 1, 0, yes
1463272303,  MauroPresini, 1, 1, 0, yes
99117306,  giannifesta, 2, 2, 0, yes
417196887,  quintierocar, 16, 1, 15, no
786198983630663682,  LouderConservat, 1, 1, 0, yes
760382732602048512,  alternativage, 1, 1, 0, yes
163820912,  doppioclick81, 3, 2, 1, yes
726540842660409344,  RaffaeleAcampo1, 4, 1, 3, no
390423729,  steocx, 2, 1, 1, neutral
444637440,  AGuarasci, 9, 9, 0, yes
472335341,  ybertoncini, 1, 1, 0, yes
714246326,  SivigliAgostino, 2, 2, 0, yes
4648250951,  noncicredo22, 2, 2, 0, yes
324563788,  Anto_b77, 1, 1, 0, yes
34883455,  franrascacci, 4, 1, 3, no
39423598,  Clau_strofobico, 1, 1, 0, yes
315787968,  silviapasquini, 2, 2, 0, yes
2343268665,  TeryRita, 1, 1, 0, yes
15918865,  marcobardazzi, 1, 1, 0, yes
2514997128,  Larilucos, 1, 1, 0, yes
707405739,  BBorgiattino, 1, 1, 0, yes
785916344575328258,  MatteoMente, 98, 96, 2, yes
397085846,  Borrocity, 1, 1, 0, yes
430060194,  61betty, 2, 1, 1, neutral
2730306239,  mario_konme, 1, 1, 0, yes
2754191277,  asgiu66, 1, 1, 0, yes
3065861489,  JoeGriffith97, 1, 1, 0, yes
1346966839,  marcelloseva, 6, 3, 3, neutral
941573240,  LorenzaTomasi, 1, 1, 0, yes
22655342,  santoroma, 1, 1, 0, yes
521090462,  RoselliRoselli, 48, 2, 46, no
1876638530,  antoniozannino1, 1, 1, 0, yes
151420411,  supersocrates, 2, 1, 1, neutral
2455947723,  cpierini75, 1, 1, 0, yes
533122115,  iuliano_carmine, 2, 2, 0, yes
2564440558,  zakjanus, 4, 2, 2, neutral
798166261,  RobertaPerone, 3, 2, 1, yes
2800699455,  AndreDema89, 1, 1, 0, yes
496000697,  FloraRino, 1, 1, 0, yes
499121170,  danicodispoti, 2, 2, 0, yes
121286482,  cocoXIV, 2, 2, 0, yes
3100518405,  SiringoAlberto, 2, 1, 1, neutral
1240943017,  LatoClaudio, 1, 1, 0, yes
2734382703,  PAlessandra73, 1, 1, 0, yes
861521874,  flavlesstyles, 2, 2, 0, yes
81779451,  valelibera, 2, 1, 1, neutral
720961705086492672,  Nancy165495051, 1, 1, 0, yes
2271716484,  RosinaPetretta, 1, 1, 0, yes
47148805,  mcocucci, 4, 3, 1, yes
487573100,  armandapasello, 2, 2, 0, yes
257129396,  ellfabbri, 2, 1, 1, neutral
257010843,  gianniperetti, 1, 1, 0, yes
990605366,  OttavioPirelli, 3, 3, 0, yes
150399979,  Chuck_McApples, 5, 3, 2, yes
3040728327,  ruffederico, 1, 1, 0, yes
3157869179,  murolo_nino, 2, 2, 0, yes
748145329132961793,  MaurizioGamba78, 1, 1, 0, yes
275139379,  michelapie, 2, 2, 0, yes
810928926,  GDAndrea72, 2, 2, 0, yes
1944884750,  albertograssi7, 1, 1, 0, yes
1275752329,  casati97, 1, 1, 0, yes
787986463,  Dabshalim, 1, 1, 0, yes
2308979695,  lucialullu, 1, 1, 0, yes
42604254,  Xabaras89, 5, 1, 4, no
405038860,  PuzzoVito, 1, 1, 0, yes
1401837103,  savino_a, 1, 1, 0, yes
962375468,  Alessan95844881, 1, 1, 0, yes
400352031,  Aleroma75, 2, 2, 0, yes
11084932,  fedecolonna, 2, 2, 0, yes
4219485893,  ely68486824, 1, 1, 0, yes
761067754455638016,  GiovannaRovati, 1, 1, 0, yes
2992105528,  Antonsbox, 1, 1, 0, yes
2407400013,  isarussopirro, 1, 1, 0, yes
1731603145,  DnIlar, 1, 1, 0, yes
496205059,  GiorgiaMalaguti, 1, 1, 0, yes
770940832757190656,  TELEMEDECINEOCI, 1, 1, 0, yes
3352432162,  watankergirl, 1, 1, 0, yes
1339359319,  chconsal, 1, 1, 0, yes
453394221,  CarlaCorimbi, 1, 1, 0, yes
3037846246,  maberchino, 1, 1, 0, yes
19210707,  iamdavehumphrey, 1, 1, 0, yes
435777459,  PaolaPlacenti, 1, 1, 0, yes
3971924915,  Emanuel35311932, 1, 1, 0, yes
488601703,  Emilio_Brentani, 1, 1, 0, yes
414692291,  AliceMorrone, 2, 2, 0, yes
765453674,  Peverata, 2, 2, 0, yes
54492057,  orangeket, 1, 1, 0, yes
56693905,  cotti_char, 1, 1, 0, yes
1696504896,  ercuoco72, 9, 2, 7, no
9551342,  adario, 3, 3, 0, yes
749597800170676229,  pensatore78, 1, 1, 0, yes
1561385658,  0029omar0029, 1, 1, 0, yes
3804312981,  matteovecciare1, 1, 1, 0, yes
291850624,  i500passi, 1, 1, 0, yes
731578727465922560,  pierpesca26, 1, 1, 0, yes
392729927,  bartolelli, 1, 1, 0, yes
236305508,  dottorpax, 1, 1, 0, yes
2763483839,  MavXCardinals, 4, 4, 0, yes
188328349,  NiccoBigalli, 1, 1, 0, yes
463197517,  f_mirbeau, 1, 1, 0, yes
15779253,  Almirena, 3, 2, 1, yes
505191219,  amessina_tw, 1, 1, 0, yes
170740467,  lore9625, 1, 1, 0, yes
327417226,  PedrettiEnrico, 2, 2, 0, yes
555907554,  sergiolamartina, 2, 1, 1, neutral
85180107,  JacopoOrlando, 3, 1, 2, no
747377303206920192,  narci_nanni, 1, 1, 0, yes
958132034,  andrebal1, 1, 1, 0, yes
360985537,  CowGirlLucky13, 2, 1, 1, neutral
506041654,  MattiaPierelli, 1, 1, 0, yes
475771217,  MadeInGian, 1, 1, 0, yes
572173256,  vincio97, 1, 1, 0, yes
1975430965,  redstefy78, 1, 1, 0, yes
521544592,  danzadelventre2, 1, 1, 0, yes
425386669,  Giuliano4ne, 1, 1, 0, yes
493462389,  Rossi55Marco, 2, 2, 0, yes
3434953047,  paradisoangelo8, 2, 2, 0, yes
455880770,  rudyponchia, 1, 1, 0, yes
139715784,  alportog, 8, 5, 3, yes
1058916510,  yu_creamy, 3, 3, 0, yes
425228936,  Atrignano, 1, 1, 0, yes
268579167,  m_mats_, 1, 1, 0, yes
4899402364,  8c6a097eda01497, 1, 1, 0, yes
291993585,  MatuDoubleT, 1, 1, 0, yes
2834755191,  mjfrancy, 1, 1, 0, yes
2758651299,  swantsniallshug, 1, 1, 0, yes
91313375,  bobinetv, 5, 5, 0, yes
3121453822,  mg_nardoianni, 1, 1, 0, yes
568262540,  sandro0269, 1, 1, 0, yes
270594643,  robbmonzani, 1, 1, 0, yes
152037698,  fvercellino, 2, 1, 1, neutral
143077128,  ladymarlyn, 1, 1, 0, yes
1690928773,  chanelrouge, 1, 1, 0, yes
594495236,  mr_mistero, 1, 1, 0, yes
1511626796,  ContiMarinaxc, 1, 1, 0, yes
3183027280,  GuzzardiGiorgia, 1, 1, 0, yes
2456227901,  F35535029, 9, 1, 8, no
83933813,  eltidona, 1, 1, 0, yes
1324690742,  90stakethat, 1, 1, 0, yes
1562369946,  StabiaAmore, 1, 1, 0, yes
2180630159,  EliLod11, 1, 1, 0, yes
3334410377,  lucianosulis, 1, 1, 0, yes
1085863038,  tizia_b, 2, 2, 0, yes
539107366,  saravinciguerr1, 1, 1, 0, yes
118104636,  angcolo, 1, 1, 0, yes
794174439072133120,  GeoSkill, 3, 1, 2, no
129505560,  juliocuva, 1, 1, 0, yes
1004239573,  GingoGio, 3, 1, 2, no
567248619,  GMassanova, 2, 2, 0, yes
516483708,  sironidepalma, 1, 1, 0, yes
2415181569,  1950_anna, 2, 2, 0, yes
149040954,  anebo_mk, 1, 1, 0, yes
268992090,  DCiulli, 2, 2, 0, yes
1295805648,  poa_cruel_news, 1, 1, 0, yes
1011603156,  clalupClaudio, 2, 1, 1, neutral
631950372,  alexiula, 1, 1, 0, yes
351651824,  candidorai, 1, 1, 0, yes
2501334992,  stalby73, 1, 1, 0, yes
398784065,  OperaFisista, 1, 1, 0, yes
165393062,  ManiTheMaster, 1, 1, 0, yes
362386211,  filomenatiano, 1, 1, 0, yes
104566182,  revengeCat, 2, 1, 1, neutral
2853390027,  CapodaglioMario, 1, 1, 0, yes
2955103529,  TerlizziGerardo, 2, 2, 0, yes
351609587,  gmhonich, 2, 1, 1, neutral
54874852,  Il_Caccia, 1, 1, 0, yes
291763143,  leoapples8, 1, 1, 0, yes
1134403255,  EBadella, 3, 1, 2, no
49961429,  alfiocapizzi, 1, 1, 0, yes
3600926057,  esteba_rivera, 1, 1, 0, yes
150652786,  ShivaBakta, 2, 2, 0, yes
4793622923,  ovettoscorretto, 1, 1, 0, yes
306794064,  valedavid81, 2, 2, 0, yes
213752633,  7lo66, 2, 2, 0, yes
2437639697,  giancarlograsd4, 1, 1, 0, yes
2267240212,  ColottoR, 2, 2, 0, yes
3346940596,  francescacovel6, 1, 1, 0, yes
555956809,  xenossy, 2, 2, 0, yes
773231942498156546,  MikettaP, 2, 2, 0, yes
424995632,  ade7015, 1, 1, 0, yes
414884582,  Redhou_, 1, 1, 0, yes
1147664360,  Pier68Paolo, 1, 1, 0, yes
273965058,  AnitaSenesi, 1, 1, 0, yes
48340229,  anto_sacchetti, 1, 1, 0, yes
148099072,  kleinkampf, 1, 1, 0, yes
803244642,  dubo984, 1, 1, 0, yes
1498821860,  _beneathsurface, 4, 2, 2, neutral
428023928,  saraverta, 1, 1, 0, yes
56453979,  MirkovicRN, 1, 1, 0, yes
112225063,  Capitan8, 1, 1, 0, yes
2822459200,  bveronica94, 1, 1, 0, yes
838540488,  PassignanoRenzi, 2, 1, 1, neutral
465380464,  GiorgioArchers, 3, 3, 0, yes
27630638,  ManuRossi, 1, 1, 0, yes
1325552473,  LTosetto, 1, 1, 0, yes
2899180222,  tzk239, 1, 1, 0, yes
533321787,  AndreaBondanini, 1, 1, 0, yes
2939274333,  UilFplCitMetRM, 1, 1, 0, yes
466494379,  roccochiara1, 1, 1, 0, yes
735852610499059712,  Timberwolf1975, 2, 2, 0, yes
2306553491,  bigsleepy1, 1, 1, 0, yes
440021056,  valregnier, 1, 1, 0, yes
713760286235340800,  Alessia04203677, 1, 1, 0, yes
554662429,  ely_spocchiosa, 1, 1, 0, yes
47912534,  antnqu, 3, 1, 2, no
464707055,  valecogitat, 1, 1, 0, yes
467292686,  maxcirrito, 1, 1, 0, yes
1354697688,  OFrancois60200, 1, 1, 0, yes
380513422,  stefoben, 1, 1, 0, yes
2877640233,  damianifaceboo1, 1, 1, 0, yes
1219907660,  FilippoArata, 1, 1, 0, yes
437652897,  t_campanella, 1, 1, 0, yes
1485232748,  Sguscioo, 1, 1, 0, yes
55044693,  trovalavia, 1, 1, 0, yes
252628345,  dettori78, 1, 1, 0, yes
2578143551,  mannoccisilvia, 1, 1, 0, yes
2351735574,  OrazioAzzato, 1, 1, 0, yes
1895234743,  riccabianco83, 1, 1, 0, yes
248362304,  BrahimMaarad, 1, 1, 0, yes
2752773988,  cristinapitzal1, 4, 1, 3, no
2290500725,  115Patrizia, 2, 1, 1, neutral
1326873224,  Salvalentino86, 5, 5, 0, yes
2426871891,  misslollo98, 1, 1, 0, yes
2194870025,  pepito2402, 1, 1, 0, yes
783950660836491264,  EnricoGasperin3, 1, 1, 0, yes
1231873500,  MarcelloPesce2, 1, 1, 0, yes
4892583579,  doctor_mic82, 1, 1, 0, yes
805759357283692544,  Patri19942011, 1, 1, 0, yes
478515247,  LUISABONATO, 1, 1, 0, yes
242192902,  guITALYro, 3, 2, 1, yes
2706418110,  sugutierrez2011, 1, 1, 0, yes
2264883161,  CookersThe, 1, 1, 0, yes
2409566784,  dolomia4ever, 10, 9, 1, yes
246089683,  AmericoCarissim, 1, 1, 0, yes
2397628801,  Red_Arrow89, 1, 1, 0, yes
63185758,  nicovam, 1, 1, 0, yes
3044692557,  GianpieroRima, 1, 1, 0, yes
1304437381,  spinarosanna, 11, 1, 10, no
542957453,  renatoseller, 2, 2, 0, yes
533593257,  antonellaturchi, 1, 1, 0, yes
1542853177,  Daniele_Grc, 1, 1, 0, yes
785376573604102144,  luigia_ma, 1, 1, 0, yes
164808304,  pantyhosewet, 1, 1, 0, yes
735159560621559812,  mmmesoclise, 1, 1, 0, yes
2354413007,  rcclra73, 2, 2, 0, yes
448247249,  thomasson77, 2, 2, 0, yes
2732282940,  terrysimbaelsa, 1, 1, 0, yes
772159086821507072,  Rossell67313, 1, 1, 0, yes
417266970,  VittorioAlfier2, 2, 2, 0, yes
200264886,  pablodb1, 1, 1, 0, yes
260925269,  maxabbru, 3, 2, 1, yes
3897876382,  SarahBellinazzi, 1, 1, 0, yes
171447577,  skyqueen1991, 13, 2, 11, no
1874501234,  Marco_Mandorli, 1, 1, 0, yes
1322447304,  mau50rm, 4, 1, 3, no
156006854,  cas_33, 1, 1, 0, yes
789391176071729152,  SiriaGuerrieri, 1, 1, 0, yes
135634877,  CallMeFlemeth, 1, 1, 0, yes
435042938,  araujo_ady, 1, 1, 0, yes
55186344,  EmaPedilarco, 1, 1, 0, yes
239405651,  GiorgiaPapasso, 3, 3, 0, yes
1219782414,  barbarambra, 1, 1, 0, yes
404390428,  DavidGigli, 4, 3, 1, yes
422847076,  michelebruno4, 2, 2, 0, yes
761173147546779649,  MARCaraibi, 1, 1, 0, yes
796616826180472832,  carmenmia2016, 2, 1, 1, neutral
149646610,  GiuliaPagano, 1, 1, 0, yes
28640510,  DaDaful_Puck, 1, 1, 0, yes
59793556,  Allegradimente, 1, 1, 0, yes
440979939,  gaiasmiler, 1, 1, 0, yes
434270369,  satamalum, 2, 1, 1, neutral
320310173,  maurimala, 1, 1, 0, yes
1446780848,  GioCacace78, 1, 1, 0, yes
3554869815,  FraPrez96, 1, 1, 0, yes
53948808,  pilo7, 1, 1, 0, yes
3063998776,  FNCatania, 3, 3, 0, yes
3824854281,  albetiamo1, 1, 1, 0, yes
2966200155,  staybehind7, 3, 3, 0, yes
208158894,  Erika_Andrea74, 1, 1, 0, yes
3424084941,  nicog971, 1, 1, 0, yes
3007618167,  soofiassmile, 1, 1, 0, yes
998912917,  elmarino1000, 1, 1, 0, yes
1318314925,  LauraCassisi, 2, 2, 0, yes
1011158641,  Antoine_82, 1, 1, 0, yes
524257238,  EANOMIS, 3, 1, 2, no
326682973,  FuckYeaWilliams, 1, 1, 0, yes
3260408699,  albe_esisto, 3, 3, 0, yes
432843543,  LDInnocenti, 4, 4, 0, yes
2719601069,  katardino, 1, 1, 0, yes
428135247,  DaMurtas, 7, 1, 6, no
84053532,  emilianoeusepi, 1, 1, 0, yes
706137729864704000,  NugKP, 2, 2, 0, yes
2856831365,  cammaroto61, 1, 1, 0, yes
233214088,  alexjr1300, 1, 1, 0, yes
766761611965128704,  CamProietto, 2, 2, 0, yes
467330717,  clucciarini, 1, 1, 0, yes
181590262,  partenopeo82, 2, 2, 0, yes
87638937,  Giuseppebre, 3, 3, 0, yes
2975394111,  Athena66747628, 1, 1, 0, yes
1744121298,  glp1962, 1, 1, 0, yes
1115056111,  onedmalikhug, 1, 1, 0, yes
3083502694,  CorvojoeN, 1, 1, 0, yes
742085545044611072,  Giovannatanzi47, 1, 1, 0, yes
2761341579,  la_pinu, 3, 3, 0, yes
226326062,  AlbertoCaranti, 4, 1, 3, no
562334258,  BrotzuFranca, 3, 2, 1, yes
76395965,  giovakarma, 1, 1, 0, yes
950030191,  dac4856, 1, 1, 0, yes
216690200,  Ilportatore, 1, 1, 0, yes
16620601,  permorgana, 2, 2, 0, yes
303754388,  Twittefan12, 1, 1, 0, yes
483200355,  KappaLaudio, 2, 1, 1, neutral
86276945,  Dankira, 1, 1, 0, yes
2391404336,  curlyseyes, 1, 1, 0, yes
363674939,  IlariaScalabri, 1, 1, 0, yes
426029365,  MissNessunoMai, 1, 1, 0, yes
88885558,  apallavicino, 1, 1, 0, yes
563297979,  DryTonic76, 1, 1, 0, yes
227631120,  IvanovMoscow, 1, 1, 0, yes
460516696,  DamianoOrsi1, 1, 1, 0, yes
455997804,  dueffe2o, 1, 1, 0, yes
2958307780,  XJaureguiseyesX, 1, 1, 0, yes
279655508,  Tibetans, 1, 1, 0, yes
1112509458,  viale_chiara, 1, 1, 0, yes
1369503762,  _DemisMiley, 1, 1, 0, yes
2217605910,  MIPUaccelerator, 1, 1, 0, yes
159634407,  crisforconi, 1, 1, 0, yes
622645526,  tpagnini, 1, 1, 0, yes
420618787,  StefPir, 2, 2, 0, yes
67851783,  lysian67, 1, 1, 0, yes
799589452641423360,  paolapedra10, 1, 1, 0, yes
1315279232,  hameksamir, 1, 1, 0, yes
278110663,  merinialda, 2, 1, 1, neutral
2863254985,  cesare_74, 2, 2, 0, yes
65866093,  Favola666, 1, 1, 0, yes
2149548671,  ElenaSantim, 2, 2, 0, yes
58900615,  franceskasa, 2, 2, 0, yes
3221578144,  Meritxell_78, 1, 1, 0, yes
215693058,  FrancescOsamlas, 1, 1, 0, yes
924155780,  phamelacurzi, 2, 1, 1, neutral
4041487727,  Loredan70266357, 2, 1, 1, neutral
457412951,  sandromarenko, 1, 1, 0, yes
436942842,  NoemiDeMarco, 2, 2, 0, yes
23116580,  lgarbell, 1, 1, 0, yes
393517939,  sara_voza, 1, 1, 0, yes
1118849556,  E_Silvestrin, 1, 1, 0, yes
3049578399,  FraLamanna1981, 2, 2, 0, yes
3299169413,  MatteoShevao65, 1, 1, 0, yes
41782278,  emmanuelememeb, 1, 1, 0, yes
373320282,  TestiFra, 2, 2, 0, yes
539890912,  zeroproblemi1, 1, 1, 0, yes
305608187,  d_daso, 1, 1, 0, yes
498295302,  robertoricci20, 1, 1, 0, yes
2610376862,  ileanadaghino, 1, 1, 0, yes
412275301,  pietro_bembo, 1, 1, 0, yes
390942107,  danirossi3, 2, 1, 1, neutral
372264289,  giuliaViggi, 4, 1, 3, no
4373760141,  P2015JB, 3, 2, 1, yes
3240884278,  dreamerowx, 1, 1, 0, yes
849900769,  enristradi, 1, 1, 0, yes
908383837,  MagnumPgr, 1, 1, 0, yes
116011850,  sellyp, 1, 1, 0, yes
221318149,  MaryAnto1986, 2, 1, 1, neutral
551188581,  soraya_melguizo, 1, 1, 0, yes
731103578132230144,  andryviol, 1, 1, 0, yes
3514120642,  Di_Ci_, 1, 1, 0, yes
104573506,  girotripoli, 2, 1, 1, neutral
107497796,  RobbinSimmons7, 2, 2, 0, yes
79124132,  elhigadodmarita, 1, 1, 0, yes
47896860,  andpizzolato, 1, 1, 0, yes
553396754,  paul_cude, 2, 2, 0, yes
2431994833,  frailvharry, 1, 1, 0, yes
1269925304,  alessia253, 1, 1, 0, yes
345020176,  Uberbored_80, 1, 1, 0, yes
1543225994,  dvezzosi_it, 1, 1, 0, yes
306363599,  LaCris297, 1, 1, 0, yes
2745010721,  giorgiassenz31, 1, 1, 0, yes
2828427667,  MarellaMatsumot, 4, 4, 0, yes
247664788,  Massivincenzi, 2, 2, 0, yes
274945913,  FraGuttuso, 1, 1, 0, yes
555187453,  whiteoleander87, 2, 2, 0, yes
117522489,  spatolaa, 2, 1, 1, neutral
986392339,  LibieCousteau, 1, 1, 0, yes
475021467,  FertAetas, 1, 1, 0, yes
295071149,  giofox79, 3, 1, 2, no
412264581,  GiusFiorentino, 1, 1, 0, yes
805547279457337344,  panciopa81, 1, 1, 0, yes
331030643,  DanielaSchicchi, 4, 3, 1, yes
340780358,  Alesschicca, 1, 1, 0, yes
278717968,  MarioNespereira, 2, 2, 0, yes
344802896,  fsrana74, 3, 1, 2, no
64159909,  BarbaraFestelli, 2, 2, 0, yes
517843064,  donaciac, 1, 1, 0, yes
224958888,  MZandonini, 1, 1, 0, yes
480657530,  luanacatalani, 1, 1, 0, yes
422931234,  elgabongiorno, 1, 1, 0, yes
700729705490681856,  omonimia, 1, 1, 0, yes
1322580582,  welovecato, 1, 1, 0, yes
2888898605,  adorelvke, 1, 1, 0, yes
784889558441877504,  __barbarella__, 1, 1, 0, yes
3300521663,  loustheleader_, 1, 1, 0, yes
1156535916,  i_zago, 1, 1, 0, yes
2592883342,  andergsolana, 1, 1, 0, yes
2938198527,  allweneedsfaith, 1, 1, 0, yes
37077204,  AM_DArcangelis, 1, 1, 0, yes
3088790245,  egidioan, 3, 2, 1, yes
3599372182,  Lucky89957060, 1, 1, 0, yes
3187900075,  filippoclo, 1, 1, 0, yes
15735970,  alexfoti, 2, 2, 0, yes
533480981,  fedetox, 1, 1, 0, yes
435899363,  AlbertoMerlo76, 1, 1, 0, yes
312873833,  paolonobud, 1, 1, 0, yes
216372138,  gaelondon, 1, 1, 0, yes
160340162,  DadoRogfed93, 1, 1, 0, yes
468352501,  elenavilla3, 2, 2, 0, yes
216019118,  ggnacho, 1, 1, 0, yes
22183566,  chiarabassani, 1, 1, 0, yes
447010531,  Lelecottero, 1, 1, 0, yes
269344604,  Llibertferri, 1, 1, 0, yes
388297258,  Escapewithoran, 1, 1, 0, yes
368377987,  c_cantore, 1, 1, 0, yes
4632622482,  Eder_73, 1, 1, 0, yes
948427543,  vmercas005, 1, 1, 0, yes
1272331483,  syriana60, 1, 1, 0, yes
513002093,  ila_piccinotti, 1, 1, 0, yes
2986075486,  emi9173, 1, 1, 0, yes
277493361,  EnghelaBertelli, 1, 1, 0, yes
713051216536870912,  vr1774, 1, 1, 0, yes
233202081,  RosaDiVilio, 3, 3, 0, yes
15853759,  laget, 1, 1, 0, yes
775340473875591168,  Farcao1927, 2, 2, 0, yes
249067834,  stefanolusa, 8, 8, 0, yes
435327100,  gabry_cat, 1, 1, 0, yes
39952773,  carlottarumori, 3, 3, 0, yes
580012338,  davidonati, 1, 1, 0, yes
2198642988,  MarisaGherardi, 2, 2, 0, yes
1372100678,  andreagiordi, 1, 1, 0, yes
1272940472,  Lucrizzzz, 1, 1, 0, yes
707621072003317761,  GraziaPia_Tecla, 1, 1, 0, yes
968170722,  maridesi9624, 1, 1, 0, yes
978611755,  ManuelaPerrone, 1, 1, 0, yes
2728414377,  anitafiaschetti, 1, 1, 0, yes
18293363,  anna_oliet, 1, 1, 0, yes
3979838963,  MarcoFanc, 2, 2, 0, yes
29106150,  Mar_Ni, 2, 2, 0, yes
805051227834843136,  EduardoJC97, 1, 1, 0, yes
464685240,  Ignazio62, 1, 1, 0, yes
418584684,  matragrano, 2, 2, 0, yes
288871442,  uranio22, 1, 1, 0, yes
297457230,  AlessioRiccio, 1, 1, 0, yes
78277756,  mimmus75, 1, 1, 0, yes
34961421,  jack_blanga, 1, 1, 0, yes
403606449,  SergiodelOlmoC, 1, 1, 0, yes
479744359,  JLennon77, 1, 1, 0, yes
492004907,  DavidAbba_9, 1, 1, 0, yes
26547016,  millydilorenzo, 1, 1, 0, yes
2871744439,  sabatinoc85, 1, 1, 0, yes
1953894126,  Marco_Fila, 1, 1, 0, yes
203869645,  theoldcarmilla, 1, 1, 0, yes
8482792,  Nikbike, 1, 1, 0, yes
1063598154,  ta_piero, 2, 2, 0, yes
1255600675,  balbolisa, 1, 1, 0, yes
390385285,  lucianodezotti, 1, 1, 0, yes
404279648,  italolinfante, 1, 1, 0, yes
3622861097,  Amvethyst, 1, 1, 0, yes
1009531759,  carlopeluso_, 1, 1, 0, yes
1053214482,  rob_corra, 1, 1, 0, yes
786658802,  eniubo, 1, 1, 0, yes
286736622,  giulioball, 1, 1, 0, yes
582617281,  La_BalenaBianca, 1, 1, 0, yes
119162341,  GiorgioFischer, 1, 1, 0, yes
3356706585,  iustoemilio, 1, 1, 0, yes
470216061,  barbaranox, 1, 1, 0, yes
2439757830,  dhamma_76, 2, 2, 0, yes
2814777110,  namisexero, 1, 1, 0, yes
290746268,  GiuliaLibrandi, 1, 1, 0, yes
258918710,  Giosh91, 1, 1, 0, yes
1213201093,  heimbergch, 1, 1, 0, yes
3012090543,  BabyLama007, 3, 2, 1, yes
67574568,  AlexSamele, 10, 1, 9, no
44224690,  gmdn, 1, 1, 0, yes
171657407,  robertodst, 2, 2, 0, yes
298502247,  giraldo_ale, 2, 1, 1, neutral
537568744,  mParrels, 1, 1, 0, yes
887304968,  sunshvine, 2, 2, 0, yes
517405978,  FabBeronesi, 2, 2, 0, yes
2382375131,  gabrielesolcia, 1, 1, 0, yes
170775190,  nfarri, 1, 1, 0, yes
548001064,  CesnaBlancic08, 2, 1, 1, neutral
410057202,  headhunter_75, 1, 1, 0, yes
165350882,  Piggioserra, 1, 1, 0, yes
56459492,  Pulcettosa, 2, 1, 1, neutral
830584357,  cianick, 1, 1, 0, yes
307791956,  ziozetti, 4, 2, 2, neutral
23672753,  ranyuu, 1, 1, 0, yes
1032311094,  AntonioAbate12, 1, 1, 0, yes
931570220,  BenAngri, 2, 1, 1, neutral
188917143,  alessfa, 1, 1, 0, yes
1209785708,  Doctor__Flower, 1, 1, 0, yes
55889048,  pablets86, 2, 2, 0, yes
550061396,  muzzarca, 7, 3, 4, no
1172771882,  AntiGufo, 1, 1, 0, yes
434265671,  AvvStefania, 2, 2, 0, yes
367923831,  RobDeMaddi, 1, 1, 0, yes
2824517648,  thechronicleit, 2, 2, 0, yes
931231916,  mpmagic92, 1, 1, 0, yes
241470790,  erikarcn, 1, 1, 0, yes
176410109,  Danili23, 1, 1, 0, yes
1260103826,  edujordancruz, 1, 1, 0, yes
1087094706,  parodi_lucio, 3, 1, 2, no
4330314027,  SaggezzaNews, 15, 8, 7, yes
265335910,  lmcastaldi, 4, 1, 3, no
14760180,  moocca, 1, 1, 0, yes
497180474,  _4almighty, 2, 2, 0, yes
215065191,  __effe, 1, 1, 0, yes
4518207220,  robrench86, 1, 1, 0, yes
1374498684,  P_Rocchetti87, 1, 1, 0, yes
254246293,  7mara5, 1, 1, 0, yes
1647285390,  salvAuri, 1, 1, 0, yes
20323844,  BettyPav, 4, 2, 2, neutral
401064704,  FedyPerry, 1, 1, 0, yes
2949402237,  DemocraziAlert, 13, 6, 7, no
2362798963,  GiuliaFicchi93, 1, 1, 0, yes
802969043556831232,  CarolinaVallese, 1, 1, 0, yes
423733162,  ilbobbe79, 2, 1, 1, neutral
596711825,  valedanesi, 2, 2, 0, yes
858430160,  Franz_Visca, 1, 1, 0, yes
261386924,  jjruizujaen, 2, 2, 0, yes
3002121761,  palonzio90, 2, 2, 0, yes
762360667219329024,  CristinaVallin2, 3, 3, 0, yes
1352930988,  RodrigoCarrega, 1, 1, 0, yes
521529269,  mightaslirry, 1, 1, 0, yes
2935191887,  luigifontana24, 1, 1, 0, yes
473937553,  ValeV1512, 1, 1, 0, yes
947586588,  gutvm, 1, 1, 0, yes
113896242,  davidetierno, 1, 1, 0, yes
717742611,  mpbuccolieri, 1, 1, 0, yes
30960240,  Davideblu, 1, 1, 0, yes
2222183850,  EsercitoCrucian, 5, 1, 4, no
443233660,  Jacopog82, 1, 1, 0, yes
495277040,  paolapini2, 1, 1, 0, yes
3431990703,  mariala00775308, 1, 1, 0, yes
801018581018411008,  danileau, 1, 1, 0, yes
2356072980,  LuigiSorella, 3, 3, 0, yes
51037293,  robsavastano, 1, 1, 0, yes
713199883,  FederinaS, 1, 1, 0, yes
447322484,  SimoneGhitti, 1, 1, 0, yes
302610053,  DarrylDaReallst, 1, 1, 0, yes
804037361407578116,  Mario54785633, 2, 2, 0, yes
1036845894,  GiorgioMColombo, 1, 1, 0, yes
437441703,  maryjpond, 1, 1, 0, yes
234555458,  Lorenzo_Colombo, 2, 2, 0, yes
761278850286424064,  gabryprofff, 7, 1, 6, no
1976395807,  Ellistwitta, 1, 1, 0, yes
1851356982,  boboliver1968, 3, 3, 0, yes
286401962,  M2Mara, 1, 1, 0, yes
4861484467,  keesfiere485, 1, 1, 0, yes
4646292796,  colinetti80, 1, 1, 0, yes
772293494,  RPonassi, 1, 1, 0, yes
159552784,  Robvag, 1, 1, 0, yes
49752594,  badabi, 1, 1, 0, yes
2389539214,  rafpiantadosi, 1, 1, 0, yes
242948678,  GuidoMoltedo, 1, 1, 0, yes
2531011964,  StefaniaStefyss, 3, 1, 2, no
278952705,  Tonytruante, 4, 3, 1, yes
1160328079,  veschitelli, 7, 1, 6, no
55796259,  Giusi_, 1, 1, 0, yes
818654424,  filobaio, 1, 1, 0, yes
1579993796,  edidembi4, 1, 1, 0, yes
1005017562,  gsjamma764, 2, 1, 1, neutral
38146062,  loxmetender, 1, 1, 0, yes
2356672746,  NoemiAddicted, 1, 1, 0, yes
478642939,  75marcello, 1, 1, 0, yes
513732806,  MarcelloBabbi, 1, 1, 0, yes
398809482,  MaraMonti2, 1, 1, 0, yes
726702386,  _ForeverBb, 2, 2, 0, yes
309686668,  pjpaton, 1, 1, 0, yes
28977778,  erwanlescop, 1, 1, 0, yes
722463098,  Fedcittsovr, 2, 2, 0, yes
1861746218,  TerryCari89, 3, 3, 0, yes
630008725,  LuigiaFio, 3, 3, 0, yes
387063209,  ShinratenseiDom, 2, 2, 0, yes
499161119,  giuseppinaborr1, 2, 2, 0, yes
68927862,  gbonenti, 2, 2, 0, yes
2841483604,  fgutoledo1, 1, 1, 0, yes
176959832,  BeeElfo, 1, 1, 0, yes
410076512,  accab19, 2, 2, 0, yes
426425509,  MaurizioPierant, 1, 1, 0, yes
262600485,  ilravo, 1, 1, 0, yes
964899726,  Sara_CS27, 1, 1, 0, yes
864767977,  Gae95, 1, 1, 0, yes
1726428481,  matteodel79, 2, 1, 1, neutral
3986660902,  whirlingwindss, 1, 1, 0, yes
3383047540,  ciaccio83, 1, 1, 0, yes
288250040,  antonellaperego, 1, 1, 0, yes
2932329689,  123mariolino, 1, 1, 0, yes
548460337,  abbate_giulia, 1, 1, 0, yes
220724497,  se_elfie, 3, 1, 2, no
369003450,  Miryam85_DeRosa, 1, 1, 0, yes
1742405558,  cedrogallone, 1, 1, 0, yes
105147732,  giopav70, 1, 1, 0, yes
2370613668,  mrobinu, 1, 1, 0, yes
2328881514,  RaffaelloLupi, 2, 2, 0, yes
155196607,  _JustEle_, 1, 1, 0, yes
402845604,  stefano_romani, 2, 2, 0, yes
2746813361,  rabbitgllry, 1, 1, 0, yes
454177020,  Nello1896, 2, 1, 1, neutral
1588676886,  VincenzoTito90, 1, 1, 0, yes
830502684,  lorenzoscuda, 1, 1, 0, yes
2530546100,  CandideLiberte, 1, 1, 0, yes
358703224,  LukePanz, 1, 1, 0, yes
278054588,  leli1964, 1, 1, 0, yes
548415736,  LorenzoEFFEICS, 1, 1, 0, yes
617101023,  emamangiapia, 1, 1, 0, yes
435917137,  dani_laudicina, 1, 1, 0, yes
1916730854,  margheritatb1, 1, 1, 0, yes
728060804277411840,  te2_te22, 1, 1, 0, yes
1095179161,  EspostiAndrea, 1, 1, 0, yes
2929356941,  PintusVp, 1, 1, 0, yes
2177788477,  LibraryWarrior6, 2, 2, 0, yes
799220357303562240,  Rainewsroom24, 1, 1, 0, yes
396778217,  blidonni, 1, 1, 0, yes
460628395,  paoloerusso, 1, 1, 0, yes
2210726071,  SimoRazzano, 1, 1, 0, yes
10703162,  AvvDeMarchis, 4, 1, 3, no
144168169,  MarGioVel, 1, 1, 0, yes
22036033,  EasyInve, 2, 1, 1, neutral
351551003,  coccovalentina, 1, 1, 0, yes
1092375967,  tomdimaria3, 2, 2, 0, yes
744561296859860992,  Xhdjdj4, 1, 1, 0, yes
3254278582,  vccciccio, 1, 1, 0, yes
753675279420235776,  marco130772, 3, 2, 1, yes
403325692,  SimoPecchio, 2, 1, 1, neutral
2367176927,  itsmatidude, 1, 1, 0, yes
3130653934,  Apocalipto65, 1, 1, 0, yes
83412039,  RomyPhoto2, 1, 1, 0, yes
127575937,  robyg70, 1, 1, 0, yes
277955015,  salvo_dieseltec, 1, 1, 0, yes
97274260,  giulyval, 1, 1, 0, yes
2751861019,  cavaangela1, 2, 2, 0, yes
802664828141764608,  shipstellari, 1, 1, 0, yes
767076053907046400,  jiplbf, 1, 1, 0, yes
262823312,  agrumi58, 1, 1, 0, yes
2669653330,  NekoMalaika, 6, 5, 1, yes
294852352,  massimomessina1, 1, 1, 0, yes
143463688,  Giordanofornoni, 1, 1, 0, yes
432742236,  mariomagagnino, 1, 1, 0, yes
458605077,  ACorsi1971, 2, 1, 1, neutral
4187675614,  dinascaturro68, 1, 1, 0, yes
539949211,  AntonioAzara, 1, 1, 0, yes
844349287,  dav_fran, 2, 2, 0, yes
15708776,  lucabaiguini, 1, 1, 0, yes
302019918,  guidolopardo, 2, 2, 0, yes
1268953866,  StaserasolounTG, 1, 1, 0, yes
932848080,  paoloadami1970, 2, 2, 0, yes
197894056,  PierPerry, 1, 1, 0, yes
213701988,  nicofiorente, 1, 1, 0, yes
2984562905,  ilBossdiDos, 1, 1, 0, yes
789378738093977601,  asrlupo1927, 1, 1, 0, yes
496075532,  gioman73, 1, 1, 0, yes
508877148,  NoemiSorice, 1, 1, 0, yes
872455638,  natoli_chiara, 1, 1, 0, yes
632758356,  roAtzori, 2, 1, 1, neutral
751839486,  laflagio, 2, 2, 0, yes
269809161,  David_vanH, 1, 1, 0, yes
2604434907,  annascalfati, 1, 1, 0, yes
2274234895,  stefanocarbone9, 1, 1, 0, yes
790497677888856064,  SarracinoElisa, 1, 1, 0, yes
104445607,  rvurchio, 1, 1, 0, yes
738960168768180224,  EsterSpaziani, 3, 1, 2, no
1104598880,  luisapagliarani, 6, 1, 5, no
1173247711,  gingolbello, 2, 2, 0, yes
2238780044,  Mostro_Biscotto, 4, 2, 2, neutral
1107438535,  evamarghe, 1, 1, 0, yes
3431276171,  ggianmarco69, 1, 1, 0, yes
798712404288958464,  minion0382, 1, 1, 0, yes
1360157226,  lisacavazzoni, 1, 1, 0, yes
621035326,  stefanomannucc1, 1, 1, 0, yes
69098241,  matteo_melloni, 2, 1, 1, neutral
301451582,  serenaanstasio, 1, 1, 0, yes
753931328664535040,  alessiamil97, 3, 3, 0, yes
713760287573348355,  NewBalance05, 1, 1, 0, yes
3064377281,  ColomboIolanda, 1, 1, 0, yes
1857320594,  salvoverde, 11, 11, 0, yes
1974589638,  francescapagl16, 1, 1, 0, yes
939170569,  tonlizet08, 5, 1, 4, no
1102371788,  antieccezionale, 1, 1, 0, yes
114519662,  MarcoCalise, 1, 1, 0, yes
504617043,  cadairatt, 1, 1, 0, yes
654283,  ztomiolo, 2, 2, 0, yes
800544867864559616,  ravizza_fabio, 1, 1, 0, yes
369435498,  ibiskoseditrice, 1, 1, 0, yes
781880881900380164,  Fabrizi87986591, 4, 1, 3, no
407635325,  ETidili, 1, 1, 0, yes
486933064,  SaCu_J, 1, 1, 0, yes
1427933670,  babbooshi, 1, 1, 0, yes
473723290,  GianluigiLentin, 1, 1, 0, yes
555125409,  EasyDiplomacy, 1, 1, 0, yes
2815325631,  EmilioTrotti, 1, 1, 0, yes
461016189,  carmenele79, 1, 1, 0, yes
1104120920,  francy9823, 1, 1, 0, yes
1614875251,  adwoa_nicoletta, 1, 1, 0, yes
305780639,  iMilanista, 1, 1, 0, yes
1286652252,  Cristifei, 1, 1, 0, yes
1531023738,  PistanaRita, 1, 1, 0, yes
592101011,  DealexUmberto, 2, 2, 0, yes
407364224,  RedaBellal, 1, 1, 0, yes
2358169878,  Emininnik, 1, 1, 0, yes
2737405121,  piacentinigianl, 1, 1, 0, yes
364394005,  stefaniabafaro, 1, 1, 0, yes
428263420,  BuonomanoSilvia, 1, 1, 0, yes
4886669728,  KristoRm, 2, 2, 0, yes
3115019001,  stefano_cannas, 2, 2, 0, yes
363334207,  MirkoCesauri, 1, 1, 0, yes
782264242007339009,  IlRonin, 6, 6, 0, yes
1913166649,  tanillo84, 1, 1, 0, yes
142208079,  un_cuore_timido, 1, 1, 0, yes
1402483328,  GiuliaGirardi8, 1, 1, 0, yes
52413849,  davidewop, 1, 1, 0, yes
1065754602,  AntDemartis, 1, 1, 0, yes
1333266062,  Magnitudo59, 2, 2, 0, yes
900445982,  fabiotagliavia, 7, 6, 1, yes
715870473486209024,  SiDr321, 1, 1, 0, yes
263707432,  gabrielbosc, 1, 1, 0, yes
3749465776,  GiacomoBendo, 1, 1, 0, yes
786552222,  SandriGiulia, 1, 1, 0, yes
288321616,  abruzzoinpiazza, 2, 2, 0, yes
416370078,  enribarbieri, 4, 1, 3, no
873830336,  luisaMononoke, 2, 2, 0, yes
870462734,  fede_gratton, 2, 2, 0, yes
2617567862,  preziosofra, 2, 2, 0, yes
110396763,  JacZan, 1, 1, 0, yes
69696487,  redflat, 2, 2, 0, yes
1616122736,  LuigiT77, 1, 1, 0, yes
1515667106,  DiaDomrob, 1, 1, 0, yes
46369216,  FrancescaDB, 1, 1, 0, yes
607265183,  ChemistLele, 1, 1, 0, yes
2639918968,  m_pupita, 6, 2, 4, no
4410896073,  Iasdivinas, 1, 1, 0, yes
787704652326400000,  GiulianoL23, 1, 1, 0, yes
994850227,  UnDueTreTweet, 1, 1, 0, yes
2962387389,  fedvez, 1, 1, 0, yes
490432115,  sasabruno84, 1, 1, 0, yes
2663707394,  NotizieItalia1, 1, 1, 0, yes
224658838,  MagMiglio, 1, 1, 0, yes
561565372,  BenigniPietro, 1, 1, 0, yes
2449816968,  bellkethatboy, 1, 1, 0, yes
272129899,  enricodelloioio, 1, 1, 0, yes
29315272,  slowfra, 2, 1, 1, neutral
2944681743,  roberta_ripa, 2, 2, 0, yes
439208118,  cld_mzz, 1, 1, 0, yes
1412754547,  Paesedellanima, 2, 1, 1, neutral
1014738026,  frenk_franco, 6, 2, 4, no
2244974332,  cuba98w, 2, 2, 0, yes
1063898798,  Gazzabin_Andrea, 1, 1, 0, yes
1575768560,  Briga_M97, 1, 1, 0, yes
1171490287,  Emmeemme2Maria, 1, 1, 0, yes
776268201281851392,  dipsetmvmi, 1, 1, 0, yes
1231663231,  simo_donofrio, 1, 1, 0, yes
67706268,  ruggerorazza, 1, 1, 0, yes
45125424,  Themistocles89, 1, 1, 0, yes
275741325,  filocolo_, 4, 2, 2, neutral
368927198,  Ventura_Stefano, 1, 1, 0, yes
406127621,  franpiace, 10, 2, 8, no
402044163,  FedericaDeGuio, 1, 1, 0, yes
749913490987552769,  jimjoneskoolai2, 1, 1, 0, yes
799279874057891840,  malefico_q, 1, 1, 0, yes
501706273,  fadebellis, 4, 1, 3, no
937129249,  ChiccaTorchia, 2, 2, 0, yes
227323757,  trentinoinblu, 1, 1, 0, yes
1017976968,  mauro_ortolano, 1, 1, 0, yes
606223611,  augustogoio, 1, 1, 0, yes
525337793,  CleliaCaraccia, 1, 1, 0, yes
45305228,  giut88, 2, 2, 0, yes
52522751,  POQUI, 1, 1, 0, yes
305670996,  workubitch, 1, 1, 0, yes
273686840,  Fedbindi, 1, 1, 0, yes
9220912,  akari74, 1, 1, 0, yes
397393593,  andreastrano1, 1, 1, 0, yes
496136699,  AntoniettaToral, 1, 1, 0, yes
234504218,  stefanomarti, 7, 1, 6, no
423761628,  Marcovaldos, 3, 2, 1, yes
1374300920,  bark_mario, 1, 1, 0, yes
1425562926,  PiazzaaItalia, 2, 1, 1, neutral
928045495,  Iperborea_, 15, 15, 0, yes
1261644342,  antdel48, 3, 1, 2, no
3239592446,  MaialeDwaeji, 1, 1, 0, yes
349545540,  Rikydesa, 1, 1, 0, yes
1036904990,  conlamoka, 7, 7, 0, yes
562370831,  raffy210, 1, 1, 0, yes
3837156977,  RafelBekko, 1, 1, 0, yes
480661168,  CristinaNatoli, 1, 1, 0, yes
1109101213,  JJardon1, 1, 1, 0, yes
734690276703358976,  NEOHektor, 1, 1, 0, yes
3079210283,  MeSoRott0, 8, 1, 7, no
96632487,  GCCallie, 1, 1, 0, yes
3153663109,  matteobassan, 1, 1, 0, yes
717454569,  ilrenaso, 2, 2, 0, yes
2382623039,  frapietrella, 1, 1, 0, yes
489685300,  giacomo714, 1, 1, 0, yes
795261506413883392,  progresslombard, 2, 2, 0, yes
4824208840,  paolacapello3, 1, 1, 0, yes
54494349,  lightdelicious, 2, 2, 0, yes
53991436,  GiuGrilli, 2, 1, 1, neutral
418925289,  adri_LC, 1, 1, 0, yes
382586346,  Marianna_Sav, 1, 1, 0, yes
424358350,  walteragi, 3, 3, 0, yes
67314908,  bottiroli, 1, 1, 0, yes
2695840273,  Euro_Robber, 2, 1, 1, neutral
705341669403656192,  Outcityoutfit, 1, 1, 0, yes
1319044700,  paolo859092, 1, 1, 0, yes
425384503,  Bramatty, 1, 1, 0, yes
1292862438,  BdnAlbert, 1, 1, 0, yes
186055809,  xbeginagainx, 1, 1, 0, yes
327319065,  ubikfoggia, 1, 1, 0, yes
85398010,  KEVINUSSO, 1, 1, 0, yes
398209732,  NowhereLorenzo, 2, 1, 1, neutral
4860887602,  RiminiDi, 2, 2, 0, yes
595566539,  jeonghart, 1, 1, 0, yes
157361987,  lorenzomarchini, 4, 2, 2, neutral
572471627,  OmbrettaMaioran, 2, 1, 1, neutral
446155721,  CesareVola, 2, 2, 0, yes
397172451,  Davide_Perillo, 1, 1, 0, yes
2202996597,  s_bellavia, 1, 1, 0, yes
3115374447,  _sdemocratico, 1, 1, 0, yes
617904718,  AlessiaB1979, 1, 1, 0, yes
417359694,  gianlucaglugli, 1, 1, 0, yes
1320167498,  rigolina, 1, 1, 0, yes
805553772810424320,  Mauro16386688, 1, 1, 0, yes
1093072634,  LMahie, 1, 1, 0, yes
19623685,  bridges2italy, 1, 1, 0, yes
421041242,  sandropisu, 1, 1, 0, yes
105555455,  pausinisvoice, 1, 1, 0, yes
477093116,  emanuelaflammia, 5, 3, 2, yes
254683974,  __KabuKi__, 2, 1, 1, neutral
392727326,  NDerario, 1, 1, 0, yes
233178816,  ali_16_p, 1, 1, 0, yes
98385658,  marcoalessandri, 1, 1, 0, yes
438700577,  bacciottina, 1, 1, 0, yes
311481042,  Kayus_001, 1, 1, 0, yes
1443427730,  ClementeTeodon1, 5, 5, 0, yes
3023554648,  RinaRosu, 1, 1, 0, yes
614389828,  matte_di14, 1, 1, 0, yes
796394276020244480,  fabiomassimo322, 1, 1, 0, yes
52668867,  RenzoRosso, 1, 1, 0, yes
781546462069067776,  Gio_Delfi, 1, 1, 0, yes
239523558,  andrealovecraft, 1, 1, 0, yes
13252002,  ilgoa, 1, 1, 0, yes
2822702187,  charlizetherrun, 1, 1, 0, yes
326055853,  Falcerossa, 1, 1, 0, yes
2631509993,  Rebelle63760838, 1, 1, 0, yes
488789995,  rubens_103, 1, 1, 0, yes
141288943,  Annette1980, 1, 1, 0, yes
1519689577,  MikeBas87, 1, 1, 0, yes
3030080223,  DomenicoNA1967, 1, 1, 0, yes
114157032,  Mogadorf, 1, 1, 0, yes
1464350060,  austinvoicex, 1, 1, 0, yes
367011490,  ScarpelloSerena, 1, 1, 0, yes
1428556088,  giovannimastro6, 1, 1, 0, yes
620914838,  FMonderna, 1, 1, 0, yes
554957686,  FiarasSara, 1, 1, 0, yes
395234322,  ain_garcia, 1, 1, 0, yes
3288432659,  Franco_Benfi, 6, 2, 4, no
1437584052,  BiagioMoliterni, 1, 1, 0, yes
776334317857411072,  LorenzoUCBM, 1, 1, 0, yes
1417811960,  antovigibarty, 1, 1, 0, yes
45319683,  lcastagneri, 1, 1, 0, yes
290114076,  AleteiaIT, 1, 1, 0, yes
400299620,  gatto_matteo, 1, 1, 0, yes
469530751,  marco_valente_, 1, 1, 0, yes
46449015,  MassimoRoma, 8, 8, 0, yes
571780277,  MaraBardone, 1, 1, 0, yes
439177907,  nico7095, 1, 1, 0, yes
317831571,  maruko_84, 3, 1, 2, no
1924768903,  flopestelli, 4, 4, 0, yes
721263482,  ciaopigi, 1, 1, 0, yes
2908995107,  https_rosy, 2, 2, 0, yes
202383201,  Aleperdido, 2, 1, 1, neutral
51716181,  fedeborgogno, 2, 1, 1, neutral
257517267,  MGNapolitano, 1, 1, 0, yes
1271792294,  nobrain_storm, 1, 1, 0, yes
192658279,  smartyees, 1, 1, 0, yes
14238289,  gjoja, 1, 1, 0, yes
3424980839,  MaMarcoChi, 1, 1, 0, yes
805552638729265153,  drecavazzuti99, 1, 1, 0, yes
610040421,  manoskappa, 3, 3, 0, yes
222409931,  nevercube, 1, 1, 0, yes
616886078,  marattin, 5, 5, 0, yes
772100378057900033,  NemoInMatrix, 2, 1, 1, neutral
302608759,  matteoduranti10, 1, 1, 0, yes
456453383,  linolamb, 3, 1, 2, no
2195551592,  andreameli_meli, 3, 3, 0, yes
2735972217,  lexipopup, 1, 1, 0, yes
2850394315,  GravinaRocco, 2, 2, 0, yes
2662719205,  pino_manolo, 1, 1, 0, yes
497299724,  dariosordini1, 1, 1, 0, yes
263275512,  simo_b92, 2, 2, 0, yes
4812489255,  MutiCarla, 1, 1, 0, yes
551214413,  EnricoBernetti, 1, 1, 0, yes
2305061342,  Morelli_MarcoV, 1, 1, 0, yes
491438050,  michgrieco, 1, 1, 0, yes
231187717,  crimartella, 3, 2, 1, yes
370633527,  G_Cesano, 1, 1, 0, yes
292564453,  enzolerose10, 1, 1, 0, yes
1000319443,  IvanLocalzo, 2, 2, 0, yes
2884748220,  momotbk, 1, 1, 0, yes
3750796637,  gioale15, 3, 3, 0, yes
240340176,  gianluspin, 3, 3, 0, yes
195017882,  Lo_squinternato, 1, 1, 0, yes
347953519,  spike_sr71, 2, 2, 0, yes
833741882,  Stuntman_Mike93, 1, 1, 0, yes
532348218,  GiovanniFrulio, 1, 1, 0, yes
2531609483,  marik1976_pera, 1, 1, 0, yes
474967536,  Vittoriog82, 1, 1, 0, yes
26507319,  G4brielLo, 1, 1, 0, yes
126441228,  PabbloMC, 1, 1, 0, yes
424902617,  GiacomoBloisi, 1, 1, 0, yes
2939273031,  stesco74, 2, 2, 0, yes
4415415509,  DellaRoccaRuben, 6, 3, 3, neutral
228764254,  valesnail, 1, 1, 0, yes
4863834575,  MorneghiniH, 1, 1, 0, yes
714572211298897921,  PA4TRUMP2016, 1, 1, 0, yes
252755652,  Chiara_Formenti, 3, 1, 2, no
188723293,  stefanomunari, 1, 1, 0, yes
303734436,  TrishaThomasAP, 1, 1, 0, yes
2894534752,  V_Mordicchio, 1, 1, 0, yes
2937472426,  giuliasdeo, 1, 1, 0, yes
343913545,  finntastic78, 1, 1, 0, yes
2337039248,  giuliettanara, 2, 2, 0, yes
1165342207,  DonatellaBusini, 1, 1, 0, yes
924189342,  LigorioChantal, 1, 1, 0, yes
237857289,  Dada_Signo, 2, 2, 0, yes
63758976,  Aqualung61, 1, 1, 0, yes
2156097694,  manuelagatti_, 2, 1, 1, neutral
355606152,  watchmeidols, 1, 1, 0, yes
617399514,  DaniloMazzara, 1, 1, 0, yes
496250143,  ecoforumorg, 1, 1, 0, yes
475357970,  astragalo1, 2, 1, 1, neutral
368353188,  Ecodiprato, 1, 1, 0, yes
65922786,  Carlo_A_Macc, 4, 2, 2, neutral
268770130,  shesluna, 1, 1, 0, yes
181990736,  apancy, 1, 1, 0, yes
2330579884,  dumas_ma, 1, 1, 0, yes
416237400,  TommasoMancuso, 1, 1, 0, yes
120195742,  valeriaferone, 1, 1, 0, yes
3684132136,  Rodolfo14607379, 11, 6, 5, yes
4054223841,  astrojuanlu, 1, 1, 0, yes
2359502674,  ValZaff71, 1, 1, 0, yes
368333719,  gbalduin, 2, 1, 1, neutral
1615002390,  ill_pigna, 1, 1, 0, yes
427717964,  angelo_salerno, 1, 1, 0, yes
618579603,  andrea_bizon, 1, 1, 0, yes
1679201,  JackSegantini, 1, 1, 0, yes
1037841374,  FabioQuellaltro, 2, 2, 0, yes
321510042,  FulvioFrati, 1, 1, 0, yes
1362578334,  MagdaRoncaglia, 1, 1, 0, yes
510529704,  NildePaonessa, 6, 2, 4, no
725870553853100032,  MurffyJohn, 3, 3, 0, yes
393040603,  pa_lix, 1, 1, 0, yes
95295597,  Devabole, 3, 2, 1, yes
3205996847,  LSClementine, 1, 1, 0, yes
99138383,  veronicat83, 2, 2, 0, yes
102433630,  Autarchico, 1, 1, 0, yes
14742609,  MartiCst, 1, 1, 0, yes
1407951,  jcfalkenberg, 1, 1, 0, yes
267628677,  DaynaColored, 1, 1, 0, yes
501061708,  CaterinaDoglio, 1, 1, 0, yes
980074483,  gal_gio, 3, 2, 1, yes
428585709,  MarrellaMarco, 1, 1, 0, yes
159786218,  JoeChip77, 1, 1, 0, yes
3884169503,  Francescapirra3, 2, 2, 0, yes
154180320,  francescademart, 2, 1, 1, neutral
477106287,  covacev, 1, 1, 0, yes
1656173107,  BibboBaggins, 1, 1, 0, yes
2570682238,  marialuisabari, 1, 1, 0, yes
2795034179,  massavalent, 1, 1, 0, yes
408291042,  stefietodisco, 1, 1, 0, yes
789202840027750400,  FabySalvador1, 1, 1, 0, yes
757251812424577024,  CarpeDiem_57, 4, 4, 0, yes
2958400127,  lesal83, 1, 1, 0, yes
4857221537,  RickBath33, 1, 1, 0, yes
550238861,  poddaponti, 1, 1, 0, yes
548733815,  bettymanini, 1, 1, 0, yes
753269372949528576,  quovavis, 1, 1, 0, yes
2252710696,  Ivano_972, 1, 1, 0, yes
3223976823,  LukeFieldnesky, 1, 1, 0, yes
149657257,  GRAMARIZIA, 1, 1, 0, yes
2516067038,  adrianapolys, 3, 1, 2, no
516406696,  StefanoDalPraCa, 1, 1, 0, yes
548256134,  ILENIAINGUI, 1, 1, 0, yes
3424495275,  GAETANO31071958, 1, 1, 0, yes
2522389350,  kuklademetra, 2, 2, 0, yes
1006050012,  maurazamir, 1, 1, 0, yes
3065858355,  Flynnst2ne, 1, 1, 0, yes
3091747443,  graziap79, 10, 5, 5, neutral
801164245090058241,  avvjfPeruzzi, 1, 1, 0, yes
495929348,  jjscutton82, 1, 1, 0, yes
405551843,  damianosanna1, 1, 1, 0, yes
61186796,  ardiccioni, 1, 1, 0, yes
2189987572,  robutre, 1, 1, 0, yes
493311205,  CriCommisso, 1, 1, 0, yes
584840423,  lucabonti, 1, 1, 0, yes
1365340050,  carloghironi, 2, 2, 0, yes
732192637126623232,  albydonatella, 1, 1, 0, yes
980858180,  antonellabarra6, 3, 3, 0, yes
2332663479,  kingcabir, 1, 1, 0, yes
1039573423,  ZioJim, 1, 1, 0, yes
397173511,  60Mare, 1, 1, 0, yes
2955569189,  chiaraboll, 1, 1, 0, yes
2814374704,  rizio66, 1, 1, 0, yes
773148016488411136,  JLor1897, 3, 3, 0, yes
229969486,  ladydd69, 3, 2, 1, yes
1101694626,  fuoriscala13, 6, 6, 0, yes
3325539275,  mpvirgo75, 5, 4, 1, yes
2899427794,  mariacortese_pi, 1, 1, 0, yes
2823849070,  samantacellucc2, 1, 1, 0, yes
3137496366,  himem72, 5, 3, 2, yes
369490296,  sussisilvano, 1, 1, 0, yes
456636936,  EForenzi, 1, 1, 0, yes
802244169582440449,  Rebecca90675920, 1, 1, 0, yes
518501134,  loversuntold, 1, 1, 0, yes
2924963891,  Ff18Filo, 1, 1, 0, yes
3300593109,  niglio_mario, 3, 3, 0, yes
259331979,  domiziof, 1, 1, 0, yes
432969670,  Miskagr, 1, 1, 0, yes
770704986816872448,  Dario_Arry, 1, 1, 0, yes
340991415,  BarbaDaniele, 3, 3, 0, yes
399043688,  stocasticoTeo, 1, 1, 0, yes
776513891060813825,  desperate_rt, 2, 1, 1, neutral
429835426,  davide_spino, 1, 1, 0, yes
1069196982,  Pretty_Federica, 1, 1, 0, yes
205365120,  Okkiokearrivo, 1, 1, 0, yes
789387278363734016,  GiammarcoCilio, 1, 1, 0, yes
1456715186,  albertlanthaler, 1, 1, 0, yes
592154280,  catepru, 1, 1, 0, yes
2787323283,  CDyott, 1, 1, 0, yes
2541873392,  SalvatoreDelve2, 1, 1, 0, yes
98599407,  sara_389, 1, 1, 0, yes
305541513,  alienSandra, 2, 2, 0, yes
1160083722,  Popapo99, 1, 1, 0, yes
1313814055,  EuranetPlus, 1, 1, 0, yes
550126854,  RobertoCatzeddu, 1, 1, 0, yes
719076530756972544,  AngelaAlbergo, 1, 1, 0, yes
449731729,  VinceMattucci, 1, 1, 0, yes
203175327,  pizzahag, 1, 1, 0, yes
3025321877,  FreiburgFabiano, 2, 1, 1, neutral
230251192,  asantagi, 1, 1, 0, yes
2265356597,  lucalexguns, 1, 1, 0, yes
419375634,  Sara_Spitali, 7, 7, 0, yes
14692786,  perochan, 2, 1, 1, neutral
373635185,  jack_doc, 2, 2, 0, yes
619922781,  TalaricoSabrina, 3, 3, 0, yes
526809963,  mybeautypedia, 2, 2, 0, yes
24698016,  Maghdi, 1, 1, 0, yes
1219577718,  giodfz, 2, 2, 0, yes
320147231,  AleCones, 1, 1, 0, yes
118673832,  ulisse57, 1, 1, 0, yes
2382554467,  vertvigo, 1, 1, 0, yes
42954145,  aperdichizzi, 1, 1, 0, yes
290608640,  Tayla76, 1, 1, 0, yes
4228895379,  maralpoutine, 1, 1, 0, yes
153426563,  Vanil__LA, 1, 1, 0, yes
76925342,  gfrancione11, 1, 1, 0, yes
122118708,  piadinara77, 1, 1, 0, yes
2997035591,  ErikaBerynice, 1, 1, 0, yes
1210734379,  clamel66, 1, 1, 0, yes
447990549,  FregoSte, 2, 2, 0, yes
401180700,  antonTrillicoso, 1, 1, 0, yes
390199864,  francescabenati, 1, 1, 0, yes
76322339,  andrea181195, 1, 1, 0, yes
758850794800033793,  trymedej, 1, 1, 0, yes
1160960839,  DiniGiusy, 2, 1, 1, neutral
2149099038,  IsabelViele, 1, 1, 0, yes
428233040,  osvaldonastasi, 2, 2, 0, yes
148845076,  stefania62, 1, 1, 0, yes
997327320,  lamiaamerica, 1, 1, 0, yes
3002886147,  prettycolvd, 2, 2, 0, yes
3350507367,  labrunos, 1, 1, 0, yes
779220241826115584,  Emanuel85776615, 1, 1, 0, yes
2375207827,  StereKurt, 1, 1, 0, yes
388890339,  emiliocedola, 1, 1, 0, yes
91312079,  Lucareds85, 1, 1, 0, yes
760274252914421763,  NICEN0YA, 1, 1, 0, yes
201374216,  fersissi88, 1, 1, 0, yes
1043451,  pierluigir, 1, 1, 0, yes
413470048,  lucacifoni, 1, 1, 0, yes
1200946747,  thegreek1977, 1, 1, 0, yes
750963366,  gringoserra78, 2, 1, 1, neutral
16393904,  kristianfabbri, 1, 1, 0, yes
849934981,  laleamilano, 1, 1, 0, yes
519567603,  Vvaldesco, 1, 1, 0, yes
885245352,  ameliannaz, 2, 2, 0, yes
493878618,  roberto_carboni, 6, 2, 4, no
259106666,  pegnarol, 1, 1, 0, yes
460451651,  MoniaGarghe, 1, 1, 0, yes
11454032,  fabiosacco, 1, 1, 0, yes
139764514,  pinpin68, 2, 2, 0, yes
3367878088,  FrauDanielle, 1, 1, 0, yes
58685595,  Shamsnadir, 1, 1, 0, yes
4447577848,  TaVagnaccoinMoV, 1, 1, 0, yes
1431654500,  afornaser, 1, 1, 0, yes
389964532,  allessor50, 2, 2, 0, yes
1638828848,  FumusXse, 1, 1, 0, yes
18357481,  ideofugal, 1, 1, 0, yes
464150369,  camillasette, 1, 1, 0, yes
526824031,  lilianaalto, 1, 1, 0, yes
2432187224,  frarodolfo, 1, 1, 0, yes
1322990966,  luca7520, 1, 1, 0, yes
3368849687,  bot_innovation, 1, 1, 0, yes
408078043,  helenruss1, 1, 1, 0, yes
186426140,  Simy_Kaulitz, 1, 1, 0, yes
4849789397,  TourAroundItaly, 1, 1, 0, yes
74157839,  asilec, 1, 1, 0, yes
2397319407,  ClaudioManfroni, 2, 1, 1, neutral
1373198024,  cecimorello, 1, 1, 0, yes
478387478,  CDobrila, 2, 2, 0, yes
460259581,  marco_racchella, 2, 2, 0, yes
391350702,  maurostano, 1, 1, 0, yes
131197741,  kuliscioff, 1, 1, 0, yes
367833018,  ____MarTinA__, 2, 2, 0, yes
196186968,  pier_p, 1, 1, 0, yes
2155584997,  yuurikatsuqi, 1, 1, 0, yes
637018529,  recifar, 1, 1, 0, yes
2319051527,  matarazzate, 11, 1, 10, no
355604517,  AndreaaDonadio, 1, 1, 0, yes
1356826244,  alerounds, 4, 4, 0, yes
3200425029,  GuidodaRozze, 1, 1, 0, yes
1009415130,  Pisto_12, 2, 2, 0, yes
306409558,  michelab_, 2, 1, 1, neutral
3083190076,  IvanaCantoGiran, 1, 1, 0, yes
514379825,  BioLogiche, 1, 1, 0, yes
301120434,  _Giuli4, 1, 1, 0, yes
2190152245,  DanieleV65, 1, 1, 0, yes
743375857,  shadovhunter, 1, 1, 0, yes
447513293,  filippo898, 1, 1, 0, yes
290256603,  Geleo01, 1, 1, 0, yes
4251511151,  ehocapito, 1, 1, 0, yes
721214685,  InessHamad, 3, 2, 1, yes
573751754,  recfactory, 1, 1, 0, yes
994996170,  MicheleBiscaro, 1, 1, 0, yes
801889090769719297,  UnretrofiedForU, 1, 1, 0, yes
341591660,  19RedFox66, 2, 1, 1, neutral
240828508,  alexangius, 3, 3, 0, yes
363160060,  RomyP71, 1, 1, 0, yes
370193081,  antodamo, 1, 1, 0, yes
59742924,  Biond1986, 2, 2, 0, yes
2358355020,  Flaianoisalive, 2, 1, 1, neutral
624039060,  87cloverfield2, 1, 1, 0, yes
493588642,  computeramait, 1, 1, 0, yes
93416425,  jjolivella, 1, 1, 0, yes
230740381,  El_diez_, 1, 1, 0, yes
14163849,  alecosimetti, 1, 1, 0, yes
764003692123074560,  PBonissone, 2, 2, 0, yes
850774681,  SI7CN69, 2, 1, 1, neutral
453835296,  jorives73, 1, 1, 0, yes
741001556,  quicosenza, 2, 2, 0, yes
113458788,  Spina53, 1, 1, 0, yes
1952706475,  pavalover, 3, 3, 0, yes
2862381616,  Harry_saves_me_, 1, 1, 0, yes
316986519,  MartaPisani, 2, 1, 1, neutral
805394558171353088,  Potewa1Potewa, 1, 1, 0, yes
378066853,  BhoRangzen, 1, 1, 0, yes
1333876170,  CDamaggio, 1, 1, 0, yes
144176515,  JeAVRIL93, 1, 1, 0, yes
396014736,  FranciPiera, 1, 1, 0, yes
2949017423,  aurora_monaci, 1, 1, 0, yes
431518604,  DavideBortolini, 1, 1, 0, yes
479726681,  FabrizioVertua, 1, 1, 0, yes
637053615,  MencaMax, 1, 1, 0, yes
3397259693,  salustrosimona, 1, 1, 0, yes
1044156366,  loreruiu, 2, 1, 1, neutral
742400690065149952,  carlofinizio_83, 2, 1, 1, neutral
2410300840,  genovese53, 1, 1, 0, yes
396812690,  La_Sestina, 3, 3, 0, yes
776080226631704576,  LucaNardi1968, 1, 1, 0, yes
459273753,  MatteoMarzotti, 1, 1, 0, yes
802278735718260736,  HamidCarmona, 1, 1, 0, yes
4259862886,  federicafim, 1, 1, 0, yes
443842948,  AdeleAgnesoni, 2, 2, 0, yes
752029014,  micelli22, 1, 1, 0, yes
91603804,  MarianaNiembro_, 1, 1, 0, yes
2856638039,  greeneconomy458, 5, 5, 0, yes
51734793,  Floridi, 1, 1, 0, yes
13095372,  cristianomagi, 1, 1, 0, yes
51040535,  a_marraffa, 1, 1, 0, yes
4807285455,  cosele5, 1, 1, 0, yes
90616900,  aupreta, 1, 1, 0, yes
768983029,  FrancescoAzzal1, 1, 1, 0, yes
767332922651185152,  _Bad_Danny, 2, 2, 0, yes
3928129463,  Rosaria_Fichera, 1, 1, 0, yes
2216572952,  AntoViral, 1, 1, 0, yes
1339164217,  CamCremaschi, 1, 1, 0, yes
2596813652,  paola_cillo, 1, 1, 0, yes
1074962276,  fulan10, 1, 1, 0, yes
51018936,  erre6, 2, 2, 0, yes
738104685496827904,  MarcoTorzoni17, 1, 1, 0, yes
773732464254709760,  TiplGoni, 1, 1, 0, yes
2339955737,  CristinaTaglini, 2, 2, 0, yes
1147391053,  Kristia240909, 1, 1, 0, yes
412112516,  cmanara77, 1, 1, 0, yes
710011580658925568,  micheleciusa, 2, 2, 0, yes
4738929916,  marco0860, 1, 1, 0, yes
634556445,  LadyJMimetta, 1, 1, 0, yes
338999228,  vale_ascione, 2, 2, 0, yes
832829629,  cristianomeoni, 2, 2, 0, yes
221247281,  noticiassefarad, 1, 1, 0, yes
473811699,  BorioCarlo, 2, 2, 0, yes
718008585,  KatheeKate, 2, 2, 0, yes
2576530495,  TheRealBazzz, 1, 1, 0, yes
200180442,  alexiafontana, 4, 4, 0, yes
411705585,  MaddalenaBedei, 1, 1, 0, yes
432832773,  lucreziavalia, 6, 2, 4, no
489591754,  silvsav, 1, 1, 0, yes
587204335,  feboleondini, 1, 1, 0, yes
2518524856,  massazzolini, 2, 2, 0, yes
582037496,  r_vaccaro, 1, 1, 0, yes
254712153,  patriziabuzz, 1, 1, 0, yes
2845405989,  gambinodonatel1, 1, 1, 0, yes
702096941094723584,  blogfahrenheit, 1, 1, 0, yes
291019194,  carlomangini, 1, 1, 0, yes
3496837286,  cavaleriani, 1, 1, 0, yes
564701951,  RobyRaspini, 1, 1, 0, yes
968087978,  tronco70, 1, 1, 0, yes
366810365,  ccaptainoats, 1, 1, 0, yes
3005383865,  PedeNick, 1, 1, 0, yes
707867254671724544,  ale_ruzza, 1, 1, 0, yes
456222334,  hangoverr_, 1, 1, 0, yes
381457143,  Milestemplaris, 1, 1, 0, yes
3106135084,  NenaEleonora, 3, 3, 0, yes
362967539,  _dexterbad, 1, 1, 0, yes
367069322,  alebernie, 1, 1, 0, yes
203748670,  Vitlayer, 1, 1, 0, yes
1119970634,  MCubito, 1, 1, 0, yes
20926587,  laliber, 1, 1, 0, yes
4776516803,  GiancarloPoli7, 3, 3, 0, yes
636978994,  alfonsotkd, 1, 1, 0, yes
179953118,  annaruggiero, 1, 1, 0, yes
1156695648,  piercarlogiusep, 1, 1, 0, yes
2973669929,  fredbruno7, 1, 1, 0, yes
510463455,  mariapirini, 2, 2, 0, yes
774134542701432832,  rosannasusio, 1, 1, 0, yes
420713723,  FabioBruno92, 1, 1, 0, yes
245368076,  carMinasacco, 1, 1, 0, yes
238753903,  ErikaLovesBrit, 1, 1, 0, yes
65965314,  LorisB, 1, 1, 0, yes
300847991,  fabfra67, 1, 1, 0, yes
747590312,  darlingRita, 1, 1, 0, yes
16753750,  toret, 1, 1, 0, yes
51676531,  Spito83, 1, 1, 0, yes
2515300982,  osnapitzklari, 1, 1, 0, yes
44963146,  colin_surgeon, 1, 1, 0, yes
170628765,  Andrea_Lovati, 1, 1, 0, yes
60294295,  fradas82, 1, 1, 0, yes
575235227,  bellinilex, 1, 1, 0, yes
453965672,  GiuseppinaInfra, 6, 5, 1, yes
1480351040,  LucaErma, 13, 1, 12, no
2318674113,  zaz2bretagne, 1, 1, 0, yes
491144884,  SalvadorLuigi, 2, 2, 0, yes
3343934079,  chreesmarteen, 1, 1, 0, yes
163034004,  vazquezdesaro, 1, 1, 0, yes
145493922,  tomasito1234, 1, 1, 0, yes
482410790,  giulia_papaleo, 1, 1, 0, yes
3916510528,  solubilesiculo, 2, 2, 0, yes
566535232,  frenzyranieri, 1, 1, 0, yes
701859950864236544,  FEDEZ_GIANNI_, 1, 1, 0, yes
1089026418,  kitastra, 1, 1, 0, yes
264417751,  YoutuBari, 1, 1, 0, yes
2247832673,  LucianoMazzucc1, 1, 1, 0, yes
419504578,  Ginattack, 2, 2, 0, yes
354841179,  theportofmycall, 2, 2, 0, yes
120062043,  toninotavilla, 1, 1, 0, yes
2256661574,  mypieceofgold, 4, 4, 0, yes
531198622,  nodoallacorda, 10, 4, 6, no
323691674,  shydy1, 2, 1, 1, neutral
113950687,  matteoplatone, 1, 1, 0, yes
2320918986,  GattaCa_71, 1, 1, 0, yes
109254351,  peytonka, 1, 1, 0, yes
53344274,  Francesco_Caris, 1, 1, 0, yes
557343685,  Va__Sco, 2, 1, 1, neutral
66962979,  laviniaorefici, 1, 1, 0, yes
1266709873,  albisan88, 2, 1, 1, neutral
130782020,  Chefajo, 1, 1, 0, yes
45785025,  liburnix, 1, 1, 0, yes
524231745,  ElisaDellAcqua, 1, 1, 0, yes
1361292278,  amandil5, 1, 1, 0, yes
304085872,  MGabbrielli, 4, 2, 2, neutral
53152287,  PN49, 1, 1, 0, yes
185821754,  danicannizzaro, 1, 1, 0, yes
1615230631,  jmacci_9620, 1, 1, 0, yes
463848812,  MassimilianoWie, 1, 1, 0, yes
455649072,  AchHutch, 2, 2, 0, yes
103858953,  arussophd, 1, 1, 0, yes
701505930198958080,  GiuseppeVenanzi, 1, 1, 0, yes
470125420,  PaoloMontalb, 2, 1, 1, neutral
431793867,  ElettraGulle, 1, 1, 0, yes
1183790352,  cdellosiesto, 3, 3, 0, yes
1329125336,  Aledacasa63, 1, 1, 0, yes
388333048,  demjismile, 1, 1, 0, yes
753547141965082624,  mserpentoni, 1, 1, 0, yes
1071185384,  MarieleFloris, 5, 5, 0, yes
517097188,  maxi27173, 1, 1, 0, yes
2348725297,  GianniVEVO, 1, 1, 0, yes
486583213,  LeftAvvenimenti, 3, 1, 2, no
809128802,  MaurizioFresch1, 1, 1, 0, yes
572797205,  flymora, 1, 1, 0, yes
4365832461,  bminchia, 2, 1, 1, neutral
1669570261,  mariofranzin635, 1, 1, 0, yes
546741421,  IacoBlu, 1, 1, 0, yes
797832363443179520,  Gabrielladisnan, 2, 2, 0, yes
712626743648067584,  Johngraypark, 1, 1, 0, yes
2157474328,  ladykeit, 1, 1, 0, yes
527724338,  fieroperaio, 1, 1, 0, yes
3377674569,  DonGugos, 1, 1, 0, yes
3301344453,  Zi0Costa, 1, 1, 0, yes
397545854,  CorengiaClaudio, 2, 2, 0, yes
713045748338802688,  salvatorebua12, 1, 1, 0, yes
41334221,  maramaramao, 2, 1, 1, neutral
1324336380,  azimut1777, 3, 2, 1, yes
931706882,  giosilvia86, 1, 1, 0, yes
275068001,  alecroce, 2, 1, 1, neutral
2392070607,  elisacamel3, 1, 1, 0, yes
194943640,  Milo20i, 1, 1, 0, yes
573079749,  BeatricePisoni, 1, 1, 0, yes
4850526671,  SaraSueEsse, 1, 1, 0, yes
365966625,  Fabiogse, 3, 2, 1, yes
3108197332,  Malkovitze, 1, 1, 0, yes
2808551001,  kokori_89, 1, 1, 0, yes
456123746,  CiccilloC, 1, 1, 0, yes
527598706,  amemacula, 1, 1, 0, yes
1436270562,  MarcoBraia, 5, 1, 4, no
2244571279,  assataram, 3, 1, 2, no
761876962373689344,  beatricebiasi, 1, 1, 0, yes
4018431,  nicolomingozzi, 1, 1, 0, yes
22873,  bolsoblog, 1, 1, 0, yes
3049746508,  Alecscasa, 2, 2, 0, yes
74412709,  lesherbes, 1, 1, 0, yes
266067803,  wheresmikehunt, 1, 1, 0, yes
1687845709,  FedeAle1525, 1, 1, 0, yes
323743827,  fabrizio_errico, 1, 1, 0, yes
469657784,  r_marilena, 1, 1, 0, yes
600554581,  Cester88, 4, 1, 3, no
1130489732,  jackass1955, 4, 3, 1, yes
1052757072,  AleGustine, 1, 1, 0, yes
725807839915216896,  nofxois, 1, 1, 0, yes
403589214,  Federica_Sanita, 1, 1, 0, yes
397475312,  AndreaUJ1897, 1, 1, 0, yes
427441283,  casadeisimone, 1, 1, 0, yes
418105029,  DaniLucariello, 1, 1, 0, yes
117506257,  luigiflv, 1, 1, 0, yes
555643800,  ddfny, 1, 1, 0, yes
58310693,  PatriciaPisani, 1, 1, 0, yes
1183985047,  ciube53, 1, 1, 0, yes
271600868,  vggsim, 1, 1, 0, yes
625039091,  GiorgioPorro1, 1, 1, 0, yes
189997448,  _UnaLola, 1, 1, 0, yes
377363595,  AntoBert4, 1, 1, 0, yes
1625081750,  coffeebean89, 1, 1, 0, yes
2164878096,  bigarelloM5S, 10, 1, 9, no
2463936324,  AltraVerona1, 1, 1, 0, yes
864462996,  AleGuetta93, 1, 1, 0, yes
2357025416,  MattiGusme, 1, 1, 0, yes
1283615875,  tittalam, 1, 1, 0, yes
510097129,  nicolacarmosino, 2, 2, 0, yes
231076595,  taniadl79, 1, 1, 0, yes
579928036,  MungiveraDavide, 1, 1, 0, yes
4927927936,  LoSpiegone, 1, 1, 0, yes
323160947,  maxx781, 3, 1, 2, no
308553157,  ilfede74, 1, 1, 0, yes
371421306,  danj2605, 1, 1, 0, yes
2797484093,  clearlyasocial, 1, 1, 0, yes
494403804,  MarioCondorell1, 4, 4, 0, yes
25800820,  edy8, 2, 1, 1, neutral
2440243931,  BaBattistella, 1, 1, 0, yes
17864666,  ilTIZZI, 1, 1, 0, yes
1385757690,  david_fastelli, 1, 1, 0, yes
805535765925154821,  fabio_bux, 1, 1, 0, yes
118131055,  RiCiv, 1, 1, 0, yes
766276530196606976,  aniell4, 1, 1, 0, yes
188122170,  livioguglietti, 1, 1, 0, yes
397973541,  Angeldigi, 1, 1, 0, yes
964635296,  annadisanza1, 1, 1, 0, yes
170672902,  mpagetti, 1, 1, 0, yes
83236897,  Forever_Purple, 3, 3, 0, yes
1618458560,  Nelli9989, 1, 1, 0, yes
133318219,  valedupont, 1, 1, 0, yes
140059612,  nordestboulevar, 1, 1, 0, yes
460452079,  MartinoPiemonte, 1, 1, 0, yes
2775981333,  rivellandrea, 10, 2, 8, no
2591933340,  IzzyHightower, 1, 1, 0, yes
302129306,  angelo_pirrera, 1, 1, 0, yes
194935401,  gilda_caronti, 1, 1, 0, yes
129292878,  LUCIANO260578, 1, 1, 0, yes
3018825532,  molinajavierig1, 1, 1, 0, yes
90435707,  _alessandroid, 1, 1, 0, yes
729243366,  SataNilus, 1, 1, 0, yes
203495855,  steve__drake, 1, 1, 0, yes
2726839847,  armandodamaro94, 1, 1, 0, yes
2317777112,  marco_iovieno, 7, 7, 0, yes
354263877,  delpierosheart, 1, 1, 0, yes
183957988,  vejita_, 1, 1, 0, yes
798512658500747264,  FedericoMore95, 1, 1, 0, yes
595449555,  LaZiaSere_91, 1, 1, 0, yes
19683091,  Thongrim, 1, 1, 0, yes
1218836317,  VincenzoTheOLd, 3, 1, 2, no
173875570,  Giuliano_Murgia, 2, 1, 1, neutral
988984490,  violino64, 1, 1, 0, yes
2777641048,  fedesigncip, 2, 2, 0, yes
418918878,  estermuntoni, 1, 1, 0, yes
254203042,  NelloFlorio, 6, 1, 5, no
434785933,  MichaelPatano, 2, 1, 1, neutral
3014337910,  LParacchini, 1, 1, 0, yes
317945797,  redheadoula, 2, 2, 0, yes
756582525288448002,  MizarVsAndrea, 1, 1, 0, yes
425898221,  AndreaFoxVolpi, 1, 1, 0, yes
923278410,  Marta__F, 1, 1, 0, yes
2354593347,  MILSICILIANO, 1, 1, 0, yes
756881104171335680,  Nicola_7_A, 1, 1, 0, yes
934601778,  recher__, 1, 1, 0, yes
4561415122,  corrax86, 1, 1, 0, yes
115494424,  Haarmann82, 1, 1, 0, yes
1111391791,  marcomanniwho, 3, 2, 1, yes
3231343091,  AltioniM, 1, 1, 0, yes
252597268,  ioko39, 1, 1, 0, yes
1151476188,  masciam5s, 2, 2, 0, yes
4905861731,  irenebonaventu1, 2, 2, 0, yes
489605115,  Paco_Caruso, 1, 1, 0, yes
983102930,  FabolousCook, 1, 1, 0, yes
86094824,  barruggi, 1, 1, 0, yes
559785640,  LucaBorrelli27, 1, 1, 0, yes
2454935475,  BIusto, 1, 1, 0, yes
1370810204,  Mioparere, 2, 1, 1, neutral
257004386,  CarlottaOppizzi, 2, 2, 0, yes
97523009,  gennaromarchese, 1, 1, 0, yes
462456646,  LorenzoBosio1, 1, 1, 0, yes
154948003,  paubernard, 1, 1, 0, yes
513238300,  alessacart, 1, 1, 0, yes
701529016231182336,  GiuseppinaPane2, 2, 2, 0, yes
265507816,  Hitlermedijo, 1, 1, 0, yes
137397499,  donatellav62, 2, 1, 1, neutral
2214537264,  BulunmazTiyatro, 2, 2, 0, yes
3384936640,  PSparlando, 2, 2, 0, yes
4891899964,  ale220982, 6, 2, 4, no
3403583638,  bvlckstrtt, 1, 1, 0, yes
515858698,  BrioschiMa, 1, 1, 0, yes
386207571,  raffascar, 1, 1, 0, yes
1656931662,  ross5926, 1, 1, 0, yes
3045938622,  itgigulu_, 1, 1, 0, yes
3308099978,  roberto67922078, 1, 1, 0, yes
968955534,  JjFarinella, 1, 1, 0, yes
632247295,  andreamilan_, 1, 1, 0, yes
3126359453,  sovlhes, 1, 1, 0, yes
280408851,  Gamer3Life2278, 1, 1, 0, yes
4536097839,  bardobardi10, 2, 2, 0, yes
524825100,  StefiStang, 4, 4, 0, yes
720186039860609024,  cschannel_news, 1, 1, 0, yes
301585018,  Xandjr0, 1, 1, 0, yes
473147545,  Angizlatan94, 1, 1, 0, yes
2962291565,  TeoIannicelli, 1, 1, 0, yes
615328952,  DltzDesigns, 1, 1, 0, yes
1346199541,  GabriMulder81, 3, 1, 2, no
770154469283729408,  pisana62matera2, 4, 4, 0, yes
1060028629,  MCOriglia, 3, 3, 0, yes
2423424370,  clarafabiani, 2, 2, 0, yes
194095848,  TwinkleDeadStar, 1, 1, 0, yes
1122033812,  fabpicchetti, 3, 2, 1, yes
4229052987,  trassshlover, 1, 1, 0, yes
3433131149,  mandolinchris, 1, 1, 0, yes
718159838178574336,  dedosa16, 2, 1, 1, neutral
419535328,  GliOleandriStre, 1, 1, 0, yes
2849555159,  ilprogressivo, 1, 1, 0, yes
838149116,  mela_bruco, 1, 1, 0, yes
498262901,  lacomba58, 2, 1, 1, neutral
2850323542,  egoime55, 1, 1, 0, yes
2717484025,  consapevole46, 1, 1, 0, yes
4869185027,  fxck_Vane, 1, 1, 0, yes
397260164,  AlessandroTurko, 1, 1, 0, yes
2298091612,  LmbeMARIELLA, 2, 2, 0, yes
748056440481394688,  deadlyluka77, 1, 1, 0, yes
742149367562264576,  dubeluvky, 1, 1, 0, yes
444938307,  SGettulia, 2, 1, 1, neutral
773222235351965697,  dutttip, 1, 1, 0, yes
1008161112,  AndreMellano, 1, 1, 0, yes
780600092,  MauroPiace, 1, 1, 0, yes
38177107,  anna_annie12, 3, 3, 0, yes
775577177278513152,  IosoloRt, 1, 1, 0, yes
38493020,  jembenton, 1, 1, 0, yes
2371976825,  Bthisisit, 1, 1, 0, yes
418516300,  MatteoSciarra, 1, 1, 0, yes
456646487,  luciofariano, 1, 1, 0, yes
3973480762,  AngelaLetizia11, 1, 1, 0, yes
2404591097,  sorsi49, 1, 1, 0, yes
979155253,  db_mariateresa, 1, 1, 0, yes
3025426804,  UmbriaOn, 1, 1, 0, yes
20072873,  tabularius, 1, 1, 0, yes
4440079157,  gingegneri821, 1, 1, 0, yes
1239213457,  Merlo1994, 1, 1, 0, yes
1201411621,  bonaccorso10, 1, 1, 0, yes
767752220700016640,  accoglidonata66, 1, 1, 0, yes
183751573,  Baseazotata, 1, 1, 0, yes
70691549,  Lymperatore, 1, 1, 0, yes
4528167203,  mcaratozzolo58, 2, 2, 0, yes
2178160872,  yaizab82, 4, 3, 1, yes
1941265778,  marco_Chipo, 1, 1, 0, yes
38152030,  WohaItsMarco, 1, 1, 0, yes
999530510,  damose_da_fa, 2, 2, 0, yes
793582939246297089,  totinovincenzo, 1, 1, 0, yes
2984836264,  bianconi_davide, 1, 1, 0, yes
114396061,  saulmedinaguru, 1, 1, 0, yes
38546006,  albertoroggero, 1, 1, 0, yes
358289126,  pgiovannina, 1, 1, 0, yes
875349601,  PaoloFlegar, 1, 1, 0, yes
2762765963,  Cozzy2098, 1, 1, 0, yes
2356554258,  _albert_cyrus, 1, 1, 0, yes
805733715301298176,  AnnaCla20577974, 3, 3, 0, yes
2468130335,  argomatto22, 1, 1, 0, yes
2714708218,  camillazaccheo, 1, 1, 0, yes
359265217,  Ezioy, 1, 1, 0, yes
427556779,  GiulyFo, 1, 1, 0, yes
789714366,  vito_ostuni, 3, 1, 2, no
2174252699,  tiagofilipept, 1, 1, 0, yes
97995891,  lucamorvilli, 1, 1, 0, yes
932410699,  OnCitt, 1, 1, 0, yes
3133607417,  diamantedemarco, 2, 2, 0, yes
376176466,  SOTERDIPALMA, 1, 1, 0, yes
1339261796,  AlexNeedle_, 1, 1, 0, yes
827639359,  Tabbone80, 1, 1, 0, yes
613988964,  Nlkkwaa, 1, 1, 0, yes
1662233994,  Arezki_IV, 1, 1, 0, yes
1192362907,  ArtemisiaErico, 1, 1, 0, yes
3359395031,  463720c321ba43b, 1, 1, 0, yes
477774364,  FiorenzaMarani, 2, 1, 1, neutral
1589834802,  pensierocasuale, 1, 1, 0, yes
399510903,  pierocrispino, 1, 1, 0, yes
57595715,  3003bigo72, 1, 1, 0, yes
147319766,  GianpaSabat, 1, 1, 0, yes
746743698956910592,  BarneyMarinosci, 4, 3, 1, yes
171923524,  FrenkyFre, 2, 2, 0, yes
3133579845,  davidediaz10, 1, 1, 0, yes
1173320346,  chimera6868mine, 1, 1, 0, yes
412659763,  GiordanaPanegos, 2, 1, 1, neutral
100089967,  DiademaGoddess, 3, 3, 0, yes
1653297619,  Ossoneee, 1, 1, 0, yes
1048896650,  IreneZucconi1, 2, 2, 0, yes
195398823,  quatwa, 2, 1, 1, neutral
122760708,  bpagliaro, 1, 1, 0, yes
39989720,  MassimoMelica, 2, 2, 0, yes
3266856037,  trump2016fan, 1, 1, 0, yes
1298793637,  TeamMeaku, 1, 1, 0, yes
491587553,  michelepianetta, 1, 1, 0, yes
352337539,  mfchiappe, 2, 1, 1, neutral
208447500,  hellen_wide, 7, 5, 2, yes
460496317,  FDePalo, 1, 1, 0, yes
280728494,  chiccogiancarlo, 2, 1, 1, neutral
2151118633,  imintoxicatedd, 1, 1, 0, yes
792821833972191232,  flavia199002, 1, 1, 0, yes
2895641883,  tralepagine, 3, 1, 2, no
1382404632,  SelenaSardella, 1, 1, 0, yes
103628763,  akalayci34, 1, 1, 0, yes
2813156468,  RosaGhur, 1, 1, 0, yes
328500371,  GianlucaFiusco, 3, 3, 0, yes
811141470,  talialotto, 2, 1, 1, neutral
713208771,  dicesare01, 2, 2, 0, yes
98843728,  vegsxe, 3, 3, 0, yes
409691781,  StefanoOlmoCacc, 1, 1, 0, yes
732654405317713920,  lorenzo97A, 1, 1, 0, yes
1301383952,  Knives_Million, 2, 2, 0, yes
780480868611723264,  gnomo_no, 2, 1, 1, neutral
337095643,  patriziapetrucc, 2, 1, 1, neutral
2316401301,  RVenieri, 2, 2, 0, yes
505060635,  GianfrancoDelS, 1, 1, 0, yes
836880307,  alemar66ely, 1, 1, 0, yes
14800149,  valeriosavioli, 4, 2, 2, neutral
795969973,  diego_doro, 1, 1, 0, yes
913083900,  notytwit, 1, 1, 0, yes
441066308,  massilucarelli, 1, 1, 0, yes
793572685284536325,  rosariasica4, 2, 2, 0, yes
49685654,  Franc_Pomponio, 8, 3, 5, no
515912743,  foxremi, 3, 1, 2, no
449798674,  DavM_92, 1, 1, 0, yes
65948141,  nemuriko82, 1, 1, 0, yes
1090280132,  AlfonsoVivenzi, 1, 1, 0, yes
1086689330,  zaynsound, 1, 1, 0, yes
498666191,  Arthos_Neo, 5, 2, 3, no
2338991382,  Morris962, 1, 1, 0, yes
397303688,  tortadimale, 1, 1, 0, yes
1482576420,  TheEraluna, 1, 1, 0, yes
1577414666,  samsci11, 1, 1, 0, yes
580871879,  annalisanapoli2, 1, 1, 0, yes
1593961980,  AngelicaCottino, 1, 1, 0, yes
253617931,  sabrinabrescia, 1, 1, 0, yes
483974125,  MischioMisto, 1, 1, 0, yes
20443880,  peder87, 1, 1, 0, yes
2741120536,  vignadani, 1, 1, 0, yes
108289502,  R__OoO, 1, 1, 0, yes
3289965742,  Ad2015Pasquino, 1, 1, 0, yes
244836131,  stokkista62, 4, 1, 3, no
71794120,  giusy1985, 1, 1, 0, yes
3322782886,  Ponga_74, 1, 1, 0, yes
3308568305,  magnumceltic, 1, 1, 0, yes
253095798,  calamaridibosco, 1, 1, 0, yes
706934612916903936,  venividvicix, 2, 1, 1, neutral
256468638,  Rosa_Val1, 1, 1, 0, yes
504795224,  _patariko, 1, 1, 0, yes
711522502338551810,  cantoni_vanessa, 1, 1, 0, yes
799199504788582400,  Mile7396, 1, 1, 0, yes
372949296,  PisuDavide, 1, 1, 0, yes
473968604,  angelval79, 1, 1, 0, yes
544484941,  maky1399, 1, 1, 0, yes
479560424,  Love64tennis, 4, 4, 0, yes
805533862461841412,  Rayiikee, 2, 1, 1, neutral
2190635448,  cvmgranosalis, 4, 4, 0, yes
784717763587739648,  RiccardoValler2, 18, 14, 4, yes
2477014652,  Mari_Piccola, 1, 1, 0, yes
1345406318,  marconovecento, 1, 1, 0, yes
1183231076,  L_basili, 2, 1, 1, neutral
2240593940,  Superetero, 1, 1, 0, yes
4140519261,  paiabianco69, 1, 1, 0, yes
148518511,  HTaylor84, 2, 1, 1, neutral
1173253070,  Paolo_Antonucci, 2, 1, 1, neutral
783327441951526912,  Armando89787817, 2, 2, 0, yes
3325449263,  faustoarturi, 1, 1, 0, yes
155271374,  SargonADV, 1, 1, 0, yes
4561022009,  joalfano71, 1, 1, 0, yes
751776180957741056,  StormW999, 3, 3, 0, yes
1431459762,  Aladestra69, 1, 1, 0, yes
46499363,  sassari74, 4, 1, 3, no
1406300971,  udeprins, 1, 1, 0, yes
1386861416,  Fabio_biz, 10, 5, 5, neutral
241216919,  paolopiva50, 1, 1, 0, yes
2219901617,  GubbiPaolo, 1, 1, 0, yes
727883501891158017,  gratorrisi3, 1, 1, 0, yes
162312404,  pvaleriocm, 1, 1, 0, yes
520266667,  _Luigi__, 1, 1, 0, yes
38881090,  eu_durante, 1, 1, 0, yes
864765943,  AIacuaniello, 2, 2, 0, yes
147275134,  ok_emiliano, 1, 1, 0, yes
1857517531,  cuorebrescia, 1, 1, 0, yes
4018507636,  GianlucaGori63, 3, 1, 2, no
588367749,  AzzieThreadbare, 1, 1, 0, yes
3175578989,  Labellapassante, 1, 1, 0, yes
386572967,  matt_olivi, 1, 1, 0, yes
19096369,  stscholasticas, 1, 1, 0, yes
792312841458053120,  OreliaAntoniol1, 1, 1, 0, yes
3359391815,  0b199fe1a60a4b5, 1, 1, 0, yes
548558054,  StefanoMei3, 1, 1, 0, yes
767013233651773440,  manciosba, 1, 1, 0, yes
3335316244,  4d142645840147d, 6, 1, 5, no
81832300,  Oigroigos, 3, 1, 2, no
2237427870,  soara18, 3, 3, 0, yes
176138267,  criiisigno, 1, 1, 0, yes
2998807186,  sesg_, 1, 1, 0, yes
728638942459899908,  iovivodite, 2, 2, 0, yes
4185242009,  Antonio34991284, 2, 2, 0, yes
732565059306684416,  senzauscita, 2, 2, 0, yes
948420673,  angela_bkk, 1, 1, 0, yes
155725833,  MvColucci, 2, 2, 0, yes
375088326,  sara_iafelice, 2, 1, 1, neutral
4439811579,  p_chiocchetti, 1, 1, 0, yes
270211310,  tasto7, 3, 3, 0, yes
47346052,  raluca3000, 1, 1, 0, yes
703703041053224960,  ir_responsabile, 2, 1, 1, neutral
25705795,  giandime, 1, 1, 0, yes
2299657362,  chiaraamonte, 1, 1, 0, yes
437324119,  paolalapadula, 1, 1, 0, yes
150664329,  pauligurize, 1, 1, 0, yes
72126210,  IlCapoluogo, 1, 1, 0, yes
17655445,  ppriolo, 1, 1, 0, yes
1495017787,  fedman76, 1, 1, 0, yes
2494884204,  CamillaSlanzi, 1, 1, 0, yes
490406118,  davidbonazzo, 1, 1, 0, yes
844292455,  udaberg, 1, 1, 0, yes
50235992,  fralossani, 1, 1, 0, yes
422784386,  annaritab72, 1, 1, 0, yes
563168095,  CameriniRoberto, 7, 7, 0, yes
3110299618,  frantando, 1, 1, 0, yes
1065494179,  sagittar981, 1, 1, 0, yes
2576567384,  AntLucarel, 1, 1, 0, yes
610278959,  cesare_pi, 1, 1, 0, yes
381581456,  debyh10, 1, 1, 0, yes
1163495276,  FantasmicMicky, 1, 1, 0, yes
272461952,  rinotell, 1, 1, 0, yes
266705242,  mauroessepunto, 2, 2, 0, yes
348343220,  stefydreamer, 1, 1, 0, yes
493335702,  AntonioGullotta, 1, 1, 0, yes
4817576595,  ariperfectgirl, 2, 2, 0, yes
337636292,  xlightsofhope, 1, 1, 0, yes
1617382848,  ashugme, 1, 1, 0, yes
330247256,  NotxMe, 2, 1, 1, neutral
2175913857,  mruggi22, 1, 1, 0, yes
781838922578026496,  giakomo_cg, 1, 1, 0, yes
2212410343,  dp_carlo, 1, 1, 0, yes
542872619,  FrancescoScadut, 1, 1, 0, yes
64954580,  _branzo_, 1, 1, 0, yes
2859259954,  avviannuzzi, 1, 1, 0, yes
432259780,  francescaalban2, 4, 1, 3, no
3352056221,  Katy_444, 1, 1, 0, yes
3246356698,  toore_, 1, 1, 0, yes
2278209638,  RickyCaria, 1, 1, 0, yes
509053415,  NicMel1, 1, 1, 0, yes
787155383231971328,  CAm4Trump, 1, 1, 0, yes
2855022291,  majestyIwt, 2, 2, 0, yes
4775428452,  WSMTweeter, 1, 1, 0, yes
3862426114,  mattiariga1, 1, 1, 0, yes
461955421,  FrankieX74, 2, 1, 1, neutral
188093296,  Earl_Max, 3, 2, 1, yes
1429974884,  ylefsch, 1, 1, 0, yes
408084708,  gothp1, 1, 1, 0, yes
2362605194,  LIDIASTELLINA, 1, 1, 0, yes
3331253727,  galliani_1944, 1, 1, 0, yes
2929529637,  martalavit, 1, 1, 0, yes
21987351,  matteomelani, 1, 1, 0, yes
709132928,  Clelia_Conti, 1, 1, 0, yes
792395338241937408,  LucaangeliniLa, 1, 1, 0, yes
790615080652144640,  sleepzsleepz, 1, 1, 0, yes
65559143,  MadGully1, 1, 1, 0, yes
1178595583,  giuliaminoli, 1, 1, 0, yes
1069565479,  Gibbanza, 1, 1, 0, yes
1272533011,  lbrt78, 1, 1, 0, yes
1001436169,  Ziomacco, 1, 1, 0, yes
303794824,  svitoz, 1, 1, 0, yes
1289705372,  FedericaLaManti, 1, 1, 0, yes
382351598,  AntonioVotino, 1, 1, 0, yes
379365625,  roccogalotta, 1, 1, 0, yes
2429185811,  donibianco2, 1, 1, 0, yes
4471592362,  ECoscelli, 1, 1, 0, yes
4142998702,  mariaca49134846, 1, 1, 0, yes
19597426,  dotali, 1, 1, 0, yes
807621325,  1solocapitano, 3, 2, 1, yes
3380688045,  LuizAdrianoBra, 4, 3, 1, yes
267838123,  Zaffaranu, 1, 1, 0, yes
4126461076,  Utah7227, 1, 1, 0, yes
72053406,  2krondaman, 1, 1, 0, yes
116556454,  moritzwindegger, 1, 1, 0, yes
2237847739,  EBonaccorti, 1, 1, 0, yes
476790342,  lamicias, 1, 1, 0, yes
724689754311241728,  Camillo120595, 1, 1, 0, yes
250114717,  10marzo07, 2, 2, 0, yes
263484216,  yonkersoem40, 1, 1, 0, yes
2975066721,  AlxFontanelli, 1, 1, 0, yes
143921360,  xaviclemente, 1, 1, 0, yes
71032067,  nnapolitanor, 2, 2, 0, yes
962530026,  Not_Availab, 1, 1, 0, yes
281106125,  Diuds89, 1, 1, 0, yes
240255533,  gozzip011, 1, 1, 0, yes
133227580,  alessandropolli, 2, 2, 0, yes
2431707800,  L_Ferrajoli, 2, 1, 1, neutral
2510765685,  holansia, 1, 1, 0, yes
590327935,  GiadaCanduzzi, 1, 1, 0, yes
387349892,  tonyhoney74, 1, 1, 0, yes
185755347,  anapruis, 2, 1, 1, neutral
204486379,  tonicent, 1, 1, 0, yes
416354040,  modeneser, 1, 1, 0, yes
1009688736,  Gedy63, 1, 1, 0, yes
707978845,  giuvirzi, 3, 3, 0, yes
2865314139,  fpcgilprovTO, 22, 2, 20, no
797919068841971712,  indako_vg, 1, 1, 0, yes
3961040592,  SeRealSeLeal, 1, 1, 0, yes
969789116,  forgiarini_s, 2, 1, 1, neutral
1060347457,  franzbizz, 1, 1, 0, yes
444865342,  arbedsky, 1, 1, 0, yes
2915206151,  andrea_marrucci, 1, 1, 0, yes
191087189,  Antisocievole, 1, 1, 0, yes
3515068534,  mchiaracapobian, 1, 1, 0, yes
51699605,  cricad, 1, 1, 0, yes
430331353,  BobFabiani, 1, 1, 0, yes
1103955866,  mauriziocarra59, 1, 1, 0, yes
2325616361,  ziaferna, 1, 1, 0, yes
353762896,  AlexPuGa8, 1, 1, 0, yes
757468969,  sandromisu, 1, 1, 0, yes
3129162854,  dan_ceres, 2, 1, 1, neutral
265597301,  mulefer, 1, 1, 0, yes
1361623662,  mgiovanettina, 1, 1, 0, yes
218584231,  francescomichil, 1, 1, 0, yes
2377167139,  Alice160383, 1, 1, 0, yes
427656834,  XenPax, 1, 1, 0, yes
589788091,  DaniloCutropia, 1, 1, 0, yes
576135107,  RobertoUsseglio, 1, 1, 0, yes
4540563736,  Pietro29673945, 1, 1, 0, yes
56674519,  LombardiaOnLine, 14, 7, 7, neutral
134084746,  matthew_parodi, 1, 1, 0, yes
2981423489,  02giugno, 5, 4, 1, yes
439953661,  KeylaKyy, 1, 1, 0, yes
2426554258,  francescocal98, 1, 1, 0, yes
4888813282,  AlleyOop24, 2, 2, 0, yes
4203721672,  silvanocolasan1, 2, 1, 1, neutral
744837475193987072,  FrascicoB, 1, 1, 0, yes
708570847,  KuntzTyler, 1, 1, 0, yes
243772835,  semprinif, 2, 2, 0, yes
774118118,  federico_paniz, 1, 1, 0, yes
330303402,  RotaPaoloMi, 1, 1, 0, yes
317507759,  gasparebattista, 4, 1, 3, no
1103371136,  nunziaped, 2, 1, 1, neutral
44171944,  AndrewSB49, 1, 1, 0, yes
290497903,  matteo_pel, 1, 1, 0, yes
606378425,  oscarbadoino, 1, 1, 0, yes
798920530040590336,  SerenaPolly, 2, 2, 0, yes
923489755,  BiancaTrabucchi, 1, 1, 0, yes
1942231741,  elly993, 1, 1, 0, yes
1362272035,  ZamutoMazzamuto, 1, 1, 0, yes
801358448751443973,  gabextrem41, 1, 1, 0, yes
1227025849,  honeyandcotton, 1, 1, 0, yes
52129918,  paridevitale, 1, 1, 0, yes
804180066653573120,  tagopodif1989, 1, 1, 0, yes
471812789,  SpeculaThor, 2, 2, 0, yes
2872669089,  augustodetom1, 1, 1, 0, yes
198563704,  comeluicelletti, 1, 1, 0, yes
375709005,  egidiodonadio, 1, 1, 0, yes
797783036326772736,  Brigitt01490368, 1, 1, 0, yes
706546957049831429,  openspace_name, 1, 1, 0, yes
3350354537,  SmMondello, 2, 2, 0, yes
1059013326,  marilisa0853, 5, 1, 4, no
152075455,  bogdanvis, 1, 1, 0, yes
281930164,  fuscomarina, 1, 1, 0, yes
292307933,  machetuvoi, 1, 1, 0, yes
499023510,  gufopit, 2, 1, 1, neutral
84603034,  24donne, 1, 1, 0, yes
2394635943,  ISWHOIS333, 1, 1, 0, yes
513185725,  Wane_Mars, 1, 1, 0, yes
2216026485,  DiegoElcome, 6, 2, 4, no
724646644155879429,  Benismyjoy, 1, 1, 0, yes
791638537913368576,  SpiLau82, 1, 1, 0, yes
1029077407,  Vincenzo_Atella, 1, 1, 0, yes
411428698,  ungiovaneuomo, 4, 1, 3, no
804070745366298624,  radice_emanuele, 1, 1, 0, yes
486794844,  FlaviaPiredda, 2, 1, 1, neutral
2998534481,  simoventurini1, 17, 4, 13, no
4169103195,  bonfigliolimas2, 1, 1, 0, yes
3366407398,  viola_grandesso, 1, 1, 0, yes
2870507268,  berninienrico11, 4, 1, 3, no
461443740,  FlavioM77, 1, 1, 0, yes
254425459,  bandinik, 2, 2, 0, yes
427506033,  NKiuky, 2, 1, 1, neutral
53347598,  ilsasdo, 1, 1, 0, yes
2187920997,  g_mariot, 1, 1, 0, yes
355361396,  NinoAmoruso, 1, 1, 0, yes
2872489588,  ChiaraBel95, 1, 1, 0, yes
109066688,  SnakEnea, 1, 1, 0, yes
430861596,  BykerPrince, 1, 1, 0, yes
590357970,  xtueresmicielo, 1, 1, 0, yes
2173672641,  new_vinc, 7, 1, 6, no
1006030926,  andrimig, 1, 1, 0, yes
428889470,  VGiaquinta, 1, 1, 0, yes
46074236,  L_elenina, 1, 1, 0, yes
1325242873,  GiulyFau, 1, 1, 0, yes
549961218,  Luketto02, 1, 1, 0, yes
1954747494,  Rosanna_UC, 1, 1, 0, yes
2335455981,  ChisariAnna, 1, 1, 0, yes
2596987738,  Loryhack, 1, 1, 0, yes
2419472748,  LordBag, 1, 1, 0, yes
539927609,  chiaralacchini, 1, 1, 0, yes
733019965796802561,  s_cacciatore_, 1, 1, 0, yes
1408129375,  dvrcapital, 1, 1, 0, yes
3372706481,  caterinahoran_, 1, 1, 0, yes
2863196725,  DavideCiavo, 1, 1, 0, yes
750042521707880448,  utente47, 1, 1, 0, yes
3252122602,  Luca_Gualtieri1, 1, 1, 0, yes
376428291,  francebande, 1, 1, 0, yes
3647888832,  shvtn, 1, 1, 0, yes
1219585158,  FrancescaIngrav, 1, 1, 0, yes
3024739624,  CalzelunghePipi, 1, 1, 0, yes
2667220697,  andreacrdd, 1, 1, 0, yes
83695575,  MaviPicker, 1, 1, 0, yes
405564749,  RobyGallizioli, 1, 1, 0, yes
2886633449,  FpToscana, 3, 3, 0, yes
4924759103,  _hicetnunc__, 1, 1, 0, yes
45391334,  pietro99_98, 1, 1, 0, yes
1057511179,  pas_cris, 1, 1, 0, yes
1230550195,  _sigkill_, 1, 1, 0, yes
544142863,  maljkz, 2, 1, 1, neutral
2243856722,  gabbea61, 7, 5, 2, yes
4096146472,  pipay74612493, 1, 1, 0, yes
722669414,  ale_gazzoli, 1, 1, 0, yes
4149352993,  xlvislaugh, 2, 1, 1, neutral
1399740782,  marcozavagli74, 2, 2, 0, yes
2479434514,  gaybuttdem0n, 1, 1, 0, yes
2477706057,  brittyyjones34, 1, 1, 0, yes
430872182,  SilFerran, 1, 1, 0, yes
1190239524,  SimooGanz, 1, 1, 0, yes
1092793634,  marialourdesma9, 1, 1, 0, yes
2384215806,  erredantes, 3, 2, 1, yes
379450817,  ale_fe_ciro, 1, 1, 0, yes
1547916234,  G_Astaire, 1, 1, 0, yes
1446338094,  ippocampo1919, 2, 2, 0, yes
756837919088898049,  elvira_zito, 1, 1, 0, yes
2859206651,  ExpoUniversale, 1, 1, 0, yes
605796352,  mattomattone, 1, 1, 0, yes
293706018,  Giggo07, 1, 1, 0, yes
450311638,  albegalasso, 1, 1, 0, yes
1076004782,  cosaseitu, 3, 3, 0, yes
16171542,  patriciaboaglio, 1, 1, 0, yes
1897927194,  AostaNews24, 2, 2, 0, yes
1267011828,  ivandeor, 1, 1, 0, yes
3005320654,  tangocento, 2, 2, 0, yes
1643890675,  mongio80, 1, 1, 0, yes
336760825,  IvanH_C, 1, 1, 0, yes
83799867,  MaxWiz, 1, 1, 0, yes
599260945,  camiciacoibaffi, 1, 1, 0, yes
101492430,  AleNarci, 1, 1, 0, yes
542488894,  francpassarelli, 5, 2, 3, no
3401315261,  StvP7, 2, 2, 0, yes
201449579,  PGJpublishing, 1, 1, 0, yes
1096490082,  sperandellini, 1, 1, 0, yes
4077033135,  marcrocasbcn, 1, 1, 0, yes
1286955180,  marchese_76, 1, 1, 0, yes
191028339,  lapiuverde, 1, 1, 0, yes
403673747,  Passim_ES, 1, 1, 0, yes
150798877,  dmdarpizio, 1, 1, 0, yes
14771699,  guerraypaz, 1, 1, 0, yes
567557901,  Lauraludovica, 3, 1, 2, no
2838158925,  Lorenzo_Fiocco, 1, 1, 0, yes
399062606,  albygio, 3, 3, 0, yes
5869132,  maxxtallica, 1, 1, 0, yes
144855292,  valenpater, 1, 1, 0, yes
1889786136,  feoleluca, 1, 1, 0, yes
478537170,  ileniaerta, 2, 2, 0, yes
26722048,  IlBona, 2, 1, 1, neutral
40953792,  giovanniboggero, 1, 1, 0, yes
2283996312,  vazzolernico, 1, 1, 0, yes
1040293610,  PhWoelk, 1, 1, 0, yes
294163266,  _b00kw0rm, 2, 2, 0, yes
460490740,  JackFoo95, 1, 1, 0, yes
478609116,  marco_bestetti, 1, 1, 0, yes
2896671601,  axelvassallo, 1, 1, 0, yes
495359169,  kadei15, 1, 1, 0, yes
780730338,  giusyfenty, 2, 1, 1, neutral
1186392187,  MgLikeTheCar, 1, 1, 0, yes
36441166,  bennypetti, 1, 1, 0, yes
1219788192,  Ary1797, 1, 1, 0, yes
378048752,  OnezMart, 1, 1, 0, yes
450763161,  alfonsovietri1, 1, 1, 0, yes
104280890,  aletessi, 1, 1, 0, yes
3089476739,  BortoneRosalbo, 1, 1, 0, yes
129226378,  8Francesco0, 1, 1, 0, yes
602370750,  scialpi, 1, 1, 0, yes
233574116,  rosybattaglia, 2, 2, 0, yes
307019975,  sissiix, 1, 1, 0, yes
29537673,  mabeganet, 3, 2, 1, yes
397386548,  marcomagno1967, 1, 1, 0, yes
447226961,  LindaOmobono, 1, 1, 0, yes
3078210028,  GiacomoMassucco, 1, 1, 0, yes
461476920,  MorroLuca1, 1, 1, 0, yes
325103847,  lelerenzi, 1, 1, 0, yes
14711761,  PeppeMessoMalex, 2, 2, 0, yes
2320897800,  JoseIsSwish, 2, 2, 0, yes
2888269583,  auror_malfoy, 1, 1, 0, yes
513413652,  canioancona, 4, 3, 1, yes
94758638,  piripella, 1, 1, 0, yes
2764675671,  _uomosenzavolto, 1, 1, 0, yes
1115626531,  BegoPRamirez, 1, 1, 0, yes
3295847844,  tagliastaserpe, 2, 2, 0, yes
441728152,  GiuliaSalerno77, 1, 1, 0, yes
1238478012,  Luciana_Murgia, 1, 1, 0, yes
2955488711,  bignan5482, 1, 1, 0, yes
303648598,  GraceNicieza, 2, 2, 0, yes
72058480,  Maximsx, 5, 1, 4, no
386031685,  argiovannini, 2, 2, 0, yes
435000858,  Val_CohenLauri, 1, 1, 0, yes
1733774899,  eLEOlando, 1, 1, 0, yes
1529068777,  SalFittipaldi, 4, 2, 2, neutral
55300656,  nicomarti, 2, 1, 1, neutral
29807231,  elibrunetti, 3, 1, 2, no
3398530936,  GiaGalar, 1, 1, 0, yes
307541960,  Dyaale, 1, 1, 0, yes
3055459091,  FrancyAlberghi, 1, 1, 0, yes
2710243811,  EDF1998, 1, 1, 0, yes
2937536080,  donchisciote, 1, 1, 0, yes
372874917,  noma_sc, 1, 1, 0, yes
3346752575,  lesbnodrama, 1, 1, 0, yes
505111610,  gigliolacaproli, 1, 1, 0, yes
148785493,  asj_3, 1, 1, 0, yes
3323281697,  CristianoDLFuen, 1, 1, 0, yes
484484231,  Omero79, 1, 1, 0, yes
476382885,  ChitownComedy0, 1, 1, 0, yes
775781102724247552,  Magdigna, 4, 3, 1, yes
2482400314,  Roadklll65, 1, 1, 0, yes
36413868,  aleseno, 1, 1, 0, yes
2976221073,  tirreria, 1, 1, 0, yes
459840098,  patrizia_sforza, 1, 1, 0, yes
608442284,  jasmlnefritsch, 1, 1, 0, yes
1565155092,  FScozzoli, 1, 1, 0, yes
396181621,  Soniuzza81, 2, 2, 0, yes
131863572,  alexcapri86, 2, 2, 0, yes
582005365,  SilviaBiba85, 1, 1, 0, yes
417327804,  fedeli88, 1, 1, 0, yes
90845433,  barbaracarfagna, 1, 1, 0, yes
367412495,  giannizerega, 1, 1, 0, yes
126933189,  tommasoatzeni, 1, 1, 0, yes
19391648,  stefanolg, 3, 3, 0, yes
1183777562,  AndreaCaon74, 1, 1, 0, yes
143442742,  LolaVicentini, 1, 1, 0, yes
391315762,  RemoAstolfi, 2, 2, 0, yes
550040823,  amcontursi, 1, 1, 0, yes
805582271520641024,  kartika2591, 1, 1, 0, yes
435816713,  Cauett, 2, 2, 0, yes
2367157417,  goreshter, 1, 1, 0, yes
70075654,  politiconline, 3, 3, 0, yes
394849369,  maria2cesfra, 1, 1, 0, yes
537393521,  MegghieUP, 1, 1, 0, yes
799611942167977984,  rose_koranga, 1, 1, 0, yes
309771745,  lacinasiaconnoi, 3, 2, 1, yes
999110438,  alfredodepersis, 1, 1, 0, yes
26745300,  ilariapaoli, 1, 1, 0, yes
2901562716,  approfondire, 1, 1, 0, yes
131815683,  GiorgioGiuffra, 1, 1, 0, yes
8678132,  dadisem, 1, 1, 0, yes
71965204,  alan_par, 7, 6, 1, yes
488706755,  LaraRicciatti, 2, 2, 0, yes
171002941,  giannipo, 1, 1, 0, yes
504558008,  luciamauro29, 1, 1, 0, yes
334068764,  Dl289, 1, 1, 0, yes
130747989,  PietroLanzoni, 1, 1, 0, yes
805550746842316805,  LuciaFerrero9, 1, 1, 0, yes
3075717071,  tivillari, 1, 1, 0, yes
2351678732,  enrico840, 1, 1, 0, yes
840002376,  aurmajo, 1, 1, 0, yes
421112233,  BenciAnt, 1, 1, 0, yes
1897458422,  log75_it, 1, 1, 0, yes
493452187,  Silvy_Rocker, 1, 1, 0, yes
273065382,  EffeAle, 1, 1, 0, yes
537174810,  Gigidifa, 1, 1, 0, yes
719508871891578880,  Annina2109, 2, 2, 0, yes
2375950987,  MartinoSteffano, 1, 1, 0, yes
2945828200,  utop1camente, 1, 1, 0, yes
481872909,  DonatoPasquini, 1, 1, 0, yes
1142794093,  72andre__b, 1, 1, 0, yes
115048272,  alexdelli, 2, 1, 1, neutral
779074322405220353,  profumarilyn, 1, 1, 0, yes
259727818,  foxblack1, 1, 1, 0, yes
410584380,  StefCalab, 1, 1, 0, yes
3631863507,  CalimenoAdriana, 1, 1, 0, yes
4923721005,  aliinovelli_, 1, 1, 0, yes
451033799,  escaramelli, 1, 1, 0, yes
514259413,  de_riccard, 1, 1, 0, yes
1165383674,  jacopo0706, 1, 1, 0, yes
2759087925,  fufina662006, 1, 1, 0, yes
1142959554,  CaroniaDani, 1, 1, 0, yes
1528337712,  mogianati, 1, 1, 0, yes
264318097,  dariomarechiaro, 2, 1, 1, neutral
706604605988335617,  LauraPellegr128, 2, 2, 0, yes
521182595,  AlessandroMisha, 2, 2, 0, yes
3019885198,  Andreabluesky, 4, 2, 2, neutral
542151024,  corallina2, 4, 3, 1, yes
301639572,  MauraSansone, 1, 1, 0, yes
3981661755,  ANICCOLINI1, 1, 1, 0, yes
3315085115,  DeVitaCarmine, 3, 2, 1, yes
121075216,  amaruccimaio, 1, 1, 0, yes
141349313,  Giovanni_Longo, 1, 1, 0, yes
2958351993,  _mattiafalchi_, 1, 1, 0, yes
3019658033,  stefanol2006, 1, 1, 0, yes
46103474,  Vanny_Rosso, 1, 1, 0, yes
558542307,  LauraFaggi1, 1, 1, 0, yes
727658011,  evasbey, 1, 1, 0, yes
398158855,  Emanuel_Piona, 1, 1, 0, yes
49922148,  Nikko1983, 1, 1, 0, yes
246172560,  LucaBertoletti, 1, 1, 0, yes
463109924,  FerreriFederica, 3, 3, 0, yes
757227009772773376,  BilloBily82, 1, 1, 0, yes
555287914,  AndreaBrunoRoma, 1, 1, 0, yes
272464094,  annamavi, 2, 2, 0, yes
788310908925796353,  JcpZotti, 1, 1, 0, yes
492081280,  gboccanegra, 7, 3, 4, no
761555654943408129,  _saraq_83, 1, 1, 0, yes
4352298869,  dadaludi, 1, 1, 0, yes
2189949066,  pourNS2017, 1, 1, 0, yes
45466299,  sr9f6, 1, 1, 0, yes
82928606,  massimotsl, 1, 1, 0, yes
484015696,  GiorgioCasadio, 2, 2, 0, yes
3381631318,  GardaniMatteo, 1, 1, 0, yes
4630256187,  demoslombardia, 1, 1, 0, yes
2482684491,  LaneMldgett, 1, 1, 0, yes
1570979239,  RosSteward, 1, 1, 0, yes
488339747,  LiviaCarnevale, 1, 1, 0, yes
432146662,  gsdc1, 1, 1, 0, yes
1257094988,  The_Real_MS, 1, 1, 0, yes
950411336,  claudioferram, 2, 1, 1, neutral
166500904,  mcarradori, 3, 1, 2, no
387570402,  jack_seneca, 2, 1, 1, neutral
421934420,  EahsGaga, 1, 1, 0, yes
82316945,  tizianaderrico, 3, 1, 2, no
3357122169,  lalanciamara, 1, 1, 0, yes
899865349,  redcapret, 2, 1, 1, neutral
2529482186,  alesco75, 2, 1, 1, neutral
1603554078,  ciropiro1, 1, 1, 0, yes
45300696,  dariochierchia, 5, 2, 3, no
1265136662,  juventinik22, 1, 1, 0, yes
1336083961,  OrnellaChiesa, 2, 1, 1, neutral
597141529,  cigaesso, 1, 1, 0, yes
3393947795,  LaTarqui_, 1, 1, 0, yes
2990447278,  OmbreArcane, 1, 1, 0, yes
1180337983,  psychovart, 1, 1, 0, yes
794943346502434818,  LorenzoSchumi, 1, 1, 0, yes
345338849,  Antidotonaif, 1, 1, 0, yes
975700172,  ppvsf, 2, 2, 0, yes
1010846005,  Bepi_Inguscio, 1, 1, 0, yes
1389570368,  wittembergef, 3, 2, 1, yes
3362984261,  dicospessodino, 1, 1, 0, yes
197493276,  Desdemona17, 1, 1, 0, yes
773980763855421440,  silvia_bazzano, 1, 1, 0, yes
3673617375,  MasterkeyChitra, 1, 1, 0, yes
863369492,  lmacchiACM18, 1, 1, 0, yes
732049842,  Naciraema, 1, 1, 0, yes
238203936,  davportioli, 1, 1, 0, yes
6361512,  FGoria, 1, 1, 0, yes
3086292421,  Noemi_Tillocca, 1, 1, 0, yes
495225081,  CarolinaBiasca, 1, 1, 0, yes
537258769,  glucosata, 1, 1, 0, yes
456926972,  Mondo_ACLI, 1, 1, 0, yes
215102085,  aleixel, 1, 1, 0, yes
1281022508,  Sara_Tarditi, 1, 1, 0, yes
40225596,  MarcoCHardware, 2, 1, 1, neutral
4259469448,  onedonelovehnll, 1, 1, 0, yes
756832872011628544,  sofy1444, 1, 1, 0, yes
9805952,  fabiux, 1, 1, 0, yes
774544059075530752,  erika_pella03_, 1, 1, 0, yes
861204104,  FaustoBuzzi, 1, 1, 0, yes
1086424626,  AvvAngelucci, 2, 2, 0, yes
1638762523,  IlFidaDiLapo, 5, 1, 4, no
430539830,  marialombardo5, 1, 1, 0, yes
326370210,  GiulianaCavall1, 2, 2, 0, yes
350982730,  ValentinaFascia, 1, 1, 0, yes
2978935895,  Antonella_s77, 1, 1, 0, yes
3667535967,  LucaAmorosa, 1, 1, 0, yes
587596159,  TaniaSimonini, 1, 1, 0, yes
2544005815,  ZZiliani, 1, 1, 0, yes
1280322788,  HeIsMyThugNigga, 1, 1, 0, yes
1528786182,  caredda_maria, 1, 1, 0, yes
856217857,  Maldo1977, 1, 1, 0, yes
55204495,  angelocandido, 1, 1, 0, yes
3248346514,  zarelis150, 1, 1, 0, yes
2757331605,  SIloveyoursmile, 1, 1, 0, yes
270586505,  tonino10000, 4, 1, 3, no
443836053,  Bimbipopi, 1, 1, 0, yes
2154151569,  mauroluchini54, 1, 1, 0, yes
419666387,  Nistrif, 1, 1, 0, yes
739742296313335808,  fitcislSiracusa, 1, 1, 0, yes
1632483738,  karuaugustine, 3, 1, 2, no
294801723,  LuigiMellone, 1, 1, 0, yes
2996675495,  _lopez_sergio, 1, 1, 0, yes
29972394,  _gogoYubari, 1, 1, 0, yes
2751171987,  Mme_Vie, 1, 1, 0, yes
771743063303720961,  GalaPaoPao, 1, 1, 0, yes
793530303205806080,  CAFE_1933, 1, 1, 0, yes
2215880604,  lanapepsy, 1, 1, 0, yes
755420544,  yolandavassallo, 1, 1, 0, yes
258939103,  SegundoSanz, 1, 1, 0, yes
514224011,  Davide_Dada, 1, 1, 0, yes
246463738,  Samanthafi, 1, 1, 0, yes
267972821,  CuaPisa, 2, 2, 0, yes
2419891337,  varruzzu, 1, 1, 0, yes
428553573,  viorelvigna, 1, 1, 0, yes
541932820,  marcellalafea, 1, 1, 0, yes
4817910947,  fab_yasss, 1, 1, 0, yes
2949416062,  masterchef476, 1, 1, 0, yes
2862460560,  adeoli1011, 1, 1, 0, yes
1431559854,  calirobe, 1, 1, 0, yes
461810032,  PhilRoom, 1, 1, 0, yes
448367456,  magibilo, 1, 1, 0, yes
943581247,  enrico_patrizio, 2, 2, 0, yes
1847822384,  Nymsee, 1, 1, 0, yes
437365313,  AndreaArmaroli, 1, 1, 0, yes
204351427,  rova90, 1, 1, 0, yes
4887647637,  thatonesofierce, 1, 1, 0, yes
172872551,  fabriziomds, 1, 1, 0, yes
214833086,  nnapoliso, 1, 1, 0, yes
1219723040,  PezzuttoAntonio, 1, 1, 0, yes
252526909,  bombolotto, 1, 1, 0, yes
141327690,  ckortega, 1, 1, 0, yes
60374588,  Mr_Desolazione, 1, 1, 0, yes
696895616610344961,  giooo127, 1, 1, 0, yes
202227535,  Juzoar, 1, 1, 0, yes
159818131,  lukaye9, 1, 1, 0, yes
2568515717,  manuelcremonese, 1, 1, 0, yes
1918430684,  passatorio, 1, 1, 0, yes
396646592,  nicoladc1989, 1, 1, 0, yes
2311460295,  fabio_venezia, 1, 1, 0, yes
712962595817435136,  ladruncolozoppo, 1, 1, 0, yes
3705717620,  deathcump, 1, 1, 0, yes
329659385,  DirittoeLiberta, 1, 1, 0, yes
396833510,  seriouslyaleks, 1, 1, 0, yes
559893611,  CurcioDavide, 1, 1, 0, yes
3841392257,  xissur2, 3, 1, 2, no
29949992,  Adarrigo, 3, 2, 1, yes
3833381302,  MapelliMartina, 1, 1, 0, yes
336406661,  gecla5, 1, 1, 0, yes
3346955091,  haleyjamessco12, 1, 1, 0, yes
32603102,  salvomizzi, 1, 1, 0, yes
2509150289,  rosciablu, 1, 1, 0, yes
2873869361,  sthrytayes, 1, 1, 0, yes
485863030,  enrico_pozzi, 3, 2, 1, yes
410995542,  francescaventu5, 1, 1, 0, yes
2652084482,  skumfuuck, 1, 1, 0, yes
941339383,  arvm70, 1, 1, 0, yes
2423486085,  giorgiorodolfo, 1, 1, 0, yes
1117075328,  floristw, 1, 1, 0, yes
408587774,  LucaScandale, 3, 2, 1, yes
2363760975,  MarinellaSclocc, 1, 1, 0, yes
14334094,  mambaitaliana, 2, 2, 0, yes
965060024,  16sett59, 1, 1, 0, yes
2899305975,  francoocchineri, 1, 1, 0, yes
2554469229,  Roberto_Forrer, 1, 1, 0, yes
516609889,  bambi652, 1, 1, 0, yes
425201162,  great_AS, 1, 1, 0, yes
426692718,  SamueleMurtinu, 1, 1, 0, yes
3233037204,  dillah2210, 2, 2, 0, yes
635665513,  butyouremydrugs, 1, 1, 0, yes
1593329725,  CostanzaSoavi, 1, 1, 0, yes
235438573,  CirMancin, 1, 1, 0, yes
197769066,  giordanoriello, 1, 1, 0, yes
938746693,  teogazza, 1, 1, 0, yes
2258396676,  SemihGokmen66, 2, 2, 0, yes
429327262,  DavideFalchieri, 2, 1, 1, neutral
17400044,  teppdude, 1, 1, 0, yes
3238871079,  roby04081961, 1, 1, 0, yes
3437869852,  Kingkylizze, 1, 1, 0, yes
185657735,  danielemaddalo, 1, 1, 0, yes
25442408,  youmakemephil, 1, 1, 0, yes
800088627120214016,  varethesun, 1, 1, 0, yes
1422519314,  PEnzoSGroup, 1, 1, 0, yes
1116634686,  MariciComm, 1, 1, 0, yes
1855532930,  ProsperiMara, 1, 1, 0, yes
4872303610,  PascucciAugusto, 3, 3, 0, yes
1015224715,  MariaAmc44, 1, 1, 0, yes
67351208,  l3p4, 1, 1, 0, yes
1225880509,  lillyp74, 1, 1, 0, yes
2888026811,  AnnaT1414, 6, 1, 5, no
148561980,  JRRachadell, 1, 1, 0, yes
1106431202,  PBellardone, 1, 1, 0, yes
16200543,  giammy71, 1, 1, 0, yes
81160877,  40_and_life, 1, 1, 0, yes
2250160702,  Amolamusica95, 2, 1, 1, neutral
356091133,  patripezzilli, 1, 1, 0, yes
16842538,  france42, 1, 1, 0, yes
14414217,  iMarck90, 1, 1, 0, yes
1573569888,  coco_mundo, 1, 1, 0, yes
52027615,  DarioBo, 1, 1, 0, yes
757884608742625280,  Schifato2, 1, 1, 0, yes
329647103,  MarianoGiustino, 1, 1, 0, yes
20899744,  Bisax, 1, 1, 0, yes
7064212,  Cepeda, 1, 1, 0, yes
436038865,  BoopLucy, 2, 2, 0, yes
701627927,  FPiredda75, 1, 1, 0, yes
465569844,  Nicco_D612, 1, 1, 0, yes
534656278,  BringMichDahin, 2, 2, 0, yes
380379681,  AltimariVero, 1, 1, 0, yes
500868373,  dariox93, 1, 1, 0, yes
508760710,  columbus63, 2, 2, 0, yes
390866471,  TVannuzzi, 1, 1, 0, yes
720415132350742528,  JeanBoiree, 2, 2, 0, yes
614254926,  jmg162, 1, 1, 0, yes
585063081,  elenaguaitoli, 1, 1, 0, yes
281996404,  Rubs_13, 1, 1, 0, yes
2870693475,  ticozzellistefa, 1, 1, 0, yes
124545762,  mirrocafort, 1, 1, 0, yes
2975041599,  guidonig, 2, 2, 0, yes
1260045176,  waltercomer, 7, 2, 5, no
482482833,  valentinadigrav, 9, 1, 8, no
346649922,  colferslama, 1, 1, 0, yes
140069873,  eclissidelcuore, 1, 1, 0, yes
1089667200,  GiuliRipa, 1, 1, 0, yes
487700801,  laurabici, 1, 1, 0, yes
868320558,  ileniaappendini, 1, 1, 0, yes
353637223,  ccalerp, 1, 1, 0, yes
227655824,  tommaso_cenci, 1, 1, 0, yes
138751586,  breathagain_, 1, 1, 0, yes
2946604054,  anna_mc88, 1, 1, 0, yes
2728900653,  MailMaraelisa, 1, 1, 0, yes
50647381,  semerix, 2, 2, 0, yes
18581097,  malgastarte, 1, 1, 0, yes
912412638,  CorrentiMelanie, 1, 1, 0, yes
304661441,  lastue, 6, 1, 5, no
701764429738807296,  p_mos1970, 1, 1, 0, yes
501642421,  stemaestro, 1, 1, 0, yes
2357346573,  larryshipper105, 1, 1, 0, yes
1029273391,  tgbboss, 1, 1, 0, yes
2248491127,  GeorgeTetradis, 2, 2, 0, yes
2777145614,  ArturaVidal, 1, 1, 0, yes
2168394298,  Maninmanomai, 1, 1, 0, yes
794233570155970560,  bladeadly, 1, 1, 0, yes
476685667,  ELENABALESTRI1, 1, 1, 0, yes
418997717,  anna_pensil, 2, 2, 0, yes
387170756,  Guillaumemp, 1, 1, 0, yes
192705735,  Kemalsefkan, 1, 1, 0, yes
65063850,  greggnunziata, 1, 1, 0, yes
52039595,  marcoDeAmicis, 1, 1, 0, yes
439523816,  albatutt, 1, 1, 0, yes
595333619,  claudiaa_24, 1, 1, 0, yes
3060367293,  BKoeniguer, 1, 1, 0, yes
1296447642,  Vivincenzoje, 1, 1, 0, yes
4874119852,  silvietta1972, 2, 2, 0, yes
49358807,  costanzog, 3, 1, 2, no
4145282481,  angiode15, 1, 1, 0, yes
4917071151,  mat24182, 1, 1, 0, yes
4612111041,  ferrando_castro, 1, 1, 0, yes
4869130227,  Donato12428983, 1, 1, 0, yes
599344563,  Do_Lombardo, 2, 2, 0, yes
236960787,  ignasiferrerb, 1, 1, 0, yes
3129121354,  alessan73035828, 1, 1, 0, yes
2168559093,  _fijitime, 1, 1, 0, yes
133627135,  onesiemes, 1, 1, 0, yes
594689707,  3DaysofCondor, 3, 3, 0, yes
715507532274470912,  martective, 1, 1, 0, yes
216415724,  Antonio16_92, 1, 1, 0, yes
372245054,  MultiOmg22, 1, 1, 0, yes
1880677069,  kimilsuung, 1, 1, 0, yes
1923855710,  19Fabr, 1, 1, 0, yes
927816210,  gabdignazi, 1, 1, 0, yes
236422356,  salviendo, 1, 1, 0, yes
98335113,  riccardopisco, 1, 1, 0, yes
498799207,  marcofina60, 2, 2, 0, yes
122996845,  lukerunner, 1, 1, 0, yes
132338383,  davideguiotto, 1, 1, 0, yes
796191021294125058,  MoraschiE, 3, 1, 2, no
537014254,  riccgori, 1, 1, 0, yes
437870122,  santasubito73, 1, 1, 0, yes
484876382,  beckybrambilla, 2, 2, 0, yes
2847838805,  Rik3080, 2, 1, 1, neutral
535629994,  QuartieriSilvia, 1, 1, 0, yes
123940715,  carlaisoladelba, 1, 1, 0, yes
1169043776,  luca_viscomi, 1, 1, 0, yes
2868362039,  G0ULIDAKIS, 1, 1, 0, yes
797782706,  micioruffi, 2, 1, 1, neutral
1532365549,  salvatore_pasca, 1, 1, 0, yes
3380923694,  kbss738, 1, 1, 0, yes
466570453,  Titti_da, 1, 1, 0, yes
106367315,  miparevastrano, 1, 1, 0, yes
341760748,  conduepi, 1, 1, 0, yes
2498201600,  zunita90, 1, 1, 0, yes
3246519603,  19miky77, 2, 2, 0, yes
2791075923,  c21c5badc2c14d0, 3, 2, 1, yes
475025414,  stefa652012, 2, 1, 1, neutral
855050606,  Barbaquadra, 1, 1, 0, yes
802273105292967936,  mmzumb, 1, 1, 0, yes
2188136124,  paoluccio3, 1, 1, 0, yes
1277394462,  antoniosicilia6, 4, 1, 3, no
1921039550,  piwipeba, 1, 1, 0, yes
803495063267540992,  JKRpromo4, 1, 1, 0, yes
2887095707,  faccioligaia, 1, 1, 0, yes
747622538,  quellichelapl, 1, 1, 0, yes
727877553927671808,  ArianiGarage, 1, 1, 0, yes
63822625,  tweetaninsight, 1, 1, 0, yes
292902687,  teobocconi, 1, 1, 0, yes
3335390896,  garofoliluana_, 1, 1, 0, yes
995271438,  andbera, 1, 1, 0, yes
1005739862,  RosiForti, 1, 1, 0, yes
896131003,  clemdean, 1, 1, 0, yes
2283994623,  ziatitti71, 1, 1, 0, yes
611135914,  dibigueye, 1, 1, 0, yes
3245933643,  GiovanniManci19, 2, 2, 0, yes
407921274,  xlouehsvoice_, 1, 1, 0, yes
763378622983970816,  Stefano53671430, 1, 1, 0, yes
2497067365,  barbifag, 1, 1, 0, yes
3796395328,  Moscatelliluci1, 1, 1, 0, yes
4784384717,  molinarigiulia_, 1, 1, 0, yes
2875453408,  MangiacarneM, 1, 1, 0, yes
3025781515,  AmatiMaur, 1, 1, 0, yes
420995289,  SarnoRaffaele, 3, 2, 1, yes
3248474141,  aurora_mannar, 2, 2, 0, yes
2653585010,  MovimentoxBA, 1, 1, 0, yes
332726868,  puccibru, 1, 1, 0, yes
101400639,  Giova70ita, 2, 2, 0, yes
2729986610,  michsjbh, 1, 1, 0, yes
481130225,  marina_pagani_, 1, 1, 0, yes
257166217,  crysis_xx91, 1, 1, 0, yes
160631997,  Maddy92Med, 1, 1, 0, yes
1439123106,  uraniasole, 2, 2, 0, yes
369919068,  Fabione62, 2, 1, 1, neutral
961186884,  PSBeziers3, 2, 2, 0, yes
2809989688,  Roberto24170, 3, 1, 2, no
464892799,  AndreaCaleffi16, 1, 1, 0, yes
705069342661218305,  alba75784165, 1, 1, 0, yes
1071920456,  FrancoBordo1, 1, 1, 0, yes
56711184,  10luca, 1, 1, 0, yes
4884166671,  ceccomarisa, 2, 2, 0, yes
1275426734,  lamico_dellABC, 4, 2, 2, neutral
2758035340,  simodelpiero93, 1, 1, 0, yes
1045756388,  GabrieleScritta, 1, 1, 0, yes
1716594409,  luigi_giulini, 1, 1, 0, yes
117004990,  phisaz, 1, 1, 0, yes
4864250579,  glassofeverglow, 1, 1, 0, yes
805727869318156289,  RagazzinoM, 1, 1, 0, yes
794186187237969920,  mosheIRaz, 1, 1, 0, yes
3381526636,  Sinopya, 3, 1, 2, no
1640288251,  Antoride, 1, 1, 0, yes
534297810,  Pierluca_85, 1, 1, 0, yes
1202152525,  elisabettag61, 1, 1, 0, yes
2725233833,  mdino67, 1, 1, 0, yes
378743872,  johan_76, 1, 1, 0, yes
978271016,  marviglio, 1, 1, 0, yes
443777565,  felisiadz, 1, 1, 0, yes
2458034649,  ConfucioSapiens, 1, 1, 0, yes
1221818034,  Mauro5686, 10, 2, 8, no
49771732,  elegere, 1, 1, 0, yes
756833104862572544,  MtCrocetrails, 1, 1, 0, yes
926398490,  nadiam85, 2, 1, 1, neutral
514499246,  dottmattiello, 2, 2, 0, yes
1275230222,  mariarosaria321, 2, 2, 0, yes
1016302554,  Simone_Flore, 1, 1, 0, yes
2582158936,  GiovanniNinobis, 1, 1, 0, yes
1956997106,  LucaVignoni, 1, 1, 0, yes
2823024909,  EAgrigenti, 1, 1, 0, yes
1174975232,  comeH2O, 5, 5, 0, yes
2187861779,  MariaCe55838972, 1, 1, 0, yes
486497313,  Marconickk, 1, 1, 0, yes
2356163072,  jackfolla1959, 3, 1, 2, no
2571330985,  antoninonasone, 24, 24, 0, yes
256177809,  Alligallina, 1, 1, 0, yes
2760630059,  raisaferri60, 2, 1, 1, neutral
717894110,  GiuliaViv, 1, 1, 0, yes
703263208358936576,  flo9671, 1, 1, 0, yes
59475391,  Gibadiplomatico, 1, 1, 0, yes
717446834134859776,  eleanor_mec, 1, 1, 0, yes
789531619,  CaffeMorlacchi, 1, 1, 0, yes
394263454,  qamarfar, 1, 1, 0, yes
1860435552,  grilliserafino, 2, 1, 1, neutral
1701198374,  UffPost, 1, 1, 0, yes
1624749512,  GeremiaPaolucci, 3, 2, 1, yes
4200745175,  marcomng91, 1, 1, 0, yes
29007074,  gioby, 1, 1, 0, yes
195363475,  Giangimerlo, 1, 1, 0, yes
3311713204,  rafmontagnoli, 1, 1, 0, yes
322037405,  GasperiniLuca, 7, 2, 5, no
49956932,  margydaisy, 5, 4, 1, yes
540061435,  MaxZaramella, 1, 1, 0, yes
2284493470,  VittorioBrunofg, 5, 4, 1, yes
239002061,  P_Giordano, 1, 1, 0, yes
2767049080,  andrevalla25, 1, 1, 0, yes
748205390043746305,  MonicaLaMiola, 1, 1, 0, yes
19810233,  GanoGanelli, 1, 1, 0, yes
797235889764233216,  n0sh_tsherlock, 1, 1, 0, yes
436570699,  iL_maniScalco_, 3, 3, 0, yes
215224614,  Arsenio_, 13, 1, 12, no
799981099166404608,  Giampie01791011, 3, 1, 2, no
2173904793,  acheni_23, 2, 2, 0, yes
519270357,  MauroMaffizzoli, 2, 2, 0, yes
474293230,  SerioEnzo, 1, 1, 0, yes
477998487,  MBjan78, 1, 1, 0, yes
476416458,  AngeloLacagnina, 1, 1, 0, yes
558929345,  PaolofromRome, 7, 1, 6, no
2557324242,  maurorosar, 1, 1, 0, yes
701151374638247937,  gusperti, 1, 1, 0, yes
3891977338,  cinziagalante03, 2, 2, 0, yes
395803990,  robyter70, 1, 1, 0, yes
57687321,  FABIUSH, 2, 1, 1, neutral
2384955978,  pasqualekp, 3, 1, 2, no
1037475938,  BWV_1041, 1, 1, 0, yes
254957138,  Call_me_Otis, 1, 1, 0, yes
1050911497,  BigMaxOfficial, 1, 1, 0, yes
2292699266,  michaeljuve89, 1, 1, 0, yes
410157432,  ancilo90, 1, 1, 0, yes
893784643,  movimentozero, 2, 2, 0, yes
2742194606,  lechuzeta, 1, 1, 0, yes
1480020949,  xmaflex, 1, 1, 0, yes
259428725,  davidexy, 1, 1, 0, yes
328482006,  fulcele, 1, 1, 0, yes
2622683400,  Scempioemostruo, 2, 2, 0, yes
1694413363,  susy_ott, 2, 1, 1, neutral
3348932435,  simone_foresti, 1, 1, 0, yes
2842549305,  Francy590, 1, 1, 0, yes
2387199067,  OrlandoAita1992, 2, 1, 1, neutral
1499571295,  ScusaSuca, 1, 1, 0, yes
166067490,  marcocrimi, 1, 1, 0, yes
414894324,  mandia12, 1, 1, 0, yes
2889269897,  CeccaLory, 1, 1, 0, yes
72055505,  RifiutiImperia, 2, 1, 1, neutral
493640854,  pbaucheron, 1, 1, 0, yes
744871559098146816,  antoniodb_91, 6, 3, 3, neutral
785554968103313408,  Marco6820, 5, 1, 4, no
413002453,  SAETTAPIA, 3, 3, 0, yes
865098782,  MarcoBottes, 1, 1, 0, yes
2389771008,  hippo44700, 1, 1, 0, yes
950435516,  HB2C, 1, 1, 0, yes
1917243626,  GiliuTododina, 5, 5, 0, yes
2921641162,  RobyLibera5, 1, 1, 0, yes
205264128,  LaiEmanuele, 1, 1, 0, yes
92002598,  packzenoch, 1, 1, 0, yes
1635205140,  Wally_G_Fin, 3, 1, 2, no
4577275889,  marc0ver0, 2, 1, 1, neutral
1063996328,  davorusso, 1, 1, 0, yes
968870299,  piero_sklero, 1, 1, 0, yes
4845010499,  negrelli14, 4, 1, 3, no
781946959598870528,  Ginepro6, 1, 1, 0, yes
795043750816911360,  linuzzamia, 4, 4, 0, yes
709304095375495168,  AdpTaranto, 3, 1, 2, no
2894510331,  xAlbertonex, 2, 2, 0, yes
96406666,  lgfmefrance, 1, 1, 0, yes
388401730,  emaxuele, 1, 1, 0, yes
747777122018672640,  Internato165, 1, 1, 0, yes
108987060,  ElenaJocker, 2, 2, 0, yes
3958858588,  barpizzeriaalp2, 1, 1, 0, yes
2592095857,  SimoPello, 1, 1, 0, yes
401975985,  Fra_Smoke, 2, 2, 0, yes
718831473101520896,  francy1973tosi, 2, 2, 0, yes
1142534742,  simonemorelli_, 1, 1, 0, yes
388757464,  SerenaGuss, 1, 1, 0, yes
490662096,  alby773, 1, 1, 0, yes
524616762,  maurogabutti, 1, 1, 0, yes
581399988,  burcy1, 1, 1, 0, yes
504249870,  Marco_Ponziani, 3, 3, 0, yes
1112651670,  annalisacanetti, 1, 1, 0, yes
3241849743,  Krciy, 2, 2, 0, yes
3500831,  CapaGira, 3, 2, 1, yes
2764203485,  d_acierno, 10, 1, 9, no
2296150485,  FrancescaBelliz, 1, 1, 0, yes
267098925,  guacamole666_, 1, 1, 0, yes
1658632189,  briggybri, 1, 1, 0, yes
183211549,  Gianpsis, 1, 1, 0, yes
802907146467868672,  fantasmazdanie, 2, 2, 0, yes
422502823,  AntonioIngroia, 6, 1, 5, no
1412896242,  DaniloStancato, 26, 26, 0, yes
1087160287,  ilariacoscia, 2, 2, 0, yes
425069433,  BeaAloise, 1, 1, 0, yes
760168608890818564,  rosannaprocacci, 3, 1, 2, no
549062047,  tommasobarsali, 3, 2, 1, yes
409607216,  AndreaAAmato, 1, 1, 0, yes
719945822348144640,  sicurarmor, 4, 1, 3, no
429054107,  matteodipaolo89, 1, 1, 0, yes
633613479,  Joe_il_buono, 1, 1, 0, yes
517990318,  FonzoPaola, 1, 1, 0, yes
3170073534,  silvia_burtone, 15, 12, 3, yes
710968578,  IDAFRAU, 3, 3, 0, yes
760531868529922049,  Antonin66888401, 1, 1, 0, yes
993284737,  nopino40, 1, 1, 0, yes
700417503944695808,  martucciauccia, 3, 1, 2, no
1282926986,  ArnaldoPerilli, 1, 1, 0, yes
4773912928,  MoncalieriTO, 2, 2, 0, yes
1065654302,  ElisaMoretti59, 1, 1, 0, yes
291596551,  sandratani1, 1, 1, 0, yes
1673659374,  NAccurso, 1, 1, 0, yes
755109617324191744,  aboringbrunette, 1, 1, 0, yes
347907371,  elibal11, 1, 1, 0, yes
210781142,  TheVeiled_Fairy, 1, 1, 0, yes
270465914,  xavierjacobelli, 1, 1, 0, yes
305798744,  danielesosorio, 1, 1, 0, yes
323729290,  gjamesbond, 1, 1, 0, yes
105032281,  SantEgidioUSA, 2, 2, 0, yes
946564446,  Aleksos82, 1, 1, 0, yes
1211216773,  opi_max, 1, 1, 0, yes
2480594429,  B2lov6d, 1, 1, 0, yes
3294297172,  b7c38375aa944ce, 1, 1, 0, yes
1036882280,  marilar54, 2, 2, 0, yes
126454439,  BARBYD3, 3, 1, 2, no
400139381,  ContiMatteo, 1, 1, 0, yes
24673213,  Axel_Bxl, 1, 1, 0, yes
796253638641467392,  poppy198279, 1, 1, 0, yes
3358771300,  LicitraCarmela, 1, 1, 0, yes
2356712557,  037Giuseppepepe, 1, 1, 0, yes
2429238004,  scrdnl1973, 1, 1, 0, yes
118090614,  ricciolaa, 1, 1, 0, yes
805586878615392258,  BobbyGreennnn, 1, 1, 0, yes
476598883,  giovanelli81, 1, 1, 0, yes
68379147,  ereticodarogo, 2, 2, 0, yes
162807809,  AntonioBuccieri, 2, 1, 1, neutral
1098510534,  effeil53, 2, 2, 0, yes
3832681397,  futurelawdigita, 1, 1, 0, yes
517976318,  gclaudiagcla, 2, 2, 0, yes
2364680733,  Gian_Cesari, 2, 2, 0, yes
723207895299547136,  pascal56314, 1, 1, 0, yes
1704554534,  NevioPavan, 1, 1, 0, yes
538091526,  Gianluca800, 1, 1, 0, yes
413809101,  ErnestoRonci, 2, 2, 0, yes
183961134,  LukaFallica, 1, 1, 0, yes
2757417090,  cacurrodinogarr, 1, 1, 0, yes
1095432498,  Giovanni_Errani, 1, 1, 0, yes
217823173,  Simolaker, 1, 1, 0, yes
542402644,  GianSlim, 3, 2, 1, yes
413007749,  tvzoomitalia, 1, 1, 0, yes
1676734230,  AntonBattaglia, 12, 2, 10, no
746417388988555265,  OmbrettaPievai2, 1, 1, 0, yes
2663641827,  vi_basta, 1, 1, 0, yes
798534572401131520,  45fc5d9de4674ad, 1, 1, 0, yes
316393390,  LAristopazzo, 3, 2, 1, yes
54187793,  DePoliWebTV, 2, 2, 0, yes
53368287,  MauroAnnunziata, 2, 2, 0, yes
788291127384367105,  UdcIta, 2, 2, 0, yes
859534544,  Piu_Italia, 2, 2, 0, yes
859494601,  PerItalia, 2, 2, 0, yes
288094317,  UdcVeneto, 2, 2, 0, yes
859521930,  Per_Italia, 2, 2, 0, yes
1587765782,  francescoorefi4, 1, 1, 0, yes
483247998,  gcacciatores, 1, 1, 0, yes
764925639254237184,  graziarusso11, 1, 1, 0, yes
222408719,  loryr52, 1, 1, 0, yes
717318984958402560,  EmployersDay, 1, 1, 0, yes
793894788156297216,  Andrea26303906, 2, 2, 0, yes
3087203878,  Franco946Franco, 1, 1, 0, yes
443821474,  MaxMiglietta2, 2, 2, 0, yes
2904253755,  viaggiatoridigi, 2, 1, 1, neutral
405728539,  Azazel67Nadin, 2, 2, 0, yes
1369086320,  GianlucaBarone6, 2, 2, 0, yes
430021582,  ekkekkazzo, 4, 4, 0, yes
619750462,  Calcio247, 1, 1, 0, yes
1513517870,  saullant, 1, 1, 0, yes
3310400303,  patriziaserang1, 1, 1, 0, yes
1076850626,  DarioScopel, 2, 2, 0, yes
1002562748,  Alb4ChicoForti, 5, 5, 0, yes
411197067,  riccardocadiz, 6, 2, 4, no
780099851245740033,  WifeDesperate, 1, 1, 0, yes
599593018,  sciubbis, 2, 2, 0, yes
1221300356,  Guerri1960, 1, 1, 0, yes
2212749012,  ermellyna, 1, 1, 0, yes
1231882657,  RESHBD, 3, 3, 0, yes
33902597,  IAmGippi, 1, 1, 0, yes
245112151,  stefen49, 1, 1, 0, yes
398851374,  astronomiclaura, 1, 1, 0, yes
8809222,  Monsieurdosto, 1, 1, 0, yes
2463165895,  TrustMeImFab, 2, 1, 1, neutral
257537852,  valemood, 1, 1, 0, yes
496769260,  81mceagle, 2, 1, 1, neutral
200027753,  ValComm, 1, 1, 0, yes
98715039,  mstakdmr, 1, 1, 0, yes
261134746,  Emanuelakoala, 2, 1, 1, neutral
987011982,  EdivadCalabrese, 1, 1, 0, yes
290433689,  mgrco, 1, 1, 0, yes
130949265,  sirgolly, 3, 3, 0, yes
1234164054,  CarloCaparrotti, 1, 1, 0, yes
2184002018,  toni_nadine, 1, 1, 0, yes
425422965,  giamma84regina, 3, 3, 0, yes
395260015,  DaliaDalu, 4, 1, 3, no
803350832829886464,  SHIVER_MARTINA, 1, 1, 0, yes
91652757,  semifonte, 1, 1, 0, yes
167406951,  WineNewsIt, 2, 2, 0, yes
1139704651,  vince_ditaranto, 1, 1, 0, yes
2956287347,  NoireVn, 1, 1, 0, yes
2792943238,  saruwatari997, 2, 1, 1, neutral
597926584,  ChicoForti_Free, 5, 5, 0, yes
2249068752,  LaMarchesa13, 1, 1, 0, yes
1640886434,  RobinG00d, 1, 1, 0, yes
2937288747,  comepasquino, 1, 1, 0, yes
524684548,  giannamottadell, 1, 1, 0, yes
166663254,  Ignoto2011, 1, 1, 0, yes
2235126648,  vlnicolao, 1, 1, 0, yes
2318888982,  tarcisiofortin, 2, 1, 1, neutral
803287506875727872,  CaioloSalvatore, 1, 1, 0, yes
1169393178,  RossellaSenesi, 1, 1, 0, yes
787669678957203456,  giulif77, 4, 4, 0, yes
3398494691,  andreatorti90, 1, 1, 0, yes
241520591,  lookatluca, 2, 1, 1, neutral
183292987,  zanotto_franco, 2, 1, 1, neutral
849195252,  social_mediaset, 3, 3, 0, yes
939455448,  Penzovi, 1, 1, 0, yes
970548324,  GiancarloVivone, 1, 1, 0, yes
952150290,  XBritsch, 1, 1, 0, yes
400781881,  Danilo_mgh, 1, 1, 0, yes
392656492,  rep_bari, 16, 3, 13, no
29953896,  lucaborsari, 1, 1, 0, yes
537994532,  ParodiEmanuele, 1, 1, 0, yes
338842441,  roby_whitehead, 1, 1, 0, yes
201412456,  Didi1648, 5, 1, 4, no
803238613915930625,  GL23299480, 1, 1, 0, yes
195956316,  GENNYWIRO, 1, 1, 0, yes
2709633235,  PerlArtemisia, 3, 1, 2, no
414117676,  LuigiBarlocco, 2, 1, 1, neutral
3226296935,  morini1712, 3, 1, 2, no
3105484471,  lux_chiara, 1, 1, 0, yes
3208155737,  PescaAngela, 1, 1, 0, yes
335906092,  Aequa42, 1, 1, 0, yes
767794621917323264,  dadaxx83, 2, 2, 0, yes
2848223301,  scrigno71, 5, 1, 4, no
2345472305,  andreapoli8788, 3, 2, 1, yes
507382148,  TeresaDeIulio, 6, 6, 0, yes
31533927,  fraba, 1, 1, 0, yes
790505956954308608,  BoucherGregoire, 1, 1, 0, yes
3451041142,  Girolam50446435, 1, 1, 0, yes
763485613,  nonexpedit, 1, 1, 0, yes
735053112273207301,  alex_sandro91, 1, 1, 0, yes
3361958991,  AnelaKovacs, 1, 1, 0, yes
746985479992709120,  EuEthnic, 1, 1, 0, yes
557250105,  reinedetrianon, 1, 1, 0, yes
170710393,  massi1966, 1, 1, 0, yes
1000366015,  amset68, 25, 1, 24, no
612630627,  mmontagner85, 1, 1, 0, yes
796824766548234240,  Alelelele7, 4, 1, 3, no
717824772,  malintenzionato, 7, 6, 1, yes
379264571,  emanuel_press, 3, 3, 0, yes
2783140927,  Fasakun, 1, 1, 0, yes
412134662,  spaccapietre, 3, 3, 0, yes
208962256,  bittenPear, 1, 1, 0, yes
1089979686,  CiccioAmarante, 8, 2, 6, no
512204721,  colnaghi75, 1, 1, 0, yes
2860637063,  nonquella, 1, 1, 0, yes
1060911842,  Elygabrysabry1, 2, 1, 1, neutral
278743750,  Marinotoma, 6, 0, 6, no
428411075,  VFumero, 3, 2, 1, yes
2885129761,  gungui_a, 1, 1, 0, yes
721947462823501825,  artur_torcda, 1, 1, 0, yes
1205859403,  manuelamanzulli, 1, 1, 0, yes
217146986,  capriglionefran, 4, 3, 1, yes
1048291818,  NoClass81, 13, 7, 6, yes
56346691,  robertalerici, 1, 1, 0, yes
217534298,  dario_harbas, 2, 1, 1, neutral
1364992884,  Andwolfli, 1, 0, 1, no
406277596,  cioffi_marco, 1, 0, 1, no
43157996,  mrfrancescato, 2, 1, 1, neutral
1388859108,  sa_ma95, 2, 1, 1, neutral
805406150321639424,  zacafilip, 2, 1, 1, neutral
790984475656192000,  kiarastrega, 22, 11, 11, neutral
1032240782,  Luca_torresan_, 2, 1, 1, neutral
762958064861507585,  Mariodellerose1, 4, 2, 2, neutral
803859098127257601,  FabioValenza2, 4, 2, 2, neutral
773573943978590210,  fashionevents81, 2, 1, 1, neutral
635446554,  NicolaMolteni, 5, 1, 4, no
80941489,  nickledgers, 2, 1, 1, neutral
338524973,  Nottesenzaluna1, 3, 1, 2, no
422152255,  GuidoDeMartini, 2, 1, 1, neutral
1867337995,  onnis4president, 2, 1, 1, neutral
797910575728721921,  PrincipeDeiPove, 6, 1, 5, no
800981529983877121,  ZenoSiri, 6, 1, 5, no
804453720872415232,  PinoChiodi, 6, 1, 5, no
3319178885,  antonelloscarl2, 5, 2, 3, no
473153266,  ElisaIsoardi, 2, 1, 1, neutral
1247005489,  Stefano_Corti85, 4, 2, 2, neutral
464167534,  alecasigli, 2, 1, 1, neutral
709291269135187968,  Ildebrandodisoa, 5, 1, 4, no
3048023601,  puccionieli, 1, 1, 0, yes
414811187,  enzo_salvi, 6, 6, 0, yes
121722049,  discoversilia, 1, 1, 0, yes
4145340147,  ElisaRicciardi3, 1, 1, 0, yes
970032865,  Nandos0804, 1, 1, 0, yes
738361680787312640,  annalisalisio, 1, 1, 0, yes
786498222554550272,  michelarandy, 1, 1, 0, yes
811786944,  ONinnone, 1, 1, 0, yes
2625335697,  grandeladro, 1, 1, 0, yes
1134720390,  bonoboforever, 10, 1, 9, no
112167809,  AntoGranato, 1, 1, 0, yes
4119726443,  miriamgamadi, 3, 0, 3, no
467708411,  FILIPPOELMoRo, 3, 0, 3, no
4739059103,  EuroMacht, 1, 0, 1, no
112386378,  grox77, 2, 0, 2, no
3084719191,  pap_pina, 6, 2, 4, no
816389954,  RafaeleFigliola, 3, 0, 3, no
2482335605,  ClaudioDurigon, 31, 0, 31, no
259206260,  michele_valente, 4, 0, 4, no
1876700449,  effemedica, 16, 0, 16, no
732504227961044992,  Autoferro_Ugl, 23, 0, 23, no
3090093706,  MillochFabio, 38, 1, 37, no
983347904,  pomax67, 1, 0, 1, no
1154282738,  1IlMigliore, 18, 2, 16, no
725591918,  Pater_Pat, 2, 0, 2, no
2768905294,  stefanofrascaro, 5, 0, 5, no
731569732151836672,  Rita58256346, 1, 0, 1, no
418966250,  LuciaCavaliere1, 5, 1, 4, no
747460891885604865,  DePasquale_Ugl, 4, 0, 4, no
2477149305,  saraceni_UGLFP, 2, 0, 2, no
1119665262,  gildo_rossi, 161, 0, 161, no
476812303,  piero_peretti, 121, 0, 121, no
943625054,  77Freddo, 109, 0, 109, no
3398643791,  fcappadonia86, 162, 0, 162, no
3439568590,  uglabruzzo1, 35, 0, 35, no
1224387126,  cammi_nando, 44, 0, 44, no
4645739417,  ManderioliLaila, 3, 1, 2, no
455700963,  RosyRoseLeo, 81, 0, 81, no
519365999,  D_Pellerano, 1, 0, 1, no
3041231505,  gmascolo70, 14, 0, 14, no
4905419657,  Vassiliadis_Cos, 35, 0, 35, no
3247710875,  MattiaMalossini, 1, 0, 1, no
3457594222,  s_soniaproietti, 31, 1, 30, no
783439386880999424,  ellafognolane81, 1, 0, 1, no
1303980487,  mroghiUGL, 6, 0, 6, no
1353760267,  uglspera, 11, 0, 11, no
780749266155286528,  uglpolpensicil, 1, 0, 1, no
454915627,  LorenzoMicari, 1, 0, 1, no
2502342492,  74Fasano, 1, 0, 1, no
2472152787,  michelevirg53, 4, 0, 4, no
3020347815,  Ezio_all_59, 1, 0, 1, no
323428736,  CARLODELGIUDIC1, 7, 0, 7, no
575630635,  Riccardo_enki, 2, 0, 2, no
3374467005,  RosaBillo, 5, 0, 5, no
423731914,  LorenzoLaMalfa, 1, 0, 1, no
63791702,  saveriomarino, 3, 0, 3, no
1369083600,  PieroGiovatti, 7, 2, 5, no
754007153187360768,  TarloParlante, 1, 0, 1, no
736299731152961536,  u_ceretto, 2, 0, 2, no
3044896882,  m5s_marche, 6, 0, 6, no
767028974174277636,  antonio_polenta, 1, 1, 0, yes
425907195,  AngeloComiato, 1, 1, 0, yes
431810837,  claudiochianura, 4, 2, 2, neutral
1143014718,  HCE__, 1, 1, 0, yes
28072761,  beppegi, 6, 1, 5, no
254777897,  giusyeffe, 1, 1, 0, yes
2350895996,  CarloPizzaballa, 1, 1, 0, yes
892990969,  DNAZZARENO, 2, 2, 0, yes
776123069979033600,  ateliergueli, 2, 2, 0, yes
732211591773618177,  lasilvereconomy, 1, 1, 0, yes
33182303,  luciolamberti, 1, 1, 0, yes
976771596,  BambiniNOsbarre, 1, 1, 0, yes
3130877788,  Stopttip_SestoC, 2, 2, 0, yes
2929621361,  plgiannetti, 3, 1, 2, no
4405224977,  GiovannellaG, 11, 0, 11, no
714085984091111424,  gilbertoghizzi3, 1, 0, 1, no
2902401513,  Altra_News, 2, 0, 2, no
781593851182063616,  Arebilaaa, 3, 0, 3, no
112810232,  Frenkoz, 4, 1, 3, no
378461293,  Marcello_Caputo, 1, 0, 1, no
441623488,  sesa25, 15, 0, 15, no
422037955,  Roby_Bius, 1, 0, 1, no
1688524777,  IZ5UFK, 1, 0, 1, no
804761754899283968,  Romy91353725, 1, 0, 1, no
361386856,  brunomarche, 2, 0, 2, no
1680057799,  grazia_marco, 1, 0, 1, no
728584655079915520,  rc1364, 2, 0, 2, no
599940695,  romafaschifo, 11, 0, 11, no
7200472,  RPlacido, 1, 0, 1, no
803347714104770562,  CheChestefano2, 1, 0, 1, no
1342258555,  AndrewMcCarey, 1, 0, 1, no
711170604486029312,  PaxetIux, 4, 0, 4, no
709724815146545152,  ldalfi, 4, 0, 4, no
353637140,  LauraDalfollo, 4, 0, 4, no
711163800465055745,  AmoR_Marte1, 12, 1, 11, no
3998148285,  CeniFranco, 2, 0, 2, no
4515619593,  AngelaCiardi2, 13, 1, 12, no
3466793483,  Silvio1Di, 1, 0, 1, no
832669237,  rotondo_rotondo, 21, 0, 21, no
696294331716653056,  GinoArseni, 1, 0, 1, no
611557487,  marinox24, 1, 0, 1, no
1013216689,  SBigalli, 1, 0, 1, no
180292368,  cyntes, 1, 0, 1, no
106062337,  Cassandrino, 1, 0, 1, no
1891177956,  mimmociardulli, 1, 0, 1, no
328140558,  MassimoDiana, 1, 0, 1, no
4915140063,  baronegianfran1, 1, 0, 1, no
37669592,  Danetto, 1, 0, 1, no
1009350042,  AnnaMBellosi, 1, 0, 1, no
625487678,  v_salvati, 1, 0, 1, no
790992803916554240,  brunamariamari1, 1, 0, 1, no
383910544,  salvatoredifra2, 1, 0, 1, no
165192608,  HalZanetti, 2, 0, 2, no
1225147400,  BaldoniLetizia, 2, 0, 2, no
448110982,  TiziFr, 1, 0, 1, no
3023877706,  ireastrina, 2, 0, 2, no
803594927959580672,  magnifiko75, 2, 0, 2, no
291928126,  simofons, 2, 0, 2, no
30849011,  marcowait4it, 2, 0, 2, no
615962268,  RITAGLIATO, 2, 0, 2, no
1311038371,  Sbornod, 3, 2, 1, yes
934103166,  AgarPm, 1, 0, 1, no
3389821143,  violipaolo, 1, 0, 1, no
799004369979117568,  ScelgoNOVdA, 1, 0, 1, no
67717371,  carlabrandolini, 4, 1, 3, no
2346750207,  loryadoncecchi, 5, 0, 5, no
1361067690,  GraziaMg2000, 2, 0, 2, no
1262576665,  vincenzoammi, 3, 0, 3, no
367202498,  EndriolDoko, 1, 0, 1, no
303047906,  AntoninoSindona, 1, 0, 1, no
430698104,  Enia50, 3, 0, 3, no
993939740,  stefanello73, 1, 0, 1, no
22988685,  sabinomaggi, 1, 0, 1, no
439877772,  CB990ND, 1, 0, 1, no
187256895,  juliet_hall, 2, 0, 2, no
3531524723,  Lanterna00043, 1, 0, 1, no
481046302,  robsili, 5, 1, 4, no
1045134870,  cmprtr, 1, 0, 1, no
422449941,  jhansen63, 1, 0, 1, no
475829005,  StaffAmbiente, 3, 0, 3, no
550428173,  fiorigorini, 9, 0, 9, no
317336535,  pidemath, 1, 0, 1, no
1041677040,  DomenicoP_1991, 2, 0, 2, no
266084021,  stefu63, 1, 0, 1, no
2525303475,  alessandra5857, 1, 0, 1, no
406831073,  superigig, 1, 0, 1, no
755642990316621824,  RemorenzoRizz, 1, 0, 1, no
261361900,  cinziajo, 1, 0, 1, no
1928092940,  Dibi_Fra, 8, 0, 8, no
781240119881760768,  SIPRomaeLazio, 6, 0, 6, no
420473032,  francescocardil, 1, 0, 1, no
2879642111,  simona676767, 1, 0, 1, no
94377101,  luigicaserta, 1, 0, 1, no
3003467823,  mortcinder1111, 1, 0, 1, no
316466266,  Morgaine1967, 4, 2, 2, neutral
116193538,  damiano_dd, 3, 0, 3, no
324046456,  pieromenno, 2, 1, 1, neutral
941068543,  emilioquintieri, 2, 1, 1, neutral
13276922,  maudel15, 1, 0, 1, no
44592301,  nicodina, 1, 0, 1, no
229966869,  emiliotoffano, 1, 0, 1, no
701058764850511873,  sinitSermoneta, 1, 0, 1, no
754680784548667393,  renegate1979, 1, 0, 1, no
410986900,  antonellabizza1, 2, 0, 2, no
420987413,  fabiosilvestri3, 8, 0, 8, no
1377722724,  ChristianPaltri, 1, 0, 1, no
1589606430,  DicintioEn, 1, 0, 1, no
1528766720,  svane_, 1, 0, 1, no
3903990677,  LaurusRavni, 2, 0, 2, no
805349047,  ValerioGulia, 1, 0, 1, no
454710765,  ChiccoRaffaelli, 1, 0, 1, no
3332423949,  68Ary, 1, 0, 1, no
255233338,  mr_etti, 1, 0, 1, no
1242548042,  dario_calzavara, 1, 0, 1, no
472955722,  GraziellaAmenta, 1, 0, 1, no
208447128,  EmaPihk, 1, 0, 1, no
320990787,  fcordio, 1, 0, 1, no
190084519,  JohnnyICS, 4, 0, 4, no
735587915078742017,  Vi_Pi_H, 1, 0, 1, no
436107066,  NUNZIODE, 3, 1, 2, no
116679213,  latrudy, 2, 0, 2, no
2217330908,  afumagalli2, 2, 0, 2, no
4526794900,  annas964, 2, 0, 2, no
1291614584,  tagliapc3, 3, 0, 3, no
117181647,  Johndartois, 1, 0, 1, no
4886966033,  lolli_10, 1, 0, 1, no
736168420719394816,  angimatalone, 1, 0, 1, no
615072676,  RobertoRossini5, 1, 0, 1, no
270337080,  marcogiuf, 1, 0, 1, no
522203766,  aannnnaa1403, 1, 0, 1, no
2492674834,  ladinbel, 3, 0, 3, no
1330947722,  mikisoll, 1, 0, 1, no
865346486,  enzorus2020, 1, 0, 1, no
3207502492,  mariannafiorino, 1, 0, 1, no
262777162,  ulvy3000, 1, 0, 1, no
310215639,  giadanajarro, 1, 0, 1, no
96380866,  falcao83, 5, 0, 5, no
715914627,  keta2167, 1, 0, 1, no
2277360169,  CensoreCatone, 1, 0, 1, no
426498186,  Fabrikios, 1, 0, 1, no
2325858169,  Matteo_NFL, 1, 0, 1, no
55518746,  piulibri2016, 1, 0, 1, no
3438227752,  LAURACARIA2, 2, 0, 2, no
3445295777,  g_blandini, 2, 1, 1, neutral
468666230,  bertonesilvio, 1, 0, 1, no
3052866272,  casula63, 1, 0, 1, no
1318605636,  pieroscivoletto, 7, 0, 7, no
78943556,  fra_marchiano, 2, 0, 2, no
1296698486,  formosa_g, 5, 0, 5, no
319822986,  AntonioNegri, 15, 0, 15, no
1192897722,  Mikypa79, 3, 0, 3, no
120176980,  stefany74, 1, 0, 1, no
3751200317,  paolellam147, 1, 0, 1, no
459575207,  AntonioBachis, 2, 0, 2, no
1198833228,  bibalbit, 2, 0, 2, no
424164438,  RobertoFazzolar, 2, 0, 2, no
1620821989,  inniallsarmsxx_, 3, 0, 3, no
397125568,  mbidoni, 1, 0, 1, no
490504850,  PietroMazzara1, 2, 0, 2, no
504501744,  alexbaravelli, 4, 1, 3, no
2954019286,  giampo1975, 1, 0, 1, no
85358343,  bobalsor, 2, 0, 2, no
1219462364,  Vincenzo_Franze, 1, 0, 1, no
2751130101,  roby_lioncastle, 2, 0, 2, no
451425647,  davidenotav, 1, 0, 1, no
237633755,  danisol74, 2, 0, 2, no
21185883,  francesca_bria, 2, 0, 2, no
1001442932,  conteashanti, 4, 0, 4, no
4017605728,  Officine3D, 1, 0, 1, no
274608461,  officinevdl, 1, 0, 1, no
467401158,  sergio_scorza, 9, 2, 7, no
718837077304086528,  BarbaraAzzara, 1, 0, 1, no
4855564132,  V_Capitolina, 3, 1, 2, no
361268701,  MaricaCasoni, 2, 0, 2, no
321903922,  FrancescaG92, 2, 0, 2, no
498994112,  manuel_guidi, 1, 0, 1, no
2214232422,  BariMigliore, 2, 0, 2, no
170769737,  Woodstock_76, 11, 0, 11, no
221064731,  frankowolf1, 2, 0, 2, no
795937245253484544,  BSailsItaly, 1, 0, 1, no
395216654,  MarcoDiMichele1, 8, 0, 8, no
2716622877,  gianpigervasi, 4, 0, 4, no
2596359046,  fc5b81746974419, 1, 0, 1, no
422947099,  rinoseq, 3, 0, 3, no
357100487,  bensilve68, 5, 2, 3, no
3144292696,  CriAutolitano, 3, 0, 3, no
601417871,  ILoveDelenaNian, 3, 0, 3, no
3812572893,  TAXICABria, 5, 0, 5, no
447038194,  StefanoIncolla, 2, 0, 2, no
122072439,  Indigestio, 1, 0, 1, no
498007394,  _645236501049, 5, 0, 5, no
450828495,  rgigino2002, 1, 0, 1, no
3213779287,  Econo167Econo11, 1, 0, 1, no
308042987,  LadyElizabeth93, 2, 0, 2, no
1110771230,  davidepovero, 1, 0, 1, no
69218842,  sergio0463, 5, 0, 5, no
184018328,  desantismar, 4, 0, 4, no
373398962,  MarcoTrozzi1, 3, 0, 3, no
2341326693,  Zio_FranK_1, 6, 1, 5, no
462082356,  AironAngel, 1, 0, 1, no
306021140,  davidantonio136, 2, 0, 2, no
457833517,  bestosoalessand, 5, 0, 5, no
747967353682550784,  ItalianTonyQ, 2, 0, 2, no
780829149950726144,  thatgirlsandra5, 1, 0, 1, no
3668101515,  1776tamara, 2, 0, 2, no
794896448890564608,  taem878401, 1, 0, 1, no
449984080,  matsoc203, 1, 0, 1, no
421203723,  DenDr77, 1, 0, 1, no
634999260,  AlbertoAirola, 16, 3, 13, no
318927329,  lucacarabetta, 1, 0, 1, no
1332412902,  lavi_azz, 1, 0, 1, no
404394458,  dinavilla60, 1, 0, 1, no
731173638435704833,  nidim66, 3, 0, 3, no
391441252,  maxfarano, 1, 0, 1, no
367600267,  MontyGTweet, 4, 0, 4, no
373970310,  LivianaG, 1, 0, 1, no
773214636715995136,  robegatt, 1, 0, 1, no
1320273294,  GiordanaMoltedo, 2, 0, 2, no
3982426332,  UgoMattei, 1, 0, 1, no
492939871,  ToninoCamp, 1, 0, 1, no
1908166152,  ale_villarosa, 1, 0, 1, no
382207939,  PalettaAndrea, 1, 0, 1, no
754275355100413952,  KnightPicardi, 3, 0, 3, no
2843814810,  alter_more, 1, 0, 1, no
2973110446,  nasolec80, 1, 0, 1, no
1164447662,  Alessandrofed16, 1, 0, 1, no
40962257,  violet6femme, 9, 2, 7, no
757879535375360000,  denielg23, 1, 0, 1, no
979243700,  claudiabiella, 1, 0, 1, no
1109838932,  RoviSilvia, 1, 0, 1, no
178112460,  scicorina, 4, 0, 4, no
1264710499,  LocaMatteo, 9, 0, 9, no
753919791140855808,  la_mulas, 1, 0, 1, no
4775755047,  M5SgiovaniTO, 3, 0, 3, no
476591207,  limpidgreen_, 3, 0, 3, no
509058151,  giusepp95340777, 1, 0, 1, no
507758921,  MirkoGiovs, 1, 0, 1, no
2917487926,  DiAmato_Davide, 2, 0, 2, no
783307585206222848,  Sdf4774, 45, 0, 45, no
482513993,  luca7goldenwing, 5, 0, 5, no
537536062,  BarbaraCiolli, 1, 0, 1, no
1588777538,  sydlsd, 2, 0, 2, no
751412274,  Giu_dig, 1, 0, 1, no
2154499070,  FrankCapitone, 1, 0, 1, no
3347508815,  alileo9710, 5, 0, 5, no
797490358305386497,  ShikimyMikashi1, 1, 0, 1, no
69565598,  IlGorga, 5, 0, 5, no
2247573164,  JioalimLimone, 5, 0, 5, no
1190283926,  spartakomax, 8, 2, 6, no
2244108384,  sosground, 2, 0, 2, no
1037624108,  giugoio, 2, 0, 2, no
431747635,  pandeussilvae, 2, 0, 2, no
331795273,  Fede_Navy, 2, 0, 2, no
440142755,  Calvogigi, 1, 0, 1, no
18100097,  pos_kay, 9, 0, 9, no
427671749,  echoof_rain, 2, 0, 2, no
3395095977,  ZarAleinikov, 1, 0, 1, no
950480676,  AlexMaksura, 1, 0, 1, no
263053332,  torino5stelle, 2, 0, 2, no
464687764,  renzalana, 1, 0, 1, no
370596367,  TitoLivio85, 1, 0, 1, no
4227091119,  piopio7831, 5, 0, 5, no
486612789,  marco_box, 1, 0, 1, no
460465100,  adestefanis11, 1, 0, 1, no
2478641336,  _paoloratti_, 2, 0, 2, no
804484172777717760,  hiaviaroffa1975, 1, 0, 1, no
418634231,  GiovanniBucci1, 1, 0, 1, no
47111878,  FloraZanichelli, 1, 0, 1, no
474032443,  thepopexxx, 1, 0, 1, no
234819447,  Gianla79, 2, 0, 2, no
4076765242,  ToscoDomenico, 5, 0, 5, no
417213380,  RAccoss, 3, 0, 3, no
405659403,  PaolaMilani1, 13, 0, 13, no
97240151,  aledurin, 1, 0, 1, no
30626248,  AleKi8, 1, 0, 1, no
307356280,  ManuRobertigna, 1, 0, 1, no
614476004,  bardpt, 1, 0, 1, no
2549720989,  MarcoRm6, 3, 1, 2, no
525783195,  Cal0re, 3, 1, 2, no
808984266,  ronza66, 1, 0, 1, no
81846818,  AndreaLigios, 1, 0, 1, no
603513371,  maurocancellie1, 5, 0, 5, no
3211795961,  daino55, 2, 1, 1, neutral
63149834,  LIBERALAICO, 3, 0, 3, no
722862976856928256,  GiarruzzoMarika, 1, 0, 1, no
547553319,  CaputoDavide185, 2, 0, 2, no
625012293,  andreacalzecchi, 2, 0, 2, no
636955791,  ChangeItalia, 3, 0, 3, no
255669937,  gioalpha, 13, 1, 12, no
25713289,  GfZucchi, 1, 0, 1, no
1466803693,  GianpaoloZatti, 3, 0, 3, no
126583546,  leotambe, 2, 0, 2, no
1701645288,  Alex_Ssl1900, 2, 0, 2, no
7250482,  biancoraffaele, 1, 0, 1, no
2231898250,  colincogs, 2, 0, 2, no
485187851,  InuUrbanistica, 1, 0, 1, no
1605951806,  carla7310, 5, 0, 5, no
3748044561,  barbaragagliar, 1, 0, 1, no
712917292955385856,  CovertFinance, 1, 0, 1, no
384930259,  RadixOM, 1, 0, 1, no
980693485,  marcoeSseMS, 2, 0, 2, no
435644392,  Antonb60, 1, 0, 1, no
632400257,  machenesoio2, 4, 0, 4, no
64167037,  zoobeno, 1, 0, 1, no
4342527448,  varasano_gianni, 2, 0, 2, no
554160145,  Mspigaroli, 3, 0, 3, no
2464482982,  dema936, 1, 0, 1, no
2330508651,  valro65, 1, 0, 1, no
4218794297,  Eli_Russo_, 1, 0, 1, no
494827982,  annietrop, 10, 0, 10, no
1468332938,  roberto_malanca, 1, 0, 1, no
508088713,  ernestomondo, 3, 0, 3, no
379293784,  skler0, 1, 0, 1, no
1190943824,  cinco21274, 2, 0, 2, no
3252721365,  RossanaTric, 1, 0, 1, no
337372191,  Travagliato, 6, 1, 5, no
1069414741,  alessan49921573, 9, 0, 9, no
2652070796,  g31860794, 3, 1, 2, no
441080032,  MLetiziaRub, 1, 0, 1, no
2154774592,  SPettigiani, 4, 0, 4, no
143113340,  zioterry, 1, 0, 1, no
1245767360,  GSigno47, 2, 0, 2, no
508717801,  francescocantin, 1, 0, 1, no
2353359824,  gattoMostrino, 1, 0, 1, no
828570210,  natascia69, 7, 0, 7, no
551156956,  Direttorex, 1, 0, 1, no
39454215,  isazan, 1, 0, 1, no
2825259495,  FrancjKicca, 4, 0, 4, no
2893109039,  Monica10001, 1, 0, 1, no
421715120,  brunosalustri1, 3, 0, 3, no
724967510072786948,  ilMartello78, 2, 0, 2, no
3384958936,  alespool62, 5, 0, 5, no
273854836,  virfal79, 1, 0, 1, no
1080972302,  SilvestroLuig, 2, 0, 2, no
393398115,  m_tropeano, 1, 0, 1, no
2911669271,  amorfabb, 2, 0, 2, no
433955520,  agostinobarbera, 2, 0, 2, no
472919383,  naberni, 2, 1, 1, neutral
286544227,  sanso2011, 4, 0, 4, no
288828205,  Luca15N, 2, 0, 2, no
432552791,  BSapphire27, 1, 0, 1, no
119506508,  frasurano, 1, 0, 1, no
126970118,  vilmamoronese, 13, 0, 13, no
17706954,  Tecnobarbaro, 2, 0, 2, no
508747838,  Davidrugo1, 3, 0, 3, no
103303397,  DolphinAndroid, 4, 0, 4, no
3122188607,  AntonellaBerta2, 2, 0, 2, no
221902171,  lauraboldrini, 13, 12, 1, yes
803523999288410112,  ziomario5, 1, 0, 1, no
865077301,  CostanzaNicola, 3, 0, 3, no
2518419121,  CarloCheld08, 1, 0, 1, no
2968679031,  zoleociro_ciro, 3, 0, 3, no
416402068,  emanbj, 4, 0, 4, no
554958008,  fliston12, 1, 0, 1, no
714927852152561670,  Roberto_Sandano, 1, 0, 1, no
1178495641,  cittAgora, 5, 0, 5, no
3407428384,  prato_mauro, 4, 0, 4, no
921116641,  Massimiliano5S, 1, 0, 1, no
341589210,  Errata_0, 1, 0, 1, no
880920932,  raffaellanotar1, 1, 0, 1, no
1235060898,  Gianni_Nocera, 7, 0, 7, no
1905524532,  AntonioFornari2, 3, 0, 3, no
2387695565,  giuseppedm57, 7, 0, 7, no
634991622,  ErnestoMilanesi, 1, 0, 1, no
52824910,  gravitazeroeu, 2, 0, 2, no
1012423344,  rlusci, 1, 0, 1, no
41328420,  FDebenedetti, 2, 0, 2, no
118505502,  LUKA37, 1, 0, 1, no
586513270,  GrandeDibba, 1, 0, 1, no
297945336,  MaaxGargura, 4, 0, 4, no
877456254,  lafratta49, 9, 0, 9, no
396626479,  nella_norma, 3, 0, 3, no
41348383,  _Leti_19, 1, 0, 1, no
3044774409,  ssempreviva1, 2, 0, 2, no
3032760082,  Ema_Olmi, 2, 0, 2, no
220628425,  marchiori_carlo, 1, 0, 1, no
4031202537,  IvaldoVernelli, 3, 2, 1, yes
47968034,  Luca_Borio, 1, 0, 1, no
487674751,  ClaudioBianco88, 2, 0, 2, no
843441636,  plume_emulp, 1, 0, 1, no
133663155,  Dunant99, 6, 0, 6, no
1076258972,  camillocarrea, 1, 0, 1, no
804753644,  joseph_cav, 23, 0, 23, no
4642775073,  GiuseppeGiusto9, 1, 0, 1, no
379262450,  foresta233, 1, 0, 1, no
53096801,  GhigoTrieste, 1, 0, 1, no
3373403367,  Giovantoniotw, 1, 0, 1, no
506586076,  FLEPARInail, 1, 0, 1, no
700711428538421249,  DomesDomenico, 1, 0, 1, no
303883951,  chiara149, 1, 0, 1, no
518969832,  sebyliccia, 1, 0, 1, no
3347512257,  PetraReski, 2, 0, 2, no
213588883,  SaraMayaCo, 8, 0, 8, no
1015037964,  CatalanoGianni, 7, 0, 7, no
141686435,  fbernabe, 1, 0, 1, no
1953729241,  78_michela, 2, 0, 2, no
1084011908,  mynightmaresguy, 3, 0, 3, no
1046538596,  samuelrere, 3, 0, 3, no
3179785922,  tripazia00, 3, 0, 3, no
495623215,  Claudestar2012, 6, 0, 6, no
137643354,  giuseppebaggio, 2, 0, 2, no
1243172797,  Saraamor71, 3, 0, 3, no
783627340861538304,  Giornaliste, 1, 0, 1, no
3334095760,  Sharytex, 4, 0, 4, no
224690887,  Plutone999, 2, 0, 2, no
470003688,  GuidoPignoli, 25, 0, 25, no
218067973,  faustofellini, 14, 2, 12, no
602918666,  marcellocurrel1, 3, 0, 3, no
1169245177,  ilcosta72, 9, 1, 8, no
702924803,  ScampoliAntonio, 3, 0, 3, no
2200336955,  fabriziopisu, 1, 0, 1, no
241519703,  HHnoraH, 1, 0, 1, no
2254861851,  dssgpp, 4, 0, 4, no
220627149,  sergiopagliaro, 1, 0, 1, no
1262829973,  Agcaval, 3, 0, 3, no
419676762,  giubecc, 1, 0, 1, no
3928289074,  leoquergdr, 2, 0, 2, no
1708399825,  simonedatorino, 2, 0, 2, no
1001138461,  GianmariaRaboin, 3, 0, 3, no
116907932,  urbanagranbar, 2, 0, 2, no
3905591125,  matteomu1, 1, 0, 1, no
1045064690,  VelloneErcole, 4, 0, 4, no
1012135158,  canaleluca71, 9, 0, 9, no
405697475,  nicolacichelli, 2, 0, 2, no
58788449,  pcautela, 1, 0, 1, no
257491066,  marjsang, 3, 0, 3, no
253194616,  chissa_perche, 1, 0, 1, no
433236708,  rosannaangioi, 1, 0, 1, no
318878875,  paolohippos, 3, 0, 3, no
4695730892,  ulixtulix, 8, 0, 8, no
1616907128,  pacileoangelo, 1, 0, 1, no
2175690087,  PanettaRosita, 1, 0, 1, no
4233859347,  laele28158946, 5, 0, 5, no
3323080689,  antzorb, 1, 0, 1, no
515351678,  pasqualemarina, 8, 0, 8, no
2452102818,  PippyCattiva, 4, 0, 4, no
3031014982,  Michela45754477, 1, 0, 1, no
766703303845699585,  ComitatoNo_UK, 3, 0, 3, no
393551120,  PatriziaBugnano, 1, 0, 1, no
378801199,  MatteoFiaschett, 1, 0, 1, no
1201470660,  lauraorestano, 5, 2, 3, no
2210971446,  FrancescescoV, 1, 0, 1, no
543616855,  StefanoGiraudo, 1, 0, 1, no
740883123379048448,  simone_mondino, 1, 0, 1, no
2227385970,  5stellelonatep, 1, 0, 1, no
418050006,  IvraChanel, 4, 0, 4, no
1039387388,  FrancoLucano, 4, 0, 4, no
2696609369,  bombergiunta, 1, 0, 1, no
191835437,  maxgranata, 1, 0, 1, no
476235682,  kiniron, 8, 0, 8, no
2358680459,  31patt, 1, 0, 1, no
348744693,  FedericoGuiati, 4, 0, 4, no
2696366840,  asialollo15, 12, 0, 12, no
1050542586,  alebezza, 2, 0, 2, no
2297955914,  girasol44247939, 1, 0, 1, no
3107226245,  giulyeh, 13, 0, 13, no
171202259,  fabio_fucci, 2, 0, 2, no
257398221,  spazimau, 12, 0, 12, no
390304031,  pmilite, 3, 0, 3, no
429340113,  amoridellavita, 1, 0, 1, no
330933789,  veronelle1, 2, 0, 2, no
580331655,  AnninaLombardo, 2, 0, 2, no
1172851158,  Classe_74, 3, 0, 3, no
326451864,  maxcon00, 8, 0, 8, no
3396685594,  giaguaro067, 1, 0, 1, no
740663614688890880,  Rosanna49785870, 2, 0, 2, no
258375186,  TOsostenibile, 2, 0, 2, no
129865921,  pinpas60, 1, 0, 1, no
4892651727,  GuglielmoRodati, 6, 0, 6, no
472786126,  dolzasyl, 2, 0, 2, no
445687226,  lorefanto, 2, 0, 2, no
700444597600833536,  Ste3073, 1, 0, 1, no
134487700,  scienzaltro, 1, 0, 1, no
1096100132,  DirettoriHotel, 3, 0, 3, no
1582784514,  ElGranYago, 4, 0, 4, no
2256161788,  GiordanaPaolo, 1, 0, 1, no
491118242,  SoniaBelforte, 1, 0, 1, no
295122999,  Yuri480, 1, 0, 1, no
708689965,  minodigiorgio, 1, 0, 1, no
428304150,  sergiolupo, 2, 0, 2, no
807801223,  AlbertoTrevi79, 4, 0, 4, no
235593445,  celesteondeck, 1, 0, 1, no
541787569,  laurarocci1, 5, 0, 5, no
24926778,  lorenzodamelio, 1, 0, 1, no
3873538582,  giu61ma1903, 1, 0, 1, no
97279759,  PaoloValimberti, 1, 0, 1, no
96746296,  MarjadeSanctis, 1, 0, 1, no
3399351406,  Proof_Jey, 2, 0, 2, no
426114352,  michelemonello, 4, 0, 4, no
2373433018,  CateIngra, 1, 0, 1, no
220858588,  emiliomaglietta, 4, 0, 4, no
353750900,  Mayflower014, 3, 0, 3, no
2504360748,  vero_taba, 1, 0, 1, no
2344839862,  Elisabe250265, 2, 0, 2, no
706545045449678848,  FedeVell, 1, 0, 1, no
1007154330,  PeeGeeDaniel, 1, 0, 1, no
422829258,  donatocalderoni, 2, 0, 2, no
20517522,  Bolets, 1, 0, 1, no
539871980,  FRALOMY, 3, 0, 3, no
349319486,  Samuraikoi, 12, 0, 12, no
56115235,  Chicco_Rossi, 1, 0, 1, no
807358640,  toniolp83, 1, 0, 1, no
271810587,  tony040151, 1, 0, 1, no
2753082201,  enrico_camma, 1, 0, 1, no
29202025,  fraversion, 1, 0, 1, no
418217672,  MarisaTafuni, 1, 0, 1, no
480612566,  rivarobe, 9, 0, 9, no
938561695,  antomaszana, 1, 0, 1, no
2765919539,  UrbaniAda, 3, 0, 3, no
1852088028,  Wolfango83, 2, 0, 2, no
1700280511,  karrielynn88, 1, 0, 1, no
381510554,  macno82, 1, 0, 1, no
134869337,  Sy8i, 1, 0, 1, no
4765032501,  CMeneghetti74, 2, 0, 2, no
882407088,  egizianolombard, 1, 0, 1, no
458368651,  luca_podio, 1, 0, 1, no
759772392444993536,  hickstead1_2011, 1, 0, 1, no
498240204,  riccardogiani, 4, 0, 4, no
476799662,  fbozuffi, 2, 1, 1, neutral
87159394,  maxperri71, 4, 2, 2, neutral
515507237,  Vigraf79, 2, 0, 2, no
731072461081595904,  GianfGalli, 5, 0, 5, no
712266973070159872,  fraziggy82, 8, 0, 8, no
800272805304487936,  Unpodisport1, 1, 0, 1, no
318661130,  riderperugia, 3, 0, 3, no
164237295,  farinatommaso, 3, 0, 3, no
111327481,  ItaProtagonista, 3, 0, 3, no
792628448552509440,  piquadromezzi, 3, 0, 3, no
17969850,  AvvMdiBari, 4, 0, 4, no
2830254804,  James64Jessy, 2, 0, 2, no
232534560,  fabioalisei, 2, 0, 2, no
17549059,  giacomo_b12, 1, 0, 1, no
1913735490,  and_gali, 1, 0, 1, no
989485837,  PatriziaAbramo, 3, 0, 3, no
2216727409,  forzaitaliaceri, 1, 0, 1, no
31854945,  Risparmiainrete, 1, 0, 1, no
93023987,  Frankbig62, 1, 0, 1, no
2440218877,  LorenzoColombis, 1, 0, 1, no
2279462713,  cacio68, 1, 0, 1, no
398856511,  GioRampini, 1, 0, 1, no
805010128017756160,  NoMisantropo, 2, 0, 2, no
219715197,  Bernifire, 1, 0, 1, no
407285782,  GroZzio, 1, 0, 1, no
194281145,  fededido, 1, 0, 1, no
304148663,  SavMarco, 1, 0, 1, no
433377978,  gabrigiunchi, 1, 0, 1, no
2756333990,  ops791, 1, 0, 1, no
1972832178,  DiComemai, 7, 0, 7, no
2775983397,  morata94juve, 1, 0, 1, no
508768082,  RobRova, 1, 0, 1, no
428103254,  Irislap, 1, 0, 1, no
78562487,  sheol77, 10, 2, 8, no
440237281,  MassimAngelo, 2, 0, 2, no
570143414,  fonsi57, 1, 0, 1, no
2733321629,  giacobazzipier, 1, 0, 1, no
805780207953186816,  LUIGI72147162, 1, 0, 1, no
136238828,  gerypa, 1, 0, 1, no
457646025,  ombrettabugane, 2, 0, 2, no
466628457,  lnzpcr, 1, 0, 1, no
429817276,  bechilar, 1, 0, 1, no
192886030,  TerreniBrotzu, 5, 0, 5, no
574340003,  fededilo98, 2, 0, 2, no
490342535,  oscarorrei, 2, 0, 2, no
429427800,  giocen1, 2, 0, 2, no
772056899814645760,  alealeNY19, 4, 0, 4, no
4076497583,  umbertosimone1, 1, 0, 1, no
2787709025,  77patrizia1, 3, 0, 3, no
3980609777,  ilSiberiano_, 1, 0, 1, no
3512608043,  giangiocontipe, 1, 0, 1, no
1430875939,  _fefella, 2, 0, 2, no
2987285175,  Hi5tory34, 1, 0, 1, no
4472952436,  chettiperdi, 1, 0, 1, no
2221398780,  GianfrancoTrois, 2, 0, 2, no
2978373227,  Maina2508, 2, 1, 1, neutral
3400107676,  JohnCrosta, 3, 0, 3, no
3417762706,  TatySirio85, 2, 1, 1, neutral
317081203,  Salvo_kun, 1, 0, 1, no
906080510,  BarbaraCongiu, 5, 0, 5, no
470989221,  S1m0n3z, 1, 0, 1, no
991573146,  SimonettaGreco, 1, 0, 1, no
2885796447,  ldiresta, 1, 0, 1, no
113728322,  CALCIOGEMINI, 2, 0, 2, no
2913429669,  MassaroPiet, 8, 0, 8, no
252332089,  andyallnews, 2, 0, 2, no
2983947047,  katechista, 4, 0, 4, no
715993103451234309,  giulorpanna2, 1, 0, 1, no
1111294963,  ADAM51252413, 2, 1, 1, neutral
480248512,  areale7508, 1, 0, 1, no
382085343,  ProiettiMauro, 4, 2, 2, neutral
415619638,  remolabarca3, 1, 0, 1, no
405646874,  ierfra, 1, 0, 1, no
2273749855,  AndreaCosta378, 2, 0, 2, no
4214416708,  giusgio88, 3, 0, 3, no
494875751,  DTramannoni, 1, 0, 1, no
788727641562030080,  AgainFlash, 1, 0, 1, no
483431115,  ilgrandepier, 4, 0, 4, no
2342894531,  annalisa_masi, 3, 0, 3, no
761243555788619777,  Zero_Gradi_C, 2, 0, 2, no
1173315229,  a_casaccio, 1, 0, 1, no
22063717,  drusilla70, 6, 0, 6, no
768834311206346760,  GiacomelliZena, 3, 0, 3, no
142802377,  blufox55, 5, 0, 5, no
701030177262977024,  17Damio, 2, 0, 2, no
2965969887,  simone_lopresti, 1, 0, 1, no
2261802180,  luigim5491, 1, 0, 1, no
240671826,  marcomake, 3, 0, 3, no
1006962451,  SergioNardone1, 1, 0, 1, no
4256851395,  mov_idea, 2, 0, 2, no
379916380,  MatteoDeMei, 1, 0, 1, no
795760051210350592,  emanovizzi, 1, 0, 1, no
2765618325,  justcozze, 3, 0, 3, no
41688102,  nasellofra, 1, 0, 1, no
2293813528,  Belmonte82M, 3, 0, 3, no
799465139154092032,  tortoli_marco, 2, 0, 2, no
447452303,  AndreaAsilo, 1, 0, 1, no
1153571498,  PDLPistoia, 6, 0, 6, no
161464462,  lucianoaforte, 1, 0, 1, no
804271992660758528,  gianniciga58, 2, 1, 1, neutral
399250204,  DarioPalugan, 1, 0, 1, no
112812650,  TiberioBrunetti, 1, 0, 1, no
39811956,  yahweahh, 1, 0, 1, no
415081496,  MASSIMOMARUSSI, 1, 0, 1, no
1045056012,  Figliodipooh, 3, 0, 3, no
744972803762454528,  IleanaCiarlegl4, 1, 0, 1, no
61776957,  boksic72, 3, 0, 3, no
1945166732,  OTTOWEBER72, 2, 0, 2, no
2913888338,  forzasilvio2014, 5, 0, 5, no
2270281069,  NunzioPanzarell, 1, 0, 1, no
187305166,  terronpedro, 1, 0, 1, no
63756533,  davidaus82, 1, 0, 1, no
2868479991,  maya20071974, 1, 0, 1, no
1638096936,  campuseverest, 1, 0, 1, no
437745594,  cipollinoso, 1, 0, 1, no
3044708182,  IlCuoio, 2, 1, 1, neutral
76345466,  mariavenera, 3, 0, 3, no
53416446,  imieitentativi, 1, 0, 1, no
410807255,  doc_giovanni, 1, 0, 1, no
1357458175,  fabioper66, 1, 0, 1, no
475197913,  U_mBertOsTwEet, 1, 0, 1, no
2731877036,  andreagarnero, 1, 0, 1, no
4896166115,  AdessoNon, 1, 0, 1, no
198977983,  CafiDanna, 2, 0, 2, no
1080471613,  BilleraMirko, 1, 0, 1, no
466415211,  buenavidaxxx, 1, 0, 1, no
1305916776,  JimWildChild, 3, 0, 3, no
1662392455,  BellanovaFlavio, 1, 0, 1, no
3957585869,  carlohebdo, 1, 0, 1, no
2732001785,  carlone100, 1, 0, 1, no
423024537,  alerizzo_, 9, 1, 8, no
3963984257,  FrancoGros1, 1, 0, 1, no
30649504,  g_brindisi, 2, 0, 2, no
221681754,  whiskylick, 1, 0, 1, no
206146639,  fourthalf, 3, 0, 3, no
745675802143035392,  lleleeeee, 1, 0, 1, no
405294207,  mlancioni, 1, 0, 1, no
432352683,  logon99, 5, 1, 4, no
780667395002118144,  Micheluccio_, 3, 2, 1, yes
972612174,  chiccolenza, 2, 1, 1, neutral
194945732,  Ciocco_Laura, 1, 0, 1, no
2946666304,  cortopassi_dan, 5, 2, 3, no
396185916,  tempivillani, 1, 0, 1, no
411820876,  LucianoSavares1, 1, 0, 1, no
2381833319,  ValleDellavalle, 1, 0, 1, no
2565896626,  orfanolorenzo, 2, 0, 2, no
4502398887,  PippoM66, 1, 0, 1, no
254663124,  simonelocci, 1, 0, 1, no
708449047544205316,  giovcammarata, 1, 0, 1, no
200422029,  lucabar2, 2, 0, 2, no
797592047893020676,  francesco301189, 1, 0, 1, no
2738271195,  da78a07f4707422, 1, 0, 1, no
490744618,  vincpezzuto, 2, 0, 2, no
2242177337,  krimm62, 1, 0, 1, no
239892470,  giuder91, 1, 0, 1, no
450045015,  riccardotarulli, 1, 0, 1, no
2482482240,  jolandafederica, 10, 0, 10, no
1103789143,  SimoneViola73, 1, 0, 1, no
747971202166231040,  MattiCalderone, 1, 0, 1, no
37776682,  ITA360COM, 3, 0, 3, no
413247485,  michelgrimaldii, 1, 0, 1, no
703927817885655040,  SalvatoreBacio, 1, 0, 1, no
56748540,  nicolagenovasi, 1, 0, 1, no
487599462,  groppon, 1, 0, 1, no
2927037939,  elisabethend, 1, 0, 1, no
430788723,  ValterDD, 1, 0, 1, no
406162937,  TheSnoopyG, 2, 0, 2, no
1154510216,  m_scala, 1, 0, 1, no
796454452756676608,  frenzissss, 1, 0, 1, no
2724274001,  bruzziches00, 1, 0, 1, no
2677706490,  Vittorietto4, 1, 0, 1, no
63452476,  giovycut, 2, 0, 2, no
427456064,  SDressi, 5, 0, 5, no
4114741037,  noiperilno, 4, 0, 4, no
506539762,  gito96, 1, 0, 1, no
254136151,  EligioDeRoma, 3, 0, 3, no
113750550,  lluca32, 2, 0, 2, no
2156763691,  mariagraziadea2, 1, 0, 1, no
335189017,  AzzopardiJason, 1, 0, 1, no
2651868966,  v_taito, 1, 0, 1, no
4089097761,  Sibillinamente, 2, 0, 2, no
3119633084,  ghislanzoni, 1, 0, 1, no
719529452594675712,  elyfly70, 1, 0, 1, no
740031002,  Luca_Arioli, 25, 3, 22, no
718178467293097986,  MarcinJudzinski, 2, 0, 2, no
49775576,  Whatsmicio, 1, 0, 1, no
247296118,  BOTROMAGNOVINI, 1, 0, 1, no
2930697713,  robertosgro89, 1, 0, 1, no
187419451,  LuigiDeRose, 10, 1, 9, no
1038029066,  Serra92Gianlu, 2, 0, 2, no
228010525,  AlemannoTW, 1, 0, 1, no
930668582,  liveinvektor, 1, 0, 1, no
247472267,  zirio90, 1, 0, 1, no
2995947293,  migliorerosari1, 5, 0, 5, no
756820331331919872,  DeeLouiseWhitn1, 3, 0, 3, no
802814151164825601,  CavalloScemo, 9, 0, 9, no
856874911,  odiluzio, 1, 1, 0, yes
1538637733,  3ozero, 4, 3, 1, yes
406270078,  lennoxlw, 1, 1, 0, yes
422868495,  evadiniero, 1, 1, 0, yes
79988162,  feltrinellied, 1, 1, 0, yes
614219170,  MaggicaPolly, 2, 1, 1, neutral
166933685,  DSFEurope, 2, 2, 0, yes
22637980,  Aleks_Paris, 2, 2, 0, yes
1343975432,  M5S_Senato, 5, 0, 5, no
330020463,  Mrkiwob, 1, 0, 1, no
1949018238,  GrulliGrullo, 1, 0, 1, no
1028707682,  CBdCavour, 1, 0, 1, no
2219416923,  capitoni_gianna, 2, 0, 2, no
416489772,  MauroVicini, 2, 0, 2, no
1355366514,  udods, 3, 0, 3, no
1060130900,  alinaseb, 1, 0, 1, no
727054163520184320,  scattoselvaggio, 1, 0, 1, no
594155232,  giulianaleoni, 2, 0, 2, no
486633667,  massy_bi, 1, 0, 1, no
467761042,  mariagraziamot1, 1, 0, 1, no
620997183,  VignoliMassimo, 1, 0, 1, no
118140512,  Vincisco, 4, 0, 4, no
2587937128,  _pid_69, 2, 1, 1, neutral
799370718324621312,  ruscelli77, 1, 0, 1, no
104609732,  SAMNSS, 1, 0, 1, no
1261773409,  MASSIMILIANOFEO, 2, 0, 2, no
4461464967,  paolocasu76, 1, 0, 1, no
1373198504,  amodio_angelo, 4, 2, 2, neutral
712200530349711360,  giulyz77, 2, 0, 2, no
999127400,  pa50antonio, 2, 0, 2, no
483120454,  Nicocacciatore, 1, 0, 1, no
151389582,  cbocconetti, 1, 0, 1, no
560988400,  DomeCecere, 1, 0, 1, no
371506417,  pocciacarlo, 1, 0, 1, no
2348264148,  deriva50, 5, 0, 5, no
2525278324,  patroleader, 1, 0, 1, no
243227792,  Maurix03, 2, 0, 2, no
3377294939,  percis50, 3, 0, 3, no
7647152,  rujero, 1, 0, 1, no
431749782,  CARACHILLE, 1, 0, 1, no
2354819957,  orlandi492, 1, 0, 1, no
791521154,  _47Ronin_, 5, 0, 5, no
418962970,  iside_vi, 1, 0, 1, no
96314541,  AndreaBellei, 1, 0, 1, no
139346534,  giocosso64, 1, 0, 1, no
280516751,  guidotweet, 1, 0, 1, no
401559083,  FalconeCarla, 1, 0, 1, no
2838629008,  AlfieriFilippo, 1, 0, 1, no
408035333,  AMiracolo, 1, 0, 1, no
409118790,  MorettiGaia, 1, 0, 1, no
246696739,  zanessi, 1, 0, 1, no
296955653,  AngeloNisi1, 1, 0, 1, no
1318706930,  Spiderfrancy, 1, 0, 1, no
3020669236,  a_zucconi, 2, 1, 1, neutral
4818447916,  Elandkam, 1, 0, 1, no
1188862585,  benedettomineo, 4, 0, 4, no
426726936,  bruna_dini, 1, 0, 1, no
79155963,  GMDeFrancesco, 2, 0, 2, no
70737754,  madaArch, 2, 0, 2, no
2267387652,  ioledana, 1, 0, 1, no
62459428,  Stenopeci, 12, 0, 12, no
436888427,  lo_gio, 1, 0, 1, no
420483264,  FESTA58, 1, 0, 1, no
244848309,  raffaelemad, 1, 0, 1, no
977021820,  geppiMi, 2, 1, 1, neutral
299707371,  ATuretta, 2, 0, 2, no
486781554,  RosatiGino, 2, 0, 2, no
971800837,  stefano_donnini, 1, 0, 1, no
1389298008,  DarioDraghi, 1, 0, 1, no
503061875,  PietroIdili, 1, 0, 1, no
985154594,  AmeliaLoprete, 1, 0, 1, no
79532738,  alaurasparsi, 1, 0, 1, no
1008540553,  maxadam71, 1, 0, 1, no
467802673,  br_santi, 2, 0, 2, no
4707720814,  1947palma42, 2, 0, 2, no
2940718365,  maoretm, 1, 0, 1, no
225319138,  Topogigio_57, 1, 0, 1, no
272847388,  agputzu, 1, 0, 1, no
1050482834,  gianniproce, 2, 0, 2, no
1040351857,  SMordeglia, 4, 0, 4, no
22605662,  serromano, 2, 1, 1, neutral
1239450805,  EtziAndrea, 1, 0, 1, no
744590265281839104,  benvenuto_e, 1, 0, 1, no
890891564,  Locoz83, 3, 0, 3, no
314623392,  destefanonicola, 3, 0, 3, no
1641098160,  GianlucaTedoldi, 3, 0, 3, no
373870683,  mauromagnani1, 2, 0, 2, no
610117076,  fabrizioluconi, 1, 0, 1, no
203570539,  ranucchiularo, 2, 0, 2, no
765879972464656385,  maltieri46, 8, 0, 8, no
1829373277,  ABarbesta, 2, 0, 2, no
1280346662,  arrcasati, 1, 0, 1, no
516970620,  Ale__Tarantino, 1, 0, 1, no
1065578654,  lella_marti, 1, 0, 1, no
993692924,  mauriziobazzoni, 1, 0, 1, no
909949962,  Sovra_pensiero, 1, 0, 1, no
462220063,  lazy__jack, 1, 0, 1, no
2508150650,  massiguerra77, 1, 0, 1, no
2228125304,  valerialm26, 2, 1, 1, neutral
9047792,  Amfortas, 1, 0, 1, no
2662381998,  CalObama2, 1, 0, 1, no
2776292367,  simoca70, 1, 0, 1, no
1530823356,  frankapizzi, 2, 0, 2, no
322915773,  mariani_nic, 1, 0, 1, no
311392231,  pippo_netti, 1, 0, 1, no
1487707045,  76Caiazza, 1, 0, 1, no
712780797,  bertacchini80, 1, 0, 1, no
2280378259,  digoxin55, 1, 0, 1, no
1222942753,  SMuscetta, 1, 0, 1, no
3233492463,  parisimaria47, 1, 0, 1, no
115447443,  interstellare, 1, 0, 1, no
112474043,  Piconese, 2, 0, 2, no
194681264,  danielpommier, 1, 0, 1, no
4229782887,  MicheleDepalo8, 1, 0, 1, no
235963979,  vernalucy, 1, 0, 1, no
475222684,  Manushry, 1, 0, 1, no
812943912,  BedeEmerem, 4, 0, 4, no
935492714,  maxdea11, 1, 0, 1, no
367301110,  polipodepolipi, 2, 0, 2, no
2816882335,  giorgioperi19, 1, 0, 1, no
374747479,  davidegeddo, 1, 0, 1, no
476049203,  SSargentini, 1, 0, 1, no
1607816904,  riccardokruje, 4, 0, 4, no
1249475719,  Giorgiaro67, 1, 0, 1, no
315997719,  rodavossa, 1, 0, 1, no
1828365332,  maudamcri, 1, 0, 1, no
597752798,  RobertoZanatta0, 2, 0, 2, no
269255378,  camax1V, 2, 0, 2, no
2170390380,  MatteoNeri00, 1, 0, 1, no
1281238016,  mvil_63, 1, 0, 1, no
924212281,  angielongo, 1, 0, 1, no
2362803854,  giustinaluci, 1, 0, 1, no
1221291,  simona_kay_, 1, 0, 1, no
250649897,  paolapica, 1, 0, 1, no
805106423436865536,  ROUGE235, 1, 0, 1, no
805857083178553344,  Bruno23483212, 1, 0, 1, no
742716979392450561,  Seven______7, 1, 0, 1, no
483035480,  carmensasso2, 1, 0, 1, no
406783704,  danilofabbroni, 1, 0, 1, no
1110124999,  greegrace, 1, 0, 1, no
579723244,  GennaroFavale, 1, 0, 1, no
279367690,  gypsystel, 3, 0, 3, no
126579485,  federicaflo, 4, 3, 1, yes
314851902,  diegoandreotti, 1, 0, 1, no
805440451335585793,  Flavio_DiC, 1, 0, 1, no
255125630,  spapi68, 1, 0, 1, no
358057757,  danigeo72, 1, 0, 1, no
491183275,  seiunozero1, 1, 0, 1, no
99099435,  Parapiero, 1, 0, 1, no
371258463,  Climatec_Srl, 1, 0, 1, no
1267780669,  FIERRODOMENICO, 1, 0, 1, no
342672995,  AndreaBaio, 1, 0, 1, no
792097117162639360,  viumbo71, 1, 0, 1, no
1251431112,  Suethespider_, 1, 0, 1, no
1037146854,  mimisalvo, 1, 0, 1, no
472124094,  LorenzoCapirone, 2, 0, 2, no
4832618572,  69ayylmao69, 1, 0, 1, no
3071993301,  muzzi_mario, 2, 0, 2, no
125942842,  mauriziocelia, 1, 0, 1, no
50608867,  Cirusguti, 2, 0, 2, no
354166819,  lorisemme, 1, 0, 1, no
475194395,  MarianPuosi, 1, 0, 1, no
411617221,  armando_cirillo, 1, 0, 1, no
2389384395,  namoroso80, 1, 0, 1, no
799366283250847744,  AndBassoli, 1, 0, 1, no
515271142,  marmottola, 2, 1, 1, neutral
52019004,  enricoisopi, 1, 0, 1, no
1069408890,  SauroStacchiott, 1, 0, 1, no
434829316,  fabrizio_rollo, 1, 0, 1, no
1645029769,  Russo3Luisa, 1, 0, 1, no
534111651,  DavideGassino, 1, 0, 1, no
257383300,  GVergnasco, 1, 0, 1, no
2786641987,  9ff332a225b8441, 1, 0, 1, no
1216222302,  mariacaffo, 1, 0, 1, no
2955100415,  oho_zone, 1, 0, 1, no
254079422,  graz_81, 6, 1, 5, no
396787275,  aler06, 1, 0, 1, no
431756712,  valeferdiet, 1, 0, 1, no
407047260,  AAngelini68, 1, 0, 1, no
900152504,  GabrieleGiorgi7, 1, 0, 1, no
1068069210,  FrancoTollerini, 1, 0, 1, no
520518526,  paolied, 1, 0, 1, no
248633006,  AlessandroRaggi, 1, 0, 1, no
15004167,  tomval, 1, 0, 1, no
560439381,  CosimoGoos01, 1, 0, 1, no
3653031257,  ConzadoriAnna, 3, 0, 3, no
463094763,  TLucidi, 1, 0, 1, no
724578776659701761,  attico64, 2, 0, 2, no
394748822,  luigipatarnello, 1, 0, 1, no
477984092,  BONAZZIROMANO, 1, 0, 1, no
747892541400428544,  northias, 4, 0, 4, no
432025754,  Alberto_Belloni, 1, 0, 1, no
998952552,  sirobargiacchi, 1, 0, 1, no
482872015,  porcellinorosa, 1, 0, 1, no
64644350,  pinuccioalia, 1, 0, 1, no
780490807480553472,  sgn70, 1, 0, 1, no
3289847579,  ilbiadolaio, 3, 0, 3, no
1076456299,  CigarroRoberto, 1, 0, 1, no
429898007,  filippoboatti, 1, 0, 1, no
2565011447,  makkiarossa, 1, 0, 1, no
1466641994,  frigo_giancarlo, 1, 0, 1, no
419060272,  GDimporzano, 1, 0, 1, no
50374598,  MurielSowden, 1, 0, 1, no
986564732,  171822elFranca, 5, 0, 5, no
429141884,  MarioCaporali, 7, 0, 7, no
501594854,  cgiltoscana, 1, 0, 1, no
955895382,  wpulze, 1, 0, 1, no
1162344666,  gianniDalla, 1, 0, 1, no
179941490,  avvcervellera, 1, 0, 1, no
50661164,  delfp, 1, 0, 1, no
462233476,  EnidSadedini, 1, 0, 1, no
1049167112,  __sisco__, 1, 0, 1, no
301049143,  ValenCaffieri, 1, 0, 1, no
1157829871,  frialdigraziell, 1, 0, 1, no
2301791792,  ritapasku, 2, 0, 2, no
386463269,  Antonella881, 2, 0, 2, no
1216209888,  torridani, 1, 0, 1, no
593560634,  EffeCati, 1, 0, 1, no
412363318,  ConconiGiovanni, 1, 0, 1, no
1005109537,  kelevra_889, 1, 0, 1, no
432804141,  MarcoMechi, 1, 0, 1, no
33196168,  cinemanu, 1, 0, 1, no
823919240,  campoluc, 1, 0, 1, no
2886677145,  aldo_graziani, 1, 0, 1, no
473109812,  andreamassa4, 1, 0, 1, no
170666252,  ilConteMax24, 2, 0, 2, no
2367438201,  c_sangalli, 1, 0, 1, no
402135794,  JTelmont, 3, 0, 3, no
1366334430,  quantotanto, 1, 0, 1, no
714913659,  LaCiarass23, 1, 0, 1, no
278273822,  silvioingalera, 14, 0, 14, no
3720121229,  paolamzzm, 1, 0, 1, no
381129608,  DasaraShullani, 1, 0, 1, no
228027870,  nemboc, 5, 1, 4, no
849568508,  catdam1, 3, 1, 2, no
251148054,  johnnybeback, 1, 0, 1, no
3292905852,  delmoromassimo, 4, 0, 4, no
38139984,  chiccotesta, 2, 0, 2, no
4722997649,  Camillo86906021, 1, 0, 1, no
801871901006200832,  Bernard31935716, 1, 0, 1, no
649363,  mariocanno, 1, 0, 1, no
228702883,  DemRif, 1, 0, 1, no
855409538,  annalaura_tola, 1, 0, 1, no
256466502,  PaoAlBon, 1, 0, 1, no
141877526,  malam87, 3, 0, 3, no
531715709,  GIACOMOMattegi1, 1, 0, 1, no
22031757,  aleredo, 1, 0, 1, no
2547567674,  aiazzielda, 1, 0, 1, no
489334750,  ZIORIUMA, 1, 0, 1, no
599003292,  DivoElGalante, 1, 0, 1, no
960825452,  AlbertoMazzo99, 1, 0, 1, no
3068102367,  emmacecco, 1, 0, 1, no
399545508,  elisagenti_, 1, 0, 1, no
128811499,  Persian_Coral, 3, 0, 3, no
49288229,  B_MCristina, 1, 0, 1, no
713751156690911232,  maupallavicini, 1, 0, 1, no
37489640,  Dimonios, 1, 0, 1, no
420680501,  ElisabettaMoret, 2, 0, 2, no
805725653563805698,  fabriziarapagna, 1, 0, 1, no
296334489,  GiuseppeDeLeo, 2, 0, 2, no
1068011798,  giampao17175170, 1, 0, 1, no
2900333043,  LazzMenico, 1, 0, 1, no
727150387539664896,  gilsca1480, 1, 0, 1, no
781140776613011456,  GiuseppeAltavi4, 1, 0, 1, no
471443583,  Wladi_Anders, 1, 0, 1, no
245462152,  marc0marav1gna, 1, 0, 1, no
2294935707,  raro5102, 1, 0, 1, no
441696914,  NicoisKastah, 6, 0, 6, no
1172370252,  giorgiograssi76, 2, 1, 1, neutral
564629186,  nicolettapetri, 1, 0, 1, no
1394857658,  giova_leo, 1, 0, 1, no
970172977,  bradipo54, 1, 0, 1, no
48003965,  nikands, 1, 0, 1, no
611545736,  Lety28June, 1, 0, 1, no
1861609885,  MattiaMah, 1, 0, 1, no
71218300,  Robplague, 5, 0, 5, no
855050430,  MicMuse, 2, 1, 1, neutral
1365032677,  walter_walessan, 3, 0, 3, no
1291795656,  Tomas1374, 4, 0, 4, no
2292753403,  Torino_14, 1, 0, 1, no
331483394,  augustomoretti, 1, 0, 1, no
420312158,  MarcoImolaGuidi, 1, 0, 1, no
55188515,  diluente, 1, 0, 1, no
2348779554,  RMargher, 2, 1, 1, neutral
3179825100,  ogniqualvolta, 1, 0, 1, no
781921325044604928,  L_P_C64, 1, 0, 1, no
2771313035,  fabmoglianesi, 1, 0, 1, no
407233459,  HaironMen, 2, 0, 2, no
38007650,  cocco2200, 1, 0, 1, no
742417542556332032,  2zeller, 1, 0, 1, no
727209001327427585,  radicale_ignoto, 1, 0, 1, no
3023095461,  _Kynosarges, 1, 0, 1, no
49661882,  lucasaba, 1, 0, 1, no
998771113,  mauriziofortina, 1, 0, 1, no
461173908,  lanfranconp, 1, 0, 1, no
97448438,  sgu45, 1, 0, 1, no
764748993440182272,  Nino42225481, 1, 0, 1, no
2722229206,  expocasacaragl1, 2, 0, 2, no
799413733541998592,  SaverioZanella, 1, 0, 1, no
4041893956,  kocsa42, 1, 0, 1, no
743080755467849728,  alfber2, 3, 0, 3, no
160134796,  jerryMassloII, 1, 0, 1, no
1675944013,  s_signorello, 1, 0, 1, no
2171879132,  Ferroearte, 3, 0, 3, no
238909679,  F_DUva, 7, 0, 7, no
2813101535,  MPE_HVE, 8, 7, 1, yes
2397680665,  simonaderossi4, 3, 2, 1, yes
50298131,  CescoV, 1, 1, 0, yes
871793340,  BrambillaFlavia, 8, 6, 2, yes
2981473816,  ilaria_ITP, 7, 4, 3, yes
115029557,  ITPFormazione, 3, 3, 0, yes
778929980520730629,  EdoardoZaccardi, 4, 3, 1, yes
300763581,  GianmariaF, 5, 3, 2, yes
2803725662,  AlBrambilla, 3, 2, 1, yes
613387563,  ColombaMongiell, 6, 5, 1, yes
1667168719,  brunacondello, 1, 1, 0, yes
453382829,  anoipiace, 2, 1, 1, neutral
411538627,  EricaDAdda, 2, 2, 0, yes
4122391403,  lentedicronista, 1, 1, 0, yes
4490969968,  AssocasaNapoli, 1, 0, 1, no
727899457145212929,  alessiaferret, 1, 0, 1, no
403051679,  ChiaraColosimo, 1, 0, 1, no
1174818342,  FabioGarritano, 3, 0, 3, no
819824736,  CSInforma, 1, 1, 0, yes
2264872490,  Cristian86GTR, 2, 1, 1, neutral
3182201530,  umbfal78, 1, 1, 0, yes
2498928031,  3397766924, 5, 2, 3, no
2598425588,  sunisval, 2, 1, 1, neutral
1372918387,  Pierotaris, 3, 2, 1, yes
2282191525,  Giuseppe_2705, 1, 1, 0, yes
764799963209539584,  albertobocc1, 1, 1, 0, yes
200129564,  ErcoleC, 1, 1, 0, yes
1395687914,  MarisaMarygio, 5, 4, 1, yes
221424835,  priange, 4, 1, 3, no
717800486078976001,  spagnolimarco8, 2, 2, 0, yes
555322548,  TullioM_C, 2, 2, 0, yes
421784817,  AleCutrona, 1, 1, 0, yes
3870902416,  LellaAuteri, 2, 1, 1, neutral
804080566949859328,  fuocolyquido, 6, 1, 5, no
1064106758,  manuelromoli, 2, 2, 0, yes
840311305,  TonyMarche14, 1, 1, 0, yes
406552900,  MarianoRabino, 7, 7, 0, yes
702508983240814593,  media_funding, 3, 1, 2, no
252162156,  enricomartial, 1, 1, 0, yes
741024105386893312,  FabianiFabio83, 3, 3, 0, yes
446366385,  Lampisa, 1, 1, 0, yes
999575790,  gaetanoferrari2, 2, 1, 1, neutral
2959472392,  gianpiero85pf, 2, 2, 0, yes
1490793978,  orsini_federico, 1, 1, 0, yes
791755612979888128,  mazzuoccolo_e, 3, 3, 0, yes
804416832790790145,  CeccariniBruno, 1, 1, 0, yes
720266365911719937,  oneflageu1, 1, 1, 0, yes
432027097,  CMoselli, 1, 1, 0, yes
4707136094,  MartorelDaniele, 1, 1, 0, yes
92541601,  dna67, 1, 1, 0, yes
2569050558,  gug20094, 1, 1, 0, yes
787657195206873089,  laragirra, 1, 1, 0, yes
372195351,  MarcoScasso, 1, 1, 0, yes
1095531864,  albertoorselli, 1, 1, 0, yes
711587750269554688,  Paolapapa8, 1, 1, 0, yes
161659612,  dskillshiphop, 2, 2, 0, yes
41917375,  RudiAntonioli, 2, 2, 0, yes
988651070,  AleCamarca, 1, 1, 0, yes
1718379914,  darioT_, 1, 1, 0, yes
86054527,  NiFrMa, 1, 1, 0, yes
480572988,  danraina, 1, 1, 0, yes
313428390,  MarcoLombardi1, 1, 1, 0, yes
419478860,  VLionetti, 2, 2, 0, yes
490533954,  CPalatresi, 1, 1, 0, yes
392170955,  gsaccoia, 1, 1, 0, yes
859896331,  HypsterCHT, 2, 1, 1, neutral
1478115104,  paolopanteghini, 1, 1, 0, yes
520580726,  AlessiaSaccone, 1, 1, 0, yes
1104761490,  super_facile, 3, 1, 2, no
477122234,  CillarioA, 1, 1, 0, yes
2314286333,  RiccoSteh, 1, 1, 0, yes
285491707,  chiabenzi, 1, 1, 0, yes
539344114,  Ballerinadijazz, 1, 1, 0, yes
1074200670,  flower___, 2, 2, 0, yes
738675744,  makpalan, 1, 1, 0, yes
406633613,  zappa301, 1, 1, 0, yes
353618083,  marsalazukov, 1, 1, 0, yes
2885765296,  marcio6910, 1, 1, 0, yes
2259216822,  Andrea_Bracco_3, 1, 1, 0, yes
719993478147653633,  m_bergadano, 2, 1, 1, neutral
161609363,  giolud, 1, 1, 0, yes
622708061,  AlbertMotta82, 1, 1, 0, yes
233900481,  silviagrilli, 12, 12, 0, yes
2300997220,  la_mancina, 2, 1, 1, neutral
1203919590,  PaoloToccafondi, 1, 1, 0, yes
724138546664247297,  toplou2, 1, 1, 0, yes
383227063,  GiudittaPeliti, 2, 1, 1, neutral
2812981270,  Simone70tre, 1, 1, 0, yes
788381041975328768,  66robertoff, 1, 1, 0, yes
2953078161,  hobbitsizedelle, 1, 1, 0, yes
156283574,  _EmptySpaces_, 1, 1, 0, yes
327316481,  BorginiM, 3, 3, 0, yes
580931348,  unr3ad, 1, 1, 0, yes
2537297638,  sparuzzu89, 1, 1, 0, yes
712715493,  giraffa49, 1, 1, 0, yes
15700293,  irene_r, 1, 1, 0, yes
63799365,  cococco, 1, 1, 0, yes
802547227671535616,  mario_barberini, 2, 2, 0, yes
629068160,  mabi_francesca, 1, 1, 0, yes
986645120,  MorettiPatri, 1, 1, 0, yes
302633416,  bifolca, 1, 1, 0, yes
2518376945,  v_sonica, 1, 1, 0, yes
3242084475,  rizzomarcello1, 2, 1, 1, neutral
711226135,  LoRBon995, 1, 1, 0, yes
796145153991909376,  NadiaTrentini1, 1, 1, 0, yes
22169209,  laniho, 1, 1, 0, yes
955794691,  zapping_italy, 1, 1, 0, yes
1728523100,  feyb88, 1, 1, 0, yes
802408960414416896,  mabst85, 3, 1, 2, no
127091412,  Super_VeroV, 1, 1, 0, yes
4854061971,  crochets_monia, 3, 2, 1, yes
369725754,  Casaqaz, 3, 1, 2, no
422872381,  MarioV8au, 1, 1, 0, yes
386779723,  Elena_Riccia, 1, 1, 0, yes
794426853327040512,  DiManunta, 4, 4, 0, yes
339932639,  MMiguelAGS, 1, 1, 0, yes
2509796906,  eli_cas1, 1, 1, 0, yes
794629032533000192,  Lorenzo41239337, 1, 1, 0, yes
779506339710140420,  Elondor79, 1, 1, 0, yes
335395171,  vittoriagheno, 2, 2, 0, yes
1132416883,  alessandro7933, 3, 1, 2, no
3037486419,  Fatii95_, 1, 1, 0, yes
2231877025,  sandro_monti, 3, 3, 0, yes
2451856765,  spzbarbara, 1, 1, 0, yes
723242392002895873,  imecojoni, 1, 1, 0, yes
2622859317,  MMantovani75, 1, 1, 0, yes
788445931079344128,  annamariastri, 1, 1, 0, yes
401527322,  stino121083, 1, 1, 0, yes
1244345414,  lunasversa, 1, 1, 0, yes
710189412341178368,  giulia_delogu, 1, 1, 0, yes
269982226,  giacomofavaro, 1, 1, 0, yes
745714817319710720,  maryolina04, 1, 1, 0, yes
1912251979,  Loregiuseppina, 1, 1, 0, yes
783316519895834624,  WilHardacre, 1, 1, 0, yes
724876311869706241,  kolesnikovasnea, 1, 1, 0, yes
425261926,  il_Fabio988, 1, 1, 0, yes
563011862,  Secutula, 1, 1, 0, yes
477809206,  dreaminwithsel, 1, 1, 0, yes
137057007,  andimabxl, 1, 1, 0, yes
242758162,  capitansalv, 1, 1, 0, yes
768860666727919616,  Ros13522091, 1, 1, 0, yes
4343359779,  lepanto17, 10, 10, 0, yes
914997096,  ariannamerlo2, 1, 1, 0, yes
3791284815,  danielat65, 1, 1, 0, yes
1006148712,  Graficnovel, 4, 4, 0, yes
3338790610,  alessandro25122, 1, 1, 0, yes
2962778668,  Mairizio3, 1, 1, 0, yes
91522905,  il_fonico, 1, 1, 0, yes
306131467,  branchetti, 2, 2, 0, yes
527802631,  letsgocrazytil, 1, 1, 0, yes
765509459305201664,  AntonellaFragn1, 1, 1, 0, yes
349355508,  illustratori, 1, 1, 0, yes
40006630,  smenichini, 11, 11, 0, yes
3987103817,  feelingshades, 1, 1, 0, yes
2210540756,  ruggenz, 2, 2, 0, yes
247694065,  ciccarema, 1, 1, 0, yes
2798224784,  SuperTWGattona, 3, 1, 2, no
85099571,  muzza1966, 1, 1, 0, yes
482456427,  CarloLettieri, 1, 1, 0, yes
535195516,  Alessandrodane, 1, 1, 0, yes
502977462,  Valeanto2301, 1, 1, 0, yes
415580398,  b_nunzio, 3, 3, 0, yes
9107872,  bbdaibudo, 1, 1, 0, yes
898392492,  patriziamaggio1, 1, 1, 0, yes
363266069,  mircomoreschi, 1, 1, 0, yes
211435254,  trevornicolini, 1, 1, 0, yes
1444894993,  alewildmonkey, 1, 1, 0, yes
334749868,  Marcella478, 1, 1, 0, yes
2232498868,  giovdiego, 1, 1, 0, yes
397338548,  Ricore564, 1, 1, 0, yes
306302295,  Tamelda, 1, 1, 0, yes
791271148940066817,  GiuliaBonaccor7, 1, 1, 0, yes
2794139935,  PeterNHerold, 2, 2, 0, yes
768424410978156544,  isabellla19bel6, 1, 1, 0, yes
3014425612,  AibiNews, 2, 2, 0, yes
796847494105796608,  PiaZorzi, 3, 3, 0, yes
570259528,  lucioalivernini, 2, 2, 0, yes
476754234,  rita_desideri, 3, 3, 0, yes
2779850985,  zivago_lara, 1, 1, 0, yes
200149647,  manuluzi, 1, 1, 0, yes
3717753735,  HelgaCZanotti, 2, 2, 0, yes
710170418955620352,  filimasini, 3, 3, 0, yes
266222825,  remiromi1, 8, 4, 4, neutral
345580549,  EnzoMorucci, 1, 1, 0, yes
528584555,  AntoeNico, 1, 1, 0, yes
1111272996,  interni2, 2, 2, 0, yes
1084535791,  superkanaz, 1, 1, 0, yes
3125099459,  Piu9603, 13, 13, 0, yes
1219371014,  _Mica81, 1, 1, 0, yes
3047533212,  Ninuz94, 1, 1, 0, yes
4655578961,  vincenzosettan1, 1, 1, 0, yes
4263801316,  isagardin99, 1, 1, 0, yes
1005353498,  caos11125, 8, 8, 0, yes
3801432315,  DDary18, 1, 1, 0, yes
984704059,  betta_82, 1, 1, 0, yes
764547279260966913,  baroneluca23, 1, 1, 0, yes
2479712105,  SeanMeser536, 1, 1, 0, yes
27283790,  stefanotrentino, 1, 1, 0, yes
476615991,  frafanta, 1, 1, 0, yes
798546185636212736,  DMihalac, 2, 2, 0, yes
719213767133917185,  gaedepasquale, 1, 1, 0, yes
1065634260,  stefbergamini, 1, 1, 0, yes
374229409,  FabioTerzi16, 1, 1, 0, yes
1384801004,  enzoizzo99, 1, 1, 0, yes
199610799,  cristianbr78, 1, 1, 0, yes
1030729472,  antoincerti, 1, 1, 0, yes
2990153159,  laurapiccolo76, 2, 2, 0, yes
715993334817357825,  AntonioSiringo, 1, 1, 0, yes
777161285721067521,  Dimitri419, 1, 1, 0, yes
498859163,  GianlucaDeFeo, 2, 2, 0, yes
2394515776,  AndreaCalari, 1, 1, 0, yes
407002506,  BarbaraZarrillo, 1, 1, 0, yes
1020342666,  asterixhood, 7, 6, 1, yes
1190578578,  PoggiActress, 1, 1, 0, yes
114268888,  GiovannniBert, 1, 1, 0, yes
2701642310,  NicoCabeza1, 2, 2, 0, yes
3202279292,  MarinaGilardi, 1, 1, 0, yes
2613905455,  StoKarma, 1, 1, 0, yes
1143239196,  mimmomaiorino, 3, 3, 0, yes
2876484350,  sbenbanido, 1, 1, 0, yes
3117770661,  Boomer87Alessio, 1, 1, 0, yes
1154475409,  mikesanzo, 1, 1, 0, yes
4272659117,  sergiolanzi78, 1, 1, 0, yes
3019772284,  AsunisMariella, 1, 1, 0, yes
2698697022,  scrocknroll, 7, 7, 0, yes
335964986,  AnnaRagosta, 1, 1, 0, yes
709470932,  Annamaria50Pisa, 2, 2, 0, yes
3362746077,  _cacodemone, 1, 1, 0, yes
609319929,  FabioPammolli, 1, 1, 0, yes
2755616210,  BurguenoSusana, 1, 1, 0, yes
2986650100,  CogitoLiber, 1, 1, 0, yes
704270026669486080,  MarioNoveCifre, 1, 1, 0, yes
106134549,  Cristiano1984, 1, 1, 0, yes
591386247,  SFUCKSIA, 1, 1, 0, yes
3288265978,  paternogiorgio1, 3, 1, 2, no
2228775365,  MarcoTallia, 1, 1, 0, yes
4151240067,  Annatonnaro, 1, 1, 0, yes
3394136542,  prina_95, 1, 1, 0, yes
1726451294,  MariLitterio, 1, 1, 0, yes
424406999,  LaRossella_, 1, 1, 0, yes
514582922,  giacomokuba, 1, 1, 0, yes
25150293,  AlexGirola, 1, 1, 0, yes
411327661,  PinoBenincasa, 1, 1, 0, yes
215728045,  Linkiesta, 4, 3, 1, yes
916584090,  mauropariscgil, 1, 1, 0, yes
3912125459,  paolettoc70, 5, 5, 0, yes
29188520,  FilippoViviani, 1, 1, 0, yes
565615102,  geoluca78, 1, 1, 0, yes
133447001,  mariomaffei73, 2, 2, 0, yes
303109666,  MateuPablo, 2, 2, 0, yes
3944687067,  magicdide, 1, 1, 0, yes
1262378611,  RossaDC, 1, 1, 0, yes
3383211964,  860932Enzo, 2, 2, 0, yes
53766835,  bloko23, 1, 1, 0, yes
2278995820,  Montecitorio, 21, 20, 1, yes
253230032,  masmoalive, 1, 1, 0, yes
570812802,  FranciGalletti, 3, 3, 0, yes
504273161,  NovelliGnovelli, 1, 1, 0, yes
2242244208,  renato_gangemi, 1, 1, 0, yes
439884911,  spigonico, 2, 2, 0, yes
48090650,  Scarfoglio, 4, 3, 1, yes
1332581676,  DavidGiacanelli, 1, 1, 0, yes
717128288804675585,  Luca85191, 4, 4, 0, yes
91574000,  emmedimarco, 2, 1, 1, neutral
157654836,  jeenedgar, 2, 2, 0, yes
712028880861704192,  milena_vava, 1, 1, 0, yes
165059017,  An_Evil_Queen, 1, 1, 0, yes
766621206883737600,  blondeandbold1, 1, 1, 0, yes
504729836,  MUSAfactory, 1, 1, 0, yes
380824560,  DocGDE, 1, 1, 0, yes
793539300977700865,  balducs, 1, 1, 0, yes
770016621607972867,  _annacugini_, 1, 1, 0, yes
431867098,  cathwincky, 5, 5, 0, yes
723159067267612672,  marlasinger2046, 1, 1, 0, yes
2340552066,  lagatta4739, 2, 2, 0, yes
4614202121,  ruggierodibito1, 1, 1, 0, yes
245048586,  leonatre, 3, 3, 0, yes
2873576710,  AsinioPollione, 1, 1, 0, yes
4828915329,  lazzaruslazzaro, 2, 1, 1, neutral
564377347,  tierix_75, 3, 1, 2, no
321979904,  caterinazanfi, 1, 1, 0, yes
1135315892,  JuliaVicioso19, 1, 1, 0, yes
211550281,  giuliainnocenzi, 2, 1, 1, neutral
85089978,  catemoscetti, 2, 2, 0, yes
55183166,  giulydeferrari, 1, 1, 0, yes
1500687954,  rota_sperti, 1, 1, 0, yes
247850658,  Annalaiser, 1, 1, 0, yes
1106253925,  vassilissa_doll, 1, 1, 0, yes
1270692270,  n15844331, 1, 1, 0, yes
142745300,  alessioangius, 1, 1, 0, yes
796837709994196992,  la_mastroianni, 1, 1, 0, yes
625219203,  strawberryzante, 1, 1, 0, yes
3920787796,  magliano1982, 1, 1, 0, yes
3018730888,  Felisia_Farnese, 4, 4, 0, yes
711920818582904832,  giusepp39855751, 2, 2, 0, yes
1130793836,  Hofbrau13, 2, 1, 1, neutral
1098221046,  valentinamonc, 4, 4, 0, yes
1109886678,  primavera1950, 1, 1, 0, yes
1377069902,  CinziaBattagli, 1, 1, 0, yes
791374730536386560,  romeonays, 3, 3, 0, yes
22769889,  highwall_86, 2, 2, 0, yes
43106925,  Jankus, 2, 2, 0, yes
1647344210,  Asiablog_it, 2, 1, 1, neutral
198822370,  luigicontessa, 5, 2, 3, no
463182289,  CescoYo, 2, 1, 1, neutral
551915032,  RockOnToSkillet, 1, 1, 0, yes
162662421,  riccardoMKcioni, 1, 1, 0, yes
1354633818,  FinDicitore, 1, 1, 0, yes
316640641,  AndreaBellino, 1, 1, 0, yes
3481441407,  danaesullacqua, 1, 1, 0, yes
286216634,  DanieleLorusso1, 1, 1, 0, yes
429125361,  fravigator, 1, 1, 0, yes
305549528,  DianosOddone, 1, 1, 0, yes
602544919,  SabrinaDagnolo, 1, 1, 0, yes
583762058,  Ascotone, 1, 1, 0, yes
18579961,  IamMargherita, 1, 1, 0, yes
2725663345,  rotanicolas, 1, 1, 0, yes
1084087626,  papoeta5, 1, 1, 0, yes
96366187,  monicafrassoni, 5, 2, 3, no
1202486570,  Bomba_SSL, 1, 1, 0, yes
128631063,  tipax78, 2, 1, 1, neutral
2373495638,  matteoborgia64, 1, 1, 0, yes
1539501919,  MariPanzarino, 1, 1, 0, yes
135086060,  contepazzo, 1, 1, 0, yes
552659943,  marilbuccolieri, 1, 1, 0, yes
2276517593,  FabioTripleboss, 1, 1, 0, yes
2711589210,  Vano_Sil, 1, 1, 0, yes
1640342070,  lanuovariviera, 1, 1, 0, yes
437525870,  MartyJones92, 1, 1, 0, yes
803245873618620417,  blastbitch2, 1, 1, 0, yes
984555210,  teobert86, 2, 2, 0, yes
398303100,  E_Megamind, 2, 2, 0, yes
40430869,  abbassolamore, 2, 2, 0, yes
435663871,  AndreaBosco4, 12, 3, 9, no
772177045820506112,  Breakfreebitch, 1, 1, 0, yes
14979502,  LileyArniman, 2, 2, 0, yes
217577417,  Elanna76, 3, 3, 0, yes
3687391228,  OrestinaOnofri, 1, 1, 0, yes
322005190,  lmastrogiovanni, 3, 3, 0, yes
2955623645,  ferrettilucian2, 1, 1, 0, yes
799271137276477440,  lfredo64, 1, 1, 0, yes
69835945,  xbelieveinpeace, 2, 1, 1, neutral
1063575205,  zannic91, 1, 1, 0, yes
713474860899516416,  morkmarc, 2, 1, 1, neutral
637111332,  lellagolfo, 2, 2, 0, yes
2790757204,  ziaflaminia, 1, 1, 0, yes
254632122,  Flexct, 1, 1, 0, yes
468742060,  casadonne, 3, 2, 1, yes
50673258,  cristinapecchio, 1, 1, 0, yes
1079723678,  SNOQuandoSP, 1, 1, 0, yes
4391467180,  Michel98066841, 1, 1, 0, yes
502089250,  domenico_lizzi, 1, 1, 0, yes
1364123287,  PattyBiancacci, 2, 1, 1, neutral
4244823916,  NataVegana, 1, 1, 0, yes
2725874927,  cheekysides, 1, 1, 0, yes
3390942778,  eb602bd2cd4a4a8, 1, 1, 0, yes
724367483071770626,  peyte_anja, 1, 1, 0, yes
303988517,  PavoniMarco, 1, 1, 0, yes
3415357985,  savino2905, 4, 4, 0, yes
732475690566619136,  sararazzicchia, 1, 1, 0, yes
776364656009023488,  micheledea88, 2, 2, 0, yes
802933525745901568,  manuela_lapenna, 1, 1, 0, yes
497268862,  antonellac177, 1, 1, 0, yes
2328562800,  Morilla70, 1, 1, 0, yes
788717815528353792,  AngelSanto22, 2, 2, 0, yes
2739829006,  iltignuso, 1, 1, 0, yes
1200977984,  gm_giu, 1, 1, 0, yes
16418144,  luigimichielon, 1, 1, 0, yes
500103357,  marcofrax, 1, 1, 0, yes
22833587,  padipal, 1, 1, 0, yes
802473183047729152,  elisa_calabrese, 1, 1, 0, yes
218021759,  nocensura, 1, 1, 0, yes
1367677159,  zigulik62, 1, 1, 0, yes
266608541,  giorjolly, 2, 2, 0, yes
231245867,  ToroSvenuto, 1, 1, 0, yes
1658688919,  moccia_luigiste, 1, 1, 0, yes
3191002378,  1977Giovanni, 2, 1, 1, neutral
165348110,  MartinoMTT, 4, 2, 2, neutral
986586822,  GFE_JefItaly, 2, 2, 0, yes
379867059,  salvdangelo, 2, 1, 1, neutral
2251584384,  forteforte111, 1, 1, 0, yes
2995844008,  TMelchionda, 1, 1, 0, yes
529290461,  ChiaraBartolett, 2, 2, 0, yes
793060472912244736,  ErikaBelluardo, 1, 1, 0, yes
2400349604,  imelda3959, 2, 2, 0, yes
2982254236,  13rioma, 1, 1, 0, yes
4306786001,  ChiSiaioVoi, 1, 1, 0, yes
89992240,  claudiobenve, 3, 3, 0, yes
754080207817039872,  Nadia45459366, 1, 1, 0, yes
933878252,  DarioMurari, 1, 1, 0, yes
4901218149,  Angie_Marangie, 1, 1, 0, yes
578848085,  pyer69, 1, 1, 0, yes
215087363,  evagiovannini, 1, 1, 0, yes
1376382397,  Iphranz, 2, 1, 1, neutral
103529808,  gvernarecci, 1, 1, 0, yes
361109299,  ChiaraProtano, 1, 1, 0, yes
256184416,  fp_gibby, 1, 1, 0, yes
2800104787,  vale_b_85, 1, 1, 0, yes
3236277882,  EdizioniGoree, 1, 1, 0, yes
1336561027,  MarioPeracchio, 1, 1, 0, yes
50979599,  pietrobaroni, 1, 1, 0, yes
1139407896,  nennellarinaldi, 1, 1, 0, yes
510346865,  LorussoManu, 1, 1, 0, yes
2233388418,  mammamanfredi, 1, 1, 0, yes
4697302040,  nonparlomai, 1, 1, 0, yes
788678875089924096,  Sifilone89, 1, 1, 0, yes
507327369,  corscri, 1, 1, 0, yes
505980311,  amandatupak, 1, 1, 0, yes
703073281,  francescoavoli1, 1, 1, 0, yes
511961726,  michelamazzei, 4, 4, 0, yes
415406147,  SilviaP1008, 1, 1, 0, yes
451060727,  Paone80, 1, 1, 0, yes
1076629952,  glendaspiller, 1, 1, 0, yes
616220544,  cyssques861, 1, 1, 0, yes
116528440,  car_dm85, 2, 1, 1, neutral
1411042874,  barbaradmicheli, 2, 2, 0, yes
150354782,  anfivas, 1, 1, 0, yes
409323369,  albespadafora, 1, 1, 0, yes
758599960942247936,  AmalioCampanile, 1, 1, 0, yes
420597088,  starkgazing, 2, 2, 0, yes
763113068662558720,  crazybuffalo47, 1, 1, 0, yes
404985135,  katroia, 2, 2, 0, yes
75802704,  framignemi, 2, 2, 0, yes
3005296665,  Giordano_Contu, 4, 4, 0, yes
517185905,  lukaz7230, 1, 1, 0, yes
36624024,  alelovari, 3, 3, 0, yes
143393752,  silviaerario, 2, 2, 0, yes
271998317,  Patagarro80, 1, 1, 0, yes
417860399,  inform_ant, 2, 2, 0, yes
841469377,  agnus_torre, 1, 1, 0, yes
1591102081,  GiancolaT, 1, 1, 0, yes
775697679166873600,  susannaP1234, 1, 1, 0, yes
346676055,  RAQU72, 1, 1, 0, yes
551808291,  whiteowl48, 1, 1, 0, yes
491426516,  massimocarcuro, 2, 1, 1, neutral
136753391,  linda_dorigo, 1, 1, 0, yes
135554444,  barakei, 2, 1, 1, neutral
27917146,  LeoFFM, 1, 1, 0, yes
2748283938,  MassariEderica, 1, 1, 0, yes
4746068242,  Lupazzo1978, 3, 3, 0, yes
2574668816,  AnnaMpilika, 3, 3, 0, yes
949310378,  GrabowskaAga, 1, 1, 0, yes
771638218517118976,  maganza_nicolo, 1, 1, 0, yes
1867555033,  GiuliaBeltrami9, 1, 1, 0, yes
1351944336,  BetelliMaurizio, 1, 1, 0, yes
4829216056,  Antonio24574556, 4, 1, 3, no
1449796104,  igiabas, 6, 5, 1, yes
283546298,  EttoreTimpanaro, 1, 1, 0, yes
244656602,  Nic18_, 1, 1, 0, yes
403366682,  Trico_ria, 3, 1, 2, no
2827358223,  bononi64, 2, 2, 0, yes
1186828039,  Il_Boccaccio, 2, 1, 1, neutral
16114528,  pierograziano62, 2, 2, 0, yes
161212876,  serendipity_87, 12, 1, 11, no
771813883,  lepore_liliana, 1, 1, 0, yes
4201108078,  RunnerA19, 1, 1, 0, yes
481367573,  nadiazampini1, 1, 1, 0, yes
29990130,  gabrielesalari, 1, 1, 0, yes
4644414735,  gp_bortolotti, 2, 1, 1, neutral
1966711322,  GaeVera, 2, 2, 0, yes
2944834883,  alebike73, 4, 3, 1, yes
289796077,  ilarioDP, 1, 1, 0, yes
473956079,  MaurizioDAuria, 1, 1, 0, yes
2757940289,  CPaccosi, 1, 1, 0, yes
458182729,  Baraban_Italy, 1, 1, 0, yes
99090506,  giannigaldi, 1, 1, 0, yes
553490318,  ClaudiaCaiaved, 1, 1, 0, yes
1603915909,  Curlyhaired_G, 2, 2, 0, yes
805437787616972801,  larsmazz, 1, 1, 0, yes
1566071294,  sheloryy, 1, 1, 0, yes
912281024,  FioreFiorini, 1, 1, 0, yes
618174060,  angelaritaiolli, 1, 1, 0, yes
370583162,  FlorianDiego, 1, 1, 0, yes
490685556,  dannibaccio, 1, 1, 0, yes
353612019,  Andrea_Calboli, 1, 1, 0, yes
1137546056,  GianniSemino, 1, 1, 0, yes
1076114564,  MarcoCetini, 1, 1, 0, yes
1344088633,  Bianconero73Gp, 1, 1, 0, yes
3321194891,  nicolabolida, 4, 4, 0, yes
855232669,  whiteflour00, 3, 1, 2, no
619321737,  __Sarcastic__Si, 1, 1, 0, yes
600546499,  fleur_pau, 1, 1, 0, yes
47495257,  eleonoravallone, 1, 1, 0, yes
3344001694,  RobyStarlady, 2, 2, 0, yes
312909231,  carloigliozzi, 1, 1, 0, yes
2368780252,  MatteoGiusti00, 1, 1, 0, yes
1063899488,  GiacomoFerru, 1, 1, 0, yes
904310665,  MelinaMarmottin, 1, 1, 0, yes
804786031027437573,  eleprincipe, 1, 1, 0, yes
3044646874,  ClaudioContiMMA, 1, 1, 0, yes
778301520,  girogenti, 2, 2, 0, yes
1067792364,  RRAMBELLI, 1, 1, 0, yes
50665410,  seble_w, 1, 1, 0, yes
385416021,  Ghidonss, 1, 1, 0, yes
84014909,  marcozanellato, 1, 1, 0, yes
396333984,  neofreeedom, 1, 1, 0, yes
4472938067,  Nopercattiveria, 1, 1, 0, yes
1209926364,  SacconiPaolo, 1, 1, 0, yes
804834636903940096,  kettyketty85, 1, 1, 0, yes
989250955,  pat_zagaglia, 1, 1, 0, yes
793821366608953351,  Piola7415, 1, 1, 0, yes
483884270,  AntoniaVerna, 1, 1, 0, yes
1362230798,  SELTreviso, 10, 10, 0, yes
1485107682,  Mascarin_2014, 1, 1, 0, yes
260834193,  giacomozacconi, 2, 2, 0, yes
14919483,  sbocci, 1, 1, 0, yes
14770559,  ziomau, 1, 1, 0, yes
6067292,  alesstar, 2, 2, 0, yes
434980220,  rositauau, 4, 4, 0, yes
468764094,  demiurgo80, 2, 2, 0, yes
107434862,  F_Memini, 2, 2, 0, yes
91380029,  martinapennisi, 9, 7, 2, yes
482178515,  twitmarcomagli, 10, 10, 0, yes
713754689389637632,  MirandaFelli, 1, 1, 0, yes
3065500461,  nlckkkkaaaa, 1, 1, 0, yes
461867800,  CristinaFavento, 1, 1, 0, yes
1727612048,  yayito73, 1, 1, 0, yes
1319255352,  lbonfadini1966, 1, 1, 0, yes
1780853522,  FilippoNcl, 1, 1, 0, yes
2892590987,  TittiGi, 1, 1, 0, yes
2869098909,  PasionariaIT, 2, 2, 0, yes
759409360397303809,  MariaTremolati, 1, 1, 0, yes
2952892109,  MarottoFabio, 1, 1, 0, yes
4634999891,  Dr__Edgar_Mihas, 1, 1, 0, yes
281056550,  DeboraGuillem, 1, 1, 0, yes
3384381916,  FnsiSocial, 4, 4, 0, yes
107810622,  VicentePugliaAr, 1, 1, 0, yes
49544302,  BabylonianRob, 3, 3, 0, yes
41075939,  PrimaDaNoi, 1, 1, 0, yes
355590443,  LauraArrias, 1, 1, 0, yes
54302011,  realdjralf, 1, 1, 0, yes
529417647,  VincenzoN1957, 1, 1, 0, yes
5464132,  lastknight, 2, 1, 1, neutral
2896172313,  Lauretta__91, 1, 1, 0, yes
287557719,  SDA40, 1, 1, 0, yes
87452421,  Crimarzor, 1, 1, 0, yes
2326622073,  MaurizioVolta, 1, 1, 0, yes
2789534304,  alen915, 1, 1, 0, yes
1164174092,  Tuzik_ac, 5, 5, 0, yes
4425384496,  viggiano9565, 2, 2, 0, yes
44578781,  albio77, 1, 1, 0, yes
2201591408,  ElviraRicioppo, 2, 2, 0, yes
1441091340,  swanpressagency, 1, 1, 0, yes
544502107,  andreabernabeo, 1, 1, 0, yes
17644344,  Peackmuff, 3, 3, 0, yes
627845498,  ManySkills1701, 1, 1, 0, yes
462779268,  AFoderi, 2, 2, 0, yes
798766976323620864,  ArslanG20673465, 1, 1, 0, yes
506451531,  Salvoilmazarese, 1, 1, 0, yes
36815444,  agoclem, 1, 1, 0, yes
1395172189,  LucaRaineri, 2, 2, 0, yes
15123812,  rudi51, 3, 3, 0, yes
42583638,  eldaelda, 1, 1, 0, yes
2647082770,  andrea____russo, 1, 1, 0, yes
1078171560,  MarioRm78, 3, 2, 1, yes
337073996,  clabagnara, 1, 1, 0, yes
39019040,  mauropalermo, 1, 1, 0, yes
1377887738,  corisereni, 1, 1, 0, yes
727607989583089665,  verotelle, 1, 1, 0, yes
418683219,  maservil81, 1, 1, 0, yes
95878193,  eXtrapola_srl, 2, 2, 0, yes
2782424044,  ferriant48, 1, 1, 0, yes
1162603992,  remartino64, 1, 0, 1, no
2290092179,  nomecognome911, 1, 0, 1, no
3300691827,  NoixMilano, 1, 0, 1, no
1155060330,  paronchi, 1, 0, 1, no
469127838,  claudiettatata, 3, 0, 3, no
1381868022,  gibinter, 1, 0, 1, no
123408064,  avbayon, 1, 0, 1, no
2563847123,  1893_fs, 1, 0, 1, no
4180556788,  isabcor, 1, 0, 1, no
88630804,  giorgioventre, 2, 0, 2, no
357063589,  massimosideri, 1, 0, 1, no
209923,  marcocc, 1, 0, 1, no
34569603,  enriconardelli, 4, 0, 4, no
1152234782,  IleanaMoriconi, 4, 0, 4, no
16592657,  nico_stac, 2, 0, 2, no
614771274,  francy_0207, 5, 0, 5, no
574732560,  RobertoVjlla, 1, 0, 1, no
20790972,  ppiac, 3, 0, 3, no
252045618,  FraC14, 1, 0, 1, no
14637273,  edocolombo, 1, 0, 1, no
17873238,  cfabry, 9, 0, 9, no
637327428,  antonioturi4, 6, 0, 6, no
3289808236,  CuoreDigitale, 1, 0, 1, no
1554152342,  postoccupato, 1, 0, 1, no
193672948,  mcaressa, 1, 0, 1, no
103908511,  biagiosimonetta, 1, 0, 1, no
217709750,  vololontano, 1, 0, 1, no
96028504,  andreacaccia, 1, 0, 1, no
14409745,  maponi, 3, 1, 2, no
120620483,  maxvurro, 1, 0, 1, no
772703285681745920,  pdamore74, 3, 0, 3, no
100264171,  LeonardoBertini, 1, 0, 1, no
494915050,  massimoemme, 1, 0, 1, no
4340457033,  prodigeoIL, 2, 0, 2, no
1011181519,  GRicci1978, 1, 0, 1, no
38135277,  mcanducci, 2, 0, 2, no
14335321,  rscano, 7, 0, 7, no
149077120,  AlessandroZonin, 1, 0, 1, no
11791472,  eugenio_cau, 1, 0, 1, no
28098604,  annamasera, 4, 3, 1, yes
26499377,  gioiozzia, 3, 0, 3, no
2596196060,  ComSociale, 1, 0, 1, no
702091089914830848,  LangellaBarbara, 1, 0, 1, no
1359704244,  Daniela27D, 2, 0, 2, no
475516139,  kirsypu, 1, 0, 1, no
178757667,  millozzi, 2, 0, 2, no
1259767670,  FondazioneIBM, 3, 0, 3, no
1568063760,  EPietrafesa, 2, 0, 2, no
617037479,  RodriCip, 1, 0, 1, no
2151597338,  Lutechspa, 1, 0, 1, no
106769415,  AlessioMantegna, 2, 0, 2, no
528940975,  veasyt, 3, 0, 3, no
62786647,  luigiscorca, 2, 1, 1, neutral
268455349,  ks7000, 3, 2, 1, yes
400607584,  Carlomochisis, 2, 0, 2, no
551653007,  il_leopardi, 1, 0, 1, no
558859189,  DaniDGia, 2, 0, 2, no
2354476783,  asutecoppe, 1, 0, 1, no
518701496,  MazzantiS, 2, 2, 0, yes
2826388232,  netwoplus, 1, 1, 0, yes
2945701839,  michelriccio13, 1, 1, 0, yes
3898934153,  PatriziaPog, 1, 1, 0, yes
2306340504,  RafPannuti, 2, 2, 0, yes
865113606,  pietro_nurra, 1, 1, 0, yes
932961775,  ABorraccetti, 3, 3, 0, yes
555975778,  F_Baudassi, 2, 2, 0, yes
508842758,  L_Torri, 1, 1, 0, yes
1485632245,  ARPASicilia, 1, 1, 0, yes
492973665,  fieramonti, 2, 2, 0, yes
786568292,  gschiona, 3, 3, 0, yes
970134013,  GloriaChiarini, 1, 1, 0, yes
144461365,  a_corda, 1, 1, 0, yes
171186272,  gmprivate, 2, 2, 0, yes
3428087639,  serenellastefa1, 1, 1, 0, yes
4060056862,  rudy_rossetto, 1, 1, 0, yes
1487338699,  arena_michele, 2, 1, 1, neutral
129456641,  jkyoox, 1, 1, 0, yes
303105004,  A_MdV, 1, 1, 0, yes
2316727530,  Cfm_Arpacal, 1, 1, 0, yes
1426298784,  paola_d1, 1, 1, 0, yes
478994038,  gigalimberti, 1, 1, 0, yes
793850754083725312,  AquafilSpa, 1, 1, 0, yes
620081055,  Corepla_Riciclo, 1, 1, 0, yes
1166821154,  ShareTheRoadFab, 2, 1, 1, neutral
1485324258,  ATimossi, 1, 1, 0, yes
468602078,  gNellerba, 1, 1, 0, yes
448613424,  andrea_vitta, 1, 1, 0, yes
588579160,  claudioaronica1, 1, 1, 0, yes
359555283,  gianpierodalia, 6, 6, 0, yes
2210612407,  iPopolari, 5, 5, 0, yes
809019169,  AttilioBiancala, 1, 1, 0, yes
802840890784043008,  PatriziaPoggio3, 2, 2, 0, yes
1530151454,  GreenItalia1, 1, 1, 0, yes
306780713,  mrgruppioni, 1, 1, 0, yes
22011746,  r50, 1, 1, 0, yes
1479188036,  ArpaCalabria, 1, 1, 0, yes
461049017,  arpatoscana, 1, 1, 0, yes
1055333070,  arpalombardia, 1, 1, 0, yes
492361204,  LandiDario, 1, 1, 0, yes
404994168,  francesca_zarri, 2, 2, 0, yes
407883178,  ArpaPiemonte, 2, 2, 0, yes
193642133,  EmilBanca, 1, 1, 0, yes
342798255,  ImprontaEtica, 2, 2, 0, yes
1349000059,  luigi_gia, 2, 2, 0, yes
44747985,  alevaccari, 4, 4, 0, yes
428627361,  loregasperini, 2, 0, 2, no
471825793,  astroiogyasf, 1, 0, 1, no
433751931,  CherylCllma, 1, 0, 1, no
412310752,  cigark7, 1, 0, 1, no
494400208,  antonellor68, 3, 0, 3, no
283467587,  Melissa__Peraza, 1, 0, 1, no
785910725185302528,  pkeko73, 1, 1, 0, yes
897627558,  PE_Italia, 1, 1, 0, yes
763647291660046336,  00OPO, 1, 1, 0, yes
1556735083,  ViVal111, 1, 1, 0, yes
1219296788,  PDTMath, 7, 6, 1, yes
2876520795,  PerpetuaMatita, 1, 1, 0, yes
2420202672,  Sciacquariello, 1, 1, 0, yes
546736761,  EU_Aluminium, 1, 1, 0, yes
1246309315,  scutuleia, 1, 1, 0, yes
1251748020,  laumaini, 1, 1, 0, yes
393629424,  ingdimario, 1, 1, 0, yes
22907119,  La_LauraC, 1, 1, 0, yes
631767111,  PediciniM5S, 2, 1, 1, neutral
112823471,  marghebianchi, 1, 1, 0, yes
4892369867,  carlafalaschi2, 1, 1, 0, yes
400703537,  SirianniChiara, 3, 3, 0, yes
771694410396557316,  Elisa74540290, 1, 1, 0, yes
625009623,  SVOTP, 1, 1, 0, yes
756511417541468161,  arialuce49, 1, 1, 0, yes
734293401785499648,  bisealess9699, 1, 1, 0, yes
2466067561,  gcmarchetti, 1, 1, 0, yes
21299451,  emanuelebompan, 1, 1, 0, yes
2964458164,  KHackurtz, 1, 1, 0, yes
612831033,  PaoloAcciai, 2, 1, 1, neutral
381544806,  tonianto2, 1, 1, 0, yes
265042576,  matthewflour, 1, 1, 0, yes
780287907387015169,  MoningaOnlus, 1, 1, 0, yes
2937313281,  Ka_Nes04, 1, 1, 0, yes
3251474159,  femmesdimpact, 1, 1, 0, yes
218480265,  gloriagoldoni, 1, 1, 0, yes
2217543306,  firenzedigitale, 1, 1, 0, yes
368242968,  carloerbaa, 1, 1, 0, yes
1466983518,  EDNapoliCEICC, 1, 1, 0, yes
3699668423,  giagiacobba, 1, 1, 0, yes
428663168,  LudovicoLuongo, 1, 1, 0, yes
3695767215,  Nottola_Minerva, 3, 3, 0, yes
789443764939026432,  strosilvia, 2, 2, 0, yes
630152241,  helvain2020, 1, 1, 0, yes
727854054697734144,  bashir_khalim, 1, 1, 0, yes
161620805,  MaxCollesano, 1, 1, 0, yes
108251354,  minima_moralia, 1, 1, 0, yes
1924562743,  maurizio191060, 7, 3, 4, no
1005158634,  stel_93, 1, 1, 0, yes
708772158353379328,  SRussano21, 1, 1, 0, yes
1020854767,  annarella50, 2, 2, 0, yes
2538706456,  effelumi, 1, 1, 0, yes
787697704466079744,  WRRoute, 1, 1, 0, yes
299269691,  RacheleBombace, 2, 2, 0, yes
2729299155,  jisaacmercier, 1, 1, 0, yes
484666748,  ECFRRoma, 1, 1, 0, yes
3012286540,  ItaliaHospitali, 2, 1, 1, neutral
201786249,  VincenzoArena, 2, 0, 2, no
368647460,  Paolo_Broglio, 1, 0, 1, no
247714397,  VincenzoBerardi, 2, 0, 2, no
798952638545088512,  morellogianfr, 2, 0, 2, no
465661057,  FabFornaciari, 1, 0, 1, no
3244803611,  FiorellaScarpo1, 1, 0, 1, no
546202998,  goffredov, 3, 1, 2, no
1861590582,  Acerob71, 1, 0, 1, no
418744756,  GiuliaMatteucc1, 1, 0, 1, no
518612766,  DanieleToto1, 1, 0, 1, no
2601914321,  ingfederica, 1, 1, 0, yes
418648496,  andreatrapasso, 1, 1, 0, yes
209459072,  MaryGregoritch, 2, 2, 0, yes
525346071,  PSMBologna, 2, 2, 0, yes
230817595,  virginiomerola, 1, 1, 0, yes
752153072370118656,  passantedimezzo, 1, 1, 0, yes
183139550,  rpirrello, 1, 1, 0, yes
197940697,  giordanomasini, 1, 1, 0, yes
55807676,  mariocalderini, 1, 1, 0, yes
397874065,  adapagliarulo, 2, 2, 0, yes
489386062,  marcogrimaldi0, 1, 0, 1, no
755165842862637056,  AttiVistiFoggia, 1, 0, 1, no
776446341123825664,  mrpanicus, 2, 2, 0, yes
411329576,  luigi_raffo, 1, 1, 0, yes
615546330,  MimmoContu, 1, 1, 0, yes
705489178,  GiovanniGueccia, 2, 1, 1, neutral
1016215621,  MSantoiemma, 33, 0, 33, no
292204573,  mirkomasotti, 1, 0, 1, no
2360515482,  Antonio79B, 1, 0, 1, no
589291887,  paola555999, 3, 0, 3, no
1063230986,  DanielaBeatrici, 2, 0, 2, no
2420044737,  GrazTo, 4, 0, 4, no
455181360,  Valtermiki, 2, 0, 2, no
1034862121,  cosimomanni, 15, 2, 13, no
31882493,  annalolanardi, 1, 0, 1, no
469894513,  giorgiogiomo, 1, 0, 1, no
147889932,  antoniosgobba, 1, 0, 1, no
475952330,  federcomazta, 2, 0, 2, no
720852852,  roccolisi1961, 2, 0, 2, no
863791340,  PaolaAguggia, 2, 0, 2, no
3020356043,  nannoni_daniele, 1, 0, 1, no
1171488392,  Zico21Gylmar, 71, 4, 67, no
2486333230,  claudia061167, 1, 0, 1, no
450950333,  gnammm, 1, 0, 1, no
856244276,  vanni_md, 2, 0, 2, no
1475697865,  filbier, 2, 0, 2, no
1103152945,  TarabellAlberto, 1, 0, 1, no
3000382647,  pastorecarmela1, 2, 0, 2, no
536718541,  mimmodistante, 1, 0, 1, no
797418784848019456,  gcmpucci, 2, 0, 2, no
374314630,  maratreiu, 6, 0, 6, no
246966243,  CalamityVa, 1, 0, 1, no
94656850,  nalial, 1, 0, 1, no
2973738196,  GiovBorz, 3, 1, 2, no
581561624,  FPanico1980, 1, 0, 1, no
83819316,  VideoNewsTV, 3, 0, 3, no
2808761,  okkio, 1, 0, 1, no
3036266535,  Nardoit, 1, 0, 1, no
1231844054,  colellalbina, 2, 0, 2, no
1061399634,  mariodelprete3, 2, 0, 2, no
2718141621,  zenovinci, 2, 0, 2, no
786920361858326528,  sergioCurcio3, 2, 0, 2, no
441730292,  AndreaGreco78, 1, 0, 1, no
306925405,  GiuseppeBuzzanc, 6, 2, 4, no
129265964,  DavidePozzi, 1, 0, 1, no
3044526632,  bumbumblakie1, 2, 0, 2, no
397474839,  LeoPiglionica, 8, 0, 8, no
422857222,  PBicchielli, 1, 0, 1, no
3056392801,  angelico_lilly, 3, 0, 3, no
3205922975,  cataniaFranc, 1, 0, 1, no
203831509,  CiaoNe100, 7, 2, 5, no
408766834,  AlexKannavale, 3, 0, 3, no
3518198235,  CesareVernaleo1, 1, 0, 1, no
782335052084633600,  Cinzia614770521, 1, 0, 1, no
2748424515,  rorato_andrea, 7, 6, 1, yes
484647669,  filippoimpiccia, 4, 0, 4, no
451090526,  MaridaLomPijola, 1, 0, 1, no
732278814093529088,  aurorarusso74, 1, 0, 1, no
470906034,  MVisceglia, 3, 1, 2, no
303961621,  ParenteSandra, 1, 0, 1, no
309141945,  stino87, 2, 0, 2, no
554993833,  TaleGigi, 1, 0, 1, no
482403856,  mikrobo1, 6, 0, 6, no
902101675,  Anunakyi, 3, 0, 3, no
2805383652,  riccardocallea, 2, 0, 2, no
224594895,  panunziomichele, 20, 0, 20, no
425360766,  TittyRisorseuma, 1, 0, 1, no
1306849784,  RaffaeleTour, 2, 0, 2, no
539341789,  LuiginaSi, 1, 0, 1, no
780004838604173312,  filogaeta, 1, 0, 1, no
1366650288,  restoalsud, 2, 0, 2, no
399337159,  fedegiancane, 1, 0, 1, no
551122649,  CISLFoggia, 2, 0, 2, no
2360365059,  v3rd3acqua, 7, 0, 7, no
3394106926,  OscarOscarnati, 2, 0, 2, no
96562150,  GiuseppeRinaldi, 1, 0, 1, no
391398732,  rafpiemontese, 2, 0, 2, no
746452118651961344,  LAltraala, 1, 0, 1, no
976995883,  TPeppino, 5, 0, 5, no
805900851235713024,  LeMattarellate, 1, 0, 1, no
700692490,  CDipietrangelo, 5, 0, 5, no
513080000,  Angelo_Rossano, 4, 0, 4, no
414253688,  Vito_Mitrotti, 1, 0, 1, no
2936766136,  DiDimiero, 5, 0, 5, no
483910971,  VincenzoRenna3, 2, 0, 2, no
3228896301,  saverioroc, 1, 0, 1, no
312666968,  Jo_Fuck, 3, 0, 3, no
1657542980,  GiosuRosa, 1, 0, 1, no
1086264085,  clara_muollo, 1, 0, 1, no
76634165,  Shivahma, 5, 1, 4, no
951365918,  Telebari, 7, 1, 6, no
426038482,  GMANDOLFO, 1, 0, 1, no
393550671,  blutarsky77, 2, 0, 2, no
1328616810,  WrachienDe, 4, 0, 4, no
528475682,  AntonioLoRe69, 3, 1, 2, no
3749352077,  MirellaMusci, 6, 0, 6, no
4845878153,  allerubino1, 1, 0, 1, no
471401393,  alex_arrighi, 4, 1, 3, no
708801020,  MarchionnaVania, 1, 0, 1, no
4265388017,  ByTheMelodySide, 1, 0, 1, no
227371681,  cronacheorg, 2, 0, 2, no
364331185,  spetrarolo, 1, 0, 1, no
101000387,  yourcenar09, 3, 0, 3, no
2168544166,  angscal77, 1, 0, 1, no
949722102,  beatriceale65, 1, 0, 1, no
2155539577,  dodoclock, 1, 0, 1, no
160949747,  BluGemma, 1, 0, 1, no
22785182,  gmassaro1975, 2, 1, 1, neutral
798072438445772801,  JpastorePastore, 1, 0, 1, no
834021516,  angcent, 2, 0, 2, no
2942180603,  2epicfail, 1, 0, 1, no
415618260,  peppemanzo, 3, 0, 3, no
757702137451274240,  ValVibrataNO, 1, 0, 1, no
545448505,  A_LisaCorrado, 67, 0, 67, no
4074057137,  ernstred, 5, 1, 4, no
239779690,  Baruch977, 10, 0, 10, no
1277454559,  fr_mont, 1, 0, 1, no
80836295,  stavrinouX, 2, 0, 2, no
386800314,  MarcoFattorini, 1, 0, 1, no
140872133,  michelelomonaco, 1, 0, 1, no
227454770,  ayxel2, 1, 0, 1, no
2499834158,  daniel_dd89, 1, 0, 1, no
2719001525,  AnnaCorsianna, 4, 0, 4, no
1461815022,  Ilikepuglia, 13, 0, 13, no
781973582,  59Gian, 1, 0, 1, no
253664818,  Vito__68, 1, 0, 1, no
3295662571,  m_saccomanni, 1, 0, 1, no
2417446748,  mmontanaro69, 1, 0, 1, no
4864281946,  MaxMarzulli, 2, 0, 2, no
132965464,  lospaziodimauri, 3, 0, 3, no
2601921913,  Zullo_Ignazio, 1, 0, 1, no
2365210698,  venerina57, 3, 0, 3, no
30949900,  andreafattizzo, 1, 0, 1, no
325152794,  LAccogli, 7, 2, 5, no
151200799,  Avv_AleLeo, 1, 0, 1, no
2184159493,  03_manila, 3, 0, 3, no
440943555,  SusannaCamusso, 2, 1, 1, neutral
588553042,  CadauThorelara, 5, 1, 4, no
791363997505359872,  Frances35754479, 1, 0, 1, no
411574224,  MarcoSolci, 9, 0, 9, no
1601362758,  _sorrentino21, 3, 0, 3, no
2798466252,  giumarchitelli, 2, 0, 2, no
733371908750708737,  Ant5410, 3, 0, 3, no
462372902,  DomMarPet, 1, 0, 1, no
238068247,  olgadiasparro72, 1, 0, 1, no
561493985,  ilariabonaccors, 1, 0, 1, no
295961054,  BettaPiccolotti, 2, 1, 1, neutral
787376854458109957,  lenovopieroit_c, 7, 0, 7, no
356031456,  lunaendor, 1, 0, 1, no
262133589,  robertomele, 1, 0, 1, no
751351053791158272,  angelo_perrone1, 1, 0, 1, no
124426856,  sologian, 6, 2, 4, no
212669183,  passionerossobl, 1, 0, 1, no
897446522,  LorLegrottaglie, 6, 1, 5, no
469667518,  Falcopellegrin1, 1, 0, 1, no
2155309777,  Conosciilsud, 2, 0, 2, no
1278327180,  ademaradei, 1, 0, 1, no
2584065829,  annalisalatarta, 1, 0, 1, no
503387161,  paolavallati1, 1, 0, 1, no
48272554,  leonardo4it, 4, 0, 4, no
234085296,  djlucio83, 2, 0, 2, no
785128857070428160,  LiberaMarghera, 1, 0, 1, no
455151962,  antonio_scogna, 1, 0, 1, no
32130104,  Al_Brambilla, 3, 1, 2, no
408076062,  erostiaco, 1, 0, 1, no
2483189321,  IdaFava, 1, 0, 1, no
3340132480,  barneypan, 3, 0, 3, no
546275216,  MauroMast, 5, 1, 4, no
427237029,  simmairo, 1, 0, 1, no
2800284308,  IngQuarta, 1, 0, 1, no
919355984,  giovanninistic, 2, 0, 2, no
738613686596554752,  a_manuelli, 7, 0, 7, no
3148108978,  AngelaFrisenda, 4, 0, 4, no
739114742485241857,  giogenetics, 1, 0, 1, no
428393835,  RCalcatelli, 2, 0, 2, no
418116243,  Malam4rco, 1, 0, 1, no
1173116102,  FPugliaVE, 4, 0, 4, no
401634856,  serdefilippis, 41, 0, 41, no
714184584787845121,  la_colecchia, 2, 0, 2, no
2784187913,  DipietrangeloC, 2, 0, 2, no
407873578,  roce03, 1, 0, 1, no
133267422,  Mauro030, 1, 0, 1, no
565035726,  PaceTotopace, 1, 0, 1, no
2699999945,  ugl_uniba, 2, 0, 2, no
993838274,  Vazzano64, 1, 0, 1, no
3918456983,  Fyx3nty, 2, 0, 2, no
405196197,  lamoussina, 22, 0, 22, no
42689668,  anna_mazzone, 4, 0, 4, no
468689162,  jenomy, 1, 0, 1, no
426673401,  EgidioEgi, 1, 0, 1, no
2740676513,  CletoDepalo, 3, 0, 3, no
760091608247328768,  Rigna1Francesca, 1, 0, 1, no
2197493125,  ABosurgi, 5, 0, 5, no
417070549,  Cartvideo, 5, 0, 5, no
1857386930,  v_dalessandro, 1, 0, 1, no
1192772778,  Celli_Seba, 2, 1, 1, neutral
388348486,  BCapula, 4, 0, 4, no
127627436,  grazianoschumy, 3, 0, 3, no
3823323202,  antmaggio, 4, 0, 4, no
1111665702,  marcovivianino, 5, 1, 4, no
2482513896,  Bisceglie24, 1, 0, 1, no
3074652513,  kosma1818, 3, 1, 2, no
1006133983,  MartinoCarriero, 2, 0, 2, no
717973505170608128,  luisella_albano, 3, 0, 3, no
52032507,  tuttodaniele, 2, 0, 2, no
868049126,  PdSudPuglia, 10, 0, 10, no
10329302,  vitodanese, 2, 0, 2, no
821310469,  Marevivo1, 1, 0, 1, no
401652014,  VIMAR55, 4, 2, 2, neutral
478470423,  LUIGIZAGARIA1, 1, 0, 1, no
135125831,  Giuseppedibi, 1, 0, 1, no
3706658056,  FernandoANFCMA1, 3, 0, 3, no
723480201599045632,  myfeel67tina, 5, 0, 5, no
542498398,  andreacappozzo, 1, 0, 1, no
1166991482,  ALekVittozzi, 1, 0, 1, no
750786600213381122,  lacurvadigauss, 1, 0, 1, no
465557489,  CapognaDavide, 1, 0, 1, no
2635526840,  madia_satalino, 2, 0, 2, no
272171460,  OssRifiutiFCO, 1, 0, 1, no
991984152,  GianniStanzione, 3, 0, 3, no
3297443457,  superbrein, 1, 0, 1, no
63764089,  saltuccio, 1, 0, 1, no
512927236,  Scioppa75, 1, 0, 1, no
1603515306,  HermesHill, 2, 0, 2, no
577814489,  CiccioMontebell, 1, 0, 1, no
2572860751,  GiuseppeJango, 2, 0, 2, no
1227447218,  teddytep, 1, 0, 1, no
3130649488,  fpaolocampo, 1, 0, 1, no
1098725179,  IvanMorl, 1, 0, 1, no
471250754,  renzilara, 2, 0, 2, no
527379677,  followgiorgio, 1, 0, 1, no
282022150,  Fargo_84, 1, 0, 1, no
447432073,  PetrisDe, 2, 1, 1, neutral
2725435126,  denik229, 13, 2, 11, no
2310173294,  ChiArroi, 1, 0, 1, no
150709009,  MORETTI3, 2, 0, 2, no
707879681845010432,  Sciu_Sciu_dolce, 1, 0, 1, no
776846953296588801,  maddalena0108, 4, 1, 3, no
911088012,  f_petrossi, 1, 0, 1, no
189874068,  emigrante81, 2, 0, 2, no
521501519,  NeroneMaurizio, 1, 0, 1, no
3238619722,  JacopoOrtizz, 11, 0, 11, no
456172613,  LancellottiFabi, 2, 0, 2, no
591364724,  LLopalco, 2, 1, 1, neutral
3350975284,  maxmarc69, 3, 1, 2, no
419907704,  giuliofc, 7, 0, 7, no
1413583716,  apeluso76, 1, 0, 1, no
303708603,  DiGioiaLeonardo, 1, 0, 1, no
721432185790705664,  PScianatico, 3, 1, 2, no
487765597,  fabribiondi, 5, 1, 4, no
154808415,  rogendanisalcon, 2, 0, 2, no
2657353205,  colagiorgio51, 1, 0, 1, no
200680504,  gl_wonder, 1, 0, 1, no
964956758,  nascapatata, 2, 0, 2, no
478485142,  martaciccarese, 1, 0, 1, no
1168562678,  Fa_Patti, 1, 0, 1, no
910250568,  thejankus, 1, 0, 1, no
2357226215,  Danielatamillib, 3, 0, 3, no
367194372,  giacomomedugno, 4, 0, 4, no
412894524,  silviarussofrat, 6, 0, 6, no
473984977,  sofiabarbina, 1, 0, 1, no
39464907,  Renato75, 1, 0, 1, no
394903214,  pep_89, 1, 0, 1, no
3159544901,  AnconaKame, 1, 0, 1, no
551331260,  gagino_cri, 40, 1, 39, no
2546075732,  manuelbasso26, 1, 0, 1, no
3485055077,  esra_nasran, 1, 0, 1, no
463690982,  ScaleraPietro, 2, 0, 2, no
708077520999079941,  triaragorn, 2, 0, 2, no
2945995006,  39b93321412d454, 2, 0, 2, no
1857302460,  gmdenicolo, 1, 0, 1, no
413125855,  EnzoGiannico, 2, 0, 2, no
433446505,  DanieleJD78, 1, 0, 1, no
1469191586,  TELADOIOLANIUS, 1, 0, 1, no
63766605,  giuseppeflagex, 1, 0, 1, no
468197270,  mimmocasu, 2, 0, 2, no
97442729,  fabio_iaci, 2, 0, 2, no
147885727,  angrageo, 2, 0, 2, no
3350829082,  SimonLucaSpada, 4, 0, 4, no
2909963555,  KraussAli, 4, 1, 3, no
1150471465,  delucaornella, 1, 0, 1, no
2786004480,  carmenmarta6, 3, 0, 3, no
1551594259,  Nino_Paradiso, 1, 0, 1, no
57617942,  justinoueda, 1, 0, 1, no
825997561,  19BIK, 1, 0, 1, no
379091940,  anIulian, 1, 0, 1, no
353573393,  roccolamonarca, 1, 0, 1, no
426977136,  DewidAlberti, 1, 0, 1, no
3187182555,  angela_merico, 3, 0, 3, no
1278572593,  DonzellaGiusy, 1, 0, 1, no
303072125,  MosconeF, 1, 0, 1, no
2748191567,  AucielloMarisa, 2, 0, 2, no
2591269446,  TeresaD_Leone, 2, 0, 2, no
105462498,  milla1972, 1, 0, 1, no
473132045,  Stefanolopasso, 1, 0, 1, no
442735223,  valfurla, 1, 0, 1, no
2502868003,  piera1957, 2, 0, 2, no
24386364,  andreananni, 1, 0, 1, no
480640741,  AnnaBarison, 1, 0, 1, no
2358815361,  aldo_aloisi, 2, 0, 2, no
219709201,  jjoyx, 1, 0, 1, no
797524210453217281,  MariapiaLeggie, 3, 0, 3, no
366525998,  OpheliaFra, 2, 1, 1, neutral
96785186,  SandroAcito, 1, 0, 1, no
251141871,  Aryo_Stark, 2, 0, 2, no
991477326,  maisto_maisto, 1, 0, 1, no
146090099,  raffaelegiuoco, 1, 0, 1, no
2997431799,  giugiuli2015, 10, 0, 10, no
2883998483,  PascaliLuciana, 2, 0, 2, no
107025395,  karmaturo, 2, 0, 2, no
3304165457,  massipetrone75, 1, 0, 1, no
820315045,  LsjDeLuca, 1, 0, 1, no
898459140,  B77Mela, 3, 0, 3, no
2359343661,  fuffo, 1, 0, 1, no
253601881,  francescomater, 1, 0, 1, no
735454076847132673,  AndreaDd23, 1, 0, 1, no
4393347915,  LucaNicotra84, 2, 0, 2, no
3226161388,  vocealsalento, 1, 0, 1, no
54232520,  RAF2attac, 2, 0, 2, no
319061161,  RBarchetti, 1, 0, 1, no
2765885890,  Ariele_1234, 1, 0, 1, no
396819051,  rosagravina1, 3, 0, 3, no
749499688546603008,  lavoratoricdr, 1, 0, 1, no
778961456746430464,  AntonioIovino16, 1, 0, 1, no
258460263,  cinziac12, 1, 0, 1, no
1382210870,  RobertoMelis7, 1, 0, 1, no
2477124216,  strangisn, 3, 0, 3, no
2376293973,  AbbinanteV, 1, 0, 1, no
2413811529,  19Francesco75, 1, 0, 1, no
793392004159987712,  Carpino56, 2, 0, 2, no
366149314,  PietroPatti, 1, 0, 1, no
2778219279,  emmeffeti, 1, 0, 1, no
51905142,  adigiorgio, 2, 0, 2, no
517823398,  NicolaRonic, 3, 0, 3, no
1244210036,  AnnaMariaDeFalc, 2, 0, 2, no
415824457,  BaronePietro, 1, 0, 1, no
120574321,  Combass, 1, 0, 1, no
2478535980,  Carladaddetta, 2, 0, 2, no
284654598,  papela17, 1, 0, 1, no
826724414,  Victor77Te, 1, 0, 1, no
342008649,  Marco_Furina, 1, 0, 1, no
442324308,  valeria_tweet, 2, 0, 2, no
454052321,  GiampaoloFagot1, 1, 0, 1, no
576139081,  ILazzaro, 2, 0, 2, no
419513827,  CappeIIaioMatto, 1, 0, 1, no
962736661,  maxiannic, 1, 0, 1, no
2718765850,  gigipezzu, 1, 0, 1, no
3345584741,  taysrecords13, 2, 0, 2, no
1367362759,  AlessPutzolu, 1, 0, 1, no
700117048,  patgio67, 1, 0, 1, no
480216833,  FilippoElba, 1, 0, 1, no
1153892731,  pinoalbero, 1, 0, 1, no
56061798,  USadopted, 2, 0, 2, no
82949077,  alfonso_errico, 1, 0, 1, no
738993503666118656,  TuxMaui, 1, 0, 1, no
3224935295,  Virtus_Leo, 1, 0, 1, no
3242236869,  enricocampo84, 15, 0, 15, no
2208150118,  GiuseppeRuiuAgr, 1, 0, 1, no
138008505,  mookiewi, 2, 0, 2, no
333644386,  FerraTrader, 4, 0, 4, no
481375605,  Tradecon1, 1, 0, 1, no
1063367166,  claudiobelvisi1, 1, 0, 1, no
459460560,  FederossiRossi, 2, 0, 2, no
452828571,  ITALIANBOTTLING, 2, 0, 2, no
67691388,  Marida2, 1, 0, 1, no
2404859790,  emmelle72, 2, 0, 2, no
937257948,  ScorcaMichele, 1, 0, 1, no
3827262383,  01Alegallotta, 1, 0, 1, no
418022254,  andreacarducci1, 1, 0, 1, no
334811128,  STEFANIADIFELIC, 1, 0, 1, no
563047128,  morena_ferrari, 1, 0, 1, no
746826726538383360,  aKos_76, 3, 0, 3, no
251826152,  piratataragna, 1, 0, 1, no
794774793648218112,  silvio041050211, 1, 0, 1, no
421905654,  michelapatruno, 1, 0, 1, no
1015814694,  brunopistolese, 8, 1, 7, no
258787593,  davide_vecchi, 6, 2, 4, no
415135980,  laurafasolino78, 3, 1, 2, no
66363389,  antoniocantoro, 3, 0, 3, no
400755376,  Giangiagainst, 4, 2, 2, neutral
793769938569822208,  Buon_Pomeriggio, 1, 0, 1, no
891456458,  nickprock, 4, 0, 4, no
2335615140,  IlPerdu, 3, 0, 3, no
3069421049,  marinuzzafra, 1, 0, 1, no
1049521440,  Gigisemart, 1, 0, 1, no
379615563,  ferdiocello, 2, 0, 2, no
58328967,  konan1234, 1, 0, 1, no
47313959,  ale_bau, 1, 0, 1, no
2427052056,  quipugliaonline, 2, 0, 2, no
252308694,  stefanoval1, 1, 0, 1, no
2358287784,  gavefa, 2, 0, 2, no
3233660728,  Gianni76373672, 3, 1, 2, no
2974296478,  Hermesh24Jr, 1, 0, 1, no
2721619085,  vincenzosando, 1, 0, 1, no
382148214,  LoreVegLombardi, 1, 0, 1, no
2321072358,  ProAdelio, 5, 0, 5, no
604023898,  Tunell0, 2, 0, 2, no
417800630,  basaxo, 3, 0, 3, no
425780142,  gianpiero32, 5, 1, 4, no
45120421,  robeffo, 1, 0, 1, no
541704097,  VeronaPossibile, 14, 0, 14, no
428169348,  Sasylongo, 2, 0, 2, no
2366138431,  saviina78, 1, 0, 1, no
795896647,  salvatoregold, 1, 0, 1, no
332222423,  Piero_Farenti, 2, 0, 2, no
1266500113,  lulucammini, 35, 2, 33, no
523306939,  ALESSANDROSPOR1, 2, 0, 2, no
583941667,  elenafrance0, 1, 0, 1, no
748156955974311936,  duedubbi, 3, 0, 3, no
2523972016,  gcfrancavilla, 1, 0, 1, no
763979325888536577,  Mastronardo2016, 1, 0, 1, no
3105346516,  ROMPI1964, 1, 0, 1, no
323769270,  Giurnal, 1, 0, 1, no
454048091,  simpaol, 1, 0, 1, no
420146229,  apeironpaola, 7, 1, 6, no
2359450492,  MicheleVesch, 2, 0, 2, no
461229005,  F_Boccia, 5, 2, 3, no
334321591,  N_DeGirolamo, 9, 1, 8, no
602824919,  sergiopaganotto, 1, 0, 1, no
3417586493,  Db34Daniela, 1, 0, 1, no
129939757,  Chiari75, 3, 2, 1, yes
507697095,  1952maggio, 7, 3, 4, no
708432352,  morettiroberto3, 4, 1, 3, no
4691636054,  fatfree2punto0, 2, 1, 1, neutral
972123007,  favilli_chiara, 6, 5, 1, yes
4854451399,  FrankoEinstein, 2, 1, 1, neutral
2337487947,  Biancageoffry, 2, 1, 1, neutral
4850071475,  noemi_meeks, 2, 1, 1, neutral
520423421,  diegoturcinovic, 2, 1, 1, neutral
4114189888,  nicomalfer, 3, 0, 3, no
1283915827,  irisdg81, 1, 0, 1, no
299897209,  NicolaVendramin, 1, 0, 1, no
485485288,  enribea62, 1, 0, 1, no
1081297633,  los_diau, 2, 0, 2, no
1213113511,  dreaming05, 1, 0, 1, no
2166800480,  NoSlotOrg, 1, 0, 1, no
976622414,  AlessMarin, 1, 1, 0, yes
61212638,  liukzilla, 1, 1, 0, yes
928203079,  MaxDelPapa, 1, 1, 0, yes
545689676,  sorandroida, 1, 1, 0, yes
102736428,  rbtino, 1, 1, 0, yes
976598371,  tocqueville7, 6, 3, 3, neutral
295312913,  Torpagano, 4, 2, 2, neutral
556966919,  lucacalia, 1, 0, 1, no
846987439,  zanon_alessio, 13, 0, 13, no
2400072632,  MiCamilleri, 1, 0, 1, no
2909939349,  diegosardellit1, 4, 0, 4, no
264941030,  vitre09, 1, 0, 1, no
128799214,  ilemaggio, 1, 0, 1, no
3030182237,  paradiso_elisa, 1, 0, 1, no
124778919,  VicusMartis, 2, 0, 2, no
31752746,  martamburini, 2, 0, 2, no
831788292,  enzotoia, 1, 0, 1, no
4777584309,  ambroxvez, 1, 0, 1, no
2421124847,  dxmariella, 2, 0, 2, no
460330693,  UnoFRAtanti, 1, 0, 1, no
3385886236,  CREA_Ricerca, 2, 1, 1, neutral
140772582,  AndreaOlivero, 5, 4, 1, yes
97241568,  nicoloscarano, 1, 1, 0, yes
2959049698,  manzini_anna, 2, 2, 0, yes
2224498087,  francabeti, 1, 1, 0, yes
3105976319,  luisa_imparato, 1, 1, 0, yes
1282508136,  clelialarenza, 1, 1, 0, yes
945989622,  Paolo_MD, 2, 2, 0, yes
1583119626,  fscireIT, 2, 2, 0, yes
2282594402,  laura_fazzini, 1, 1, 0, yes
1138004840,  Meridemartino, 1, 1, 0, yes
2484041780,  PDPratello, 2, 2, 0, yes
480628476,  ggfiorentino, 1, 1, 0, yes
539009133,  Grufius, 3, 0, 3, no
207583079,  tildefalcone, 1, 1, 0, yes
282593537,  valentinacefalu, 1, 1, 0, yes
1854766598,  Pat25Lic, 1, 1, 0, yes
420236092,  PaoloMessa, 1, 1, 0, yes
46959509,  michelepierri, 1, 1, 0, yes
407765988,  EleBozzo, 2, 1, 1, neutral
190389182,  idialoghi, 1, 1, 0, yes
165547516,  GiulioVada, 1, 1, 0, yes
2164429638,  luca_bechelli, 1, 1, 0, yes
505883601,  GianfrancoIncar, 1, 1, 0, yes
14828588,  mmachiavelli, 2, 2, 0, yes
1657435081,  Alessandro__Ma, 1, 1, 0, yes
1547704086,  carlo_mauceli, 2, 2, 0, yes
780621571,  seipolpette, 1, 1, 0, yes
418649567,  mariodepizzo, 2, 2, 0, yes
3760519041,  FrVitt, 1, 1, 0, yes
335212536,  autoexportitaly, 4, 4, 0, yes
976924820,  dPiovan, 1, 1, 0, yes
443613583,  claudiodilizio, 1, 1, 0, yes
66687479,  MeL_Ledur, 2, 2, 0, yes
1041640260,  rosamariafreda, 1, 1, 0, yes
191685685,  Escudrojo, 2, 2, 0, yes
2698763456,  UMBERTOALF, 1, 1, 0, yes
434360065,  kiarammare, 2, 2, 0, yes
772434643492691969,  NutraceuticaIT, 1, 1, 0, yes
2732492729,  TotoDinoi, 2, 2, 0, yes
418084273,  TittiGiammetta, 2, 2, 0, yes
3080146495,  midori8150, 1, 1, 0, yes
256553617,  sisinis, 2, 2, 0, yes
69310631,  Mondo_Birra, 1, 1, 0, yes
231717139,  redape2, 2, 2, 0, yes
81437461,  simonemonetti, 1, 1, 0, yes
154511261,  saxmikka, 1, 1, 0, yes
4126131670,  prioritalia, 2, 2, 0, yes
734740811338878976,  ProgettoFiliere, 1, 1, 0, yes
56982346,  evolvenza, 2, 2, 0, yes
956162408,  BeneMayer, 1, 1, 0, yes
186623247,  insolitamente, 1, 1, 0, yes
2952722229,  ciatoscana, 1, 1, 0, yes
727946377393737729,  irene_pragliola, 1, 1, 0, yes
2763791466,  monicascatena, 2, 2, 0, yes
1235372959,  ruminantia_it, 1, 1, 0, yes
251286285,  Franco56Montera, 4, 4, 0, yes
38902641,  fabio55, 1, 1, 0, yes
436591777,  VeronaManagers, 1, 1, 0, yes
786506557437640704,  Abdalla13350726, 1, 1, 0, yes
2348285916,  TwitItalianWine, 1, 1, 0, yes
701796846952386560,  TweetWineBOT, 1, 1, 0, yes
733011210547912704,  GenerazioneSi, 2, 2, 0, yes
719921687622508544,  food_comm, 1, 1, 0, yes
722816711049646083,  CondifesaFoggia, 1, 1, 0, yes
1623148244,  unica_milano, 1, 1, 0, yes
1924647492,  Siddurasrl, 1, 1, 0, yes
76012420,  militanteignoto, 2, 2, 0, yes
763504009034526720,  sinistraxilSI, 3, 3, 0, yes
2308461984,  Maur0068, 1, 1, 0, yes
2276549584,  debernardisa, 1, 1, 0, yes
450712216,  SarahCYeomans, 1, 1, 0, yes
974830003,  LLottero, 1, 1, 0, yes
296480070,  LucaCefisi, 1, 1, 0, yes
426874964,  GianCastiglia, 1, 1, 0, yes
745147358,  LipuOnlus, 1, 1, 0, yes
68633352,  francescobazza, 1, 1, 0, yes
3947635347,  RivoltaF, 1, 1, 0, yes
715668574292074496,  marinomicheleca, 9, 3, 6, no
557682931,  MarcoGiacinto1, 1, 1, 0, yes
2955136911,  pdurbino, 2, 2, 0, yes
1048968648,  massimofusini1, 3, 1, 2, no
175831657,  paulecci, 1, 1, 0, yes
500804936,  leonardopisani1, 1, 1, 0, yes
421914873,  Avantionline, 1, 1, 0, yes
389470413,  Matteo_DiMaio, 1, 1, 0, yes
1328396414,  ninnipetrol, 1, 1, 0, yes
2604070285,  vlucisano1, 2, 2, 0, yes
453168575,  vincenzofolino, 1, 1, 0, yes
246418452,  francescodinoia, 4, 4, 0, yes
752429886954930176,  europaPERILSI, 2, 2, 0, yes
429825654,  matteobruxelles, 1, 1, 0, yes
618840131,  Haaaayley__, 1, 1, 0, yes
168163906,  mweilx, 1, 1, 0, yes
728754830,  guggamba, 1, 1, 0, yes
751072386305449984,  ragionepubblica, 8, 8, 0, yes
480246066,  ClaudioZardo, 2, 1, 1, neutral
295643868,  clacala76, 1, 1, 0, yes
1274722686,  albert6510, 1, 1, 0, yes
797756728460845056,  PasqualeFazio4, 1, 1, 0, yes
1599296083,  confcoopbg, 2, 2, 0, yes
119686516,  ATS_BERGAMO, 1, 1, 0, yes
236395960,  framerca75, 1, 1, 0, yes
1351697966,  inter_valli, 1, 1, 0, yes
796036776158785536,  delmaschiogiam1, 1, 1, 0, yes
2804318513,  zelli_gianluca, 1, 1, 0, yes
1295297316,  48mariob, 1, 1, 0, yes
2517359068,  fracapri92, 1, 1, 0, yes
794510895254794241,  ari_carmi, 1, 1, 0, yes
1121443682,  mauro_parolini, 1, 1, 0, yes
1595545141,  AdelaideCorbe, 3, 3, 0, yes
628380486,  FraAlleva, 2, 2, 0, yes
378565367,  fastomas, 2, 2, 0, yes
325096730,  laurawildermuth, 1, 1, 0, yes
2571207469,  Perniola20Vale, 1, 1, 0, yes
499888275,  albertoismaele, 1, 1, 0, yes
298774756,  GloriaPaolini, 1, 1, 0, yes
384444944,  SoAppi, 1, 1, 0, yes
615945406,  albertotrivelli, 2, 0, 2, no
465408460,  13dontbreak, 1, 0, 1, no
1536486193,  MartinaMusetti1, 2, 0, 2, no
474074110,  mammuthgiallo, 2, 0, 2, no
310925040,  PolGalbusetti, 1, 0, 1, no
67002064,  castagnett, 1, 0, 1, no
977706000,  ricky_pru, 1, 0, 1, no
764080205656981504,  gamberoblu, 1, 0, 1, no
3233551233,  lorenzobellini9, 3, 1, 2, no
253037330,  nembokidy1, 1, 0, 1, no
1565314302,  GiovanniSalvin2, 1, 0, 1, no
487816917,  bl771, 2, 0, 2, no
1565359196,  SimoneAngelanto, 1, 0, 1, no
3221546987,  AnnaRossani, 1, 0, 1, no
1536275011,  MichelaCarli3, 1, 0, 1, no
3298086872,  89Lidiamartini, 1, 0, 1, no
1534824038,  GiovanniBerti4, 2, 0, 2, no
66742297,  locchif, 1, 0, 1, no
4415101463,  sobieski_iii, 1, 0, 1, no
3244161467,  DaridaGabriele, 6, 3, 3, neutral
201750208,  3mendie20, 1, 0, 1, no
2252314592,  valtomm, 1, 0, 1, no
2746719371,  vpiazza50, 1, 0, 1, no
1923459475,  LKcultura, 1, 0, 1, no
709078210068217856,  annasag10, 2, 0, 2, no
389969558,  robciral, 1, 1, 0, yes
3152227665,  rosanna_52, 2, 2, 0, yes
486124606,  angelo_moscarel, 1, 1, 0, yes
805130140766392320,  BenitaLicata1, 1, 1, 0, yes
865360170,  VegasHC, 1, 1, 0, yes
549344250,  marco_sauro, 1, 1, 0, yes
46931635,  mauriziocarta, 1, 1, 0, yes
2287528211,  ricondorelli, 2, 2, 0, yes
2374022130,  bu_giu, 1, 1, 0, yes
379385287,  giusygiorgianni, 2, 2, 0, yes
742168498911203328,  AriannaFiorenza, 3, 3, 0, yes
854650580,  ulisseacquario, 1, 1, 0, yes
802931122371969028,  Apprenti44, 1, 1, 0, yes
970809704,  FBelladone, 1, 1, 0, yes
249751492,  giuseppedgr, 3, 1, 2, no
763709308869705728,  TeodoroPaola, 1, 1, 0, yes
761036676,  MassimoAgricola, 1, 1, 0, yes
523054469,  FondazioneCurel, 1, 1, 0, yes
899684497,  campluslife, 3, 2, 1, yes
786855189005365248,  angela_pellino, 1, 1, 0, yes
2471431530,  APEItaliani, 1, 1, 0, yes
2760739042,  AssuntaPirri, 1, 1, 0, yes
3908391321,  autismoit, 2, 2, 0, yes
3018858028,  PampaloniGianni, 1, 1, 0, yes
142416036,  Giorgiogabermax, 2, 2, 0, yes
125313918,  piero_galli, 1, 1, 0, yes
1308714193,  GiovAccardi, 2, 2, 0, yes
554634501,  alternances, 1, 1, 0, yes
485939604,  AnnamariaGenchi, 4, 3, 1, yes
2318976182,  paticosocio, 1, 1, 0, yes
318438903,  cipollaccio, 4, 3, 1, yes
603077240,  waltermazzucco, 1, 1, 0, yes
51848010,  esperya63, 1, 1, 0, yes
870156012,  beppeabc123, 1, 1, 0, yes
166449444,  vindidio, 2, 1, 1, neutral
876015499,  dsantare, 1, 1, 0, yes
1163103648,  EmanueleDeLuc17, 1, 1, 0, yes
3103981311,  cherchezlaSam, 4, 4, 0, yes
475184361,  albertofc1908, 2, 1, 1, neutral
75590296,  claudioreale, 1, 1, 0, yes
2969687992,  leo_lucisano, 2, 2, 0, yes
1897601790,  chiararubin75, 3, 1, 2, no
342292429,  NicoleBossoni, 1, 1, 0, yes
119004812,  Elena_Giorgi, 1, 1, 0, yes
158083176,  matteo_belfiore, 1, 1, 0, yes
298734391,  zolt4r, 2, 2, 0, yes
732640909544853504,  Territoriditaly, 2, 2, 0, yes
517611091,  angeloghinelli, 2, 1, 1, neutral
2280596834,  Univa_Stampa, 1, 1, 0, yes
1060109168,  dianamontagna, 2, 2, 0, yes
24006136,  Binksterb, 1, 1, 0, yes
3035435236,  ReginaCoeliCORC, 1, 1, 0, yes
610429671,  MELLOWCELLO1, 1, 1, 0, yes
142407091,  Novamont, 1, 1, 0, yes
2196005464,  adrianocappe, 7, 1, 6, no
4692016008,  RubnerLatina, 2, 2, 0, yes
231432433,  bioediliziaroma, 2, 2, 0, yes
123840070,  bio_edilizia, 2, 2, 0, yes
1080998839,  meneghelandrea, 2, 2, 0, yes
2712187096,  DimitriEmanuela, 1, 1, 0, yes
2476708401,  punlsherawr, 1, 1, 0, yes
4126862374,  GreenHub_Italy, 1, 1, 0, yes
425039950,  Leonardobecchet, 6, 6, 0, yes
851085422,  robertocosta_ge, 1, 1, 0, yes
454883271,  EticarCaes, 2, 2, 0, yes
613424496,  ClarkHepler71, 1, 1, 0, yes
298038274,  Ecodallecitta, 2, 2, 0, yes
388796548,  WorksInItalian, 1, 1, 0, yes
2436764943,  Chefhdm988, 1, 1, 0, yes
989648000,  crigerardis, 1, 1, 0, yes
132981223,  empedoclino, 1, 1, 0, yes
2476324354,  _LoveLost70, 1, 1, 0, yes
412260592,  TandoorSaras0ta, 2, 2, 0, yes
4320197602,  Sarita_Libre, 4, 2, 2, neutral
589811677,  IlariaCatastini, 1, 1, 0, yes
1672580731,  bioedilizianews, 1, 1, 0, yes
1969212895,  SardegnaSposi, 1, 1, 0, yes
740859011684257792,  Coop_ventuno, 1, 1, 0, yes
401612847,  grandealdo, 1, 1, 0, yes
1330873988,  edoperox, 2, 2, 0, yes
577919503,  mazzeo77, 1, 1, 0, yes
515389487,  Giuliaerdas59, 1, 1, 0, yes
162746028,  CittadelBio, 1, 1, 0, yes
614298536,  cariosvnext, 1, 1, 0, yes
540200727,  Venturelli62, 1, 1, 0, yes
2512561941,  sandrosposito, 1, 1, 0, yes
574814553,  fedechiavaroli, 1, 1, 0, yes
256444181,  GiacomoM26, 1, 1, 0, yes
864984350,  guarducciale, 1, 1, 0, yes
3224691417,  FondCaript, 1, 1, 0, yes
2597478368,  ComuneRosignano, 1, 1, 0, yes
4849267259,  FavillaDaniele, 1, 1, 0, yes
2376908430,  Toscana900, 1, 1, 0, yes
89286782,  Noel_0409, 1, 1, 0, yes
2230070580,  TerrestreT, 2, 2, 0, yes
125941209,  BLIND_DATA24, 4, 2, 2, neutral
1635317684,  NicolaBonoUccio, 2, 2, 0, yes
2790548972,  MrsMiry78, 2, 2, 0, yes
277675174,  E_opi, 1, 1, 0, yes
375179336,  sara_antonella, 1, 1, 0, yes
617069188,  Marco_Spedo, 2, 2, 0, yes
128870883,  marcocappato, 2, 2, 0, yes
429268185,  marinacril, 1, 1, 0, yes
4172212191,  Ettorelmt, 5, 2, 3, no
1136338860,  DanielaCavenago, 2, 2, 0, yes
947529132,  BrunaNerazzurra, 1, 1, 0, yes
1162613372,  anna_ciriolo, 2, 2, 0, yes
406382270,  evagio13, 1, 1, 0, yes
293555666,  cesarelab, 1, 1, 0, yes
2167468704,  destefano_fede, 2, 2, 0, yes
462435837,  arena_teresa, 1, 1, 0, yes
1640675455,  festappraif, 1, 1, 0, yes
2965979237,  Lord_Hanmar, 1, 1, 0, yes
726134754723151872,  Capofficina666, 1, 1, 0, yes
2874842817,  stefanolai56_sl, 3, 1, 2, no
453990634,  gabertipa, 1, 1, 0, yes
453995936,  BarbaraVenditti, 1, 1, 0, yes
793785919933411328,  FanAmici16, 1, 1, 0, yes
431411443,  wwf_taranto, 3, 2, 1, yes
981832592,  monicascapin77, 4, 4, 0, yes
2347271728,  Sirian1Giuseppe, 3, 3, 0, yes
2795617577,  MonteverdiOnyx, 2, 2, 0, yes
747838930398101504,  Dybaradona, 1, 1, 0, yes
68943414,  ErPucce, 4, 1, 3, no
1103569482,  vitocarlucci78, 1, 1, 0, yes
558101743,  giannicolacione, 7, 5, 2, yes
801009522798161920,  DiegoBellopede, 2, 2, 0, yes
472338354,  faustin73, 1, 1, 0, yes
414869112,  cristinagorini, 2, 2, 0, yes
606694260,  FScarfato, 3, 3, 0, yes
309639034,  FlavioRadice, 2, 2, 0, yes
259449213,  FulvioPaglia, 1, 1, 0, yes
509157552,  FedeFane, 1, 1, 0, yes
706498833430269952,  TgrLiguria, 1, 1, 0, yes
703721705492107264,  Dinao86, 2, 2, 0, yes
264941030,  vito_trecarichi, 24, 15, 9, yes
2995754453,  giuseppecrupi68, 2, 2, 0, yes
523073727,  RosannaPadoin, 1, 1, 0, yes
231834513,  xoxoxben, 2, 2, 0, yes
721571639142391808,  MarcoTedeschex, 2, 2, 0, yes
362416205,  fratazzo, 1, 1, 0, yes
2853625643,  lucettelegaz1, 3, 3, 0, yes
3136730549,  mazzarovich, 2, 2, 0, yes
464954800,  laurivirgola, 2, 2, 0, yes
2496519414,  AntonellaRugge6, 3, 2, 1, yes
429157117,  gabriellaradano, 1, 1, 0, yes
3091392485,  LuigiBrugnaro, 2, 2, 0, yes
2839739320,  comuntwist80, 2, 2, 0, yes
429392796,  ClaudioLauretta, 1, 1, 0, yes
3045081677,  felixss52, 1, 1, 0, yes
331617619,  MediasetTgcom24, 1, 1, 0, yes
3030837185,  pomeriggio5, 1, 1, 0, yes
106164453,  nicolapicco, 2, 2, 0, yes
1630393692,  sergiodis63, 1, 1, 0, yes
2997756838,  SaSempreverde, 2, 2, 0, yes
448048809,  RadioRock106e6, 2, 2, 0, yes
714962364,  vacesari, 1, 1, 0, yes
208538102,  MatteoRadioRock, 2, 2, 0, yes
81626770,  emiliopappagall, 2, 2, 0, yes
2351400748,  DCetnikovic, 3, 3, 0, yes
419100641,  ale_pacc, 2, 2, 0, yes
2987051320,  vaya1pijo, 1, 1, 0, yes
1094582054,  newinterlimo, 2, 2, 0, yes
1070880144,  triceRomana, 1, 1, 0, yes
361840414,  serriuiltucs, 1, 1, 0, yes
22144968,  lapisa, 1, 1, 0, yes
798538357844295680,  Lea_Gea91, 1, 1, 0, yes
4890128368,  Ella_287, 1, 1, 0, yes
2346458381,  tonneiro, 9, 9, 0, yes
1472636252,  NunziataF89, 1, 1, 0, yes
334622726,  AngeloMattina, 2, 2, 0, yes
786443950458544128,  cuoregranata61, 1, 1, 0, yes
392749188,  ilmochi, 3, 2, 1, yes
1278452804,  mr_geffrey, 2, 1, 1, neutral
283023020,  Brandofrascella, 1, 1, 0, yes
2726505142,  claudiopanarel7, 2, 1, 1, neutral
726834822052761601,  CseFilai, 24, 24, 0, yes
2735301707,  fcaroli9865, 4, 2, 2, neutral
971897629,  RuinaElisabetta, 6, 6, 0, yes
485174785,  Marcellomasitg2, 1, 1, 0, yes
746316843607015424,  PaolaDeffendi, 4, 4, 0, yes
557520229,  66Orsino, 24, 24, 0, yes
789398336,  CarpiaLa, 2, 2, 0, yes
932425244,  MancinoAniello, 1, 1, 0, yes
499967652,  aureomuzzi, 4, 4, 0, yes
608541872,  crisci_lorenzo, 1, 1, 0, yes
745124581,  Blessedvgltd, 2, 2, 0, yes
537263615,  brunomattiuzzo, 6, 3, 3, neutral
774184208306573312,  Rosamariazan12, 1, 1, 0, yes
398180854,  PPacioni, 3, 1, 2, no
768921750,  CristinaMassara, 2, 2, 0, yes
774695874630909952,  SuperFresta, 22, 22, 0, yes
164608349,  ezia77, 8, 2, 6, no
1561166036,  FAmarella, 1, 1, 0, yes
557046501,  giovanni_alvaro, 1, 1, 0, yes
2267611574,  wasabasketcase, 2, 2, 0, yes
786953730746937345,  gianv17o, 1, 1, 0, yes
421862447,  menadelgiudice1, 1, 1, 0, yes
618148740,  StartEndRoma, 3, 2, 1, yes
4906981425,  ITnewsFG, 2, 2, 0, yes
628367500,  Trevisi_Paolo, 1, 1, 0, yes
737356912921083905,  Bruno7331070219, 4, 4, 0, yes
410643022,  michgiardino68, 1, 1, 0, yes
2178861689,  mazzanti46, 1, 1, 0, yes
4252857562,  marcobonsy, 1, 1, 0, yes
2187374813,  SimonaGabriele, 2, 2, 0, yes
106473438,  jhonmiglia, 3, 1, 2, no
2598110537,  rossi20_rossi, 1, 1, 0, yes
802876261215436800,  emy_gigante, 1, 1, 0, yes
759295239299428352,  SEUROP56, 2, 2, 0, yes
284515442,  sandrocolombo65, 2, 2, 0, yes
589927876,  ollenotna48, 1, 1, 0, yes
426842172,  stedipi, 3, 1, 2, no
418578991,  tappa_rella, 1, 1, 0, yes
271622920,  Fanclub_dUrso, 1, 1, 0, yes
59240210,  dcuder, 1, 1, 0, yes
485088788,  FabioVenturiVR, 2, 2, 0, yes
774539006579187712,  Bisic3, 4, 4, 0, yes
3111391300,  Sberla78Daniel, 1, 1, 0, yes
464828004,  WalinoPupino, 2, 1, 1, neutral
85017305,  ale_spada, 1, 1, 0, yes
3152358089,  p_focsa, 1, 1, 0, yes
59527288,  virginievotier, 1, 1, 0, yes
2873716210,  francescosass18, 4, 4, 0, yes
44103891,  iretos, 1, 1, 0, yes
4709374697,  gina23249, 1, 1, 0, yes
1471491456,  sandralicciardi, 2, 2, 0, yes
449629791,  MorenaIzzo, 1, 1, 0, yes
20250902,  AlicePilia, 1, 1, 0, yes
1890241374,  EAPOandIC, 1, 1, 0, yes
36392373,  giuseppebarila, 4, 1, 3, no
2909313208,  AndrewCvz, 3, 1, 2, no
456356985,  agglebarnes, 1, 1, 0, yes
1705500134,  CottoAlessandro, 2, 2, 0, yes
902140578,  VicinanzaG, 1, 1, 0, yes
372178559,  ScriviStella, 4, 2, 2, neutral
729079437875150849,  Diretta24, 5, 5, 0, yes
3339842842,  silviaferrari88, 1, 1, 0, yes
1954625887,  sszappo, 1, 1, 0, yes
458433890,  RosapiaFarese, 1, 1, 0, yes
448933522,  VicinanzaL, 1, 1, 0, yes
793534426990911488,  Clearabafenice, 1, 1, 0, yes
596778943,  emilfav, 1, 1, 0, yes
975831408,  BandieraMary, 1, 1, 0, yes
2836485897,  ajifparis1, 1, 1, 0, yes
339218501,  PF1970, 11, 10, 1, yes
57444664,  Brunoverlezza, 3, 2, 1, yes
4883535952,  Stefaniax98, 2, 2, 0, yes
1067933125,  BoeroTerlizzi, 1, 1, 0, yes
976742690,  Fuochidipaglia, 2, 2, 0, yes
89271619,  adrianoschi, 14, 2, 12, no
292924733,  GiacomoGiura, 4, 1, 3, no
296212723,  MichelaMarzi, 1, 1, 0, yes
789178339,  anahitaraissy, 2, 2, 0, yes
199665750,  Nuntio, 3, 2, 1, yes
1474686408,  Sfogliaspuria, 1, 1, 0, yes
116823216,  Roulandus, 1, 1, 0, yes
175480581,  hermesmitter, 1, 1, 0, yes
2325391093,  maria19561, 1, 1, 0, yes
1090368349,  g_colantuono, 1, 1, 0, yes
38830450,  Crisi_Finanza, 7, 6, 1, yes
1372078580,  lastolfino, 6, 2, 4, no
2333674306,  elenamarra18, 1, 1, 0, yes
1007059536,  Barbarella2323, 1, 1, 0, yes
3053074869,  paolocoppo1949, 1, 1, 0, yes
781578050865627137,  Joseph_Karplus, 7, 1, 6, no
36152010,  valerjo79, 2, 2, 0, yes
377318801,  st_2351, 9, 2, 7, no
471937914,  pupoghinazzi, 1, 1, 0, yes
1130955072,  baroninitti, 1, 1, 0, yes
402054071,  AlmaGrandin, 1, 1, 0, yes
474235269,  and_montesano, 2, 2, 0, yes
1039034725,  AndreaAstrolog, 2, 1, 1, neutral
369786674,  PanaroFrancesco, 1, 1, 0, yes
349746542,  MassimoCassano, 1, 1, 0, yes
2850607960,  Naemati, 3, 3, 0, yes
410828204,  VikyBorgomeo, 1, 1, 0, yes
1588323260,  isiberiani, 59, 1, 58, no
964338524,  CosimoDf, 2, 2, 0, yes
802862781250867200,  yanana_az, 1, 1, 0, yes
2272909142,  salesociale, 1, 1, 0, yes
368441096,  rosannaTK5SOSJB, 2, 2, 0, yes
845920736,  Polvere78, 2, 1, 1, neutral
303636190,  cigarafterten, 3, 3, 0, yes
215952329,  CMLocatelli, 1, 1, 0, yes
224589369,  MaCMakeaChange, 1, 1, 0, yes
379852143,  GaretJax81, 1, 1, 0, yes
2978585015,  CarmeloGarofalo, 1, 1, 0, yes
1264550808,  ComuneRandazzo, 1, 1, 0, yes
2989522569,  SaraPauk, 1, 1, 0, yes
1094947446,  SandyBubbola, 2, 1, 1, neutral
2646449907,  marykarrots, 1, 1, 0, yes
2458549645,  redellerose, 2, 1, 1, neutral
50987647,  AlePasso, 1, 1, 0, yes
631133874,  wpkofficial, 1, 1, 0, yes
725202692835041280,  lucagizza, 1, 1, 0, yes
337054637,  PedemonteMikela, 1, 1, 0, yes
2227296243,  dciozzani, 1, 1, 0, yes
379684020,  GianlucaCantoni, 1, 1, 0, yes
396956382,  RedRonnie, 3, 3, 0, yes
350791815,  IvanoPaterno, 12, 12, 0, yes
603585557,  centomaria, 1, 1, 0, yes
1854806077,  JaroslavHasek56, 1, 1, 0, yes
2857112236,  cristianvaldo1, 1, 1, 0, yes
190896259,  Mirkoballarini, 1, 1, 0, yes
325588415,  RobertaZarcone, 2, 2, 0, yes
188041743,  Fntwitt, 2, 1, 1, neutral
2870725799,  CostanzaStanchi, 1, 1, 0, yes
402676744,  Anto8919, 3, 2, 1, yes
2786634666,  psegni54, 1, 1, 0, yes
559358452,  Spalmer1961, 3, 3, 0, yes
703329959276892161,  gieffeco, 1, 1, 0, yes
130619137,  Tomcross68, 1, 1, 0, yes
2803754132,  CarloMelato, 2, 2, 0, yes
103361315,  cuoreazzurrona, 1, 1, 0, yes
393307261,  gianlucac1, 2, 2, 0, yes
4396246217,  monica_torriani, 1, 1, 0, yes
873667866,  pieromaini, 1, 1, 0, yes
712603584215576576,  luigi_fantasia, 8, 8, 0, yes
792144781,  freddi_goffredo, 1, 1, 0, yes
3311667347,  venetic_graboid, 1, 1, 0, yes
1244376643,  RenatoSchifani, 2, 2, 0, yes
636747278,  FM_Roma, 1, 1, 0, yes
949414074,  alessio_papi, 1, 1, 0, yes
1455387631,  VWulture, 1, 1, 0, yes
120412446,  continenteblu, 4, 4, 0, yes
551650362,  raptusmo, 1, 1, 0, yes
1056404035,  Annamaria2058, 3, 1, 2, no
1084072584,  angelahallerbac, 1, 1, 0, yes
318414872,  ErmannaSarullo, 12, 7, 5, yes
2172152693,  VMarinari, 2, 2, 0, yes
2754177590,  lucianoraffael3, 1, 1, 0, yes
2339402154,  Claudio_Romano_, 8, 1, 7, no
3195775203,  Federlavoro, 1, 1, 0, yes
437497406,  Adriano161093, 1, 1, 0, yes
716010070455238657,  LuigiCorra81, 1, 1, 0, yes
2161009932,  almaxhaxho, 1, 1, 0, yes
425320444,  Pomar1952, 1, 1, 0, yes
4218875813,  EccoLaDani, 1, 1, 0, yes
450022951,  31febbraio, 1, 1, 0, yes
787276284246290432,  asso3c, 1, 1, 0, yes
790878167783370752,  piuRicerca, 3, 3, 0, yes
1176661957,  akillejr, 3, 2, 1, yes
1715740765,  StefySS9, 1, 1, 0, yes
980194902,  spaziohub, 1, 1, 0, yes
479029869,  Nede46, 3, 1, 2, no
2728423823,  BoniPedini, 1, 1, 0, yes
885406213,  CartolanoSara, 4, 4, 0, yes
448120331,  AlessandraR72, 4, 4, 0, yes
2698941508,  ArmandoBeatrice, 3, 2, 1, yes
768019641558073344,  MBernetti66, 1, 1, 0, yes
296215921,  Ivan_Pigino, 4, 1, 3, no
105904218,  aviola59, 2, 2, 0, yes
144293212,  pablitopla, 1, 1, 0, yes
426573258,  RadioABCMundial, 1, 1, 0, yes
801786034728079360,  VeronikaEnkova7, 1, 1, 0, yes
2993675883,  RostellatoPh, 1, 1, 0, yes
4184588655,  sisterpolla, 2, 2, 0, yes
2894832211,  christianbian18, 1, 1, 0, yes
796668992651935744,  ammazzasocere, 2, 2, 0, yes
2375532170,  Atticus92420606, 1, 1, 0, yes
453929176,  supergallaccio, 3, 2, 1, yes
486541388,  angelapedrola, 1, 1, 0, yes
2878338268,  FabioGaglia, 1, 1, 0, yes
29543719,  RParisella, 2, 2, 0, yes
788483606708678656,  rosaconti5, 4, 4, 0, yes
331684462,  gilmox0512, 3, 1, 2, no
780796439353962496,  trentinietrento, 1, 1, 0, yes
1094933798,  stralisi, 1, 1, 0, yes
463748796,  Marco_Ventu, 1, 1, 0, yes
365462238,  eziomauro, 3, 2, 1, yes
2423821445,  lindonb5, 1, 1, 0, yes
433604815,  RPegna, 2, 1, 1, neutral
774267120268050432,  scoRAGGIati1, 20, 1, 19, no
221490175,  zio_davide, 2, 1, 1, neutral
366221457,  carmineg1989, 1, 1, 0, yes
2417673871,  robertoadone, 21, 21, 0, yes
132303430,  robertobernabo, 1, 1, 0, yes
728594389824622593,  latoscanadicesi, 1, 1, 0, yes
96143583,  espomas, 1, 1, 0, yes
176760567,  panzer61, 1, 1, 0, yes
2308599589,  zeta_d1, 1, 1, 0, yes
403299956,  smignanego, 1, 1, 0, yes
4032167968,  NobildonnaMon13, 1, 1, 0, yes
2237723124,  annagianduia, 1, 1, 0, yes
3364379494,  septaria00, 1, 1, 0, yes
3127914066,  BaroneGabrieles, 2, 1, 1, neutral
2379119342,  sminacciolo, 2, 2, 0, yes
2881464153,  moscatelli69, 5, 2, 3, no
270501780,  zuma2007, 1, 1, 0, yes
519360327,  FedSolidarieta, 1, 1, 0, yes
792738572302479360,  marcobagnariol, 1, 1, 0, yes
262057267,  barcellamattia, 1, 1, 0, yes
421891170,  Ynes_dg_, 1, 1, 0, yes
2824900016,  GiovaTheQueen, 1, 1, 0, yes
1222929786,  angiefioravante, 1, 1, 0, yes
1088665963,  alessandrotimpa, 1, 1, 0, yes
3631212201,  alecroci11, 1, 1, 0, yes
1006493750,  NewsLele, 2, 2, 0, yes
433409100,  lumorisi, 1, 1, 0, yes
3289061985,  flamynonce, 1, 1, 0, yes
731813529670410240,  RI_Novara, 1, 1, 0, yes
796410172646232069,  Brugiuss, 2, 1, 1, neutral
485672360,  DarioGarrapa, 1, 1, 0, yes
593635807,  FrancescoSalv18, 1, 1, 0, yes
2246289873,  Massimi92696377, 1, 1, 0, yes
252566192,  baldinich, 1, 1, 0, yes
772204111,  giocardaterzino, 1, 1, 0, yes
149519170,  angelozanzotter, 5, 2, 3, no
806140925856665600,  popolanosc, 1, 1, 0, yes
4797671500,  LoredanaGallo70, 1, 1, 0, yes
789916703815823360,  piumoncino, 5, 1, 4, no
27624235,  duppli, 5, 4, 1, yes
3133181793,  MartaAbbiati, 3, 2, 1, yes
2285227968,  LadyChioma, 1, 1, 0, yes
705462955626930176,  mattiaghion, 1, 1, 0, yes
71366031,  evodelio, 1, 1, 0, yes
1295386164,  Karinolino, 4, 4, 0, yes
3123514041,  Tittawa, 1, 1, 0, yes
396860362,  Maxybar, 1, 1, 0, yes
442818314,  andreacauti, 1, 1, 0, yes
3030847123,  roslonghitano, 2, 2, 0, yes
4927335563,  renatocesare51, 6, 2, 4, no
2320036413,  marzocchi_fabio, 2, 2, 0, yes
2288254558,  pastaiofranco, 3, 2, 1, yes
790879265831153669,  alexbardi75, 2, 1, 1, neutral
1029182665,  PasqPugliese, 1, 1, 0, yes
226641470,  alinidax, 3, 1, 2, no
3302489337,  FlixBus_IT, 1, 1, 0, yes
801068866822664192,  Tg1RAI, 2, 2, 0, yes
1802661806,  RosaClarice80, 16, 15, 1, yes
315393815,  Maury1958, 1, 1, 0, yes
596955861,  gm_1982, 1, 1, 0, yes
1710149400,  tittitacc, 1, 1, 0, yes
1050593575,  VittorioEboli, 1, 1, 0, yes
2535188654,  NicolaNik4, 9, 9, 0, yes
607985679,  nico_lai93, 2, 2, 0, yes
4451197595,  noigepincontact, 6, 6, 0, yes
2367055346,  giancofalchi, 1, 1, 0, yes
1568556576,  gene_bb, 1, 1, 0, yes
999283472,  ninoaltomonte, 6, 4, 2, yes
543874665,  TheTheDoctorWho, 2, 2, 0, yes
3186836867,  __Fidelio, 2, 2, 0, yes
3188341251,  __Florestan, 2, 2, 0, yes
3187534642,  __Leonore, 2, 2, 0, yes
3199087762,  __Pizzarro, 2, 2, 0, yes
281778116,  sognichianti, 2, 2, 0, yes
550643804,  johnnystockx, 2, 2, 0, yes
3131204511,  _AlfredoGermont, 2, 2, 0, yes
3131275618,  VioletteValery, 2, 2, 0, yes
2787878054,  claudrinald, 1, 1, 0, yes
570873859,  fusaro2007, 2, 1, 1, neutral
1073912359,  hotmail_pani, 1, 1, 0, yes
420430028,  BertoliniSer, 1, 1, 0, yes
243703728,  chiarelettere, 1, 1, 0, yes
760842477607776256,  JersyyhhCOD, 1, 1, 0, yes
717760787075440641,  miryvincy, 3, 3, 0, yes
476661302,  paola_saluzzi, 1, 1, 0, yes
800007711584874496,  ivshav1, 2, 2, 0, yes
792338652600864768,  Antonel0508, 4, 4, 0, yes
51039698,  filleacgil, 1, 1, 0, yes
185428829,  uaversano, 1, 1, 0, yes
582124699,  ManuelBoiardi, 1, 1, 0, yes
712312811305758720,  mmarinasan, 4, 2, 2, neutral
2902073457,  juvelele19611, 1, 1, 0, yes
488765188,  fabiomarante, 1, 1, 0, yes
953556182,  Bremawood, 1, 1, 0, yes
205305015,  assaglietta, 1, 1, 0, yes
300386004,  massimosilv, 2, 1, 1, neutral
1040719004,  annargrivelli, 2, 2, 0, yes
601876444,  NdecarloDe, 2, 1, 1, neutral
253018145,  Spadina84, 1, 1, 0, yes
571894424,  Robin_Gentile, 1, 1, 0, yes
238957255,  sprawlit, 1, 1, 0, yes
79804562,  ebonfo, 1, 1, 0, yes
750983524438736896,  luisa0203i, 3, 3, 0, yes
18768671,  iboitwit, 1, 1, 0, yes
55275273,  lupusetagnus, 1, 1, 0, yes
452275725,  simonecapozzoli, 1, 1, 0, yes
766894742265294848,  born_biafra, 2, 2, 0, yes
1338967328,  Telosaes, 2, 1, 1, neutral
61188276,  Er_Conte, 1, 1, 0, yes
516320049,  club_dante, 1, 1, 0, yes
755306573967331329,  GBtwit8, 2, 1, 1, neutral
250554232,  alexrodani, 1, 1, 0, yes
388150035,  Lucoprofene, 1, 1, 0, yes
4125338663,  marc0__b, 1, 1, 0, yes
525905151,  caro_natoli, 1, 1, 0, yes
4008640756,  ArtinoClaudio, 1, 1, 0, yes
1651383518,  CeSantoro, 8, 2, 6, no
4794943352,  antolapeste, 5, 3, 2, yes
2571700242,  MatteBale, 1, 1, 0, yes
53111341,  Fangareggi, 1, 1, 0, yes
357147757,  chetimette, 1, 1, 0, yes
2528983773,  prelazione1, 1, 1, 0, yes
18249798,  SheridanBird, 1, 1, 0, yes
554265521,  claudiomullaliu, 1, 1, 0, yes
420122609,  PaoloZatta2, 1, 1, 0, yes
2306559009,  stefaniamassim2, 1, 1, 0, yes
189643689,  luisabetti, 1, 1, 0, yes
696738123838070784,  S_H_U_R_E_N, 3, 1, 2, no
481910310,  FredChecchinato, 1, 1, 0, yes
209223666,  Ciccio_Brigati, 1, 1, 0, yes
2513804886,  renata32053570, 2, 2, 0, yes
99671046,  renaxcek, 3, 3, 0, yes
788488943536902147,  MelissaLaBroca3, 2, 2, 0, yes
1667805188,  Lanadiluna, 3, 1, 2, no
222460953,  angelo_menel, 5, 2, 3, no
716634695602143232,  nwabiafran, 2, 2, 0, yes
791530631415070720,  NadirOttobre, 2, 2, 0, yes
3428885193,  monzani_alvaro, 1, 1, 0, yes
3004158627,  LucaAlfio91, 1, 1, 0, yes
855455059,  speeeezzzz, 1, 1, 0, yes
888283579,  gheroriver, 1, 1, 0, yes
243276176,  Water_On_Mars_, 2, 2, 0, yes
34718178,  beltrandelrio, 1, 1, 0, yes
324393778,  roberto_truzzi, 2, 2, 0, yes
1066130568,  emma_dami, 1, 1, 0, yes
3402915261,  JennyCrisostomi, 2, 2, 0, yes
1127815087,  MassimoG5, 5, 5, 0, yes
2221643012,  annamariaandalo, 9, 2, 7, no
415563447,  yorghenxp, 2, 2, 0, yes
720538154495844355,  up_ban, 1, 1, 0, yes
2383824626,  AntBocar, 1, 1, 0, yes
805103089233645568,  ioemozart, 1, 1, 0, yes
777554065861607425,  lagori3, 1, 1, 0, yes
1121493445,  MerryMust, 1, 1, 0, yes
3678039617,  Abenedetto82, 1, 1, 0, yes
167338429,  classe_tumblr, 1, 1, 0, yes
377343553,  SteFiore9, 1, 1, 0, yes
2509421380,  rikylek, 1, 1, 0, yes
702539275397632000,  Stefaniataby, 3, 3, 0, yes
2423438713,  SilviaScurati, 1, 1, 0, yes
1114933524,  IngCarli, 2, 2, 0, yes
257390333,  Garra25, 2, 2, 0, yes
216361529,  symdona, 2, 1, 1, neutral
2231585551,  HausderWunder, 5, 1, 4, no
79397446,  antobbo, 1, 1, 0, yes
139192625,  queengoldch4ins, 1, 1, 0, yes
1240806810,  saviane2, 1, 1, 0, yes
711616051587510272,  MariaPaolaL72, 18, 18, 0, yes
399003300,  darge65, 1, 1, 0, yes
142630470,  costia31, 1, 1, 0, yes
1377735108,  lazzagiampi, 2, 1, 1, neutral
773032049276022784,  MatteoNormann, 1, 1, 0, yes
627367368,  RiminiFuturo, 2, 1, 1, neutral
414880861,  and_bassi, 1, 1, 0, yes
2335579765,  turied99, 1, 1, 0, yes
462736672,  StellaAndri, 2, 2, 0, yes
16370155,  seba22758, 1, 1, 0, yes
1446490651,  alemelchioni, 1, 1, 0, yes
374120442,  dianelebeguec, 1, 1, 0, yes
2201016872,  frastebe, 1, 1, 0, yes
36039763,  Brigante_Paolo, 1, 1, 0, yes
2396252383,  lightmoon972, 1, 1, 0, yes
2986114714,  Antonio14143579, 1, 1, 0, yes
3309776511,  ismfup, 1, 1, 0, yes
208464545,  CleliaDC, 3, 3, 0, yes
395179767,  PenelopeVr46, 1, 1, 0, yes
95953821,  robyv73, 2, 2, 0, yes
2521854263,  FPlatania58, 1, 1, 0, yes
734684918932996096,  KovacksLazlo, 1, 1, 0, yes
533112380,  gpf70sax, 2, 2, 0, yes
2867657152,  MarrelliHosp, 1, 1, 0, yes
713665005128966144,  udojude1, 2, 2, 0, yes
47308221,  msg_emanuele, 1, 1, 0, yes
830762161,  a_publica, 1, 1, 0, yes
2377155925,  PCPadoan, 2, 2, 0, yes
1316602933,  AurelioCampore, 2, 1, 1, neutral
728255224729743360,  AlexOkeke14, 2, 2, 0, yes
455983932,  borrellimassimo, 3, 2, 1, yes
783869562852868096,  dicksonudensi1, 2, 2, 0, yes
1013749958,  ProgettoJobClub, 2, 2, 0, yes
258269178,  ricmaggiolo, 1, 1, 0, yes
781711046960709632,  SylvesterOhobu, 2, 2, 0, yes
737320028270415872,  SinIta_ER, 2, 2, 0, yes
516547916,  LuanaAngelone, 1, 1, 0, yes
2181791921,  CorradoRen, 2, 2, 0, yes
782957256434409472,  Johniky5, 2, 2, 0, yes
56153676,  andreapacella, 4, 3, 1, yes
827315960,  EMarsella, 1, 1, 0, yes
360528197,  barbaracannelli, 1, 1, 0, yes
297487584,  gaeden62, 1, 1, 0, yes
552596257,  SergbatSergio, 1, 1, 0, yes
3139667865,  mimmogammella2, 12, 3, 9, no
328635035,  sarahvaretto, 1, 1, 0, yes
51590611,  francescoarcuri, 1, 1, 0, yes
312666587,  IsmbOnweb, 1, 1, 0, yes
1057808264,  DanielePezza, 1, 1, 0, yes
801592304725266433,  brakenotvi1976, 1, 1, 0, yes
729900338975739904,  Auroravittorin1, 1, 1, 0, yes
146506001,  Mannippo, 3, 3, 0, yes
2998176689,  FrancaBordi, 2, 2, 0, yes
3050450017,  MOLON_LABE84, 1, 1, 0, yes
798087152806543362,  marcobank_sy, 4, 1, 3, no
2594893740,  LucBecc, 4, 4, 0, yes
390236218,  cirimba, 1, 1, 0, yes
96874558,  paolantonio87, 1, 1, 0, yes
124178555,  CorriereAlpi, 1, 1, 0, yes
97193301,  tribuna_treviso, 1, 1, 0, yes
724068270,  fisioteo, 9, 1, 8, no
3337636385,  mariagualea, 2, 1, 1, neutral
1435828483,  stemot, 1, 1, 0, yes
2213170646,  ReteDisarmo, 2, 1, 1, neutral
2925363454,  filleasp, 1, 1, 0, yes
354397758,  giuseppe_ivo, 1, 1, 0, yes
2856871329,  maurizio_staff, 2, 2, 0, yes
1390584163,  76_francesca, 1, 1, 0, yes
1330050397,  GaeMancini, 1, 1, 0, yes
3308027920,  musicatempo, 1, 1, 0, yes
2753756865,  ilu_iciao, 1, 1, 0, yes
1964575616,  RosanticaP2, 2, 2, 0, yes
518644534,  FILLEA_BERGAMO, 1, 1, 0, yes
34916967,  francescoguerra, 1, 1, 0, yes
3346000648,  OnyiiProbity, 2, 2, 0, yes
12204732,  brunopompa, 1, 1, 0, yes
802106836392480768,  massi833, 2, 2, 0, yes
542064372,  ToreDeriu, 1, 1, 0, yes
1134541987,  WalterPaoletti, 1, 1, 0, yes
482480981,  VincenzoMurgolo, 1, 1, 0, yes
399948614,  koba_86, 1, 1, 0, yes
47683227,  Salva_tore, 1, 1, 0, yes
521072521,  FrancescaMezzio, 1, 1, 0, yes
17028890,  Phastidio, 1, 1, 0, yes
789750300,  CpnMro, 1, 1, 0, yes
4196398887,  _giannic, 1, 1, 0, yes
2467306834,  and_garavello, 2, 2, 0, yes
795765112917413888,  Lucentezzas, 1, 1, 0, yes
724322930,  _dolcino_, 2, 1, 1, neutral
1906193504,  bob_vox, 1, 1, 0, yes
4017914423,  FondCarispezia, 1, 1, 0, yes
976600392,  HeadlineGiornal, 1, 1, 0, yes
1882751365,  gabriele_sardu, 1, 1, 0, yes
134060232,  Fabry27, 1, 1, 0, yes
3080933840,  fabiothriller, 2, 2, 0, yes
632063651,  NOUANAD, 2, 2, 0, yes
223645273,  alechelo, 1, 1, 0, yes
3180451295,  angelique2111, 1, 1, 0, yes
507087283,  Barbarafanpage, 1, 1, 0, yes
328671064,  EleonoraBechis, 1, 1, 0, yes
1317015313,  tancrediturco, 1, 1, 0, yes
574609969,  MassimoArtini, 1, 1, 0, yes
768727362397675520,  uchennaomulu1, 2, 2, 0, yes
337109689,  GiorgiaRossi3, 1, 1, 0, yes
424899445,  Vin_Pampalone, 7, 7, 0, yes
3955038435,  SamuelNnaji9, 2, 2, 0, yes
4910251161,  Luga77964764, 2, 2, 0, yes
603170028,  Manuel19961996, 3, 1, 2, no
779853415,  _JSLP, 1, 1, 0, yes
384715317,  SaraMeini, 1, 1, 0, yes
477301363,  FBorgh72, 1, 1, 0, yes
707695073727803392,  Sup_Poste_Ita, 4, 4, 0, yes
1035880080,  dancaloi, 1, 1, 0, yes
2404831176,  Vivoverde3, 2, 1, 1, neutral
499758540,  niagara_xgames, 1, 1, 0, yes
1683547854,  valedimola, 1, 1, 0, yes
783008521768108032,  JachettiIvana, 1, 1, 0, yes
5378612,  Fabopolis, 1, 1, 0, yes
377465277,  mirkoceccato, 2, 1, 1, neutral
399971842,  JorgeGarofalo19, 3, 2, 1, yes
758419807834411008,  Tiziana6611, 2, 2, 0, yes
896746550,  toskolina, 1, 1, 0, yes
3154086009,  AndRomano64, 1, 1, 0, yes
458700330,  CosimoAngelini, 1, 1, 0, yes
431822373,  tommasochambry, 2, 2, 0, yes
724175341942648832,  27jakovlev, 1, 1, 0, yes
4540086256,  Graziel11014735, 1, 1, 0, yes
43746760,  giularo, 1, 1, 0, yes
2784533667,  russianpriroda, 1, 1, 0, yes
2336376229,  UMontevecchi, 3, 2, 1, yes
407364835,  coluidiconga, 2, 1, 1, neutral
7695932,  ludik, 1, 1, 0, yes
3054088155,  pistisluigi, 3, 2, 1, yes
190624049,  ItaloRulli, 1, 1, 0, yes
162654200,  adelemecca, 1, 1, 0, yes
2330564455,  Durduzzi, 2, 2, 0, yes
904244798,  Confcooperativ1, 1, 1, 0, yes
2190019526,  ItaCooperativa, 1, 1, 0, yes
2386234197,  sole_francesco, 1, 1, 0, yes
2931690377,  di_gelsomina, 3, 3, 0, yes
101327082,  angelbene, 1, 1, 0, yes
424936746,  filoXXL, 5, 2, 3, no
2527625792,  PepSbarra, 1, 1, 0, yes
346897429,  Minenti_design, 1, 1, 0, yes
454240864,  AndreaBononi, 1, 1, 0, yes
54229408,  robymaior, 2, 2, 0, yes
3039679821,  masciameleo, 27, 27, 0, yes
123195225,  MASCHERATRISTE, 1, 1, 0, yes
2831447465,  CavalliniManola, 2, 2, 0, yes
2524478908,  eddiholly1, 1, 1, 0, yes
50369920,  cateronchieri, 1, 1, 0, yes
730320256229638145,  mandis_stylist, 2, 2, 0, yes
452172065,  il_Case, 1, 1, 0, yes
910726700,  loudlike_lies, 1, 1, 0, yes
916732627,  fra_jaya, 1, 1, 0, yes
404270503,  Kylemariani44, 1, 1, 0, yes
500689494,  an_merlin, 1, 1, 0, yes
821112817,  annaidramante, 1, 1, 0, yes
2610108451,  Enzo_Iacovino, 1, 1, 0, yes
36051983,  maurosereni, 1, 1, 0, yes
1489362702,  FrancescoPecco1, 1, 1, 0, yes
342550868,  FraBenvenuto, 1, 1, 0, yes
772516683693101058,  MudiMido, 1, 1, 0, yes
386684448,  cirrid, 3, 1, 2, no
777103966668718081,  okikeamaka1, 2, 2, 0, yes
385875369,  ricuccid, 2, 2, 0, yes
3013366229,  DrAleFaggiano, 1, 1, 0, yes
4836690834,  obi_marvelous, 2, 2, 0, yes
18358916,  simmyu, 2, 2, 0, yes
3182090610,  chinenyemaryan9, 2, 2, 0, yes
760956170702028804,  Thah_wizard, 2, 2, 0, yes
1721349372,  travelingdario, 1, 1, 0, yes
3588986417,  NkemdiMary, 2, 2, 0, yes
4059049942,  IVekkio, 2, 2, 0, yes
476917655,  ViscontiRari86, 3, 3, 0, yes
3239066199,  B_Muscatello, 2, 1, 1, neutral
364906833,  DeliaZuccaro, 2, 2, 0, yes
529645960,  reallylaugh, 2, 2, 0, yes
1688268902,  footballdata_fi, 1, 1, 0, yes
171844789,  24emilia, 7, 7, 0, yes
738415085194989569,  france_lollo, 2, 2, 0, yes
2194037379,  LuisaRagni, 2, 2, 0, yes
2774933159,  CupparoMary, 1, 1, 0, yes
4746168976,  giafre77, 4, 3, 1, yes
502057361,  gerardo60996690, 1, 1, 0, yes
436172981,  giampaolob55, 1, 1, 0, yes
1239689270,  kim_capo, 5, 1, 4, no
782496009708507136,  LuCiaIom, 6, 6, 0, yes
568224676,  patriziasalvat5, 1, 1, 0, yes
426106156,  mircocattai, 1, 1, 0, yes
804325213206958080,  fereskn4, 2, 2, 0, yes
1243558052,  Massimi01883716, 1, 1, 0, yes
730132598765330432,  Lorenzo33408405, 1, 1, 0, yes
522328047,  pietrosbardella, 1, 1, 0, yes
3619110377,  angelsorrenti91, 2, 2, 0, yes
429039024,  ChiaraDAndrea1, 1, 1, 0, yes
3209081,  paolo_barberis, 1, 1, 0, yes
287586387,  anacasalayuso, 1, 1, 0, yes
706212090701340672,  Angelom02137599, 1, 1, 0, yes
1234875217,  armidmar, 2, 1, 1, neutral
2780243882,  NapoliOutsider, 1, 1, 0, yes
497949112,  MarcoBottichio, 4, 4, 0, yes
1632836317,  DeDng, 1, 1, 0, yes
2189370886,  natalidElia1, 1, 1, 0, yes
421313460,  lucadabbicco, 1, 1, 0, yes
448976959,  OroLezzi, 1, 1, 0, yes
770278759148773376,  ImpactZoneITA, 1, 1, 0, yes
3856669288,  ArwenBarbara, 1, 1, 0, yes
1201200074,  Ignazio_Brusca, 3, 3, 0, yes
141326259,  ValeDik4, 2, 2, 0, yes
51694183,  Ricky_LA, 1, 1, 0, yes
3939301649,  Ginko_21, 4, 1, 3, no
471017358,  Ste_Feboli, 1, 1, 0, yes
929744809,  michelebabuder, 2, 2, 0, yes
2181823281,  barbara_zampini, 1, 1, 0, yes
154492035,  GoodLifeSSL, 1, 1, 0, yes
519706356,  _Carolina1604, 1, 1, 0, yes
2891847855,  SbBolognese, 1, 1, 0, yes
732562726837473280,  IL_mattei, 1, 1, 0, yes
320447394,  leopontalti, 1, 1, 0, yes
706194032930758657,  cesare1202, 3, 3, 0, yes
74090914,  emmanuelap, 1, 1, 0, yes
423357382,  AndyMaFiniscila, 1, 1, 0, yes
1050019945,  mariovattani, 1, 1, 0, yes
231198437,  sadefenza, 5, 2, 3, no
2909385365,  Massgamba, 1, 1, 0, yes
789514081107447808,  piero_dincecco, 1, 1, 0, yes
2939393062,  MissFrost76, 2, 2, 0, yes
380506029,  Bovacr, 1, 1, 0, yes
1709629910,  dajekevin, 2, 1, 1, neutral
406609546,  PrestintB, 1, 1, 0, yes
1358880168,  tgrvda, 1, 1, 0, yes
119828611,  serbelloniserbe, 1, 1, 0, yes
824046336,  busirao, 1, 1, 0, yes
3064826483,  AndriGuidotti, 1, 1, 0, yes
783219154660851712,  lutheperry, 1, 1, 0, yes
701296182,  isabelcasale, 2, 1, 1, neutral
458216932,  danielcame, 1, 1, 0, yes
2192860138,  M_Lilla88, 1, 1, 0, yes
1428230713,  Flypaina, 1, 1, 0, yes
1262870395,  LoiotileV, 1, 1, 0, yes
3313156330,  FedeNeroBlu, 1, 1, 0, yes
4832314828,  XeniaBusse, 1, 1, 0, yes
484832519,  FeliciaDeCrist, 1, 1, 0, yes
306107346,  CollavoAC, 1, 1, 0, yes
352496553,  diludovico, 1, 1, 0, yes
300397741,  Gata2310, 2, 2, 0, yes
741652933,  MnlFranci, 1, 1, 0, yes
72271885,  simoneranoc, 1, 1, 0, yes
34277656,  annaliavenezia, 3, 3, 0, yes
1295641470,  MarsiliCristian, 2, 2, 0, yes
587606091,  BrunoVeniero, 1, 1, 0, yes
2850437163,  Ioda911, 1, 1, 0, yes
498136058,  MalatadelDoCtor, 1, 1, 0, yes
352329985,  Lojero_Mattia, 2, 1, 1, neutral
53204665,  CarolinaCleto, 1, 1, 0, yes
122354210,  paolomelis42, 1, 1, 0, yes
267875450,  Matteo_Poli, 2, 1, 1, neutral
1193388126,  TgrRaiLazio, 1, 1, 0, yes
65396178,  sierraf31, 2, 1, 1, neutral
3060241467,  francestyle77, 1, 1, 0, yes
146448681,  valigiablu, 1, 1, 0, yes
28128812,  _Chiara_, 2, 2, 0, yes
1876958665,  AlbanCordier, 3, 3, 0, yes
189410830,  Leleprox, 2, 2, 0, yes
2488269433,  096955, 2, 2, 0, yes
29017626,  ladydoo82, 1, 1, 0, yes
440367693,  ArtanDuraku, 2, 2, 0, yes
3736183456,  KatiaTrudinia, 2, 2, 0, yes
768749141841281024,  EU_VitoMaltese, 1, 1, 0, yes
297128407,  NeroazzurroOne, 2, 2, 0, yes
1367865254,  cosimomang, 1, 1, 0, yes
3334897025,  SimoMjInter16, 1, 1, 0, yes
522372103,  chiaraluaar, 1, 1, 0, yes
905979727,  a_galea, 1, 1, 0, yes
876489133,  dicamolla, 1, 1, 0, yes
1479214932,  lelegery, 1, 1, 0, yes
2727002045,  IleniaMancin, 1, 1, 0, yes
2365638917,  cribazz, 1, 1, 0, yes
286045303,  alex_bomber94, 1, 1, 0, yes
2701208107,  Grulloni, 1, 1, 0, yes
2200431036,  TuEsBigott, 1, 1, 0, yes
2279396928,  PatriziaCarere, 25, 25, 0, yes
854372184,  LucariniCl, 1, 1, 0, yes
1361042348,  tripolino2, 1, 1, 0, yes
763748776351850496,  renatocerioli, 1, 1, 0, yes
2186653264,  BotteGiuseppe, 1, 1, 0, yes
520484458,  MarcoDErrico2, 1, 1, 0, yes
523549201,  Deepskyline, 2, 1, 1, neutral
3534080537,  RASTELLIFRomana, 1, 1, 0, yes
776146146771304451,  Umberto31990186, 20, 20, 0, yes
1257010327,  itinera51, 2, 2, 0, yes
783393755617456128,  IvanoBla, 4, 4, 0, yes
3408525531,  Vendrick7, 5, 1, 4, no
2656833795,  ma_lio, 1, 1, 0, yes
446112021,  G_Mulazzani, 1, 1, 0, yes
4885203837,  salvato03428194, 1, 1, 0, yes
804179086708969472,  moh451212, 1, 1, 0, yes
141745277,  provolina66, 3, 2, 1, yes
786967430191022080,  massimojamann, 2, 1, 1, neutral
583035300,  michelemalfatti, 2, 2, 0, yes
532161446,  AnselmoCimino, 1, 1, 0, yes
248846280,  MarkyRusso, 1, 1, 0, yes
460533065,  pierolacorazza, 6, 1, 5, no
1101021343,  annamariasummon, 7, 1, 6, no
3367479099,  ketty2ts360, 12, 1, 11, no
2846611515,  dubito_, 1, 1, 0, yes
1295567060,  mbecchi1, 3, 1, 2, no
98586308,  Aulereb, 1, 1, 0, yes
4515949217,  cristin33241731, 8, 8, 0, yes
2205245198,  labucarimini, 2, 2, 0, yes
953255348,  GM_Imp, 3, 3, 0, yes
3232623358,  FViolst, 1, 1, 0, yes
415825377,  paola83princess, 1, 1, 0, yes
1042127750,  samuele_nacci, 1, 1, 0, yes
795530342581018624,  AbuchiEzeh1, 2, 2, 0, yes
1586026363,  radicalifoggia, 2, 2, 0, yes
2343518160,  onofrio_lorusso, 2, 1, 1, neutral
424585535,  alessiocrobu, 1, 1, 0, yes
169054597,  AgenziaGiovani, 3, 3, 0, yes
1428112362,  3MunicipioRm, 1, 1, 0, yes
762013690027802624,  yepeto79, 1, 1, 0, yes
485844145,  alinomilan, 1, 1, 0, yes
3975122236,  iamandreaalbano, 6, 1, 5, no
1064271224,  enzolembo, 1, 1, 0, yes
477615019,  demismuffin, 1, 1, 0, yes
61766658,  _MaStiCa_, 1, 1, 0, yes
38844748,  LightmyFire77, 3, 2, 1, yes
3747207076,  piersicil, 3, 1, 2, no
786605753456926723,  sandromrts2, 2, 2, 0, yes
23974882,  Ila_b, 1, 1, 0, yes
430621429,  felixpaino, 1, 1, 0, yes
862981326,  antonellaiacop1, 1, 1, 0, yes
426435191,  sandrobah, 1, 1, 0, yes
550442189,  Nicolet97557325, 1, 1, 0, yes
396637085,  CettinaSortino, 5, 5, 0, yes
51017120,  alex179ohm, 1, 1, 0, yes
2911224066,  AngeloMinicucci, 1, 1, 0, yes
634523644,  Mirko799, 1, 1, 0, yes
2619223101,  sanelycastro7, 1, 1, 0, yes
306980807,  francypotter, 1, 1, 0, yes
3379087654,  mai65plt, 1, 1, 0, yes
794716578789068800,  danyelino_93, 1, 1, 0, yes
507917765,  vitzanfo67, 1, 1, 0, yes
2932523673,  mvnavats, 1, 1, 0, yes
22245415,  nunziospc, 1, 1, 0, yes
331645415,  GPFilidoro, 2, 2, 0, yes
701786362773639168,  gaiamarss, 1, 1, 0, yes
468615064,  psycoimmune, 1, 1, 0, yes
2456614380,  gianlumercio, 1, 1, 0, yes
372357124,  gilunax, 1, 1, 0, yes
463175854,  ECapilli, 1, 1, 0, yes
110401565,  Maverick53ms, 1, 1, 0, yes
3808357942,  semidellaparola, 1, 1, 0, yes
1607652990,  Atti_1974, 1, 1, 0, yes
395911036,  AmbraBisoni, 1, 1, 0, yes
587365940,  DeMissWorldwide, 1, 1, 0, yes
2486183150,  Marcodg89, 1, 1, 0, yes
392920903,  epmoretti, 1, 1, 0, yes
58611201,  natsumi95, 1, 1, 0, yes
399564740,  46_NADIA_58, 1, 1, 0, yes
462710873,  CarmineLazzaro, 2, 1, 1, neutral
471481763,  freddieont, 1, 1, 0, yes
2347562993,  fusaro_alex, 2, 1, 1, neutral
4892811688,  spin_anna, 1, 1, 0, yes
437108521,  ItaloStrusi, 1, 1, 0, yes
251062818,  giorgiocars, 1, 1, 0, yes
1264572464,  Gabri0344, 1, 1, 0, yes
198282057,  AndreaFdeCesco, 1, 1, 0, yes
181178915,  GRUPPO_CGM, 1, 1, 0, yes
416709850,  FraFARINA23, 1, 1, 0, yes
785769745538621445,  robertospampi, 1, 1, 0, yes
2341855316,  ABCMundial, 1, 1, 0, yes
2590412644,  bladolcevita, 3, 3, 0, yes
3259170333,  Dispa86, 1, 1, 0, yes
2772829118,  Zhuk_News, 1, 1, 0, yes
3158750214,  fragnolialfons1, 1, 1, 0, yes
1128250579,  Marilena_Vinci, 1, 1, 0, yes
372326171,  pikkiata82, 1, 1, 0, yes
452105508,  ToscanoRino, 2, 1, 1, neutral
955761992,  StefanoGallinar, 1, 1, 0, yes
4263230189,  MakoAlasow, 1, 1, 0, yes
971708142,  GottiTe, 1, 1, 0, yes
177497774,  Diddacus, 1, 1, 0, yes
195676494,  alecavo, 1, 1, 0, yes
462129639,  CarloVerticale, 2, 2, 0, yes
2631793210,  maxmessina82, 1, 1, 0, yes
3383079958,  Adriana_Volzone, 2, 2, 0, yes
887639833,  amedeopesenti, 6, 4, 2, yes
986119338,  V_Or_Treat, 1, 1, 0, yes
1045753357,  FrankyCapri, 1, 1, 0, yes
324885927,  Ste_Celia, 1, 1, 0, yes
369718764,  lostinaglass, 1, 1, 0, yes
23012394,  TizCaia, 1, 1, 0, yes
854622270,  CarloDemurtas, 1, 1, 0, yes
1676773849,  Sara_mertin, 1, 1, 0, yes
3793289243,  marcmar12, 2, 2, 0, yes
769290160035000320,  Rokj44, 1, 1, 0, yes
69238668,  LucaLombroso, 1, 1, 0, yes
1147701895,  MmePlumcake, 1, 1, 0, yes
3317377714,  teoble21, 1, 1, 0, yes
100185915,  Radio3tweet, 1, 1, 0, yes
561310353,  MsgSilvia, 3, 3, 0, yes
94058277,  jslindquist, 1, 1, 0, yes
97281883,  mstadri, 1, 1, 0, yes
2231601391,  BorrasBatalla, 1, 1, 0, yes
703508760807997440,  nicolet67326702, 1, 1, 0, yes
2710138923,  Adriano_Izzo, 1, 1, 0, yes
63705563,  CALentola, 35, 1, 34, no
2561484014,  marinac71, 1, 1, 0, yes
19164478,  rosamdinatale, 1, 1, 0, yes
312846503,  ManzoPower, 3, 1, 2, no
2292038776,  PietroMorelli6, 1, 1, 0, yes
791316572287762456,  tragedyst, 1, 1, 0, yes
2479879152,  JMRubenJM, 1, 1, 0, yes
4092368398,  MagicMik89, 1, 1, 0, yes
187669778,  PaoloLocatelli, 1, 1, 0, yes
36066393,  Nello_Morlotti, 1, 1, 0, yes
413462431,  zizozizo13, 1, 1, 0, yes
1332553795,  ChangaSkywalker, 1, 1, 0, yes
1172639022,  fortimar, 1, 1, 0, yes
424452293,  FDeco1, 1, 1, 0, yes
578977033,  nadiapancetti, 1, 1, 0, yes
1062769387,  luca_palm, 1, 1, 0, yes
260791798,  claud_detommaso, 1, 1, 0, yes
471862492,  MarioRomanus, 1, 1, 0, yes
1645793970,  Ste2900, 2, 1, 1, neutral
900629300,  FrancesESPO, 1, 1, 0, yes
318519850,  ARoldering, 2, 1, 1, neutral
8483062,  bl4ckbird, 1, 1, 0, yes
345954990,  ValeMacherio, 2, 2, 0, yes
702918430966587392,  giovannilatempa, 1, 1, 0, yes
1064054094,  pisano1123, 1, 1, 0, yes
915635018,  realbonash, 1, 1, 0, yes
3119125755,  MPeschetta, 2, 2, 0, yes
512018266,  rebaf136, 1, 1, 0, yes
58033969,  moghi2020, 2, 2, 0, yes
428051810,  Fertoni91, 2, 2, 0, yes
1089229140,  fedemontevecchi, 2, 2, 0, yes
766745652470640640,  aliceturcato97, 1, 1, 0, yes
15007608,  federicovidari, 1, 1, 0, yes
789613120981438464,  avvcristiano, 1, 1, 0, yes
269842154,  rtm78, 2, 1, 1, neutral
617969770,  soulvniall, 1, 1, 0, yes
727520658,  drpinedat, 1, 1, 0, yes
1356835392,  lu_pisa, 1, 1, 0, yes
1217803939,  Grace_Stamper, 1, 1, 0, yes
715198316586336256,  keus_tv, 1, 1, 0, yes
617397262,  wonderpana, 1, 1, 0, yes
3319596183,  vidarte62, 1, 1, 0, yes
23481109,  silvia_quici, 1, 1, 0, yes
289496469,  cdetoro, 1, 1, 0, yes
222247914,  COMOLOVEOYO, 1, 1, 0, yes
329756383,  Bischerella, 1, 1, 0, yes
625759230,  jaimecabreramon, 1, 1, 0, yes
432639718,  stefanorossi29, 1, 1, 0, yes
3545111663,  ScialpiBlasi, 1, 1, 0, yes
444053735,  varano1972, 1, 1, 0, yes
410981874,  MaxGrandi, 1, 1, 0, yes
801482236877012993,  DanielaDany7777, 1, 1, 0, yes
18800996,  Corniciaro, 3, 1, 2, no
3010994267,  brt180480, 1, 1, 0, yes
3080569749,  just_daa, 1, 1, 0, yes
849685388,  AzzilonnaGian, 2, 1, 1, neutral
486658660,  GiorgioCastano, 1, 1, 0, yes
494006958,  RicordiAnna, 1, 1, 0, yes
3093423987,  B2WN2PZIdyCnbfb, 3, 2, 1, yes
276197431,  Brentoncity, 1, 1, 0, yes
103591063,  ___LaJe, 1, 1, 0, yes
955724113,  LRuspio, 1, 1, 0, yes
798238417834377216,  daniberloffa59, 2, 2, 0, yes
343269126,  StefanoDiCicco, 1, 1, 0, yes
219427574,  carlitadecuba, 1, 1, 0, yes
2268050412,  Lunedi74, 1, 1, 0, yes
2967772661,  everywell72pa, 7, 7, 0, yes
561417419,  GianniSozzi, 3, 1, 2, no
4889102937,  F80ulvio, 9, 9, 0, yes
1643119441,  goffredomarcosi, 2, 1, 1, neutral
1079081996,  ugoarrigo, 1, 1, 0, yes
168417198,  romaebraica, 2, 1, 1, neutral
4717111827,  chynellyeze1, 2, 2, 0, yes
1332176233,  PALOMBAGI, 4, 4, 0, yes
2782616380,  francodelmese, 1, 1, 0, yes
478810003,  mercyswan, 1, 1, 0, yes
1111425114,  ValeAratri, 1, 1, 0, yes
1013045366,  MarcoMelgrati, 1, 1, 0, yes
874257408,  MirkoPasca, 1, 1, 0, yes
998056568,  edwin3387, 1, 1, 0, yes
234786856,  Ibraawy, 2, 1, 1, neutral
1125030042,  s_morna, 1, 1, 0, yes
56382553,  cianino, 1, 1, 0, yes
411810147,  massimocarlone, 1, 1, 0, yes
1293072541,  santobias19, 1, 1, 0, yes
4738020981,  BenfenatiM, 1, 1, 0, yes
447496377,  AusiliaRifici, 2, 2, 0, yes
405187355,  ChristianOddono, 2, 2, 0, yes
1648145288,  Mauro_Colombo7, 2, 1, 1, neutral
173102718,  giulianodonati, 1, 1, 0, yes
2465171211,  lidiadec26, 1, 1, 0, yes
132307470,  pical60, 1, 1, 0, yes
36374014,  Pierferdinando, 1, 1, 0, yes
452777469,  boxtrader1, 1, 1, 0, yes
1034268726,  occhimirko, 1, 1, 0, yes
48971201,  marcoregni, 1, 1, 0, yes
2930073010,  deniselivotti, 2, 2, 0, yes
49989292,  klandestinho, 1, 1, 0, yes
713803328,  ciotti_simona, 2, 2, 0, yes
2529236481,  annellapasta, 3, 1, 2, no
382052171,  marburdrava, 3, 1, 2, no
459149667,  ecoazioni, 1, 1, 0, yes
347778847,  cparisi72, 2, 2, 0, yes
146366004,  _intersect, 4, 1, 3, no
2688913330,  SZivillica, 1, 1, 0, yes
2366791501,  GabryManco67, 1, 1, 0, yes
483057175,  AugustoMinzolin, 7, 4, 3, yes
764904998991978496,  pietrosava, 1, 1, 0, yes
826737752,  Lkrg76, 1, 1, 0, yes
275967943,  samadaff, 1, 1, 0, yes
292734405,  MrArmaar, 1, 1, 0, yes
507353180,  Daniele_Cardone, 3, 1, 2, no
189447402,  Faith_46, 1, 1, 0, yes
1037626718,  CinziaTesta19, 1, 1, 0, yes
564480485,  raffaelegi, 3, 3, 0, yes
2256780896,  gebynaccla, 2, 2, 0, yes
4242526769,  rossellafas, 1, 1, 0, yes
703001298,  CarmenVogani, 1, 1, 0, yes
1907844254,  MatildeGreco, 1, 1, 0, yes
50498589,  TheBitcoinGuru, 2, 2, 0, yes
572085741,  albusce, 1, 1, 0, yes
45355226,  Ric_Nes, 1, 1, 0, yes
970393020,  FedeRighettiVR, 1, 1, 0, yes
3326397765,  fedelatina7114, 1, 1, 0, yes
462145063,  angyjage, 1, 1, 0, yes
467841063,  paolouzzi, 1, 1, 0, yes
802991731855781888,  dina_russiello, 1, 1, 0, yes
582035064,  pjtm49, 1, 1, 0, yes
47686952,  MarleyBrandy, 2, 1, 1, neutral
2961715115,  lucaC_99, 1, 1, 0, yes
1170098136,  GhiringhelliL, 1, 1, 0, yes
182789259,  dentrolod, 2, 2, 0, yes
712600078784008192,  Luigio88, 1, 1, 0, yes
39160176,  AleZamps, 1, 1, 0, yes
1462526226,  Giulipuli, 1, 1, 0, yes
472378808,  Alepoke_, 1, 1, 0, yes
217392393,  enricogiurin, 1, 1, 0, yes
197852149,  FpCgilTaranto, 1, 1, 0, yes
45383202,  gerodotnet, 1, 1, 0, yes
885446167,  mariluiorio, 1, 1, 0, yes
397964854,  LorenMinervino, 1, 1, 0, yes
4867419527,  Alessandra_V6, 1, 1, 0, yes
3344556651,  Angireginetta, 1, 1, 0, yes
700428379514925058,  m86_laura, 1, 1, 0, yes
603433563,  legolata, 3, 2, 1, yes
2402630045,  WARNESElIO, 1, 1, 0, yes
2408531903,  egurcabogado, 1, 1, 0, yes
1914568466,  jose_amed, 1, 1, 0, yes
139222180,  MNEG03, 1, 1, 0, yes
2568390426,  MaHelenaO, 1, 1, 0, yes
890739776,  Valerio_Berra, 1, 1, 0, yes
3303171959,  JacopoGonzalez, 1, 1, 0, yes
1148870012,  cla_bru, 1, 1, 0, yes
394225673,  danielasollai, 2, 2, 0, yes
455712708,  jommas82, 1, 1, 0, yes
380261343,  AntonioAlizzi82, 1, 1, 0, yes
619390305,  LOUD__DESIRE, 1, 1, 0, yes
299638613,  criverniani, 1, 1, 0, yes
3871166063,  f_alogna, 1, 1, 0, yes
1227596455,  MTravanut, 6, 3, 3, neutral
180375721,  herbert_boy, 1, 1, 0, yes
1905327090,  MattAccia, 2, 1, 1, neutral
4046265023,  fiordiprimavera, 2, 2, 0, yes
392142875,  KayeMenner, 1, 1, 0, yes
120040293,  Lostanca, 2, 2, 0, yes
377274819,  IvanoFaraci, 1, 1, 0, yes
411005790,  Sandomenico_Lor, 1, 1, 0, yes
1681478526,  Mister_Gladio, 1, 1, 0, yes
85824229,  FabrizioBrandi, 2, 2, 0, yes
865193857,  LuigiPiccarozzi, 6, 6, 0, yes
42627416,  manu1800, 1, 1, 0, yes
154948590,  pakinapoli, 1, 1, 0, yes
271297413,  veniceman100, 2, 2, 0, yes
407990621,  silvibuzza, 1, 1, 0, yes
560680527,  sixhei_koni, 1, 1, 0, yes
499566698,  fagot_tino, 1, 1, 0, yes
528821610,  Matteox_, 1, 1, 0, yes
418884995,  skench74, 1, 1, 0, yes
744935589942788096,  crf_matteo, 1, 1, 0, yes
3392210055,  daniela_piepoli, 1, 1, 0, yes
463678969,  MattPiras, 1, 1, 0, yes
856746878,  LungoDaTaranto, 1, 1, 0, yes
270049073,  zio982, 1, 1, 0, yes
561219357,  AndreaFrateffGi, 1, 1, 0, yes
862914102,  rosspatton91, 1, 1, 0, yes
45823146,  ilKontrastivo, 1, 1, 0, yes
60732643,  stellarivello, 1, 1, 0, yes
1625597406,  jealvarezb343, 1, 1, 0, yes
309782521,  Bedhead82, 1, 1, 0, yes
805578705607266304,  orsa_maggiore6, 1, 1, 0, yes
252124333,  00doppiozero, 1, 1, 0, yes
783223122,  Giusnelmar, 1, 1, 0, yes
327973902,  paolovoltaggio, 2, 1, 1, neutral
34237970,  StefaniaDanzi, 2, 1, 1, neutral
189895030,  MPMorilloRocha, 1, 1, 0, yes
395361626,  AntonellaCica, 1, 1, 0, yes
90987749,  monromar, 1, 1, 0, yes
796534695265705985,  carlucas9566, 1, 1, 0, yes
1122739975,  CardonaMargara, 1, 1, 0, yes
765603303795417088,  Luz_guzman26, 1, 1, 0, yes
136733855,  Leilahamlaoui, 1, 1, 0, yes
506123655,  vizzionatod, 1, 1, 0, yes
4568818943,  francy2368, 5, 1, 4, no
2156341545,  DNaspo, 1, 1, 0, yes
444596022,  AxxaSocial, 1, 1, 0, yes
4228310718,  levens63, 1, 1, 0, yes
782728655818596352,  prifurlanhaut, 1, 1, 0, yes
605480882,  ana__1899, 1, 1, 0, yes
119887999,  orlinalopez, 2, 2, 0, yes
303201471,  Fra_Montesanto, 2, 2, 0, yes
4570231875,  Giovy302, 1, 1, 0, yes
305673340,  Bunnister, 3, 1, 2, no
703635891298902016,  barbaraberetta_, 1, 1, 0, yes
562031545,  vcatkin, 1, 1, 0, yes
3328851717,  brenta85, 1, 1, 0, yes
1714140121,  top_ignos, 1, 1, 0, yes
2719499155,  r_iuzzo, 3, 2, 1, yes
4643642182,  lorenzodenuc, 1, 1, 0, yes
756480048958406656,  LauraBalestra81, 2, 1, 1, neutral
810950815,  gianluca_pala, 1, 1, 0, yes
500592857,  BanAle88, 1, 1, 0, yes
1381732068,  debyb75, 2, 2, 0, yes
71425768,  RossPazz, 1, 1, 0, yes
2576566518,  gianvitocolajem, 2, 2, 0, yes
2577145604,  marcosciccutell, 2, 2, 0, yes
589836989,  sabrystevens, 1, 1, 0, yes
476627135,  VaveBorboni, 1, 1, 0, yes
277716896,  toruoga0916, 1, 1, 0, yes
22644741,  giammarcomacmac, 1, 1, 0, yes
1084216368,  maxcst85, 1, 1, 0, yes
455254102,  fabiozanna2, 2, 2, 0, yes
2828318059,  giangrande33, 2, 2, 0, yes
773219919588712448,  VinicioCristo, 1, 1, 0, yes
460072489,  CristinaVaccar1, 1, 1, 0, yes
2875225859,  francesca_morea, 1, 1, 0, yes
501976583,  DreamAboutJade, 1, 1, 0, yes
750601639539736576,  normannicus, 1, 1, 0, yes
169010405,  danielebanfi83, 1, 1, 0, yes
436106682,  Cami_HaruiYVK, 1, 1, 0, yes
534616829,  nadalut, 1, 1, 0, yes
142454786,  samothyear, 1, 1, 0, yes
143179358,  Malise_2010, 1, 1, 0, yes
427655285,  Javserna, 1, 1, 0, yes
369786451,  PopescuCo, 1, 1, 0, yes
597352358,  TVaraldo, 1, 1, 0, yes
754375350713520128,  keystonesmooth_, 1, 1, 0, yes
71877038,  Schiebulski, 1, 1, 0, yes
452259801,  ConsigliaMa, 1, 1, 0, yes
18364324,  filomunozr, 1, 1, 0, yes
2209005968,  1982Coatto, 1, 1, 0, yes
804216384,  Giu_Bertoluzzi, 1, 1, 0, yes
231530955,  ipergiorg, 1, 1, 0, yes
189403153,  Livia2930, 1, 1, 0, yes
1732219614,  AriGrosefeli, 1, 1, 0, yes
60883783,  lcargnel, 1, 1, 0, yes
1320488653,  MedusaGrind, 3, 2, 1, yes
421629334,  maxghostsamurai, 1, 1, 0, yes
407682640,  giodioni, 2, 1, 1, neutral
2447922617,  MCFC1899, 1, 1, 0, yes
761634173782294530,  dragonerossoen1, 1, 1, 0, yes
791278541073747968,  tamerelaputedu8, 1, 1, 0, yes
1272617930,  CiaralliSimone, 1, 1, 0, yes
789046529545895936,  juventinazzo66, 1, 1, 0, yes
106254280,  signoale, 1, 1, 0, yes
957540841,  scialpifans, 1, 1, 0, yes
264396151,  avalbruccioli, 1, 1, 0, yes
1210092522,  AlessioBarbiero, 1, 1, 0, yes
1224149654,  elenaporta55, 1, 1, 0, yes
1382414960,  NicoCosmi, 1, 1, 0, yes
2725246077,  PinaCalla, 1, 1, 0, yes
2193253675,  ugo_testoni, 2, 2, 0, yes
4927926358,  bluesky2317, 1, 1, 0, yes
296851567,  paololago, 1, 1, 0, yes
805560135624048641,  ilpapaufficiale, 1, 1, 0, yes
26372427,  Tonyapt12, 1, 1, 0, yes
1227307748,  gabriele_testa, 2, 2, 0, yes
1533820134,  assoabasi, 1, 1, 0, yes
50979495,  cioccoriso, 1, 1, 0, yes
571008495,  FCaio76, 1, 1, 0, yes
1354201196,  scritturamista, 1, 1, 0, yes
2192231341,  socialtoday, 2, 1, 1, neutral
951133896,  AngelaZanello, 3, 1, 2, no
2940552179,  AmedeoCro, 2, 1, 1, neutral
783982939336011776,  giovannaformic4, 3, 3, 0, yes
417150886,  MilenaSanterini, 3, 3, 0, yes
276454031,  andreabad79, 1, 1, 0, yes
275044697,  skuria7, 1, 1, 0, yes
856974438,  enzadalo8926, 1, 1, 0, yes
9348742,  voltam, 1, 1, 0, yes
297692705,  ilaliebe, 1, 1, 0, yes
4370144955,  itwittici, 1, 1, 0, yes
1511018348,  9Joe9, 1, 1, 0, yes
2789526892,  gianni_parola, 1, 1, 0, yes
2460461517,  parlocolmuro, 1, 1, 0, yes
363186036,  GiusyMastronard, 1, 1, 0, yes
582255150,  JacoLoco2, 1, 1, 0, yes
1262797818,  marymiaolou, 1, 1, 0, yes
357788544,  rodrigosalastru, 1, 1, 0, yes
241970352,  HernanChelo, 1, 1, 0, yes
418567920,  danilalunghini, 1, 1, 0, yes
497838069,  massimopiazza3, 4, 2, 2, neutral
3190025923,  drmarcolomo, 1, 1, 0, yes
69910168,  LEMENDEZA, 1, 1, 0, yes
169492374,  laura_lucchini, 1, 1, 0, yes
432829154,  GGattozzi, 1, 1, 0, yes
54886332,  MarcoBiasielli, 1, 1, 0, yes
205441454,  mar_antoinette, 1, 1, 0, yes
1262890778,  RiccardoDellaT1, 1, 1, 0, yes
1063500608,  antocarlini69, 1, 1, 0, yes
1004812916,  Telequattro, 2, 2, 0, yes
1248466592,  DeLausert, 1, 1, 0, yes
489159081,  AmeliaSmolinska, 1, 1, 0, yes
2749659524,  potamos5, 1, 1, 0, yes
1002748836,  nntsn, 1, 1, 0, yes
52349247,  ceciliafe, 1, 1, 0, yes
3025497238,  alice_carro, 1, 1, 0, yes
57870960,  olimpia09, 1, 1, 0, yes
333523955,  Articulat_, 1, 1, 0, yes
124494654,  Andydrake68, 1, 1, 0, yes
789504307611795456,  peraltamoreno3, 1, 1, 0, yes
783190940852875264,  realclacroix, 1, 1, 0, yes
2719646255,  ldessi9, 1, 1, 0, yes
1438658786,  MariaPaolaGalbi, 1, 1, 0, yes
3255753983,  FuffaFrancesca, 1, 1, 0, yes
30504173,  michimas, 2, 1, 1, neutral
2327439356,  lrdmrs52, 1, 1, 0, yes
707129460051599360,  cindyengioy, 2, 2, 0, yes
4867031578,  ugoswatty, 2, 2, 0, yes
4853446637,  Carmen71359930, 1, 1, 0, yes
898011530,  GiuliaTerrana, 1, 1, 0, yes
1252981304,  Leo66John, 1, 1, 0, yes
1013408298,  AleRosina68, 1, 1, 0, yes
3001004218,  cece_coa, 2, 2, 0, yes
4872311697,  GiovaniFimLazio, 2, 2, 0, yes
741182419907317760,  memyblogger, 1, 1, 0, yes
191810768,  kasolo_eze, 2, 2, 0, yes
2370596331,  mc83tweeting, 1, 1, 0, yes
442148347,  larasciarretta, 5, 5, 0, yes
294652639,  p_giampaolo, 1, 1, 0, yes
722005653779324929,  MarcTheDimario, 1, 1, 0, yes
413612617,  Udjats63, 1, 1, 0, yes
3981722723,  chijiokebiafra4, 2, 2, 0, yes
2327161304,  FraCalderoni, 1, 1, 0, yes
3063896079,  flavien_heart, 1, 1, 0, yes
1408883832,  raffpas82, 1, 1, 0, yes
156891379,  GerardoDAmico, 2, 2, 0, yes
386210229,  AndreaPazzi15, 1, 1, 0, yes
467773228,  ChiaraSquaglia, 1, 1, 0, yes
2502917079,  alecord78, 1, 1, 0, yes
765502489529618432,  ChikaOkugo1, 2, 2, 0, yes
1537494991,  ProgDreyfus, 6, 3, 3, neutral
3240778707,  iris_versari, 3, 3, 0, yes
2711284733,  cicciobastardo_, 1, 1, 0, yes
405435019,  Pumper60, 2, 2, 0, yes
755181263573569536,  croce_patente, 1, 1, 0, yes
2446893926,  giusallegrini, 1, 1, 0, yes
14094007,  poni, 3, 1, 2, no
4838692673,  d1dim0, 1, 1, 0, yes
768496045013753856,  micheldossena, 1, 1, 0, yes
462829190,  PgGrilli, 5, 4, 1, yes
22015750,  fpagani, 2, 2, 0, yes
168700104,  AmbraSavo, 3, 3, 0, yes
113424494,  PaoloTucci, 2, 2, 0, yes
366273092,  fciullo, 1, 1, 0, yes
2767836851,  DimitriOngis, 2, 2, 0, yes
134503949,  renatoku40, 1, 1, 0, yes
798636480323342336,  EkemezieEke1, 2, 2, 0, yes
504633298,  EmilioCecchini, 1, 1, 0, yes
984737305,  artusi94, 2, 2, 0, yes
51748015,  Colucia, 1, 1, 0, yes
456218810,  SimoneStagnitta, 2, 1, 1, neutral
427711084,  raffaghellogian, 2, 1, 1, neutral
2801845471,  giornalistiunit, 2, 2, 0, yes
1269200340,  danielaspat, 1, 1, 0, yes
4814810625,  Emy3EPongiEle, 2, 2, 0, yes
783427775709544448,  washington_HM, 2, 2, 0, yes
552318105,  YouRfuture_YF, 2, 1, 1, neutral
3088366689,  Edoardo0390, 2, 2, 0, yes
1395706896,  MichelaSunRoses, 4, 2, 2, neutral
2985944602,  UmbertoFioretti, 2, 2, 0, yes
442931558,  ClaudiaVarriano, 2, 2, 0, yes
789737439829065728,  UgwuNgene, 2, 2, 0, yes
769427987754254336,  Mr_Gredy, 3, 1, 2, no
4257422674,  EnricaBruno, 1, 1, 0, yes
1172520133,  stregastregonza, 2, 2, 0, yes
91291605,  bettybuurp, 1, 1, 0, yes
90641656,  regionepiemonte, 2, 2, 0, yes
3179982241,  raffapilloni, 2, 2, 0, yes
1592920400,  ForumSCN, 1, 1, 0, yes
800379529319436289,  felix_onyeoma, 2, 2, 0, yes
715134939155578880,  fr_maione, 17, 2, 15, no
2182797036,  ugochukwu9999, 2, 2, 0, yes
3055528731,  LanzilloPaola, 3, 3, 0, yes
713564619483164672,  jacobscarlene1, 2, 2, 0, yes
775979862381072384,  CNwabiafra, 2, 2, 0, yes
181538209,  danisng1995, 1, 1, 0, yes
395211437,  Blackstar90210, 1, 1, 0, yes
802603165174657026,  FedeDeVizia, 1, 1, 0, yes
452765524,  DarioDongo, 1, 1, 0, yes
774219039841325056,  CrawlThrouDark, 1, 1, 0, yes
769589040194654208,  VeeX7_, 1, 1, 0, yes
165536308,  julia0off, 1, 1, 0, yes
3653824277,  BignozziLivia, 4, 3, 1, yes
3146535454,  francotrotta64, 1, 1, 0, yes
773671069,  immergasitalia, 6, 6, 0, yes
2723386339,  FirinuAntonio, 1, 1, 0, yes
701319974833491968,  fafabrd, 2, 2, 0, yes
775446087884804096,  uwaoma_godwin, 2, 2, 0, yes
130940132,  giuliavaldi, 2, 2, 0, yes
498045949,  luciamainetti1, 2, 1, 1, neutral
287379981,  GMarrucci, 1, 1, 0, yes
2775975238,  WViste, 1, 1, 0, yes
795412198466195469,  Overseas_Nurses, 2, 2, 0, yes
3403004925,  inaokiyi, 2, 2, 0, yes
289786081,  Slimytrust, 2, 2, 0, yes
4860684421,  TrilliTerry1000, 1, 1, 0, yes
701190174445805569,  MilaniGisella, 3, 3, 0, yes
2396560902,  RosannaPrevideM, 1, 1, 0, yes
204797204,  myo75ho, 2, 1, 1, neutral
391283845,  LuigiFantasia, 1, 1, 0, yes
1080428341,  Paolomartinell9, 1, 1, 0, yes
948561824,  Toma1961, 3, 1, 2, no
2180748462,  GianniPiccin, 2, 2, 0, yes
3436666103,  d_g_76, 2, 2, 0, yes
1425553855,  Giamblico, 2, 1, 1, neutral
846559483,  AlexCrm4, 1, 1, 0, yes
1320760814,  marcarbonio, 1, 1, 0, yes
1320796586,  CarapucciEgeo, 1, 1, 0, yes
2489997486,  Antale72, 1, 1, 0, yes
991437282,  AntonioLaRosa8, 1, 1, 0, yes
411548379,  WiseYuri, 2, 2, 0, yes
304364739,  bioclinical, 3, 3, 0, yes
3051515969,  rocciafrancesc1, 2, 1, 1, neutral
1140535207,  ____carlo____, 2, 2, 0, yes
4234609031,  thewolfjourney, 1, 1, 0, yes
1020682760,  FilippoCasadei2, 1, 1, 0, yes
712407447219077122,  alicesottosale, 1, 1, 0, yes
781773506258280448,  Tochukw48411420, 2, 2, 0, yes
70954365,  CantineGarruto, 1, 1, 0, yes
823648998,  sara_moretto, 1, 1, 0, yes
2851793212,  Sedicente, 2, 2, 0, yes
1063299554,  Tirofijo71, 2, 2, 0, yes
87912007,  aleinmovimento, 2, 2, 0, yes
91106588,  Infoaut, 2, 2, 0, yes
186553267,  vhreccia, 2, 2, 0, yes
1307870407,  CominciaAdesso, 2, 2, 0, yes
329299177,  Jacopo_llo, 2, 2, 0, yes
784165978905120768,  Luigi42900057, 1, 1, 0, yes
189343971,  Lab_Crash, 2, 2, 0, yes
2411225194,  AdornatoAntonio, 2, 2, 0, yes
715905803195129856,  rglopezjuarez, 2, 2, 0, yes
1522471394,  fabioromeo07, 1, 1, 0, yes
788422453349519364,  MicheleAlbert59, 1, 0, 1, no
739042129230614528,  diegopornaro, 3, 0, 3, no
731863278062829569,  Groucho979, 1, 0, 1, no
1729830307,  Consuelo_Paola, 2, 0, 2, no
39594048,  DomCiarelli, 1, 0, 1, no
332934650,  ChiaraSe3, 1, 0, 1, no
456786635,  SoccorsaChiara, 1, 0, 1, no
795945148135915520,  alessia_vercesi, 1, 1, 0, yes
594940967,  SantiGuerrieri, 2, 0, 2, no
417102369,  eugeniomarino2, 1, 1, 0, yes
983325846,  robertachellini, 1, 1, 0, yes
1124778361,  graziasoarrivat, 1, 1, 0, yes
4865355658,  TatadaleSister, 2, 2, 0, yes
471463027,  TwittoSpia, 1, 1, 0, yes
443344809,  Pinobianconero, 2, 2, 0, yes
275994776,  Luca_ah, 1, 1, 0, yes
397474234,  TeleRacconto, 2, 2, 0, yes
627682711,  ilsalutatore, 1, 1, 0, yes
720714143280545793,  tata_mylove, 1, 1, 0, yes
1345240357,  alabianca3, 1, 1, 0, yes
3049683939,  WorbasCello, 1, 1, 0, yes
3064900822,  IanBurrOne, 1, 1, 0, yes
435064725,  alvaromoretti, 1, 1, 0, yes
419313596,  chiaragian, 4, 0, 4, no
408059944,  CannaCarmela, 2, 0, 2, no
4379409015,  ob_mauro, 5, 0, 5, no
454618588,  CIDRegard, 1, 0, 1, no
711654055924387840,  cristinamenecat, 1, 0, 1, no
501518665,  PezzellaMassimo, 4, 0, 4, no
794263031450632192,  marcell58711337, 4, 0, 4, no
4288578639,  LosaErnesto, 1, 0, 1, no
1166887711,  di_adl, 1, 0, 1, no
241703665,  Violare, 4, 0, 4, no
802393932894273536,  berdekatse1976, 1, 0, 1, no
4079805563,  monymurgia6, 2, 0, 2, no
777940009932484608,  vincenz39105214, 1, 0, 1, no
839372598,  paololuzi3, 1, 0, 1, no
336723287,  StregaBettina, 1, 0, 1, no
1244749964,  emmaesamuele, 4, 1, 3, no
2200777745,  romaba72, 1, 0, 1, no
402132308,  MarelloAndrea, 1, 0, 1, no
4532828368,  Seawolf_IT, 4, 0, 4, no
305561820,  BrianWagner_, 2, 0, 2, no
441714798,  matteotarta7, 1, 0, 1, no
4882556081,  FLughezzani, 1, 0, 1, no
2848098653,  MassimoCaliari, 1, 0, 1, no
17010300,  fedro1016, 1, 0, 1, no
92521732,  claudiangrisani, 1, 0, 1, no
790351717,  NonSonoChiPensi, 1, 0, 1, no
557901492,  MagdaAbbadessa, 3, 0, 3, no
3245894853,  DelpecchiaKiara, 1, 0, 1, no
583617026,  annacecconi, 3, 0, 3, no
457313238,  CriEight, 1, 0, 1, no
710151580406976513,  Melonisindaco, 1, 0, 1, no
14575613,  ardigiorgio, 4, 0, 4, no
2230137172,  malivksun, 1, 0, 1, no
96733636,  GaetanoScavuzzo, 1, 0, 1, no
738937244,  SimoneCuberti, 1, 0, 1, no
3007709236,  M86UK, 1, 0, 1, no
790302002463043584,  samumessina25, 1, 0, 1, no
534208609,  marinaeangelo, 1, 0, 1, no
765908415600361472,  TommasoLamannis, 2, 0, 2, no
2700296955,  LeederRomeo, 1, 0, 1, no
83684008,  kazamagio, 1, 0, 1, no
201200020,  MiSonrisaEsLali, 1, 0, 1, no
1410148940,  Laliesmioxigeno, 1, 0, 1, no
171513237,  Francescofrency, 1, 0, 1, no
2344654174,  guido_dameri, 1, 0, 1, no
410298671,  AlessandroLott1, 1, 0, 1, no
452087285,  SimoneDonati76, 1, 0, 1, no
493487401,  mulazzaniantoni, 1, 0, 1, no
729613256793444352,  SalvatoreSarna6, 12, 0, 12, no
509298472,  cozza_franco, 1, 0, 1, no
142017053,  fabifonfa, 1, 0, 1, no
2977102384,  salastefano71, 4, 0, 4, no
427694799,  susanna769, 1, 0, 1, no
81085097,  faberbros, 2, 0, 2, no
1676481360,  EmileeWaren, 1, 0, 1, no
1898454446,  niccocoppa, 2, 0, 2, no
355734935,  GianfrancoPelus, 1, 0, 1, no
340296465,  DanielaxMarinox, 1, 0, 1, no
4285506867,  garbomichele, 1, 0, 1, no
415686111,  manupivato, 2, 0, 2, no
453384866,  giovannivalen10, 1, 0, 1, no
358162325,  matciamb, 1, 0, 1, no
435575179,  FI_BELGIO, 5, 1, 4, no
589053637,  PaolaSpandrio, 1, 0, 1, no
1120448588,  FrancRosso, 1, 0, 1, no
1121935590,  delucamassimote, 1, 0, 1, no
1123490155,  ReAscione, 1, 0, 1, no
1063565083,  GaiettaLuca, 4, 0, 4, no
401335686,  gufo871, 1, 0, 1, no
247841802,  NellyDogali, 1, 0, 1, no
905462725,  peppe_carbone, 2, 0, 2, no
2560759612,  florianogabrie1, 1, 0, 1, no
319718473,  ErikaRubio50, 11, 0, 11, no
772938597137801216,  flaviotiravento, 1, 0, 1, no
1015689343,  KabirYus, 1, 0, 1, no
542526244,  LucianoOdorisio, 1, 0, 1, no
190957756,  visintinimanlio, 1, 0, 1, no
1068808687,  quibolgare, 1, 0, 1, no
1244285522,  SuperFede93, 1, 0, 1, no
231954707,  leottaantonio, 1, 0, 1, no
2284316591,  antoniominchel2, 1, 0, 1, no
2568933625,  MauroMorandi3, 1, 0, 1, no
4893082468,  gheorghect, 1, 0, 1, no
790218643619602436,  Forza_Italia_PN, 7, 0, 7, no
3602290937,  gius_menna, 2, 0, 2, no
3300222131,  paolovarsi1, 1, 0, 1, no
832111555,  tznab, 2, 0, 2, no
1873095224,  salvogrizzanti, 1, 0, 1, no
410733657,  AlideBonvicini, 2, 1, 1, neutral
2729939422,  peru71andrea, 1, 0, 1, no
1323345139,  bda66, 3, 0, 3, no
987455126,  unarosannina, 1, 0, 1, no
3305641006,  Cinu34H, 1, 0, 1, no
516396544,  GiulioMDiGiulio, 1, 0, 1, no
3101406220,  MatteoTafuri1, 1, 0, 1, no
74147053,  Pietroross, 2, 1, 1, neutral
2324434960,  mrighetti1967, 5, 0, 5, no
215073544,  Irenenenene, 1, 0, 1, no
27212050,  fsoltrash, 2, 0, 2, no
747104008268021760,  belfiore_mattia, 1, 0, 1, no
104850697,  lucadotto, 3, 0, 3, no
14153768,  giamp9000, 1, 0, 1, no
53210593,  DavideGanapini, 1, 0, 1, no
3545919143,  peppemanc2, 2, 0, 2, no
1705424929,  _augustocoletta, 1, 0, 1, no
61311913,  antoniodelfurbo, 1, 0, 1, no
785139179801939969,  CorradoOrfini, 1, 0, 1, no
797431310096723969,  AntonioLeRose93, 1, 0, 1, no
58076869,  paolobertazzoli, 1, 0, 1, no
1306532766,  michelamanfre, 1, 0, 1, no
837208824,  perrier_laura, 2, 0, 2, no
809076650,  SalvatoreAlbeli, 1, 0, 1, no
416277518,  AndreaBacchetti, 1, 0, 1, no
1265161945,  FrancoDAvino81, 2, 1, 1, neutral
2887842544,  Naninani1960, 1, 0, 1, no
511676243,  paologabi, 2, 0, 2, no
527778059,  GabrieleCocco17, 2, 0, 2, no
73358888,  Biagio71, 1, 0, 1, no
512377659,  rosannadimarzio, 1, 0, 1, no
2282030010,  Thucydides_1973, 6, 0, 6, no
2475286346,  ilbuonfabio, 1, 0, 1, no
250056918,  micmalan76, 2, 0, 2, no
3321233530,  Roberto71362237, 2, 0, 2, no
576326378,  MatteoAndreoni, 2, 0, 2, no
245423060,  mauriziozucca, 1, 0, 1, no
376865529,  DiegoScotece, 2, 0, 2, no
88254217,  lucianabig, 1, 0, 1, no
1142469860,  KellerZoe, 2, 0, 2, no
1077215370,  AndreaGiombi, 1, 0, 1, no
76390097,  yurisantagostin, 2, 0, 2, no
4449540112,  Mant1397, 1, 0, 1, no
487006102,  ReneeRomanelli, 2, 0, 2, no
288329762,  MarcoLifeGuard, 2, 0, 2, no
2985519345,  gioppa1972, 1, 0, 1, no
277137414,  rossmiky, 1, 0, 1, no
737370217,  ArchGrassia, 1, 0, 1, no
2758967786,  robtoselli, 1, 0, 1, no
711956791513505792,  taglianigianni, 1, 0, 1, no
501916645,  enzonardini, 1, 0, 1, no
4819495307,  Riccard40639553, 1, 0, 1, no
2638747113,  kyntia1973, 2, 0, 2, no
713380260260220928,  GiuseppaSessa, 1, 0, 1, no
29205423,  alemaggiani, 2, 0, 2, no
74696107,  FeDe__1984, 1, 0, 1, no
390593484,  cruscapertutti, 2, 0, 2, no
2534395438,  000federico000, 1, 0, 1, no
1371701359,  VitashAv85, 1, 0, 1, no
510229268,  GiacomoFarano, 2, 0, 2, no
2433071495,  IlariaBattino, 1, 0, 1, no
2393374065,  paolo_tode, 4, 0, 4, no
1146000283,  CeccoCatta, 1, 0, 1, no
7697992,  emenietti, 2, 0, 2, no
702428174630649856,  Franzoh95, 1, 0, 1, no
572394119,  tonillo58, 1, 0, 1, no
2164906730,  antondmto, 1, 0, 1, no
156048806,  mariadigregorio, 2, 0, 2, no
4896386734,  Fabrebirth, 1, 0, 1, no
352210194,  Ale_Boriani, 1, 0, 1, no
488853186,  TeobaldelliA, 3, 0, 3, no
567688029,  LucClochard, 5, 1, 4, no
2411361259,  Krispistols, 2, 0, 2, no
4049220777,  eurofollia1, 3, 0, 3, no
2211874822,  flying_pizza8, 1, 0, 1, no
798883998458056704,  annibale711, 2, 0, 2, no
914964973,  EttoreBaita, 1, 0, 1, no
148343334,  fdiYou, 2, 0, 2, no
767811918258143233,  daviregg, 2, 0, 2, no
498835221,  DannyProl, 1, 0, 1, no
501086864,  mastrolucy, 3, 0, 3, no
794287293741858816,  b3al1v1, 1, 0, 1, no
3883143269,  AlessiaDavter, 1, 0, 1, no
389611271,  R_Panarese, 1, 0, 1, no
600524618,  Juventinodoc78, 10, 0, 10, no
2338359262,  michelinacaval2, 1, 0, 1, no
804707884500185088,  ChiaraMorellii, 4, 0, 4, no
2455785021,  xlanapepsi, 1, 0, 1, no
3305144668,  AlongiUmberto, 1, 0, 1, no
1105858195,  finngiaz, 1, 0, 1, no
253667606,  taloscreta1, 2, 0, 2, no
1009779474,  LarryLLoco, 2, 0, 2, no
379804891,  Danifencer, 1, 0, 1, no
1009672723,  manuseggiani, 3, 0, 3, no
402056906,  AndreaPiomboPBS, 3, 0, 3, no
4842635686,  _deactivator, 1, 0, 1, no
27007400,  marianski65, 1, 0, 1, no
3244937621,  stayforljlo, 1, 0, 1, no
2726079623,  rgaspo2005, 1, 0, 1, no
293430350,  _PFontana, 4, 0, 4, no
48398700,  TizianaFG, 1, 0, 1, no
339931105,  Paco_Lab, 1, 0, 1, no
2483411845,  TheStuz, 1, 0, 1, no
793137233586946050,  ClaireBrutionne, 2, 0, 2, no
4290644602,  Roberta30325939, 3, 0, 3, no
422052233,  ClaudioBianchi4, 1, 0, 1, no
1407690270,  ellieBlackSky, 1, 0, 1, no
457395109,  DanieleDandr, 1, 0, 1, no
269808396,  Priorefilippo, 1, 0, 1, no
3052713239,  sestolaplus1, 1, 0, 1, no
160498055,  shyranebruno, 2, 0, 2, no
120029441,  bliss367, 1, 0, 1, no
489878046,  a_dimaso, 6, 0, 6, no
2858495127,  SardixCattaneo, 1, 0, 1, no
301922459,  fabioconti85, 1, 0, 1, no
996192925,  gigliolavalenti, 2, 0, 2, no
804939395522555904,  batbara6, 3, 0, 3, no
229428941,  paolo_mancini, 1, 0, 1, no
3303617854,  istruzione_ap, 1, 0, 1, no
381174004,  lorenzodimari1, 1, 0, 1, no
4202197246,  FioriFranco1, 1, 0, 1, no
2280788664,  s_anb1, 1, 0, 1, no
137921550,  eletati91, 1, 0, 1, no
3437690487,  GiuseppinaMp15, 1, 0, 1, no
304940135,  CiccioPiazza, 1, 0, 1, no
775793042959785984,  CampardoAdriana, 1, 0, 1, no
778531519,  87_carmy, 1, 0, 1, no
2994294622,  gallura3, 1, 0, 1, no
616386306,  MaxMontagnini, 1, 0, 1, no
417138474,  RexTomida, 3, 1, 2, no
1268536039,  bibitibobitibu, 1, 0, 1, no
4928079646,  BluJeans12, 1, 0, 1, no
786170636527767552,  Fracifra90__, 2, 0, 2, no
75837606,  prinpeach, 1, 0, 1, no
24548101,  MrSpritz, 1, 0, 1, no
101718511,  guru63_ch, 1, 0, 1, no
96505348,  SBiral, 2, 0, 2, no
2832590483,  antoniomuzzi1, 2, 0, 2, no
369449071,  cyrusfiancee, 1, 0, 1, no
355049682,  AndreaCereda, 1, 0, 1, no
782177494417960960,  ettorebsndi, 1, 0, 1, no
770413707901956096,  mezzosangue2002, 1, 0, 1, no
267351876,  FRANKYEFFE, 1, 0, 1, no
15191375,  kiakim, 1, 0, 1, no
865106616,  eugeniob3, 1, 0, 1, no
825402350,  Achifelix, 1, 0, 1, no
70124737,  giormagno, 2, 0, 2, no
808552812,  styliny, 1, 0, 1, no
1242349958,  ciro_studio, 1, 0, 1, no
780085489953112064,  marge_tatcher, 2, 0, 2, no
318274569,  thunderbird1789, 1, 0, 1, no
531521560,  AntoniniClaude, 1, 0, 1, no
3004154591,  VixCorreddu, 2, 0, 2, no
71500951,  tetobucchi, 2, 0, 2, no
538566780,  mariannabrl, 2, 0, 2, no
462389431,  FrancescoDondi, 1, 0, 1, no
884435066,  FobioGalmeni, 1, 0, 1, no
2438105965,  LaPravdania, 2, 1, 1, neutral
424383813,  GiulioGandolfi, 2, 0, 2, no
396921584,  marco_lnz, 1, 0, 1, no
335536456,  giorgiogiangrec, 1, 0, 1, no
1696277574,  lorenzo5103, 3, 0, 3, no
15198449,  Ellyssima, 1, 0, 1, no
2380627679,  tedenzo, 1, 0, 1, no
23741148,  lighea85, 3, 0, 3, no
421976918,  MIorino, 1, 0, 1, no
25975653,  da_cake, 2, 0, 2, no
903557294,  stefanodragotta, 2, 0, 2, no
174290498,  aspy77, 1, 0, 1, no
430244580,  RossiLonghi, 1, 0, 1, no
4182841036,  kei_rocker94, 1, 0, 1, no
1011915158,  FmarcheFederico, 1, 0, 1, no
117738390,  Scubamanu, 1, 0, 1, no
507586722,  GregoryMarinucc, 1, 0, 1, no
1319962368,  PGandolaFi, 2, 0, 2, no
536419265,  NonnoCirillo, 1, 0, 1, no
1264916744,  a_bello23, 1, 0, 1, no
68927547,  Giulian1, 2, 0, 2, no
242667025,  alfadixit, 1, 0, 1, no
3147471767,  07_ssergio, 1, 0, 1, no
2436383674,  tonboffi, 1, 0, 1, no
429391019,  GeopoliticalCen, 1, 0, 1, no
761182919989878784,  frSchio, 1, 0, 1, no
2333638607,  FabioMegnamix, 2, 1, 1, neutral
154109023,  teregrimaldidm, 1, 0, 1, no
1086201870,  afranchi67, 1, 0, 1, no
763674351514316800,  Gioblog1970, 1, 0, 1, no
531243852,  lucharlie65, 2, 1, 1, neutral
421245685,  silvanavignati, 1, 0, 1, no
786498737019363328,  totorocat1, 2, 1, 1, neutral
751912807,  EsadMehmeti, 2, 0, 2, no
166526251,  giulio_convento, 1, 0, 1, no
381575136,  oiramdivito, 1, 0, 1, no
258760456,  iAmTrysme, 2, 0, 2, no
2264988588,  FurioBottarella, 1, 0, 1, no
3132681590,  laura_pittu, 1, 0, 1, no
1662478286,  il_fab, 1, 0, 1, no
1336992302,  Danys184, 1, 0, 1, no
1668502464,  caniovunque, 1, 0, 1, no
2955736762,  oh_darling22, 1, 0, 1, no
39724785,  CinziaPat, 1, 0, 1, no
488321355,  lorenzobenocci, 1, 0, 1, no
165467059,  elisa_p90, 1, 0, 1, no
584096772,  mingo748r, 1, 0, 1, no
58796712,  serena_marchini, 3, 0, 3, no
2928510341,  GiulianaGrigato, 1, 0, 1, no
1043102054,  Sox1978Sox, 1, 0, 1, no
736882892505251841,  altreamerjche, 1, 0, 1, no
2494397392,  pri_mario, 1, 0, 1, no
3236172064,  rtxall, 1, 0, 1, no
1161371108,  PaloNotsoAlto, 2, 0, 2, no
804758910397743105,  Dardinello, 2, 0, 2, no
68118653,  calabriaonline, 1, 0, 1, no
3242310892,  BorrelloRosario, 1, 0, 1, no
1035334644,  colombsa, 1, 0, 1, no
4186490207,  pausau88, 1, 0, 1, no
1042922816,  marcotarchiani2, 1, 0, 1, no
522438840,  AldoVerdigi, 2, 0, 2, no
45391358,  Consuelo3v, 1, 0, 1, no
130233164,  vinicolamente, 1, 0, 1, no
1430799698,  CellittiMartina, 1, 0, 1, no
38653592,  Lenoide, 1, 0, 1, no
468746327,  CQuagliani, 6, 0, 6, no
4186937854,  vandina1954, 1, 0, 1, no
709330749774757888,  soloperRt, 1, 0, 1, no
2468278049,  realpetuffo, 1, 0, 1, no
421997770,  Stellamatteo, 1, 0, 1, no
82179120,  Alessandra_ama_, 1, 0, 1, no
549050066,  FabioCANDITA, 1, 0, 1, no
3300479032,  giovannicipol11, 1, 0, 1, no
307904463,  5Giop, 3, 0, 3, no
977054768,  R4774ELE, 1, 0, 1, no
1360217082,  felixarpino, 1, 0, 1, no
410942770,  Fra_Rosy, 1, 0, 1, no
2918014485,  df150983, 1, 0, 1, no
3144040683,  lo_loryso1974, 1, 0, 1, no
1446220230,  MAURI59N, 1, 0, 1, no
1424957299,  PaoloGrazioso, 1, 0, 1, no
307362538,  matteomarenzi, 1, 0, 1, no
742644750029819905,  fcbiggie, 1, 0, 1, no
400801252,  MaurizioAlba, 1, 0, 1, no
484540133,  f_quitadamo, 1, 0, 1, no
327525703,  japologaia, 1, 0, 1, no
738839237919944704,  phlcgn, 1, 0, 1, no
4158758146,  GmanFan44, 2, 1, 1, neutral
96102352,  cipsamat, 1, 0, 1, no
813351918,  francimarras, 1, 0, 1, no
740925871427620867,  simodo13, 1, 0, 1, no
141576538,  Adelina728, 1, 0, 1, no
1257979753,  rosati_luigi, 1, 0, 1, no
2312082696,  thenetwatch, 1, 0, 1, no
1262417935,  aconfal, 1, 0, 1, no
995193895,  DomenicoDDonnie, 1, 0, 1, no
465526247,  scapo1910, 2, 0, 2, no
1398219385,  Cescanner, 2, 0, 2, no
518496696,  DSbrollini, 5, 0, 5, no
133241974,  ciba2000, 6, 0, 6, no
1114520922,  BizziStefania, 2, 0, 2, no
65865007,  Francescapisani, 1, 0, 1, no
584794689,  MarcocciaTony, 1, 0, 1, no
861252402,  effepy49, 6, 0, 6, no
4634526567,  ErikaNobile1, 2, 0, 2, no
261137184,  RicciSimone80, 2, 0, 2, no
573872432,  mbecerto1974, 5, 0, 5, no
522233292,  matteociminari, 1, 0, 1, no
1013833908,  spgiord, 1, 0, 1, no
562168466,  immi_ruah70, 2, 0, 2, no
3214345809,  Katia260787, 7, 0, 7, no
1423657310,  Isotta56, 1, 0, 1, no
3555027683,  eleljp26, 3, 0, 3, no
326368123,  davidepadova, 5, 0, 5, no
3617778570,  Angelo30563133, 2, 0, 2, no
1545899274,  Cogo77F, 6, 0, 6, no
1027369418,  PaolaaaSkin63, 2, 0, 2, no
3240072112,  MarcatoSereno, 2, 0, 2, no
2506050759,  FarroniMassimo, 3, 0, 3, no
1389518442,  SindVeda, 4, 0, 4, no
349775045,  ToscaCappellini, 1, 0, 1, no
730500778637594625,  Gordon_original, 4, 0, 4, no
2735285272,  assane_zudy, 1, 0, 1, no
597453726,  igorgreco, 2, 1, 1, neutral
2695570123,  carlo_sapia, 1, 0, 1, no
403577590,  sedazzari, 2, 0, 2, no
2396753396,  brigetjoan, 1, 0, 1, no
269364736,  wiThDiamONt, 1, 0, 1, no
2851171270,  colalann, 1, 0, 1, no
295064979,  jacop_etti, 2, 0, 2, no
465061130,  SofiaToffee, 1, 0, 1, no
3303214061,  chiaravve, 1, 0, 1, no
1198246940,  FGrosso808, 1, 0, 1, no
4892322659,  pallaicche, 2, 0, 2, no
54906735,  socorros_ad, 3, 0, 3, no
802863869936988160,  Guerrina5, 2, 0, 2, no
3384747941,  AriannaDudine, 1, 0, 1, no
321618982,  FighterOnMars, 2, 0, 2, no
523664680,  FabyScarangella, 1, 0, 1, no
721044827962523648,  AnnaRomaAR, 6, 0, 6, no
2723423525,  iu00088, 2, 0, 2, no
1042270699,  MagnaMagnaMagn, 1, 0, 1, no
2265398249,  iretap, 9, 0, 9, no
562846287,  elenacapodacqua, 9, 0, 9, no
1613023184,  FrancescoDL80, 6, 0, 6, no
2928097725,  erricobis, 1, 0, 1, no
1160659398,  LiberatiCarla, 5, 0, 5, no
447311406,  AlbertoBuscemi, 1, 0, 1, no
2721805613,  namelesstat, 1, 0, 1, no
587415151,  tienimihar, 1, 0, 1, no
717245177,  LisaManu11, 2, 0, 2, no
578086978,  Gamberassimo, 4, 0, 4, no
3930529876,  Daniele48830200, 1, 0, 1, no
96865223,  gioelo, 1, 0, 1, no
1317745008,  luisa_rizzardi, 2, 0, 2, no
2505584184,  Teodoro66992501, 1, 0, 1, no
721150876,  BarbarisiMarina, 1, 0, 1, no
3373840360,  KevinTomasi15, 4, 0, 4, no
3306483027,  ElisabettaNaldi, 1, 0, 1, no
802649713128468481,  massybozza, 3, 0, 3, no
168743399,  Elena3092, 4, 0, 4, no
2400406304,  EvyPizzu, 2, 0, 2, no
739907330070962176,  RitaRiruzza22, 1, 0, 1, no
2415872238,  gabrieleconte93, 1, 0, 1, no
2951276554,  meetuporzinuovi, 1, 0, 1, no
1934445032,  angelo_caramia, 13, 0, 13, no
59133674,  achessa, 1, 0, 1, no
3515611696,  Nicovit80, 5, 0, 5, no
3223863561,  CaiaVince, 2, 0, 2, no
2653950543,  annasilviacipr1, 1, 0, 1, no
350642352,  DoctorSwish, 1, 0, 1, no
2462259980,  MeloMunao1970, 3, 0, 3, no
790103174925393920,  MrCurly12, 1, 0, 1, no
804515981976551424,  mario_cabboiMC, 5, 0, 5, no
603830905,  gioiellogi, 1, 0, 1, no
536613916,  luisaiafulla, 5, 0, 5, no
470039284,  pignatellit, 5, 0, 5, no
418182783,  Pami67, 4, 0, 4, no
1115017122,  FrancescaSgro3, 1, 0, 1, no
1277668488,  SalvatoreLaRo10, 3, 0, 3, no
381422013,  03Antonella09, 3, 0, 3, no
2306325718,  guidi_ile, 1, 0, 1, no
3514403363,  sandrocanala, 4, 0, 4, no
2370183870,  FedericoLoForte, 2, 0, 2, no
427583203,  CampaniLuca, 1, 0, 1, no
3419529063,  maurizio237, 3, 0, 3, no
507308372,  pietrofronteddu, 2, 0, 2, no
1482847554,  oraoccupato, 2, 0, 2, no
2212714795,  ilmagodelsat, 2, 0, 2, no
750057340112670720,  salviusfonta, 1, 0, 1, no
793827760368214016,  Nancy040780, 2, 0, 2, no
2172491427,  luca_catone, 1, 0, 1, no
4925341485,  Barone974C, 3, 0, 3, no
775085130943717376,  AntonioB28483, 1, 0, 1, no
509317962,  maxpsx, 1, 0, 1, no
566387591,  acuto_francesco, 1, 0, 1, no
554309481,  Scarry_On, 1, 0, 1, no
795003042093498368,  nicolasciulli, 1, 0, 1, no
705498619,  Nonminominare, 2, 0, 2, no
562768029,  WallKnight, 3, 0, 3, no
1112425946,  FenixSbiups, 1, 0, 1, no
2897248774,  MassimoBazzani, 2, 0, 2, no
3240372507,  araghesia67, 8, 0, 8, no
1022838002,  chieditilperche, 2, 0, 2, no
791382828500000768,  AssuntaStabile8, 9, 0, 9, no
453966391,  dalpi1, 13, 0, 13, no
711636732995891201,  FrocGuilfro, 1, 0, 1, no
2223294178,  La21Latka, 1, 0, 1, no
150184052,  sissicirce65, 1, 0, 1, no
2510503644,  Brainreset99, 1, 0, 1, no
998109013,  stiacon, 1, 0, 1, no
750732259108487168,  giancarlofeli10, 5, 0, 5, no
272934304,  lorisdordoni, 2, 1, 1, neutral
420272269,  KirobyManuela, 1, 0, 1, no
749272798565105665,  mauri7521, 2, 0, 2, no
1337421240,  CarloneFilippo, 1, 0, 1, no
221310670,  nononevero, 3, 0, 3, no
3158316394,  Gaetano19771, 1, 0, 1, no
4081630233,  mariazaccone57, 3, 0, 3, no
3864352527,  LauraLena7, 2, 0, 2, no
501762403,  ReiyelR, 2, 0, 2, no
386533778,  Trecaste, 1, 0, 1, no
433414746,  ipasinetti, 2, 0, 2, no
2352594611,  giuseppegallo69, 1, 0, 1, no
3331126263,  primavallerm, 1, 0, 1, no
1585852927,  SalvatoreLeopar, 1, 0, 1, no
264428351,  capigiu, 1, 0, 1, no
285047870,  ilCieloRosso, 2, 0, 2, no
470951423,  Salvo_Magnano, 1, 0, 1, no
1204728828,  hocus_lotus, 3, 0, 3, no
1670738971,  DavideFleur, 2, 0, 2, no
1954593727,  luigi_ruggeri, 1, 0, 1, no
723484151794569216,  MariaMurdica, 5, 0, 5, no
286584440,  Mausoleo87, 5, 0, 5, no
165377436,  arci1977, 2, 0, 2, no
4716622936,  bariccimarco2, 1, 0, 1, no
1932186163,  gianiarmd, 16, 0, 16, no
1091835762,  Vale7905, 8, 0, 8, no
469273038,  alessandracalvo, 18, 0, 18, no
45431726,  aiki86, 1, 0, 1, no
340427756,  mariafarri1, 2, 0, 2, no
2868596572,  alessandrosono, 1, 0, 1, no
753302994427449344,  girella106, 1, 0, 1, no
36182841,  ANOMIS70, 5, 0, 5, no
1106648863,  GiuseppeDAles14, 4, 0, 4, no
711684801040879616,  ladychef90, 1, 0, 1, no
622206916,  Laurie_Angel_89, 1, 0, 1, no
1314457382,  AnnaMarabini, 1, 0, 1, no
793050863052922880,  Mirko61510088, 1, 0, 1, no
483319327,  alessio_susi, 1, 0, 1, no
3425974198,  VeronicaElfani, 1, 0, 1, no
460048386,  MARIELLASCHEPIS, 1, 0, 1, no
2200517830,  Simiona1Giacomo, 1, 0, 1, no
387622699,  cristinaverolin, 3, 0, 3, no
704718743419658240,  carlo_cencioni, 11, 0, 11, no
2785705605,  gfcavallari, 2, 0, 2, no
713678311562612737,  roberto07061961, 3, 0, 3, no
281581221,  Annagiulie, 3, 0, 3, no
4589146755,  LelettaD, 1, 0, 1, no
993634406,  rsantagada70, 2, 0, 2, no
152596271,  TheLynette, 1, 0, 1, no
803005176789528576,  shahrzy28, 3, 0, 3, no
2828225637,  danieleon81, 6, 0, 6, no
527467945,  seraoantonella, 3, 0, 3, no
723840108860977152,  federicagiando1, 1, 0, 1, no
1038107510,  lanza_giuliana, 1, 0, 1, no
1586239232,  johnspring1961, 2, 0, 2, no
3318544162,  marielladbm61, 1, 0, 1, no
390340887,  AleLepri, 1, 0, 1, no
140867097,  enzapiazzolla, 5, 0, 5, no
781570556281888768,  Carlottainvolo_, 1, 0, 1, no
724603972531658752,  FeliceTraccitto, 1, 0, 1, no
906187532,  antoniokana86, 1, 0, 1, no
452318028,  RobertoFerramol, 3, 0, 3, no
3345343780,  yume_mosyume, 5, 0, 5, no
3758749036,  maxzed1972, 1, 0, 1, no
436192547,  OlivieroCasali, 1, 0, 1, no
3398291849,  gbuono23, 2, 0, 2, no
1247348185,  mirta2006e, 1, 0, 1, no
553524295,  MAGIME182, 1, 0, 1, no
1316440566,  GiorgioperG, 2, 0, 2, no
799044681480933376,  ziopower78, 3, 0, 3, no
719094683213946880,  mariarussolill6, 2, 0, 2, no
389725831,  galby1961, 1, 0, 1, no
788813950636986368,  fr4zelda, 1, 0, 1, no
516681772,  SerafiniLorena, 1, 0, 1, no
1006293282,  elviradalessand, 1, 0, 1, no
878654412,  maryolaf, 1, 0, 1, no
2528025827,  SaraButtiniPhD, 3, 0, 3, no
3372172755,  L198753, 1, 0, 1, no
411696745,  alchiumm, 1, 0, 1, no
483324627,  GianninoAntonio, 2, 0, 2, no
767473064129028097,  FrancescoRoto, 2, 0, 2, no
2455009450,  improta71, 3, 0, 3, no
4818638237,  MajorTom_MG, 2, 0, 2, no
171468531,  donatoiampi, 2, 0, 2, no
206077028,  savasa_, 1, 0, 1, no
1006993896,  m_nicodemo, 1, 0, 1, no
443333037,  themajor83, 5, 0, 5, no
3214233568,  06GiuliA3, 1, 0, 1, no
385420948,  monterosahotel, 1, 0, 1, no
497255779,  EmilianoContino, 4, 2, 2, neutral
151381490,  dobrucamarocla, 1, 0, 1, no
746077685558939648,  simeone973, 1, 0, 1, no
341408808,  gigionetweet, 1, 0, 1, no
461945819,  miasoane, 1, 0, 1, no
372193986,  Sarah_GFStudio, 1, 0, 1, no
744163262124728320,  MoTeo80, 1, 0, 1, no
13459,  mardy, 1, 0, 1, no
4920965056,  DomenicoMonter2, 1, 0, 1, no
538358467,  V3lv3tBlu, 3, 0, 3, no
2186903923,  mariomicangeli, 2, 0, 2, no
3095417459,  BuffoliA, 1, 0, 1, no
557881473,  giovtwit, 1, 0, 1, no
1275345229,  antonioarcieri2, 4, 0, 4, no
297745811,  magdafaccioli, 2, 0, 2, no
742876376,  aleverci, 6, 0, 6, no
793179502046216192,  CastiglioneSt, 3, 0, 3, no
2909203947,  AngeloGabellone, 1, 0, 1, no
1218928308,  Franceshiello6, 1, 0, 1, no
848010049,  pnoce73, 1, 0, 1, no
1076289714,  ivanspalmisano, 1, 0, 1, no
805552084460466176,  SiLvSka, 1, 0, 1, no
1015333748,  BarbaraMariella, 1, 0, 1, no
999729386,  marcooliveri5, 2, 0, 2, no
4854914741,  giorgiozigghy, 1, 0, 1, no
1725457507,  StefanoFlegoTS, 2, 0, 2, no
2340093135,  FasceMaura, 2, 0, 2, no
49301995,  nuogruroi, 1, 0, 1, no
3074444753,  bergantinif, 3, 0, 3, no
477904590,  elviseligio, 1, 0, 1, no
359993281,  FabiolaSmile, 4, 0, 4, no
1259513954,  beatriceravina1, 1, 0, 1, no
2937052317,  OliPelucchi, 3, 0, 3, no
2206448231,  RCoramusi, 1, 0, 1, no
3021934949,  6a0cf794181f44e, 1, 0, 1, no
731380824579379204,  DanselmoElda, 1, 0, 1, no
2199740816,  Stivilla76, 1, 0, 1, no
1642816093,  PieroCalanna, 4, 0, 4, no
3398036302,  Fabio65429206, 2, 0, 2, no
3360526845,  Dreware96, 2, 0, 2, no
2657797725,  RomeiAntonella, 6, 0, 6, no
804069973190725636,  nakusvaus, 1, 0, 1, no
3319129573,  LucaInnocenti10, 1, 0, 1, no
3172328747,  gcialot, 1, 0, 1, no
852688609,  AmorusoEmanuele, 2, 0, 2, no
768726335749513216,  martinacpl, 1, 0, 1, no
124576769,  fabiocatellani, 7, 0, 7, no
2506571955,  giulia_340, 7, 0, 7, no
380608235,  Alen_Iglicar, 1, 0, 1, no
358903756,  giangiove, 1, 0, 1, no
206608050,  Dragonfly_IT, 4, 0, 4, no
4386891287,  romi84550421, 1, 0, 1, no
1006442550,  ritarapidissima, 1, 0, 1, no
2867329397,  gianlucabaldi14, 1, 0, 1, no
1485214532,  aryaforestfawn, 2, 0, 2, no
729250648416464896,  danielegaspari6, 2, 0, 2, no
323381692,  CanzianiAngelo, 1, 0, 1, no
285707038,  frah_3, 1, 0, 1, no
898290865,  Paolo_Elefante, 1, 0, 1, no
447269967,  LuciaRisari, 1, 0, 1, no
999267692,  nadiamenotti68, 1, 0, 1, no
59455690,  gaetanomaisto, 2, 0, 2, no
804947531713089537,  mauriz66, 1, 0, 1, no
803206110912061440,  paolajapy, 1, 0, 1, no
740896451333607424,  DavideL_95, 3, 0, 3, no
501791958,  DIONISIOPUCCIO, 2, 0, 2, no
4876953141,  cosadibellu, 1, 0, 1, no
609965522,  fabios78395608, 2, 0, 2, no
804413634726207488,  JesMia85, 2, 0, 2, no
79829769,  RobertoSulliPE, 1, 0, 1, no
2521545964,  ivanzaina, 1, 0, 1, no
435810536,  fabrizio200176, 1, 0, 1, no
400766387,  WSkrety, 1, 0, 1, no
2209323881,  TiricoGianmarco, 3, 0, 3, no
633333,  Zuzzy, 1, 0, 1, no
792308866449047552,  Emmoverimm, 4, 0, 4, no
2617470937,  skaski4, 1, 0, 1, no
4583781076,  Iaya_68, 2, 0, 2, no
783059860007026688,  Pamela09uk, 9, 0, 9, no
799504439736463360,  DinaHaritoshina, 1, 0, 1, no
1249982101,  artigianima, 4, 0, 4, no
801421989009362944,  antoniotwitte16, 1, 0, 1, no
765564104,  enorpeleinad, 1, 0, 1, no
2902386166,  cresammarco, 1, 0, 1, no
716575881909706753,  kyaxel, 3, 0, 3, no
25660920,  Scapy, 3, 0, 3, no
522133054,  Paolazio260513, 2, 0, 2, no
3031516836,  Max79122253, 2, 0, 2, no
799569944858030080,  KKholueva, 1, 0, 1, no
245989170,  Sibilla86, 3, 0, 3, no
400073548,  andreagallucci1, 5, 0, 5, no
748158878332895232,  marcopepa, 2, 0, 2, no
425931009,  lisabefernandez, 10, 0, 10, no
2268685606,  gamberoni051, 25, 0, 25, no
595882332,  traficantemaria, 3, 0, 3, no
3417691187,  alessemanuela, 2, 0, 2, no
713026866198814720,  francesco19824, 2, 0, 2, no
1346736404,  HotmReimax, 3, 0, 3, no
1399368217,  michebortolini, 2, 0, 2, no
294776244,  Katkat76K, 1, 0, 1, no
4833727648,  giusti252, 1, 0, 1, no
593719448,  piallaccio, 2, 0, 2, no
966194582,  massimolaurean1, 1, 0, 1, no
268850788,  Rimmel2016, 7, 0, 7, no
122413948,  mcecilia1962, 1, 0, 1, no
2216906114,  a_lbrog, 1, 0, 1, no
728935613882314752,  silviaf110873, 4, 0, 4, no
3020693140,  OGildaO, 1, 0, 1, no
527534420,  CarloPalcone, 1, 0, 1, no
2390925721,  WilliamNumbOne, 1, 0, 1, no
1579963952,  Lisas_96, 1, 0, 1, no
437769265,  LucaGiveMeFive, 1, 0, 1, no
3025432512,  salv965, 3, 0, 3, no
764415856092774401,  Concett45774110, 1, 0, 1, no
3125007979,  escapewlore, 1, 0, 1, no
563160230,  SalandinMarco, 1, 0, 1, no
2981965797,  pacellidavide, 2, 0, 2, no
267220891,  quilivorno, 3, 0, 3, no
483374573,  paolo_volpi, 1, 0, 1, no
526293847,  armafan, 4, 1, 3, no
57062126,  GianniFiorani, 1, 0, 1, no
456463624,  SandroGadotti, 1, 0, 1, no
2341285060,  muschio97, 1, 0, 1, no
533599475,  Allibadcitizen, 1, 0, 1, no
53709214,  mito4u, 1, 0, 1, no
436654107,  daninicosia, 1, 0, 1, no
253621163,  esterines, 1, 0, 1, no
799223498145222656,  Imma54945437, 6, 0, 6, no
66161873,  Toscana5Stelle, 2, 0, 2, no
1192340720,  gio_c75, 7, 0, 7, no
61665033,  Empoli5Stelle, 1, 0, 1, no
1254790184,  ZaninottogG, 15, 0, 15, no
421266518,  GioiaPapallo, 4, 0, 4, no
514704736,  mardir71, 1, 0, 1, no
747476723470589952,  carmencapuozzo3, 1, 0, 1, no
801763337986068480,  Gigat74, 1, 0, 1, no
398996708,  zoe_marion, 1, 0, 1, no
250880308,  caramitello, 8, 0, 8, no
411699605,  AldoDAtri, 1, 0, 1, no
953404832,  alari75, 1, 0, 1, no
793405084990341120,  simogio72, 1, 0, 1, no
2799692505,  Tina_Cremona, 1, 0, 1, no
304501871,  IvanoLibero, 1, 0, 1, no
1647624913,  Delena_NianTVD, 1, 0, 1, no
2755345600,  Cecilia__95, 1, 0, 1, no
435850680,  gfliguoro, 1, 0, 1, no
2288690043,  FaustaCasti, 1, 0, 1, no
337977088,  mariaritacarate, 1, 0, 1, no
558409852,  BigRobLocanda, 1, 0, 1, no
412948497,  pablo13461, 3, 0, 3, no
3226396323,  fiorenzo7831, 2, 0, 2, no
4105916662,  luigi28fazio, 2, 0, 2, no
800855052999159808,  edc4ba5613c84d6, 2, 0, 2, no
321530359,  simonavairano, 1, 0, 1, no
1012877600,  tekila100s, 2, 0, 2, no
474982967,  DevaMati, 1, 0, 1, no
165408634,  alessandro1276, 2, 0, 2, no
719961865317715969,  kikaki7, 3, 0, 3, no
3906518420,  kiarakiara72, 4, 0, 4, no
2455729176,  silvio45451321, 2, 0, 2, no
4512939023,  AbueloKejika, 1, 0, 1, no
267728903,  ispirazionidigi, 10, 0, 10, no
531755919,  bravofernando1, 1, 0, 1, no
857003005,  FabriziaBovi, 1, 0, 1, no
923555906,  ter_rob, 4, 0, 4, no
484090897,  AloisiVittoria, 2, 0, 2, no
1053896976,  emanuela_olga, 2, 0, 2, no
801592927067795456,  seousisdome1972, 1, 0, 1, no
474838532,  caposele5stelle, 1, 0, 1, no
2284748301,  giopallo1, 2, 0, 2, no
4354071635,  roberto_sca, 2, 0, 2, no
440037168,  damenundherren, 2, 0, 2, no
420135838,  sabba_25, 2, 0, 2, no
424452650,  PaoloValesi1, 1, 0, 1, no
2771197095,  cd_tw, 2, 0, 2, no
2800847595,  luciavized, 4, 0, 4, no
2353797636,  risoinbianco, 1, 0, 1, no
797727634880864256,  leonard60931373, 2, 0, 2, no
798807159353917440,  kindpalena, 1, 0, 1, no
17783846,  maiux, 1, 0, 1, no
3123387999,  simplyMDA, 1, 0, 1, no
342727106,  MADeFilippis, 4, 0, 4, no
100197573,  davidego, 1, 0, 1, no
4076099719,  Paola33868844, 1, 0, 1, no
437408402,  fiorella0903, 1, 0, 1, no
482532412,  tiri_A, 1, 0, 1, no
318990262,  turchip, 4, 0, 4, no
877388203,  RevelloPartners, 1, 0, 1, no
840234690,  perlaperla7, 6, 0, 6, no
383197591,  frescoroberto, 1, 0, 1, no
552229388,  UMBIZZ1954, 3, 0, 3, no
331572952,  fantonangeli, 5, 0, 5, no
2791795096,  patriziaburla, 8, 0, 8, no
2614748019,  berto7865, 1, 0, 1, no
1365378122,  s_floris, 4, 0, 4, no
444438933,  acofab, 8, 0, 8, no
4798879156,  super_gufo, 2, 0, 2, no
3792460877,  Marcell45782770, 3, 0, 3, no
497119150,  giseppe4, 1, 0, 1, no
2504047919,  meschi_maria, 2, 0, 2, no
552764717,  Lino_Raimondi, 1, 0, 1, no
2356990407,  lucio_marciano, 2, 0, 2, no
240454257,  luicox, 1, 0, 1, no
2712570895,  Noesispotty, 1, 0, 1, no
101888791,  Cruze712, 1, 0, 1, no
2857870217,  DDArkadia71, 2, 0, 2, no
1310389435,  DChistoni, 1, 0, 1, no
559300555,  Marco5Stars, 1, 0, 1, no
3290183709,  73_asia, 7, 0, 7, no
854335436,  ace_storm, 1, 0, 1, no
3909491067,  Gallocchio77, 1, 0, 1, no
2869582841,  __lucyelizabeth, 3, 0, 3, no
802287002,  _ForrestGump_, 1, 0, 1, no
1083460182,  TeresaLaBella2, 1, 0, 1, no
138706772,  MauroDelCorno, 1, 0, 1, no
4289396916,  flavio_crinelli, 1, 0, 1, no
1026789085,  carlo_nardi, 3, 0, 3, no
495366392,  la_bodi, 1, 0, 1, no
2964939255,  FideliFideli79, 2, 0, 2, no
450957612,  raggioblu6, 4, 0, 4, no
4853392221,  Zeneizoide, 5, 0, 5, no
136974486,  adpersonamAnto, 3, 0, 3, no
1419413953,  Antonellodig, 4, 0, 4, no
289833088,  Fabio_V79, 2, 0, 2, no
1472157098,  FranScarpato, 1, 0, 1, no
391275039,  GelindoBaldin, 1, 0, 1, no
469236719,  GBartocci, 1, 0, 1, no
763798165,  typhoonmrc, 1, 0, 1, no
804267044963282944,  Lykos2900, 1, 0, 1, no
3242193825,  CbClabel, 1, 0, 1, no
2155938268,  roby4766, 1, 0, 1, no
559769442,  AndreaBianchi81, 1, 0, 1, no
444137874,  IleniaF1, 1, 0, 1, no
802157141108867073,  cerezo979, 1, 0, 1, no
4864104742,  Maria33759436, 2, 0, 2, no
992690058,  vincenzomazz1, 2, 0, 2, no
1015484834,  paogrilli5, 1, 0, 1, no
487592587,  dago_sky, 1, 0, 1, no
1187057971,  dinomerolli, 1, 0, 1, no
4827234328,  ricspeci, 1, 0, 1, no
1597928726,  maurizioLazze65, 4, 0, 4, no
2315573211,  lavelella, 2, 0, 2, no
801846201578586112,  PaoloSacchetti1, 13, 1, 12, no
3382770388,  itamorax, 3, 0, 3, no
203958586,  Josemm_94, 1, 0, 1, no
398426351,  iStefano85, 2, 0, 2, no
484127871,  VitoArdagna, 7, 0, 7, no
2361666815,  marialuceamelio, 6, 0, 6, no
484059817,  AleC2611, 4, 1, 3, no
606823551,  ierogamos, 1, 0, 1, no
4294512207,  albino_costanzo, 2, 0, 2, no
789869955244257280,  riservafraziona, 3, 0, 3, no
108548308,  barabba47, 1, 0, 1, no
285045023,  GiuliaCasarino, 4, 0, 4, no
412514464,  babyTiff83, 3, 0, 3, no
609827142,  PaserePhotos, 2, 0, 2, no
2227791917,  framiriello, 1, 0, 1, no
2166921829,  StormJts2009, 2, 0, 2, no
802848660551827457,  VetroDi, 3, 0, 3, no
46652864,  andysailor, 1, 0, 1, no
103242506,  UdaFabrizio, 2, 0, 2, no
1122344736,  GiancolaSilvia, 2, 0, 2, no
1006400634,  mikedells, 2, 0, 2, no
519322721,  francesca3197, 2, 0, 2, no
456924097,  IadyHawke, 2, 0, 2, no
522116554,  TittaMorandi, 1, 0, 1, no
97230100,  wollace_fi, 1, 0, 1, no
821776178,  Nicola_Berga, 7, 0, 7, no
720822916,  mt191583, 1, 0, 1, no
1635285210,  LucaStanisci, 2, 0, 2, no
344991357,  AlessandraLanz1, 5, 0, 5, no
1246641648,  mavaivia, 1, 0, 1, no
252245001,  AntoMatrisc, 1, 0, 1, no
433481180,  GaioCostarelli, 3, 1, 2, no
542766889,  DelGallo3, 5, 0, 5, no
2572493888,  MArtePress, 1, 0, 1, no
47618184,  maghirko, 2, 0, 2, no
466420763,  MalcaPortini, 1, 0, 1, no
1413908263,  grifonesrl, 2, 0, 2, no
4475013383,  Rm60Sergio, 1, 0, 1, no
2360686468,  lilfede83, 1, 0, 1, no
763435693699960833,  m_indelicato, 3, 0, 3, no
3384321525,  Mcristinasordi, 1, 0, 1, no
771824918400905216,  TechnoLarotuter, 1, 0, 1, no
275040235,  Dxer72, 1, 0, 1, no
416539898,  Gelsomino_Mimi, 1, 0, 1, no
4912238297,  PierMarcoC, 3, 0, 3, no
729333970261946368,  FilippoVigilia, 2, 0, 2, no
759291903602987009,  ArenaLazio, 3, 0, 3, no
466348695,  AC_1908, 4, 1, 3, no
147991962,  antoguerrera, 1, 0, 1, no
398087952,  giovannibotti2, 1, 0, 1, no
865933076,  GoldenLudo, 1, 0, 1, no
269842693,  massimop1970, 8, 0, 8, no
778710651447353344,  Meryy9000, 3, 0, 3, no
403454736,  gianni02g, 1, 0, 1, no
795278357420240896,  iogreg, 1, 0, 1, no
885184754,  giuseppegrisa, 5, 0, 5, no
3074913665,  L30n4rd086, 2, 0, 2, no
321911895,  liciafederer, 4, 0, 4, no
388229935,  Laura_o78, 1, 0, 1, no
72378735,  cryinglightnin_, 1, 0, 1, no
249723261,  adelaide_musso, 7, 1, 6, no
147622871,  fla_odo, 1, 0, 1, no
373997237,  IlPaolo_Ironico, 1, 0, 1, no
472042644,  MarcellaCaiazzo, 1, 0, 1, no
408370356,  SBuffagni, 4, 0, 4, no
718146673684439040,  hawkmoon1976, 2, 0, 2, no
790103246,  johnlockex, 1, 0, 1, no
1357005222,  rosalbadeangeli, 1, 0, 1, no
804422524838801408,  achetart, 1, 0, 1, no
801525216883183616,  giorgiamastrop, 3, 0, 3, no
2775040101,  GlukaBagatin, 1, 0, 1, no
532463016,  MircoRomanato, 6, 0, 6, no
264843937,  justindietta, 3, 0, 3, no
3150275694,  RamaAlden, 4, 0, 4, no
584025990,  barkovitz, 1, 0, 1, no
3739713681,  ritasei2, 1, 0, 1, no
914573593,  alfopilot, 2, 0, 2, no
99743316,  av0nsbiebss, 2, 0, 2, no
893330910,  dariuxman, 1, 0, 1, no
1063189604,  CentorbiMassimo, 1, 0, 1, no
295088615,  Ale_visual, 3, 0, 3, no
939317492,  AleMar1969, 1, 0, 1, no
492104860,  MatDelD, 3, 0, 3, no
1412456984,  GicoAnco, 1, 0, 1, no
4842510773,  Marialu30506022, 3, 0, 3, no
622267653,  louivsbae, 1, 0, 1, no
517665250,  FrancescaRicky, 1, 0, 1, no
183370196,  francomarsi, 1, 0, 1, no
2339481904,  DreamTravel59, 4, 0, 4, no
862580724,  707_massimo, 1, 0, 1, no
791370438907686912,  Luciasenatore3, 5, 0, 5, no
516923634,  pioli_d, 3, 0, 3, no
748825296,  stefanoguzzi1, 1, 0, 1, no
1137051529,  mimmolimmo, 1, 0, 1, no
415629977,  CiroTozza, 1, 0, 1, no
1259775931,  Leondelaserna, 2, 0, 2, no
581006334,  mend_jul, 4, 0, 4, no
313512813,  Cap_ultimo89, 2, 0, 2, no
100194373,  _Ninaya, 3, 0, 3, no
513526868,  salvo622012, 2, 0, 2, no
857715163,  MargheFlower, 2, 0, 2, no
2606221307,  maurirussowork, 1, 0, 1, no
908206586,  v1nc3n2o, 8, 0, 8, no
368085489,  multexreddito, 3, 0, 3, no
415161218,  mattiamisciali, 1, 0, 1, no
4228349893,  gianlucamuscolo, 1, 0, 1, no
498853740,  ElenaSpe, 1, 0, 1, no
368302931,  bucanevecri, 1, 0, 1, no
2860190313,  ermerlone, 8, 0, 8, no
3308288710,  ilconrad76, 1, 0, 1, no
928572510,  PCabriolu, 1, 0, 1, no
380447858,  micheleFuoco1, 1, 0, 1, no
443105581,  paqqua, 1, 0, 1, no
606394161,  Lorenzo2595, 2, 0, 2, no
2810439424,  puccinialessan1, 1, 0, 1, no
49551708,  DaniellaMasag, 4, 0, 4, no
447235932,  soniapascutto, 1, 0, 1, no
778517474472030208,  giani85, 2, 0, 2, no
395812442,  nikmaino, 4, 0, 4, no
704219861,  CangioliDaniele, 1, 0, 1, no
186369816,  AlbiAllevi, 1, 0, 1, no
52425615,  vikvix, 4, 0, 4, no
2444425252,  FioreseEffe, 1, 0, 1, no
755143705305186309,  CatalloAlessia, 1, 0, 1, no
386025550,  NickSperanza, 1, 0, 1, no
745995221348003840,  marco_favorito, 1, 0, 1, no
3074176598,  agostina1207, 1, 0, 1, no
2613219456,  domenico6208, 1, 0, 1, no
1374198374,  irsuti, 1, 0, 1, no
213998209,  Didenea, 1, 0, 1, no
767843726077071360,  valerioultimo, 1, 0, 1, no
58503950,  giovanni_ebasta, 2, 0, 2, no
371272198,  carlovigo, 4, 0, 4, no
169610638,  lllorik, 4, 0, 4, no
320706097,  DavideMatteoni, 1, 0, 1, no
351139362,  giusycannizzaro, 6, 0, 6, no
1274249790,  grandine66, 1, 0, 1, no
2792654073,  Thallulah, 1, 0, 1, no
719652438110838784,  marinarina47, 6, 0, 6, no
2656936986,  miss_simple407, 1, 0, 1, no
4885484931,  lucamantovano, 1, 0, 1, no
4654542682,  pcasa5, 1, 0, 1, no
1260538849,  colantoni_bruna, 1, 0, 1, no
635629118,  74_francesco, 3, 0, 3, no
1140378518,  ECuffini, 1, 0, 1, no
526465384,  UNIONFELICE, 2, 0, 2, no
469453365,  rrossella75, 1, 0, 1, no
2152454917,  cesare_pirotta, 2, 0, 2, no
781228956112580608,  adagionapulitan, 7, 0, 7, no
574252936,  MARZANIDOMENICO, 1, 0, 1, no
1960706378,  cangaceiro79, 1, 0, 1, no
389353555,  davide_del, 2, 0, 2, no
2235039294,  malatestap76, 2, 0, 2, no
50276763,  crikke77, 2, 0, 2, no
2867979837,  wassilli1975, 1, 0, 1, no
160252784,  0nephilim0, 3, 0, 3, no
2889902770,  LucaCambiasso, 1, 0, 1, no
2438714165,  MarcoChieregat1, 2, 1, 1, neutral
2362964227,  MartinoMigli, 2, 0, 2, no
3352915611,  missemi1633, 1, 0, 1, no
362563158,  PernecheleD, 1, 0, 1, no
2280644179,  RovereNaturale, 4, 0, 4, no
34635543,  tripleghy, 1, 0, 1, no
400410789,  FrostRiosalso, 1, 0, 1, no
247104999,  starmerks, 1, 0, 1, no
17469056,  GI_Aaron, 1, 0, 1, no
531417062,  danielinocosta, 1, 0, 1, no
2703693450,  brightl63656531, 3, 0, 3, no
424535659,  MCofani, 4, 0, 4, no
1121765677,  cardisa25, 1, 0, 1, no
573945946,  davidpurpura2, 2, 0, 2, no
988188680,  Formicola10, 2, 0, 2, no
3225886745,  LiottaBarbara, 1, 0, 1, no
517876006,  martons1970, 2, 0, 2, no
185696844,  Mikail211, 1, 0, 1, no
765596494380531713,  sark1946, 4, 0, 4, no
4252032136,  excalibur210964, 3, 0, 3, no
2361561634,  lapluffa, 1, 0, 1, no
3110684698,  ElioAllegra, 1, 0, 1, no
157060172,  MrLuka90, 6, 0, 6, no
1187728657,  EzioIt, 2, 0, 2, no
201640247,  Noioutdoor, 1, 0, 1, no
1022092364,  dematwit, 1, 0, 1, no
699554890075365376,  DanySpillo73, 1, 0, 1, no
1284065244,  gaschi84, 4, 0, 4, no
381426536,  rosita17rosita, 3, 0, 3, no
262736023,  glezzerini, 2, 0, 2, no
107847820,  Tremanagheie, 2, 0, 2, no
454283322,  CipollaFabio, 1, 0, 1, no
2572675230,  RodPolisher, 1, 0, 1, no
3311964753,  sissi7772, 2, 0, 2, no
222769177,  mirckqo, 1, 0, 1, no
553784534,  NunzioVioletti, 3, 0, 3, no
698787801748414464,  ElenaGrasso8, 1, 0, 1, no
605296679,  dellavallem5s, 1, 0, 1, no
2244632566,  peppecz85, 2, 0, 2, no
2297725321,  mistertitta, 1, 0, 1, no
1916350796,  lucaspagnoli71, 2, 0, 2, no
1269486295,  Raffol44, 2, 0, 2, no
1495551570,  g_gezzi, 1, 0, 1, no
2361781268,  sergiocucco, 1, 0, 1, no
399337255,  mypaperotta, 1, 0, 1, no
431401642,  francescoilguru, 1, 0, 1, no
45390666,  sardusrebel, 1, 0, 1, no
2475717514,  angelarajad, 1, 0, 1, no
792074788554608640,  vabenecarlo, 1, 0, 1, no
94851431,  AntoBlasi, 1, 0, 1, no
1296641610,  JohnEvansMusic, 2, 0, 2, no
97294115,  Osvi_Mongi, 1, 0, 1, no
299718468,  EnricoNapo, 1, 0, 1, no
380566039,  FrancescaTronca, 1, 0, 1, no
116039315,  taorminavinci, 1, 0, 1, no
555030818,  Gi_dk, 1, 0, 1, no
113714702,  tonino13, 1, 0, 1, no
2951210075,  Darione18dm, 1, 0, 1, no
1915491469,  AspireZ3100, 2, 0, 2, no
486251702,  IrateJay, 2, 0, 2, no
2866614668,  marcobiker81, 2, 0, 2, no
331804210,  antonello3007, 2, 0, 2, no
1103232462,  MariaLindaDebe, 1, 0, 1, no
199632556,  robbie0809, 1, 0, 1, no
1168288627,  ItComponenti, 3, 0, 3, no
2353756873,  driver71g, 7, 0, 7, no
4242264977,  sergioverolebo1, 8, 0, 8, no
1334712547,  sabahelher, 2, 0, 2, no
1502936358,  perstarebene, 1, 0, 1, no
728468647048404993,  profvento, 1, 0, 1, no
79702732,  alexukmma1, 1, 0, 1, no
3085555202,  terzofuoco26, 1, 0, 1, no
441701161,  silvanamaucioni, 2, 0, 2, no
466509888,  pasqualeflight, 1, 0, 1, no
1143357973,  AllDoctor85, 1, 0, 1, no
442735679,  cristianobtweet, 2, 0, 2, no
4697560933,  LorenaIrcone, 5, 0, 5, no
105854469,  peppemotta86, 1, 0, 1, no
801177795409932289,  isabelrejna, 1, 0, 1, no
412408303,  ecekko, 1, 0, 1, no
523394825,  supermalaxx, 3, 0, 3, no
194511339,  Ste_Messina, 3, 0, 3, no
2828466457,  sspolverini, 1, 0, 1, no
1317088771,  alexpicchi73, 2, 0, 2, no
2994158927,  vicky_cat02, 1, 0, 1, no
4850789769,  NicolaTintori, 2, 0, 2, no
3846764800,  francesco_barri, 1, 0, 1, no
79282660,  teramotexas, 1, 0, 1, no
431741869,  nicozetti, 1, 0, 1, no
768065295084818432,  LuigiCesarini2, 2, 0, 2, no
417778429,  pasksak, 3, 0, 3, no
28182634,  Seta_rossa, 2, 0, 2, no
3558973643,  TeresaColozzi, 2, 0, 2, no
2543565519,  vrrach, 1, 0, 1, no
805565234970841089,  frost_34, 1, 0, 1, no
1525042693,  AgneseZ97, 1, 0, 1, no
798191160066002945,  veve_86_italy, 1, 0, 1, no
2276225552,  pigall71, 1, 0, 1, no
606147435,  delloneno, 4, 0, 4, no
384927860,  stefyorlando, 4, 0, 4, no
471397261,  giulopa, 1, 0, 1, no
3907780402,  mike_onehundred, 1, 0, 1, no
539835980,  elenaswartele, 1, 0, 1, no
736908928769007616,  chawar66, 1, 0, 1, no
775077834612154369,  enzoamoruso89, 1, 0, 1, no
886409983,  aidafrancomacar, 1, 0, 1, no
1575780570,  MalfiToto, 1, 0, 1, no
50690845,  hoppuspotamus, 1, 0, 1, no
1262943984,  ChiricoGiulia, 1, 0, 1, no
534863473,  mjp4liberty, 2, 0, 2, no
802047416,  ErikaContardi, 1, 0, 1, no
2174646856,  susanninalma, 1, 0, 1, no
2203683053,  raffaelevolpe80, 2, 0, 2, no
2726719697,  CerinoEmiliano, 2, 0, 2, no
472298643,  salvatoredanie4, 2, 0, 2, no
70937566,  manomon, 2, 0, 2, no
2210939675,  LivAlberto, 1, 0, 1, no
1316198996,  flavhar, 1, 0, 1, no
635268290,  Fsabatelli, 1, 0, 1, no
436029270,  spinoleo, 6, 0, 6, no
721805202211401730,  ZampaloniMoira, 3, 0, 3, no
449072743,  joiauk, 1, 0, 1, no
30160207,  alberto_rossini, 1, 0, 1, no
799956470,  virgiliomax, 1, 0, 1, no
50314830,  lalby, 4, 0, 4, no
931821571,  cirasella61, 2, 0, 2, no
404537108,  Sballo46, 2, 0, 2, no
396463100,  SimonelliAldo, 1, 0, 1, no
791434621925920768,  DenisScudieri, 1, 0, 1, no
541079589,  luciadistefano5, 1, 0, 1, no
772508718198120448,  Paola19672, 1, 0, 1, no
2524869982,  9fd6b178a9f0410, 1, 0, 1, no
2180958723,  PieralisiRicky, 3, 0, 3, no
3207864399,  LUIGICAPOGROSS_, 2, 0, 2, no
1966284062,  CeciVittorino, 2, 0, 2, no
451436044,  SimoneMoneti1, 1, 0, 1, no
2799652340,  Antoonever, 2, 0, 2, no
3046149161,  francangelo48, 1, 0, 1, no
555085723,  cicintrip, 2, 0, 2, no
2323632758,  Villa5stelle, 5, 0, 5, no
3247227967,  that_foggyday, 1, 0, 1, no
4897612589,  Giancar01875527, 1, 0, 1, no
1038210043,  cirricawa, 1, 0, 1, no
456523196,  Leo94b, 1, 0, 1, no
1585726832,  PippoTentenna, 2, 0, 2, no
893895823,  santiagolatino4, 1, 0, 1, no
4703628013,  Pierluigi5s, 1, 0, 1, no
94653849,  irv_a, 1, 0, 1, no
506364019,  MomoDelia, 2, 0, 2, no
568073045,  Tita2179, 3, 0, 3, no
395823148,  Mik_Scattarelli, 1, 0, 1, no
128844770,  GiulioStefani, 4, 0, 4, no
117225838,  CentristNet, 4, 0, 4, no
345037144,  Korimrikom, 6, 0, 6, no
704462391938052096,  GiannazzoSanto, 3, 0, 3, no
256717862,  bitoon77, 2, 0, 2, no
307994172,  GiovanniEditore, 3, 2, 1, yes
847527014,  MiletheFrog, 1, 0, 1, no
460529921,  AgostinoGrillo, 6, 0, 6, no
538578000,  marcellaforni2, 1, 0, 1, no
182773660,  AlessioParadisi, 2, 0, 2, no
778208193709301761,  alfiodesilva91, 1, 0, 1, no
712949762857762818,  disambigua49, 3, 0, 3, no
4019107157,  mary050373, 1, 0, 1, no
326116085,  LudoPaone, 2, 0, 2, no
2172872273,  paulthomas1020, 4, 0, 4, no
490663784,  MicheleMasella, 6, 0, 6, no
428212697,  LorenzoRighetti, 1, 0, 1, no
3228198179,  026f6562bd0a48a, 6, 0, 6, no
2392610875,  AbeleS96, 2, 0, 2, no
2871241720,  mariella063, 1, 0, 1, no
3146219384,  umami5th, 1, 0, 1, no
526726795,  SCarpanese, 3, 0, 3, no
922990920,  zampieripatti, 3, 0, 3, no
430892218,  muletti88m, 1, 0, 1, no
2263824353,  fchella55, 2, 0, 2, no
3334399623,  gueli_antonella, 1, 0, 1, no
1031522772,  CorderaMagda, 1, 0, 1, no
714176524535132161,  LaFrancisella, 1, 0, 1, no
92065265,  DamianoMaggi, 1, 0, 1, no
251575467,  rodolforizzo76, 1, 0, 1, no
499029069,  FrancescaCont20, 1, 0, 1, no
805561469232443394,  fiezzo27, 1, 0, 1, no
365394974,  antonellobr, 1, 0, 1, no
4095964695,  Roberto07427240, 1, 0, 1, no
3104176366,  IosellaTacci, 1, 0, 1, no
1035183542,  dreamertom10, 2, 0, 2, no
376535256,  Kiryan15, 2, 0, 2, no
749365494130601984,  mkm1rk0, 1, 0, 1, no
2169077983,  benserk75, 1, 0, 1, no
788551456865579009,  LauraMelotti3, 1, 0, 1, no
329273552,  GiorgioDiGiaco1, 1, 0, 1, no
437613465,  IlMarronz, 1, 0, 1, no
448317601,  rossymarinaro, 2, 0, 2, no
771147650,  max_sciacca, 2, 0, 2, no
2837229892,  gsuperba, 1, 0, 1, no
723807407261011969,  PaoloPassera6, 3, 0, 3, no
347163786,  10marlau70, 2, 0, 2, no
3803131221,  novellovittorio, 2, 0, 2, no
3093565820,  picciannamaria, 2, 0, 2, no
733202402338312192,  Flawear64, 1, 0, 1, no
786594969884778496,  RuggeroMaestro, 5, 0, 5, no
1248179430,  klaudioatzori, 2, 0, 2, no
765852936014626816,  AntonellaFavali, 5, 0, 5, no
1374411655,  Marie_Jasmine_U, 1, 0, 1, no
1111669807,  tanobarone2, 1, 0, 1, no
713430888386805760,  maurodealberei, 2, 0, 2, no
290526506,  addiritturadici, 2, 0, 2, no
154824095,  Rafelisi, 1, 0, 1, no
2418563325,  renzinorenna, 2, 0, 2, no
4515142407,  Rossana57032057, 2, 0, 2, no
398629721,  KeythFin, 1, 0, 1, no
372058331,  miki1086, 2, 0, 2, no
2981988957,  rog_ri, 1, 0, 1, no
46202228,  ilpiolo, 1, 0, 1, no
780507044470198272,  hsbraven, 1, 0, 1, no
477703040,  MRaffaelino, 1, 0, 1, no
1853413428,  FrancescaLater3, 1, 0, 1, no
3333323567,  fr_eerider, 1, 0, 1, no
1152213248,  pablodotato, 1, 0, 1, no
98204739,  gio_valvassori, 1, 0, 1, no
37776782,  DanyDM, 1, 0, 1, no
407124709,  Felletti55, 1, 0, 1, no
793934453974433793,  Ciccio97PA, 1, 0, 1, no
346163733,  rhio75, 6, 0, 6, no
2325819461,  apratelli61, 1, 0, 1, no
2381791600,  fgagliano13, 8, 0, 8, no
2535748479,  apolizzotto51, 1, 0, 1, no
128495900,  alfenzo, 1, 0, 1, no
788419059301937152,  vcracolici84, 1, 0, 1, no
2247031480,  achilleshybris, 2, 0, 2, no
747776250840780801,  bocchieribeppe, 1, 0, 1, no
1071497792,  marty__23, 1, 0, 1, no
475404387,  duofabrimusic, 1, 0, 1, no
1379345592,  giangiulio_carm, 1, 0, 1, no
1278949189,  LgTumolo, 1, 0, 1, no
4044878537,  luasat71, 1, 0, 1, no
2394970593,  daa5b93e9a104eb, 2, 0, 2, no
290884637,  Luca_Giacomelli, 1, 0, 1, no
2332346138,  mammolita72, 1, 0, 1, no
269019138,  cipo3282, 2, 0, 2, no
359308513,  simonaruggeri_, 1, 0, 1, no
1274890934,  SoniaDeLazzer, 1, 0, 1, no
1224992959,  stefano_biotto, 1, 0, 1, no
580880845,  Guybrush964, 1, 0, 1, no
989486672,  ritapinna7, 2, 0, 2, no
4142110199,  Davide94Bjj, 1, 0, 1, no
4908625900,  Elid78Elisa, 2, 0, 2, no
3351139683,  taituyeshi, 2, 0, 2, no
2604312407,  mariagraziabon, 1, 0, 1, no
732840775,  GianlucaCurti1, 5, 0, 5, no
3297574539,  RitaRitabosco2, 1, 0, 1, no
2853690197,  gcarpesh, 1, 0, 1, no
161164067,  silvialensi, 1, 0, 1, no
803931008227799040,  John_SunriseNo, 1, 0, 1, no
796194001,  GiovannaScialla, 1, 0, 1, no
560577301,  antoazzu, 1, 0, 1, no
2853895743,  bitontikr, 1, 0, 1, no
419019604,  M5SFrance, 3, 0, 3, no
3037223092,  pietrangelosan1, 1, 0, 1, no
15336354,  triplemax, 1, 0, 1, no
612027693,  GiuseppeBorzi2, 1, 0, 1, no
83557217,  pierodepascale, 1, 0, 1, no
320840015,  enzosen, 5, 0, 5, no
754220905413378048,  vitomalfa, 1, 0, 1, no
138349879,  nedz72, 1, 0, 1, no
2234348555,  crepasfigli2, 1, 0, 1, no
429226101,  BAIOCCOPAOLA, 3, 0, 3, no
256254309,  CAROLYNN1949, 2, 0, 2, no
1021693554,  alfredilullo, 1, 0, 1, no
2951057926,  daveesupremacy, 1, 0, 1, no
785165792270749698,  tiberiom211, 6, 0, 6, no
789003725394280448,  Pocha1997_, 2, 0, 2, no
759414686072901632,  angelatub73, 1, 0, 1, no
1464376202,  TizianaAste, 1, 0, 1, no
791602493469913093,  MRitaG65, 5, 0, 5, no
2501161878,  ludimatwitt, 1, 0, 1, no
540370998,  _cusano, 1, 0, 1, no
1248853178,  clickpazzia, 2, 0, 2, no
2813738574,  OnlyRealtruthie, 1, 0, 1, no
608217046,  bartalo71, 5, 0, 5, no
69307922,  cristinabari, 2, 0, 2, no
501003185,  GianfrancoSant3, 1, 0, 1, no
698085001380937729,  deboraderai, 1, 0, 1, no
748542289853751296,  ElisaSPoulain, 3, 0, 3, no
945386772,  KalimbaClub, 1, 0, 1, no
418688411,  esangian, 2, 0, 2, no
4300612829,  ludovica_acri, 6, 0, 6, no
2296207141,  Trismoon23, 4, 0, 4, no
2339948812,  AmicoCol, 1, 0, 1, no
736664723505086464,  KahlerSabrina, 4, 0, 4, no
4386239236,  DrLMI1, 3, 0, 3, no
790626445278212096,  fedegranella, 3, 0, 3, no
743185656051081217,  SalviusJuve, 1, 0, 1, no
2594958926,  millimcafe, 2, 0, 2, no
734345496,  Fmandri87, 2, 0, 2, no
245947109,  Wasp19__, 1, 0, 1, no
79991599,  nogarin, 1, 0, 1, no
712808587446378496,  itsmedavide9, 2, 1, 1, neutral
463784862,  Bugs_mv, 1, 0, 1, no
35252397,  ginaswo, 2, 0, 2, no
4139076737,  MortgageAgents1, 3, 0, 3, no
879086671,  NJMadeline, 1, 0, 1, no
112582208,  EgoAnglus, 1, 0, 1, no
767194625329209345,  Gazzotti_F, 1, 0, 1, no
162691129,  jepsantamato, 1, 0, 1, no
320168319,  Mao_Ferla, 1, 0, 1, no
91993668,  CarloCosolo, 1, 0, 1, no
449940001,  Giu_lia_18, 1, 0, 1, no
324024931,  callmykikko, 2, 0, 2, no
231433929,  Baxysam, 3, 0, 3, no
707825864,  La_Nene10, 1, 0, 1, no
417275168,  ninfadora75, 3, 0, 3, no
758984403422810112,  SandrucciJacopo, 2, 0, 2, no
2359630247,  simoVANZ, 1, 0, 1, no
2338630951,  gioperarch, 2, 0, 2, no
55817524,  IlGualty, 2, 0, 2, no
191574580,  tanocanario, 3, 1, 2, no
804384381280382976,  Vince110272, 1, 0, 1, no
56757699,  ilmattia, 1, 0, 1, no
613350364,  GherardoLiguori, 1, 0, 1, no
322699816,  attilio24, 1, 0, 1, no
1334529307,  sserinlove, 2, 0, 2, no
2256679742,  Ferraresi_V, 1, 0, 1, no
50338513,  iMoliere, 2, 0, 2, no
737526030907232256,  francesco_fonti, 13, 0, 13, no
839626670,  str_le, 3, 0, 3, no
183141313,  MotorShowBo, 1, 1, 0, yes
102362492,  daniele_ferrari, 1, 1, 0, yes
2561544488,  tortelliniandc, 1, 1, 0, yes
4874295778,  Golf_Del_Ducato, 1, 1, 0, yes
832236301,  CarloMoceo, 1, 1, 0, yes
486001523,  giovannalucian4, 1, 1, 0, yes
411420275,  Eraclito99, 3, 3, 0, yes
16307913,  marcogallicani, 1, 1, 0, yes
415883464,  cospasq, 1, 1, 0, yes
802743952919109632,  ongravwelstrap1, 1, 1, 0, yes
451701684,  VitolucioRuoti, 1, 1, 0, yes
3153522494,  mgianluca1976, 1, 1, 0, yes
554514035,  Liberato54, 1, 1, 0, yes
1394823487,  MAnnicchiaric, 1, 1, 0, yes
434826176,  aneresblu, 2, 1, 1, neutral
150790521,  AndreaFabbo, 1, 1, 0, yes
719539943186526209,  Andreamasoni1, 1, 1, 0, yes
370320664,  BBonazzi, 1, 1, 0, yes
60875634,  AUSLBologna, 3, 3, 0, yes
1419031309,  camomilla19, 1, 1, 0, yes
274554049,  moriroberta, 1, 1, 0, yes
1205923694,  awlky, 2, 1, 1, neutral
3557708061,  MartaEvangeli10, 1, 1, 0, yes
370747500,  Soni_Es, 2, 2, 0, yes
460809256,  MLancissi, 1, 1, 0, yes
428311657,  ermirapg, 1, 1, 0, yes
106168820,  josefaidem, 1, 1, 0, yes
2184527330,  Patrizia1965Di, 1, 1, 0, yes
203512576,  Mperadotto, 1, 1, 0, yes
407833309,  Roc_and_Roll, 1, 1, 0, yes
746633514959896576,  vicreed6, 1, 1, 0, yes
2656585709,  adele_concolino, 1, 1, 0, yes
4770365541,  radicalicosenza, 1, 1, 0, yes
2728974960,  ViggianiM, 1, 1, 0, yes
259347985,  wendySfB, 2, 2, 0, yes
758205897915113472,  eu_are, 1, 1, 0, yes
2441568395,  CesaRincesa, 1, 1, 0, yes
291651238,  MarconiClaudio, 1, 1, 0, yes
700516245,  coccinigliarose, 1, 1, 0, yes
724912659162865665,  4a8cd2c6f4e54cb, 1, 1, 0, yes
54226483,  larenait, 1, 1, 0, yes
222238943,  GianDeiBrughi, 1, 1, 0, yes
360793368,  baggvale, 1, 1, 0, yes
735730894711881729,  triggersmike, 1, 1, 0, yes
799436414949740544,  Iacopo_Jacojone, 1, 1, 0, yes
4918685471,  boringia, 1, 1, 0, yes
1167459253,  MarinoRausa, 4, 1, 3, no
799522890005835779,  medialabunipi2, 1, 1, 0, yes
574642927,  montellamonica, 14, 0, 14, no
868681170,  NickRemix, 1, 0, 1, no
86611813,  aliceverdino, 2, 0, 2, no
407380746,  fracocu, 6, 0, 6, no
796442684940427266,  Ginoberna55, 3, 0, 3, no
2745513875,  hoping2000, 1, 0, 1, no
2535998835,  DemoDirettaPart, 1, 0, 1, no
802212091709026305,  StellaFedra, 1, 0, 1, no
757860425451077632,  chiodino1938, 5, 0, 5, no
1260160800,  teresa_zotta, 9, 0, 9, no
787726419149352960,  FrancyBike65, 1, 0, 1, no
972579685,  melanie_rossi, 1, 0, 1, no
896261767,  ANTONIOCIMINEL1, 2, 0, 2, no
441213910,  bellucoantonio, 1, 0, 1, no
752975877517041669,  Nella70476696, 1, 0, 1, no
364323523,  MicaOrne, 1, 0, 1, no
28352472,  WineRoland, 1, 0, 1, no
2250183727,  Paolina_BB, 3, 2, 1, yes
806655240,  luca_biasioli, 2, 0, 2, no
1219276116,  StefanoPetro, 2, 0, 2, no
3015183569,  zed_xx, 1, 0, 1, no
740614837647093761,  Marnev56, 3, 0, 3, no
418518953,  MichelaJandolo, 1, 0, 1, no
3367527737,  LucaBen80, 3, 0, 3, no
1727305202,  mrphantom96, 1, 0, 1, no
84890964,  ernestolacanna, 3, 0, 3, no
967057728,  RBulgarelli1, 4, 0, 4, no
4866946060,  Serena34573349, 4, 0, 4, no
1479816176,  candidopao, 14, 0, 14, no
724325815756967937,  PaxetBonumLux, 2, 0, 2, no
3002785552,  ritfernov, 1, 0, 1, no
741520828504911872,  mau240958, 5, 0, 5, no
241991497,  Aldostreppa, 1, 0, 1, no
706900272,  Maxprimis, 2, 0, 2, no
220976355,  giancriMi, 4, 0, 4, no
419122011,  Roberto_Galgani, 2, 1, 1, neutral
763291960727760897,  LaCroix240816, 2, 0, 2, no
2307403408,  arjanedda, 1, 0, 1, no
369379110,  ninobarone01, 1, 0, 1, no
969923378,  am30969, 2, 0, 2, no
559559659,  enzorsini, 1, 0, 1, no
776714498795311104,  Cesare73803790, 5, 0, 5, no
2505630769,  halabama_man, 1, 0, 1, no
1302464240,  giovannipapa31, 3, 0, 3, no
1228087620,  toninter75, 6, 0, 6, no
4076297056,  Michela93772993, 1, 0, 1, no
776144281,  simonon77, 5, 0, 5, no
2932297229,  arceri_gerardo, 1, 0, 1, no
2226319458,  LadyRanja, 2, 0, 2, no
325094307,  RizMarcoBeccari, 1, 0, 1, no
54939844,  IvanNFG, 4, 0, 4, no
242958381,  letmebex, 1, 0, 1, no
471486462,  Gab78asr, 3, 0, 3, no
701359002496716800,  MassimoAllinoro, 5, 0, 5, no
897447138,  ProfiloBoemo, 2, 0, 2, no
1107229501,  fabricoli, 1, 0, 1, no
722387472848695296,  AntiJournalT, 2, 0, 2, no
1553893082,  MarcoMarcoran, 2, 0, 2, no
704614221192044544,  PanGianpiter, 10, 0, 10, no
556307020,  MauriziaFarinel, 1, 0, 1, no
761901618107387904,  AlFango1, 2, 0, 2, no
2219220328,  loluleda, 6, 0, 6, no
2584756455,  miamarylun, 2, 0, 2, no
529759031,  ritagoi, 2, 0, 2, no
1132209026,  lucagoaten, 1, 0, 1, no
3324316822,  sergio25071964, 1, 0, 1, no
2567098531,  lauraefrican, 1, 0, 1, no
1148897880,  ArotaderomaTito, 2, 0, 2, no
2355048536,  LibanoStefano, 2, 0, 2, no
793504466007973889,  Mariasa95935048, 5, 0, 5, no
802812190411681792,  marcellinus1974, 1, 0, 1, no
2613980914,  alegreg71, 2, 0, 2, no
3397077149,  SferrinoVito, 3, 0, 3, no
2273437220,  StopoLT, 2, 0, 2, no
532609504,  palmas62, 1, 0, 1, no
147501849,  robertaperlini, 1, 0, 1, no
228335333,  Moketoveto, 4, 0, 4, no
271879224,  gashaquietstorm, 1, 0, 1, no
951890166,  vincal1, 3, 0, 3, no
1319334121,  DifendiRoma, 1, 0, 1, no
1042815667,  Nino_Damiano, 1, 0, 1, no
759292043973758976,  DukaLuli, 2, 0, 2, no
2320511389,  Robertoera75, 1, 0, 1, no
1222637010,  Michele20590389, 1, 0, 1, no
465486423,  lucianobaldassa, 1, 0, 1, no
500574143,  gianluc54097412, 2, 0, 2, no
1088672947,  serenasantoro3, 12, 0, 12, no
4538649137,  eugeniomaba, 2, 0, 2, no
1039374985,  SergioLoddo2, 1, 0, 1, no
793217482316193792,  EugeniaFrances2, 5, 0, 5, no
497238693,  MauroBregoli, 1, 0, 1, no
1928371358,  nicolettadamare, 2, 0, 2, no
87370820,  AlexMariniTN, 4, 0, 4, no
1070923920,  AlexSpe75, 2, 0, 2, no
3338378788,  GiMarfi, 3, 0, 3, no
379706636,  Yle_TheWall, 6, 0, 6, no
449635271,  DePaolino, 1, 0, 1, no
1040122507,  maury2762, 3, 0, 3, no
701338375643594752,  Fanrizio21, 1, 0, 1, no
4200248956,  gioy21, 2, 0, 2, no
1491175380,  GaetanDiLena, 3, 0, 3, no
38103794,  giallo24, 3, 0, 3, no
1246270873,  raffaelepiemon2, 6, 0, 6, no
1379208858,  ortolanloris, 1, 0, 1, no
1336067024,  TranchinaFabio, 2, 0, 2, no
1298570959,  MaScaramella, 1, 0, 1, no
785530954920161280,  Rita_M57, 1, 0, 1, no
1420741524,  stefano_dart, 1, 0, 1, no
4797691731,  arcadiocataldo1, 3, 0, 3, no
715632223664398336,  AlexDL78, 1, 0, 1, no
3346612277,  AlbertoRicciar3, 1, 0, 1, no
3957207015,  marangellamart1, 1, 0, 1, no
396497515,  Stepieru, 8, 0, 8, no
472954931,  AndreaCorea1, 1, 0, 1, no
469103936,  m_vale78, 5, 0, 5, no
4076059463,  barbara22ema30, 1, 0, 1, no
456854642,  passetour, 1, 0, 1, no
2801571939,  DistabileG, 1, 0, 1, no
1116879944,  antoniocuomo20, 1, 0, 1, no
420445452,  wlasky1000, 6, 0, 6, no
1052916824,  Ateoman2009, 2, 0, 2, no
2417297936,  francocaradonio, 1, 0, 1, no
3351830099,  PrestiDaniela, 2, 1, 1, neutral
470301475,  MontanaWalter, 2, 0, 2, no
2377259598,  M5SVibor, 3, 0, 3, no
402085531,  neviods, 1, 0, 1, no
2351795462,  rosannaeliseo, 1, 0, 1, no
100530020,  gtaffelli, 2, 0, 2, no
21276839,  mdogbillionaire, 1, 0, 1, no
3406161766,  paolo_trobbiani, 2, 0, 2, no
884964986,  SerroniMarco, 1, 0, 1, no
2534372572,  FavoniGiorgio, 2, 0, 2, no
2344846407,  CiaoNando, 6, 1, 5, no
441253433,  marco10579, 3, 0, 3, no
740493001248673792,  jovannissimo, 3, 0, 3, no
754260182713204736,  ZenzeroAcido, 1, 0, 1, no
992696286,  a_ruzzante, 1, 0, 1, no
722758789036957696,  alessio071204, 1, 0, 1, no
3131554253,  cesarevassalli, 3, 0, 3, no
3144494615,  giulrioss, 7, 0, 7, no
2910869781,  pinorussobat, 1, 0, 1, no
389430038,  Gi8M, 5, 0, 5, no
1083204576,  raissa_iannacci, 1, 0, 1, no
181119521,  marck_77, 1, 0, 1, no
1251971718,  Mazarinabroglia, 2, 0, 2, no
733599179906240513,  SartoriGiovann3, 4, 0, 4, no
465389756,  cinco84, 2, 0, 2, no
3044045152,  gluca0, 1, 0, 1, no
575630130,  MimmoPetrella, 1, 0, 1, no
155093398,  iliesyle, 3, 0, 3, no
2910727479,  respectjungle, 2, 0, 2, no
2346974944,  SArcidiacon, 2, 0, 2, no
2512880848,  mimmomarga, 1, 0, 1, no
715883458359398400,  martacasuccio1, 1, 0, 1, no
1402740133,  ldicarlo1, 1, 0, 1, no
778671333853040642,  VincenzoAscanio, 3, 0, 3, no
532545386,  giuseppemormino, 1, 0, 1, no
774226398961631232,  gcamiciotti1, 1, 0, 1, no
741622785122930688,  Clara33517091, 6, 0, 6, no
390752714,  coar87, 1, 0, 1, no
4902430509,  nono_b_28, 2, 0, 2, no
1017977773,  chiaraturchi63, 1, 0, 1, no
1131283195,  ElleLuciotto, 1, 0, 1, no
1063725882,  palumbo_carlo, 4, 0, 4, no
2330094224,  LoDiChi, 2, 0, 2, no
4615130548,  Monicamelloni1, 4, 0, 4, no
3433894977,  mazzeoemanuele1, 3, 0, 3, no
708280503795851264,  e_scarpino, 2, 0, 2, no
2631193317,  SpecaDaniela, 1, 0, 1, no
387770884,  M5SROMA14, 7, 0, 7, no
1077077449,  M5SRoma7, 7, 0, 7, no
2234825179,  2MunicipioRoma, 7, 0, 7, no
1362048522,  M5SRomaIV, 7, 0, 7, no
2343427327,  M5SRomaVIII, 7, 0, 7, no
871504855,  M5SROMAVI, 7, 0, 7, no
903430776,  M5SRomaXII, 7, 0, 7, no
472928902,  M5SROMAX, 7, 0, 7, no
1088527944,  M5SROMAV, 7, 0, 7, no
1026985548,  marcello_devito, 8, 0, 8, no
20736494,  max1mo4you, 6, 0, 6, no
1122681396,  M5SRomaXV, 7, 0, 7, no
1346721164,  M5SRXI, 7, 0, 7, no
131292189,  M5SRoma, 7, 0, 7, no
607286270,  M5SRoma9, 7, 0, 7, no
946701314,  M5SRoma1, 7, 0, 7, no
2308628263,  M5SRoma13, 7, 0, 7, no
3695701275,  robertoedue, 1, 0, 1, no
234929591,  poeboston, 2, 0, 2, no
798213135803023360,  AlessandroConi6, 2, 0, 2, no
1316027886,  a_ultimo, 3, 0, 3, no
1225904144,  yallama1, 2, 0, 2, no
2382424494,  gepy61, 2, 0, 2, no
2466339133,  Alfa_Phi, 2, 0, 2, no
738108664033185792,  Roma66056163, 3, 0, 3, no
20446798,  giampaolo19, 1, 0, 1, no
2305637082,  adrysns916, 2, 0, 2, no
3790217597,  pierrotriste, 3, 0, 3, no
3833401401,  ZweiundDreiszig, 1, 0, 1, no
746936386754912256,  ciccio846, 4, 0, 4, no
129576770,  stefbianchi, 1, 0, 1, no
715634542363729920,  kemalerdem777, 3, 0, 3, no
4872044806,  MassimoAlibert2, 1, 0, 1, no
711066251,  csa1976, 3, 0, 3, no
404405791,  Juvecele, 1, 0, 1, no
476179115,  CiccioPace, 5, 0, 5, no
3387234539,  thomasulmers, 1, 0, 1, no
730372688003338240,  ritabrigidaM5S, 3, 0, 3, no
401324048,  ClaudioFratini, 3, 0, 3, no
740094487,  gioiaeodio, 1, 0, 1, no
134058065,  DotIngAleFroc, 1, 0, 1, no
59069716,  Micslama, 2, 0, 2, no
714814345100791808,  LisaMartoni2015, 4, 0, 4, no
4919384266,  luludisa1969, 5, 0, 5, no
792646804751970304,  Marco_Giorgilli, 2, 0, 2, no
1435611025,  The_Rain_Man, 2, 0, 2, no
764752555834474496,  Retwitto_stelle, 2, 0, 2, no
2157178129,  LilloSferio, 2, 0, 2, no
3404959493,  Oshakowski, 3, 0, 3, no
422646984,  EzioFederici, 1, 0, 1, no
784829184682106880,  DaniloAsr1979, 1, 0, 1, no
722164688340049920,  Wendyluglio, 1, 0, 1, no
122520593,  chiamatemistiv, 3, 0, 3, no
505733936,  emiliano_po, 3, 0, 3, no
2158629268,  paoloemilius, 1, 0, 1, no
2905060763,  tizakamario, 2, 0, 2, no
777501425576341504,  Roberto74365145, 1, 0, 1, no
368574158,  paolocolocci, 6, 0, 6, no
1266769243,  BattDe, 1, 0, 1, no
1086912564,  fortealfredo70, 2, 0, 2, no
3481510162,  MarcoMosc1, 5, 0, 5, no
604451498,  czstratocaster, 2, 0, 2, no
15943109,  emanuel3, 1, 0, 1, no
1322452531,  francoamatulli1, 2, 0, 2, no
3293224625,  Atreyu976, 1, 0, 1, no
3311604711,  perlacasa01, 1, 0, 1, no
564429315,  DavideDelprato, 1, 0, 1, no
107082839,  MaryDil, 1, 0, 1, no
787235942,  charl1853, 2, 0, 2, no
789980429155721217,  RParodirg1, 2, 0, 2, no
2849986283,  mariacr76934354, 1, 0, 1, no
291245199,  adigiamba, 5, 0, 5, no
4277803971,  marcellocustom1, 1, 0, 1, no
486664655,  paoloviancini, 2, 0, 2, no
184747714,  gregory_cocco, 5, 0, 5, no
513790402,  diStasioStefano, 1, 0, 1, no
132432431,  romacaput_mundi, 1, 0, 1, no
2304409155,  MMartelli6, 1, 0, 1, no
485148799,  sherasade1958, 2, 0, 2, no
2301498411,  ginocicchini, 1, 0, 1, no
774239929865998336,  giorgio21507586, 1, 0, 1, no
3131529981,  riccardomich, 6, 0, 6, no
4318412477,  ClaudiaFische, 5, 0, 5, no
2707579435,  frappapara, 1, 0, 1, no
2472444574,  GrandoRoberto, 2, 0, 2, no
4610380588,  ilenewinkler201, 4, 0, 4, no
2276807984,  infobixio, 1, 0, 1, no
359861181,  CarloCarlo199, 2, 0, 2, no
4608384377,  annarighi15, 4, 0, 4, no
1037401735,  oleksandr69, 1, 0, 1, no
1719352879,  giggiodelprete, 2, 0, 2, no
989571222,  ANTONIOZOPPELLO, 2, 0, 2, no
455042529,  Assuntina54, 4, 1, 3, no
472222755,  stefaniarain, 1, 0, 1, no
444613355,  ramon7856, 3, 0, 3, no
392332017,  IShehi, 1, 0, 1, no
4189113322,  ma_ki_max, 1, 0, 1, no
2842602671,  MargheChiti, 1, 0, 1, no
76906137,  MarcelloPorcasi, 6, 0, 6, no
2356613778,  ArturoForlano, 1, 0, 1, no
3939868781,  VIIcomandamento, 2, 0, 2, no
3435357142,  Juandoc2, 1, 0, 1, no
785379659466899456,  SaraWmenica, 3, 0, 3, no
1225470488,  marioazzolina, 1, 0, 1, no
800163036,  peppealoax, 3, 0, 3, no
377872873,  3filetti, 4, 1, 3, no
473046356,  Hanry12, 1, 0, 1, no
2243577362,  rob_arci, 1, 0, 1, no
1222653246,  pie13748, 13, 0, 13, no
1893283914,  ghisla99, 2, 0, 2, no
1876846094,  GrilliniArdea, 5, 0, 5, no
4775690980,  amoredemamma, 1, 0, 1, no
419823209,  Barbara19691, 1, 0, 1, no
2984820215,  CianoLeone, 5, 0, 5, no
392324691,  gianmaria2011, 6, 0, 6, no
794277942427844616,  Davebrignoli, 1, 0, 1, no
8620162,  apecar, 2, 0, 2, no
1100581142,  1957Elton, 1, 0, 1, no
703776920,  felicemarano, 3, 1, 2, no
3026638931,  DKiupp, 6, 0, 6, no
407187512,  AnninaLubbock, 1, 0, 1, no
796058021784879104,  carmelo96811844, 3, 0, 3, no
1002163952,  CondottiG, 1, 0, 1, no
1440629558,  nunziabonita, 3, 0, 3, no
359899396,  Ellibec, 1, 0, 1, no
2543645621,  maurodellanna, 1, 0, 1, no
4873134448,  guiderdone57, 1, 0, 1, no
382015339,  giufechi2003, 1, 0, 1, no
716719928028631040,  angfra1998, 1, 0, 1, no
3419625731,  Ben68011410, 3, 0, 3, no
3384524717,  nomoreviction, 1, 0, 1, no
2689925565,  rosalbacola50, 5, 0, 5, no
488533911,  FrancescoRizz22, 1, 0, 1, no
1321212242,  gengj78, 1, 0, 1, no
1487351570,  SpagnoloPaola, 3, 0, 3, no
1026241580,  ludesa30, 3, 0, 3, no
798216901071687680,  PistolaMauro1, 1, 0, 1, no
1713720703,  Nonno_Carlo, 2, 0, 2, no
3057522160,  FerrettoLorenzo, 1, 0, 1, no
1551364297,  alem4you, 1, 0, 1, no
700664229376847874,  pascal777rm, 2, 0, 2, no
459556967,  antonietta_giu, 1, 0, 1, no
364797484,  mikosemily, 7, 0, 7, no
4259508101,  MauroMoretti20, 4, 0, 4, no
1719318895,  CarloFiscalini1, 5, 0, 5, no
2847131057,  echopetra, 1, 0, 1, no
805179730110611457,  valenzia2202, 1, 0, 1, no
1244059747,  sancit71, 1, 0, 1, no
706793935180537857,  AMProbo, 3, 0, 3, no
251351863,  MarieFarret16, 1, 0, 1, no
774625071059050496,  Lazzaro1969, 1, 0, 1, no
517751958,  benlau99, 3, 0, 3, no
3236866227,  dangelofra1, 1, 0, 1, no
488618381,  Claudio_M5S, 4, 0, 4, no
723877334,  margheritini, 2, 0, 2, no
143590548,  FabbioSabatini, 1, 0, 1, no
2270253242,  CarmineC_, 3, 0, 3, no
2238091980,  Port1Di, 1, 0, 1, no
3372717964,  lilly29princess, 7, 0, 7, no
1077453158,  ziccla, 1, 0, 1, no
612314316,  afab69, 5, 0, 5, no
376307086,  iulius1980, 1, 0, 1, no
83904123,  MelToBeWilde, 3, 0, 3, no
454921223,  marco_tufo, 1, 0, 1, no
406165467,  FRAtiminoRI, 1, 0, 1, no
1099414640,  PaoloPaolor, 2, 0, 2, no
3147687143,  max_ostia, 1, 0, 1, no
1861601461,  Oblio62, 1, 0, 1, no
4622433142,  saraantonelli15, 4, 0, 4, no
3047948086,  DalfinoMarcello, 2, 0, 2, no
414554793,  AlePizzuti, 3, 0, 3, no
471151069,  photovale21, 1, 0, 1, no
2400697528,  ImIvano, 2, 0, 2, no
586539054,  deltavictor75, 1, 0, 1, no
430166728,  domenicopiro, 1, 0, 1, no
2361454653,  OfficinaCrima, 2, 0, 2, no
3394746226,  alexandercaper1, 2, 0, 2, no
266198278,  max_tir, 2, 0, 2, no
235831481,  Michelle_rv604, 6, 0, 6, no
483854366,  ElioDiBella, 4, 0, 4, no
164235748,  magara77, 2, 0, 2, no
988029930,  brunaperrini, 4, 0, 4, no
747491522413731840,  andrelapeste, 1, 0, 1, no
1369959745,  diegodettodedy, 1, 0, 1, no
507971362,  ita991, 1, 0, 1, no
742113352319705088,  antongiglio, 1, 0, 1, no
878518842,  MykyCorsari, 1, 0, 1, no
1938878952,  Romule10, 2, 0, 2, no
78392326,  ilbanale, 1, 0, 1, no
189880084,  ferruccio_p, 4, 0, 4, no
3151556691,  clodraiola, 1, 0, 1, no
577122304,  giodarcoonlus, 1, 0, 1, no
3172743856,  dionisimattia, 2, 0, 2, no
4863913085,  bici_live, 4, 0, 4, no
925999238,  jacopocitterio, 1, 0, 1, no
1228542182,  gingimela, 1, 0, 1, no
336555320,  didimanc, 1, 0, 1, no
759734861586325505,  alessandro41168, 1, 0, 1, no
216759861,  simonarocchi, 1, 0, 1, no
3136221652,  marcoluch, 3, 0, 3, no
4624659274,  margherita7799, 3, 0, 3, no
55220422,  anneriittac, 1, 0, 1, no
797567182666350594,  rita74angelini, 1, 0, 1, no
495514379,  enkaipanJ, 2, 1, 1, neutral
2337708335,  T1z1an0, 17, 0, 17, no
229160327,  marcoranieri72, 4, 0, 4, no
125962407,  a_elle, 2, 0, 2, no
121553628,  Danitosc, 1, 0, 1, no
783344169041485825,  CesarinoTassoni, 1, 0, 1, no
20802488,  veloroo, 2, 0, 2, no
3962676802,  mmspm1403, 2, 0, 2, no
2176226463,  Passa92W, 1, 0, 1, no
553959228,  AlbertoIlaria, 9, 0, 9, no
1053530935,  LorenzoZamburru, 1, 0, 1, no
178803896,  grimmo78, 1, 0, 1, no
501982093,  icouldbeDebbie, 1, 0, 1, no
202166644,  gcarrarm, 3, 1, 2, no
1288422541,  giulioriotta, 3, 0, 3, no
399366563,  Biziov69, 1, 0, 1, no
456782206,  dgsquare2, 1, 0, 1, no
426849929,  FBXII, 2, 0, 2, no
478124356,  ellepuntopi, 1, 0, 1, no
521674910,  wimjsi, 3, 0, 3, no
2810187580,  verocorniciaio, 2, 0, 2, no
54661587,  voiager33, 1, 0, 1, no
1039609963,  RAFFAELLAMILAN1, 1, 0, 1, no
3048022054,  picc_pic, 1, 0, 1, no
498306432,  Sarirana84, 1, 0, 1, no
574738634,  MANCU_LI_CANI, 1, 0, 1, no
1018057250,  CarlottaGrande1, 1, 0, 1, no
1104420319,  CarlaRusin, 7, 0, 7, no
264429396,  antodicarlo, 1, 0, 1, no
15968004,  walterfantauzzi, 1, 0, 1, no
1710490044,  luisannamesseri, 2, 0, 2, no
622755007,  alessandropaso, 1, 0, 1, no
2279333173,  orsomarrone, 5, 0, 5, no
800699105118810112,  Albani_Hills, 3, 0, 3, no
3169890556,  CardilliClaudia, 1, 0, 1, no
422607723,  SaraCanducci, 1, 0, 1, no
432779927,  maxcarlesimo, 5, 0, 5, no
292260257,  AgostiniValeria, 1, 0, 1, no
604690306,  soniamarghe, 1, 0, 1, no
4738484242,  tella_free, 1, 0, 1, no
387165791,  diannaftlea, 2, 0, 2, no
795410113544802304,  andrea_tropeano, 1, 0, 1, no
2803441027,  TinaDasti, 3, 0, 3, no
186593878,  ClotiOrny, 1, 0, 1, no
1168778490,  Flori92, 1, 0, 1, no
907919298,  angqwe, 1, 0, 1, no
702809833,  soloaivlis, 1, 0, 1, no
1377883285,  Angelo_Bruno89, 1, 0, 1, no
805884499032739844,  roxydimaggio, 2, 0, 2, no
2252373657,  Fba966, 1, 0, 1, no
1333771333,  wannabefritzl, 2, 0, 2, no
285009953,  gaetanodemare, 3, 0, 3, no
491288320,  Kekkazzolekappa, 2, 0, 2, no
801507896165093376,  Rickii70, 1, 0, 1, no
1259204922,  FabFilizzola, 1, 0, 1, no
3430718068,  urbanmirrors, 1, 0, 1, no
1420699964,  PazzoGabbiano, 1, 0, 1, no
772722230761578496,  angeloaaa86, 1, 0, 1, no
1894932806,  francy6510, 4, 0, 4, no
2481673542,  FrancediSabato, 1, 0, 1, no
14840162,  fitsnews, 1, 0, 1, no
754075116783435781,  RosannaCatalan7, 2, 0, 2, no
747000185977507840,  krolsandrine, 1, 0, 1, no
801326327395708928,  silashinafn, 1, 0, 1, no
1558070772,  Mic_DAlessio, 1, 0, 1, no
223951853,  sabrinabenjumea, 2, 1, 1, neutral
2262704766,  LuigiPezzulo73, 1, 0, 1, no
515611930,  MarinoDalia, 1, 0, 1, no
758282229487398912,  ocusfocus5, 1, 0, 1, no
387762782,  erasmodaroma, 9, 0, 9, no
397366465,  StontoGrazia, 4, 0, 4, no
2578134970,  enricomorg77, 4, 0, 4, no
4835104781,  MiCozzoli, 1, 0, 1, no
3130577031,  diarioromano, 4, 0, 4, no
1306999220,  RQuadrano, 1, 0, 1, no
316033868,  simonapedone1, 1, 0, 1, no
570076370,  BrunoBattaglia6, 1, 0, 1, no
912248084,  gian_3vi, 4, 0, 4, no
717651068759511044,  FabrizioRusso, 1, 0, 1, no
52352441,  santre1977, 5, 0, 5, no
2332474422,  Rafdec59, 1, 0, 1, no
555851815,  cristianopiccin, 1, 0, 1, no
1032345572,  rossellafaragli, 1, 0, 1, no
805875199707062272,  ZioBruto, 1, 0, 1, no
487099777,  Liloia3, 2, 0, 2, no
191473946,  VeryConde, 1, 0, 1, no
460297979,  duty62, 1, 0, 1, no
552944751,  Silvano_DB, 1, 0, 1, no
1001731381,  ascoliroberto, 1, 0, 1, no
358089042,  Lorenzaccio73, 1, 0, 1, no
2786098415,  domavo1, 1, 0, 1, no
492970032,  salvatorbruno, 3, 0, 3, no
397972599,  Marcokata, 1, 0, 1, no
803259533036519424,  saveMetroC, 1, 0, 1, no
787899548555440128,  NicolettaLosac2, 1, 0, 1, no
1624989181,  gabbroka, 12, 0, 12, no
196495188,  Coline80, 1, 0, 1, no
710844636160507906,  davidemaestri, 1, 0, 1, no
805820287384244224,  FabioDiRicco1, 1, 0, 1, no
161462044,  gnovelli, 4, 0, 4, no
190963245,  FidelisMaximus, 1, 0, 1, no
702273345472090113,  enzoroncelli, 2, 0, 2, no
104061714,  gatrbait, 1, 0, 1, no
121068845,  zac1967, 1, 0, 1, no
1899972746,  ml__75, 6, 0, 6, no
123374600,  MattiaArdizio, 1, 0, 1, no
586806065,  m_dellachiesa, 1, 0, 1, no
541650578,  gaetanoministru, 2, 0, 2, no
726765581375037441,  catepoggi, 1, 0, 1, no
65933264,  LucaCelli, 1, 0, 1, no
2644280985,  luisa_pieroni, 1, 0, 1, no
2319529177,  editoriale24, 2, 0, 2, no
555791920,  FabioPetrich, 2, 0, 2, no
3304830435,  romatristezza, 11, 0, 11, no
490422216,  i_danesi, 2, 0, 2, no
783064901275222017,  Simoneuno1, 1, 0, 1, no
1016052702,  EldaLeBras, 2, 0, 2, no
742503230828126208,  drow_it, 1, 0, 1, no
791279209,  gianluca_basso7, 1, 0, 1, no
84132807,  fran78rm, 3, 0, 3, no
2898244047,  love_simon8, 5, 0, 5, no
537442556,  VenturiMaurizio, 2, 0, 2, no
599497975,  AndreaCantoro8, 1, 0, 1, no
523251306,  michelecolucci3, 1, 0, 1, no
402911478,  manuelnigriello, 1, 0, 1, no
792636693367119872,  sandro_bassani, 2, 0, 2, no
804208006254755842,  Marco16324439, 1, 0, 1, no
1265172517,  Toni_ct_1, 1, 0, 1, no
981599204,  FabrizioPititto, 4, 0, 4, no
2227467541,  misbilancio, 1, 0, 1, no
540983116,  vizoslow, 1, 0, 1, no
3351944151,  cassisifrancy, 1, 0, 1, no
3456756437,  LucaColla3, 1, 0, 1, no
803511145021800448,  altablaif, 1, 0, 1, no
2679606969,  elena_mosti, 1, 0, 1, no
781635668195827716,  _francesco_1980, 1, 0, 1, no
147200306,  TonyPostak, 1, 0, 1, no
702629084099121153,  AVulpi1, 4, 0, 4, no
249859759,  CinqueNews, 1, 0, 1, no
769202373919117312,  DesTruesdale, 3, 0, 3, no
555956189,  ThomasSelyem, 1, 0, 1, no
2893190685,  Bbs10San, 1, 0, 1, no
536395566,  AngeloSturni, 4, 0, 4, no
4449971849,  vintes18, 1, 0, 1, no
282047688,  FabianaL_, 1, 0, 1, no
1210086031,  AssuntaBurro, 3, 0, 3, no
337624301,  XtizioX, 1, 0, 1, no
1726446366,  davidvallone1, 3, 0, 3, no
4850581731,  sesasaila5, 3, 0, 3, no
3093375483,  gianluca_sant, 2, 0, 2, no
855221910,  marilenasposato, 3, 0, 3, no
1317079993,  patopancha, 2, 0, 2, no
1040908952,  emiliano______, 2, 0, 2, no
337956523,  LucaNobili, 1, 0, 1, no
1286702522,  marez60, 1, 0, 1, no
147725370,  Euippa, 2, 0, 2, no
2473348917,  gidolo, 3, 1, 2, no
1628219264,  PPellizzieri, 3, 0, 3, no
708008057981247488,  dajeeeeeeeeee, 6, 0, 6, no
1550772164,  Cindycatura, 1, 0, 1, no
716259299,  sarainnocenti80, 1, 0, 1, no
471777128,  Luciano_Jethro, 1, 0, 1, no
2294569309,  Tittypolly, 1, 0, 1, no
1732672866,  visionaria_io, 6, 3, 3, neutral
40638218,  Rossana_Capo, 1, 0, 1, no
316634046,  CarmeloSardo, 1, 0, 1, no
3158016406,  borghi75, 6, 0, 6, no
2180726666,  realepatrizia2, 2, 0, 2, no
9564632,  Moscerina, 1, 0, 1, no
482924290,  francolai2, 2, 0, 2, no
839726317,  GiusTW, 4, 0, 4, no
3188590067,  AgrippineRomana, 2, 0, 2, no
4452315099,  MarisaConca, 3, 0, 3, no
367398011,  faustini_f, 1, 0, 1, no
739689246953443328,  sonianaldi, 1, 0, 1, no
4656294467,  lumacaperforza, 2, 0, 2, no
1221210116,  SNurchis, 1, 0, 1, no
437652304,  risolina70, 2, 0, 2, no
17201066,  Di_Elle, 1, 0, 1, no
491048774,  cicciosergio, 1, 0, 1, no
515657617,  dodouran, 2, 0, 2, no
443068722,  spucho_, 1, 0, 1, no
464217456,  gustamiblog, 7, 0, 7, no
757230229740019712,  tricheco23, 1, 0, 1, no
1615832094,  salvouno1, 1, 0, 1, no
211631890,  STATUSPANGEA, 4, 0, 4, no
408047823,  gabrielapelis, 1, 0, 1, no
554197569,  Dyno78C, 1, 0, 1, no
540531263,  GabryPery, 3, 0, 3, no
703879093,  GiampyRin, 1, 0, 1, no
2502313861,  LivioEvelina, 2, 0, 2, no
3065989288,  DukDaffe, 8, 0, 8, no
1386811099,  LeoCapasso80, 4, 0, 4, no
395980701,  FrancescoMuti, 1, 0, 1, no
1010758932,  63Jump, 3, 0, 3, no
4406327014,  barone_fidanza, 2, 0, 2, no
2893649607,  kramerlengo, 2, 0, 2, no
75996547,  My_ROMA, 1, 0, 1, no
3568308916,  dafirendaflames, 1, 0, 1, no
118727314,  verdecardamomo, 1, 0, 1, no
2504371264,  LuisaPelati, 3, 0, 3, no
890672678,  vittorio_campus, 3, 0, 3, no
174197510,  heinemotogiamma, 1, 0, 1, no
772876315909324801,  Gemmasarda59, 1, 0, 1, no
4548006215,  fabry6314, 1, 0, 1, no
4785550396,  mauriziebasta, 1, 0, 1, no
110180072,  fenix71ita, 1, 0, 1, no
705338935476674560,  SergioBrigatti2, 1, 0, 1, no
369175285,  dodici75, 1, 0, 1, no
317761058,  Romulus1951, 1, 0, 1, no
445485530,  maxpat72, 2, 0, 2, no
798187756761546752,  Maia35423726, 1, 0, 1, no
4294251033,  mattiadesso1, 1, 0, 1, no
2188769004,  thedok978, 1, 0, 1, no
575374344,  7didenari, 1, 0, 1, no
1045175822,  nicolamosele, 1, 0, 1, no
302054401,  marilensias, 1, 0, 1, no
982166486,  MLuizaBottolin, 1, 0, 1, no
2765385220,  RArnesano, 1, 0, 1, no
3311120861,  Soledad_0891, 2, 0, 2, no
700786170423353346,  mibi05, 4, 0, 4, no
637245026,  ClaudioMarsilio, 1, 0, 1, no
3732226162,  fedezucc, 1, 0, 1, no
2936690493,  borzagiov, 2, 0, 2, no
55893052,  spinosoo, 2, 0, 2, no
2488407674,  LaviKyvernitis, 1, 0, 1, no
484943965,  cuorepensante1, 1, 0, 1, no
1084397318,  IXgennaio1900, 1, 0, 1, no
425060148,  ineziessenziali, 1, 0, 1, no
1160757192,  albertoaugelli, 1, 0, 1, no
3037477287,  fontan_rose, 2, 0, 2, no
3094987240,  CelestinaAriano, 1, 0, 1, no
389490141,  TWImedmar, 2, 0, 2, no
488767725,  pretoriano75, 2, 0, 2, no
448872666,  BenassaiGioia, 3, 0, 3, no
2237033255,  26aprile, 3, 1, 2, no
224973785,  l_piacco, 1, 0, 1, no
51802390,  christiank79, 1, 0, 1, no
227438020,  AliciaDede, 1, 0, 1, no
847991659,  ANGELOPANZERA, 2, 0, 2, no
726281638821412865,  Pieroma64, 1, 0, 1, no
392046617,  peppesta, 2, 0, 2, no
740477506164297732,  john__pemberton, 2, 0, 2, no
997232677,  fabertwt, 1, 0, 1, no
337240318,  ginetorz, 2, 0, 2, no
1457535378,  scardinoCa, 2, 0, 2, no
803873999960817664,  ChiaraNari88, 1, 0, 1, no
741625059123601408,  AntonioLattanz9, 1, 0, 1, no
2195380902,  CTorSapienza, 3, 0, 3, no
1441381885,  romasociale, 1, 0, 1, no
736963801258549256,  ClorindaCerzino, 1, 0, 1, no
398319264,  AlfioSerafico, 2, 0, 2, no
887469692,  anatana69, 2, 0, 2, no
516722369,  pubcomm, 1, 0, 1, no
2509432657,  FabioFra81, 1, 0, 1, no
2844932132,  mirkogranci, 1, 0, 1, no
103809135,  miandefoe, 4, 0, 4, no
187206647,  Saiax, 1, 0, 1, no
1264115138,  maione_ma, 1, 0, 1, no
487937304,  cri_tofani, 2, 0, 2, no
15806786,  tdhitaly, 1, 0, 1, no
627306800,  VittorioLupi, 1, 0, 1, no
2270280739,  Toblin_, 1, 0, 1, no
3805232716,  DanielePerri969, 1, 0, 1, no
417624241,  daniloscalise, 1, 0, 1, no
3243326117,  quota33M, 1, 0, 1, no
131446695,  23piddu, 2, 0, 2, no
3101475160,  pietropaolo1967, 1, 0, 1, no
390622504,  PrimoMapelli, 1, 0, 1, no
2512945530,  osvaldoluci, 1, 0, 1, no
3001519506,  ethanrwilkinson, 1, 0, 1, no
255612179,  elibari64, 5, 0, 5, no
337250925,  AmedeoLevorato, 1, 0, 1, no
577410791,  emiliomassari, 1, 0, 1, no
585655442,  tinammen, 1, 0, 1, no
4076693128,  nosenzo_mauro, 5, 0, 5, no
3064021768,  notteblanca, 3, 0, 3, no
2592691565,  roland_agosta, 1, 0, 1, no
130113390,  Francymela, 3, 0, 3, no
323672484,  a_aurigemma, 1, 0, 1, no
2938609954,  ScapigliatiD, 1, 0, 1, no
1972968930,  arastet77, 1, 0, 1, no
2433420551,  Pascquino, 1, 0, 1, no
1894190204,  paolodeluca296, 1, 0, 1, no
19623421,  sel99, 4, 0, 4, no
539238012,  CoppiniGiuliano, 2, 0, 2, no
166094661,  fedetia, 2, 0, 2, no
2721276416,  lumandre1, 3, 0, 3, no
457775543,  bichosbradipo, 1, 0, 1, no
8356242,  FedericoLukkini, 5, 0, 5, no
1263019249,  MarcoPalumbo66, 2, 0, 2, no
712583139,  DalColGabriele, 1, 0, 1, no
3022778475,  vittoriamancin4, 1, 0, 1, no
8851612,  Principegentile, 1, 0, 1, no
4234014981,  Alessiotto71, 1, 0, 1, no
207169955,  Giuspa78, 6, 0, 6, no
1089742220,  danzica64, 1, 0, 1, no
174919256,  eddydsb, 1, 0, 1, no
729616747272245248,  riparinigiulia, 1, 0, 1, no
432566115,  abunabuana, 1, 0, 1, no
1161138678,  Marcoblacks76, 2, 0, 2, no
800264905,  ranocchietta44, 1, 0, 1, no
77825880,  virgigullo, 1, 0, 1, no
430161001,  conni3bis, 3, 0, 3, no
4784306960,  verdini_mario, 2, 0, 2, no
634881669,  bluelaskin, 1, 0, 1, no
2319141767,  Alicia_Smith19, 2, 0, 2, no
2780281767,  MarisolPix, 1, 0, 1, no
317628440,  muchodanger, 6, 0, 6, no
781531805245640704,  Enza83850952, 1, 0, 1, no
4804242813,  MImpossibile, 1, 0, 1, no
384272086,  s_farfarelli, 2, 0, 2, no
1023264421,  FelicettiKevin, 2, 0, 2, no
3428800613,  pasquale_elia2, 1, 0, 1, no
3949254442,  AleVecchi, 1, 0, 1, no
1875965089,  Begalino82, 3, 0, 3, no
397193378,  AlessandroBoxx, 1, 0, 1, no
416552940,  Nico_Lucc, 1, 0, 1, no
478752867,  Mick_64, 1, 0, 1, no
2843525403,  FdamelioD, 1, 0, 1, no
184000199,  fabioambrosi, 1, 0, 1, no
796268494589493248,  Piomele4, 1, 0, 1, no
586869426,  psetteseven, 1, 0, 1, no
520662652,  erne1976, 2, 0, 2, no
4808531415,  alessandrastan6, 1, 0, 1, no
869514487,  Popagni, 1, 0, 1, no
3005755821,  Imperiabruno, 1, 0, 1, no
2415932786,  Ginetto53, 1, 0, 1, no
3197941023,  MarcStir, 3, 0, 3, no
3119564260,  doStrudel, 3, 0, 3, no
4594827853,  gplai1957, 1, 0, 1, no
4706693655,  tonino62222127, 1, 0, 1, no
712535686751121409,  mathena1234567, 1, 0, 1, no
3109964067,  annelory84, 1, 0, 1, no
174574401,  fabri_ross, 4, 0, 4, no
1527948434,  amicidibeppeva, 1, 0, 1, no
2545572317,  7795b9ae93a3497, 2, 0, 2, no
446942856,  LucaMezzo, 7, 0, 7, no
720247033404203008,  peppe031955, 1, 0, 1, no
24608545,  Markus70, 1, 0, 1, no
550398209,  AlfDonatucci, 2, 0, 2, no
773215488,  Melchin10, 1, 0, 1, no
429313221,  RosannaStanco, 1, 0, 1, no
50232653,  fioranialex, 3, 0, 3, no
737756994854125568,  kiaretta1886, 1, 0, 1, no
712352892053790720,  Michela17382982, 2, 1, 1, neutral
543495055,  FrancoLaurie, 3, 0, 3, no
1022215518,  Giorgio_ciarni, 1, 0, 1, no
165161686,  sabrinaangelini, 1, 0, 1, no
114899241,  BenjaminBakouch, 1, 0, 1, no
444121705,  MicheleVigliot1, 1, 0, 1, no
1101543078,  dagostino01, 1, 0, 1, no
1299121968,  AndreaCoiaM5S, 1, 0, 1, no
846625280,  Diego_VegaRojas, 1, 0, 1, no
714148965,  Lucas121279, 1, 0, 1, no
187521367,  kitkatsmexw, 1, 0, 1, no
3020513836,  siamostufi81, 3, 0, 3, no
80130808,  FranciBonardi, 1, 0, 1, no
4612373962,  seb_vivien, 1, 0, 1, no
37664215,  Monicabart, 1, 0, 1, no
401552240,  MicheleCori, 1, 0, 1, no
2321443642,  simonegrillo86, 1, 0, 1, no
479653294,  paolofranci17, 2, 0, 2, no
4098206903,  ChrisKaramazov, 2, 0, 2, no
1435333154,  ugociro, 1, 0, 1, no
803262969064947712,  PileofPhone, 1, 0, 1, no
568078380,  ArmagideonTimes, 5, 0, 5, no
805750811557064705,  persico60, 1, 0, 1, no
2150559813,  ge_francesca, 2, 0, 2, no
4026982535,  MassimoSilla_, 1, 0, 1, no
2208843094,  AsteTiziana, 1, 0, 1, no
3186148157,  letizia2511, 1, 0, 1, no
450779740,  ShadeOfInsanity, 1, 0, 1, no
934308690,  Giuseppeamb, 1, 0, 1, no
3503667437,  Alice__175, 1, 0, 1, no
353552872,  BarbaraFerrini, 2, 0, 2, no
776157810061086722,  mal_erba, 1, 0, 1, no
2410129514,  Raffaele_12, 2, 0, 2, no
2191117734,  peer_paulsen, 1, 0, 1, no
3226405349,  CAlfano69, 2, 0, 2, no
1353938107,  geometrapiras, 1, 0, 1, no
2202371624,  Jefd573, 3, 0, 3, no
484881564,  IMalaguti, 3, 0, 3, no
1381449618,  tibiaeperone, 1, 0, 1, no
490667441,  gianlucadallost, 1, 0, 1, no
787703409969336320,  neko759, 3, 1, 2, no
421003837,  giaffa86, 1, 0, 1, no
738955727339986944,  Fiddledeedee01I, 2, 0, 2, no
4623838474,  blackshrimp00, 1, 0, 1, no
832113828,  Rosegalwines, 1, 0, 1, no
751904098987966464,  supershila81, 4, 0, 4, no
2945586671,  advoreloux, 1, 0, 1, no
2286684400,  Official_RdF, 1, 0, 1, no
36342469,  Lalimpi, 1, 0, 1, no
3234130441,  eliodevito80, 1, 0, 1, no
728969390163677185,  Angelo42303508, 4, 0, 4, no
428226738,  gattobagnato, 7, 0, 7, no
1166066197,  RenzulliGabri, 1, 0, 1, no
490623980,  antonio090761, 2, 0, 2, no
14308495,  SalBer, 1, 0, 1, no
410220846,  Astro211, 1, 0, 1, no
482809660,  avvmonaco, 1, 0, 1, no
337727921,  AlessioLT, 3, 0, 3, no
236829486,  elenavellutini, 1, 0, 1, no
708471552958795776,  Unifi1Onenation, 1, 0, 1, no
1103402550,  Katys_hug, 1, 0, 1, no
3077192037,  andreceandre, 1, 0, 1, no
211284738,  WWE_ILARIA, 1, 0, 1, no
1095726703,  blogesquilino, 1, 0, 1, no
587639074,  morfurio, 1, 0, 1, no
706940531495051264,  tabata7193, 1, 0, 1, no
564075796,  enrydamy, 1, 0, 1, no
2258116508,  MarioGringos, 1, 0, 1, no
2263144866,  delfratecesare, 2, 0, 2, no
1573630574,  alleluhia68, 1, 0, 1, no
266046192,  caramella2683, 1, 0, 1, no
1539197671,  DVYLAN91, 1, 0, 1, no
555754229,  crissyluna, 1, 0, 1, no
2383649104,  Giumas79, 1, 0, 1, no
2946199577,  MarinelloGiusy, 1, 0, 1, no
2502465806,  angela_amalia, 1, 0, 1, no
376169060,  Vix85gk, 1, 0, 1, no
760755097882198016,  massimo_fornari, 2, 0, 2, no
1890129044,  DarkmanUomonero, 2, 0, 2, no
452272820,  angytarquini, 2, 0, 2, no
500802902,  23Modica, 1, 0, 1, no
2379902109,  valereds79, 2, 0, 2, no
4418988976,  5Secondzofbaek, 6, 0, 6, no
4033900996,  xgxxlxx, 1, 0, 1, no
1707243738,  VMatteo75, 2, 0, 2, no
3345525249,  ChecchiFlaminia, 2, 0, 2, no
371278555,  Gaetano_LoTurco, 1, 0, 1, no
2955027305,  _ovunquesiaH, 1, 0, 1, no
2980874405,  dr_danielepagan, 1, 0, 1, no
531024722,  Iksander47, 1, 0, 1, no
711673577318309888,  DanielePetroce3, 1, 0, 1, no
472272055,  GiusyColonna, 1, 0, 1, no
431076305,  _indieliu, 1, 0, 1, no
1148898289,  emiliolamp, 3, 0, 3, no
3298233473,  dieghito990, 1, 0, 1, no
552132820,  leo_forleo, 1, 0, 1, no
146010269,  adrianss2001, 1, 0, 1, no
2550316518,  coccadanda, 1, 0, 1, no
56819028,  arioldo, 1, 0, 1, no
99556902,  nikita82roma, 6, 0, 6, no
802921215715405824,  BoggianiGerardo, 1, 0, 1, no
250670952,  lottandoidemoni, 1, 0, 1, no
2250138083,  seivitahaz, 1, 0, 1, no
791359414993358849,  familycosta721, 1, 0, 1, no
234454722,  Takemetomyidol_, 1, 0, 1, no
1222570518,  paola0071, 1, 0, 1, no
784783472468619264,  lavinia78720130, 1, 0, 1, no
1398381302,  palad_dee, 1, 0, 1, no
290604277,  ohmybjeber, 1, 0, 1, no
138825055,  Galdaron, 10, 0, 10, no
3400254046,  jovaxm, 1, 0, 1, no
164469196,  robysimo81, 1, 0, 1, no
14099501,  plucciola, 2, 0, 2, no
705686706406690816,  davidenadali, 1, 0, 1, no
861212444,  Mic_ort, 3, 0, 3, no
2277848232,  kerossa62, 1, 0, 1, no
515462112,  fvmaurizio77, 2, 0, 2, no
293977374,  AlexCCF93, 1, 0, 1, no
951757819,  sorce7, 1, 0, 1, no
231110601,  giovannizambito, 1, 0, 1, no
2921202064,  TommasoLanda, 2, 0, 2, no
798610056119980032,  ciops06, 1, 0, 1, no
2500916406,  Tarif_Welt24, 3, 0, 3, no
1382671670,  OrylarVinca, 2, 0, 2, no
797740375213568000,  SancioClaudio, 3, 0, 3, no
121177103,  clancn, 1, 0, 1, no
131183483,  valedileva, 2, 0, 2, no
2713708404,  previl96, 1, 0, 1, no
636652709,  jimmie_blair, 1, 0, 1, no
189811579,  lampuga, 1, 0, 1, no
1187349354,  GiuliaCoccoli, 1, 0, 1, no
377348117,  laurafabrizi, 1, 0, 1, no
1415041356,  RosariaToraldo, 1, 0, 1, no
789459828007723009,  BoldroCop, 1, 0, 1, no
472202396,  alessandrotiso1, 1, 0, 1, no
804278132966617088,  simone_lamarra, 2, 0, 2, no
396802776,  Simojuventus, 1, 0, 1, no
440663402,  AltieriRaffaele, 4, 0, 4, no
433609457,  cristianaprato, 1, 0, 1, no
232259622,  luidir47, 1, 0, 1, no
1263798854,  barbara_musella, 1, 0, 1, no
4105911004,  CannaDonato, 1, 0, 1, no
2744750367,  irenebonomo3112, 1, 0, 1, no
458324440,  marco371173, 2, 0, 2, no
940811316,  LorenzoRausa, 2, 0, 2, no
248611884,  FraniGrM, 1, 0, 1, no
17732518,  ormiga, 1, 0, 1, no
392655405,  Anton_Dekh, 1, 0, 1, no
733254501675728896,  Andrew_Pez, 1, 0, 1, no
745888524,  casalserugo5ste, 2, 0, 2, no
2945845102,  GiudiRiccioni, 2, 1, 1, neutral
445284060,  silviapistone81, 1, 0, 1, no
2244584796,  AnnalisaAglioti, 2, 0, 2, no
629626485,  Aga_Tuxy, 2, 0, 2, no
2539645564,  TodiscoAmalia, 1, 0, 1, no
351221139,  clod_rich16, 1, 0, 1, no
501225684,  emi_bat, 1, 0, 1, no
966157914,  MaurizioMath, 1, 0, 1, no
402670015,  kikadit, 9, 0, 9, no
312175988,  schummy75, 1, 0, 1, no
502807296,  GiuseppeFormoso, 1, 0, 1, no
426777693,  noemicresh, 1, 0, 1, no
2764545717,  LuMia1208, 2, 0, 2, no
3353377672,  valentinarte8, 1, 0, 1, no
3404091532,  ThecocoRisto, 1, 0, 1, no
52552781,  Stepmorana, 2, 0, 2, no
216684324,  Scarla6, 1, 0, 1, no
3254557839,  BerserkuCrissi, 4, 0, 4, no
747706717656481792,  thecsergio, 1, 0, 1, no
1317075626,  rosariocorigli1, 2, 0, 2, no
717483009033768961,  Gianniveneri1, 1, 0, 1, no
2735526789,  UR_1977, 2, 0, 2, no
471163054,  waltermentre, 4, 0, 4, no
579221912,  SofiaVardaro, 1, 0, 1, no
420388790,  BrunoPuntura, 1, 0, 1, no
217432906,  Hum_Glass, 1, 0, 1, no
3466600696,  xAliAlix3, 1, 0, 1, no
1733129954,  pabloflip92, 3, 0, 3, no
2249697301,  CPregazzi, 1, 0, 1, no
742401891837968384,  BlgaethGaeth, 1, 0, 1, no
821921425,  frap1975, 2, 0, 2, no
876091626,  Lifurbi, 3, 0, 3, no
245758830,  BertaButtarazzi, 1, 0, 1, no
419660075,  aglajablunet, 1, 0, 1, no
4560243317,  JaaaneEyre, 3, 0, 3, no
134522688,  miotei, 1, 0, 1, no
56131320,  oliviertempora, 1, 0, 1, no
405435925,  Loris41086, 1, 0, 1, no
762696434093260800,  cicciama, 1, 0, 1, no
3355967475,  RinascitaVitaYT, 2, 0, 2, no
703032493558005760,  AnthonyPomilia, 1, 0, 1, no
1671778394,  Miss_Eveee, 1, 0, 1, no
4652707168,  salvomorettino, 2, 0, 2, no
300158013,  graziamacchiati, 1, 0, 1, no
585154533,  fellanavy, 2, 0, 2, no
4891650449,  Acquachiara09, 2, 0, 2, no
425125521,  KurtPzrLehr, 1, 0, 1, no
1148357390,  Jopalet, 1, 0, 1, no
1009860876,  antoninomas, 4, 0, 4, no
2878861445,  johnjohnlacca, 3, 0, 3, no
256717889,  oryoryok, 1, 0, 1, no
372030829,  fattocome, 1, 0, 1, no
499200257,  MariaLafratta, 3, 0, 3, no
939341838,  rossellabrunett, 1, 0, 1, no
735230765353598977,  AndreaFelline96, 3, 0, 3, no
2341748583,  massimi60826047, 1, 0, 1, no
203864243,  Ser_Nelkore, 1, 0, 1, no
1311669534,  PocappoPiopio, 1, 0, 1, no
2192498421,  mirco_foschi, 1, 0, 1, no
1568773796,  Herol_l, 1, 0, 1, no
449868302,  Antonangel59, 2, 0, 2, no
2751634019,  porconello, 2, 0, 2, no
808756406,  Skorpio10232405, 1, 0, 1, no
339200327,  ValeriaMeuti, 1, 0, 1, no
284220925,  gira_marco, 3, 0, 3, no
3298144097,  00e8b53f2687418, 1, 0, 1, no
2789455796,  ___Elisss___, 1, 0, 1, no
954821,  eamonn, 1, 0, 1, no
1220965501,  katy6382, 1, 0, 1, no
2757158998,  Michi00Michela, 1, 0, 1, no
62287662,  outsider63, 2, 0, 2, no
2324366672,  Ciruacchiotto, 2, 0, 2, no
805551453360234496,  MeForever_K, 1, 0, 1, no
3042805982,  DeDrant1275, 2, 0, 2, no
126524687,  LucasGiglioti, 1, 0, 1, no
4040817507,  Sharon64704996, 1, 0, 1, no
232191247,  cesareforti, 2, 0, 2, no
704238977,  sergiofabbri77, 2, 0, 2, no
794565592628035584,  paspiplus, 1, 0, 1, no
770990284159221761,  morenoiacobini, 1, 0, 1, no
1428656318,  syontai93, 1, 0, 1, no
4286762296,  misslilliehall, 1, 0, 1, no
758358681968869376,  jrlatte9, 1, 0, 1, no
4869719117,  Ela83X, 2, 0, 2, no
3405282700,  da47082db96d478, 1, 0, 1, no
247712433,  the_sintou, 3, 0, 3, no
712653089170395140,  TheDarkale_, 1, 0, 1, no
52575343,  picnic4b, 1, 0, 1, no
151917586,  EOspinaSr, 1, 0, 1, no
2775304420,  Rosignano5Stars, 2, 0, 2, no
26255191,  renovitali, 1, 0, 1, no
1273295426,  Fantoman75, 1, 0, 1, no
3049140719,  raffaelepigna11, 2, 0, 2, no
442319731,  sheriffdagreat, 1, 0, 1, no
539047267,  MuraZiv1, 1, 0, 1, no
418872542,  FulvioAugello, 1, 0, 1, no
3435520894,  MicheleAnime63, 1, 0, 1, no
2703557176,  barreca51, 3, 0, 3, no
1919511206,  FRANCES06710942, 1, 0, 1, no
36304268,  silviamobili, 1, 0, 1, no
1134464702,  anattostefano, 3, 0, 3, no
322163890,  KoenDenolf, 1, 0, 1, no
457733955,  Ruseno74, 2, 0, 2, no
431600605,  GwentaGil, 3, 0, 3, no
134858666,  dmatassino, 1, 0, 1, no
2890422803,  FranchinaFabio, 4, 0, 4, no
134671060,  stebell1974, 1, 0, 1, no
2776015188,  stappo23, 2, 0, 2, no
436660358,  SebaGiuffrida, 1, 0, 1, no
843207530,  gabriellagiarr, 2, 0, 2, no
251595754,  Sabrydoc, 1, 0, 1, no
1608719413,  Benjaminsmile_, 1, 0, 1, no
266764319,  GabrieleCerino, 1, 0, 1, no
635396890,  il_Rattocco, 1, 0, 1, no
1060911451,  mardoi31l, 1, 0, 1, no
3047490297,  MokyDeb, 8, 0, 8, no
2745589518,  bellucci129, 1, 0, 1, no
847121852,  M5SLazio, 1, 0, 1, no
788124079794577408,  crescini_fabio, 1, 0, 1, no
2731920166,  balducci78, 1, 0, 1, no
985398132,  emanuelamenicuc, 2, 0, 2, no
797144547415494661,  Roman_Warheart, 1, 0, 1, no
4632393442,  alexisUS1292, 2, 0, 2, no
329277011,  alliedelonge, 1, 0, 1, no
3134745514,  emmebi420, 1, 0, 1, no
79697729,  tranviadeseo, 1, 0, 1, no
3376387594,  1987Bianco, 1, 0, 1, no
323139288,  luiszert1, 1, 0, 1, no
145297386,  RosyVignati, 1, 0, 1, no
2522211712,  WaFF0Ls, 1, 0, 1, no
3237617343,  pcliers, 1, 0, 1, no
2948848851,  8a27d93b5ea04dc, 5, 0, 5, no
396705268,  VictorMotricala, 1, 0, 1, no
2904232168,  nuccioS59, 1, 0, 1, no
708715099935141888,  PuteadorCarlos, 1, 0, 1, no
777035492365709312,  Winner2016Trump, 6, 0, 6, no
747212738250809344,  luca1372, 1, 0, 1, no
22044633,  notmyname02, 1, 0, 1, no
480271048,  olivaflute, 1, 0, 1, no
500871116,  VendittiSimona, 2, 0, 2, no
2735054350,  virgyhome, 1, 0, 1, no
384744166,  lapunk5, 4, 1, 3, no
434226034,  AlexGobs, 1, 0, 1, no
708859255374405633,  MaxRaySpring, 1, 0, 1, no
3228944018,  ambionESC, 3, 0, 3, no
25595761,  jumlo, 1, 0, 1, no
471905877,  herbamaury, 1, 0, 1, no
1330126752,  mg_martello, 5, 1, 4, no
3381622366,  Barbara36180467, 2, 0, 2, no
2793032105,  vannic85, 1, 0, 1, no
3016841057,  GiorgiaMi92, 1, 0, 1, no
2319604766,  boemo83, 1, 0, 1, no
493303189,  GiusiCampanini, 3, 0, 3, no
2628180141,  pippo_togo, 2, 0, 2, no
1579555884,  RockSeppia, 1, 0, 1, no
60883194,  Lucadp79, 1, 0, 1, no
495299498,  Rossy_Toykova, 2, 0, 2, no
30817675,  tatore, 1, 0, 1, no
393338020,  CostanzaCecchin, 1, 0, 1, no
427274048,  19stefano78, 1, 0, 1, no
2327881259,  ClaudiaSc71, 1, 0, 1, no
3091751285,  orsetto_ale, 1, 0, 1, no
1020228091,  NegAdriana, 1, 0, 1, no
850166480,  thesecurityguy1, 1, 0, 1, no
415045443,  ChiarotMassimo, 3, 1, 2, no
276380022,  macneil54, 2, 0, 2, no
789419805002661888,  desi_enzo, 1, 0, 1, no
2312728101,  Loris69TS, 1, 0, 1, no
3383450651,  drunk__monk, 2, 0, 2, no
788570161800294406,  DarleneIacoviel, 1, 0, 1, no
464916901,  Mirko77F, 1, 0, 1, no
2922670673,  damadifuoco, 1, 0, 1, no
145382087,  ArigatoGozeiMas, 1, 0, 1, no
463958008,  Crm_Cll, 2, 0, 2, no
83933691,  shymon84, 2, 0, 2, no
1633295922,  micdan31, 1, 0, 1, no
498345515,  CripkeB, 1, 0, 1, no
2730162724,  CiattoMelissa, 1, 0, 1, no
313843015,  BlackJammer, 1, 0, 1, no
1378574263,  vestsempuguale, 1, 0, 1, no
2276618119,  Elis__abetta, 3, 0, 3, no
615532397,  UgoPerotti, 3, 0, 3, no
2174230349,  scotton_daniele, 1, 0, 1, no
426608038,  WMirigliano, 2, 0, 2, no
3763499301,  luisdett26, 1, 0, 1, no
589218993,  sitarg1927, 1, 0, 1, no
432427502,  cdio79, 2, 0, 2, no
586373819,  NovelloClaudio, 2, 0, 2, no
1137926508,  mgdaquila, 7, 0, 7, no
131506066,  antonESCU_bT95, 1, 0, 1, no
2955504839,  mariamartella2, 2, 0, 2, no
904604208,  nonsonorachele, 1, 0, 1, no
739907534518157312,  JacopoEsposito8, 1, 0, 1, no
4772785649,  GennaroCecca, 1, 0, 1, no
788932831,  fra_pastorello, 1, 0, 1, no
803474330277576704,  scuRAGGIata, 8, 0, 8, no
1543918664,  AgneseManuelli, 1, 0, 1, no
717037129042370561,  cristin92471120, 2, 0, 2, no
181950730,  marcopalombi72, 2, 0, 2, no
3318734877,  Banchi141, 1, 0, 1, no
728750584564690944,  SaladeTo, 8, 0, 8, no
446897324,  CavaniAlberto, 1, 0, 1, no
1926529471,  silvialoved1965, 1, 0, 1, no
136673570,  gaiacamossi, 1, 0, 1, no
52468851,  mauroev, 4, 0, 4, no
726164539025272832,  principatom5s, 1, 0, 1, no
1421295818,  michaelapuscar, 1, 0, 1, no
2794339455,  ADR19691, 1, 0, 1, no
2889447297,  ronganos, 1, 0, 1, no
455796667,  irma_palazzo, 1, 0, 1, no
474788900,  Riccardi_, 1, 0, 1, no
803319280225939457,  cyberse49333188, 1, 0, 1, no
735437220715335680,  annilongo, 1, 0, 1, no
174186680,  comunicale79, 1, 0, 1, no
2536730207,  cipcris, 1, 0, 1, no
752875557373808640,  Paolo58806047, 1, 0, 1, no
95019932,  racittadini, 1, 0, 1, no
1948011380,  walkerc2e, 1, 0, 1, no
446958662,  LucianoPizzelli, 1, 0, 1, no
1360090130,  GioCri_2002, 3, 0, 3, no
2176117600,  ceci_otto, 1, 0, 1, no
719080627757322240,  LoGnorante, 1, 0, 1, no
84664898,  fabio68m, 1, 0, 1, no
18939830,  cotrozzilivio, 2, 0, 2, no
345439766,  ilBignamix, 1, 0, 1, no
791951409688170497,  Roby7474, 1, 0, 1, no
3579815723,  PatriziaPalmit1, 2, 0, 2, no
772523313612591105,  fata5smorgana, 3, 1, 2, no
3025677400,  VandaLazzari65, 1, 0, 1, no
3619655957,  AlessAlongi, 2, 0, 2, no
55590913,  FrancescoHe, 1, 0, 1, no
2876969818,  Pablecito80, 1, 0, 1, no
422904136,  joyfar01, 2, 0, 2, no
173522276,  ilnotaro, 2, 0, 2, no
617598666,  annapanariello2, 1, 0, 1, no
264695144,  MarcoIlardi, 2, 0, 2, no
422414478,  GAssanti, 1, 0, 1, no
753119256573861890,  mola_gennaro, 4, 3, 1, yes
39460385,  SCOZCA, 1, 0, 1, no
106771056,  RitaGiuseppone, 2, 0, 2, no
1110311593,  itakus, 1, 0, 1, no
9940892,  fedemello, 11, 2, 9, no
621073071,  colettinadia, 2, 0, 2, no
753910937770418176,  UffiziGalleries, 1, 0, 1, no
198079470,  renzopessotto, 1, 0, 1, no
3982458934,  salomonx69, 4, 0, 4, no
4253242395,  _adaco_, 1, 0, 1, no
710713901663592448,  joeroggier, 1, 0, 1, no
444028791,  valencapuano, 1, 0, 1, no
729214200925532160,  charlieazzurro, 14, 0, 14, no
368885612,  annunziatamimmo, 2, 0, 2, no
1933271388,  MICHELEDURANTI1, 1, 0, 1, no
799323363634245632,  lucylig, 4, 0, 4, no
67347938,  Marghe_cantiere, 2, 1, 1, neutral
3901748193,  meridonare, 1, 0, 1, no
140014890,  kiarind, 1, 0, 1, no
46073660,  marziodimezza, 1, 0, 1, no
359202565,  brindisina98, 1, 0, 1, no
955582345,  valbutterfly2, 16, 2, 14, no
907601977,  marcoassante199, 2, 0, 2, no
2822999261,  vinesp57, 1, 0, 1, no
27473837,  deogo, 1, 0, 1, no
619015105,  plpetrillo, 1, 0, 1, no
318965193,  nicolapasa, 1, 0, 1, no
456335294,  EnricoLobina, 1, 0, 1, no
412453101,  antoniotesta_eu, 1, 0, 1, no
117432140,  GiuseppeDangelo, 1, 0, 1, no
472252495,  dukeonyx57, 2, 1, 1, neutral
233487608,  GioFranzese, 1, 0, 1, no
117110691,  novellatedesco, 2, 0, 2, no
159465016,  dagored3, 1, 0, 1, no
432554149,  Enzo_dErrico, 3, 0, 3, no
25743858,  luigiferraiuolo, 2, 1, 1, neutral
1617262098,  maurobiavati, 1, 0, 1, no
354900068,  ale74ru, 1, 0, 1, no
617691852,  MollleLing, 1, 0, 1, no
772827890954141696,  kekkascuola, 1, 0, 1, no
3227018709,  chissasemai, 1, 0, 1, no
4864139045,  francomartini14, 6, 0, 6, no
358122962,  MarcoCuoreazzur, 2, 0, 2, no
50262288,  framillegol, 1, 0, 1, no
587451886,  GuariniBg, 1, 0, 1, no
709105553423917058,  hihuim, 1, 0, 1, no
283450285,  olivarai, 2, 0, 2, no
432589047,  m4urinux, 2, 0, 2, no
4187641697,  Agataambro, 1, 0, 1, no
4912017454,  2Bravi, 1, 0, 1, no
741951647723737088,  la_rossa88, 2, 0, 2, no
988749812,  _gporcu, 2, 0, 2, no
437290507,  mattweetsa, 1, 0, 1, no
202946046,  msinistro, 3, 0, 3, no
1241472956,  70Angi, 2, 0, 2, no
174217550,  paololabruzzo, 1, 0, 1, no
741147210,  AdrianaBravi1, 1, 0, 1, no
3155293071,  manganellogiov1, 3, 0, 3, no
548544359,  Adesign249, 2, 0, 2, no
2796145285,  Stregatto9, 1, 0, 1, no
1623270990,  _ele94, 1, 0, 1, no
1638708829,  CeccaMilly, 1, 0, 1, no
773314313180315648,  grillotwittante, 1, 0, 1, no
729740396255916032,  Frances93139181, 1, 0, 1, no
2657124579,  angel9804, 2, 0, 2, no
2319326605,  CristianoTurato, 1, 0, 1, no
708386861,  fiorifio56, 1, 0, 1, no
2277815894,  CARLA24255338, 3, 0, 3, no
145284956,  EnzoSan69, 1, 0, 1, no
598974424,  SDino59, 9, 0, 9, no
1268204864,  MPingerna, 1, 0, 1, no
702952591,  RondelliM, 7, 0, 7, no
4544172989,  Fre1963Free, 3, 0, 3, no
2495987256,  SilvioGalantini, 1, 0, 1, no
413855425,  Setom74, 9, 0, 9, no
857730480,  gianmichelevann, 7, 0, 7, no
447043590,  andreaAocello, 2, 0, 2, no
10611402,  vincy75, 3, 0, 3, no
431694519,  steba1972, 1, 0, 1, no
736235688656576513,  dallashugg, 1, 0, 1, no
852754820,  DEBORAMASCI1, 1, 0, 1, no
624876269,  EugenioGnoffo, 1, 0, 1, no
23179771,  Gioborg, 1, 0, 1, no
776122110917902337,  claa1962, 1, 0, 1, no
421941338,  tonyy61, 2, 0, 2, no
799324496482172928,  michele656565, 2, 0, 2, no
520792250,  uno80939102, 1, 0, 1, no
436285908,  vintz_PA, 1, 0, 1, no
778634541661556736,  alexstera88, 1, 0, 1, no
801072087402221572,  Paolo72044338, 1, 0, 1, no
772800324675465216,  MauroGarrapa, 4, 0, 4, no
366235360,  LuisaMameli, 3, 0, 3, no
1538780774,  brunoueluccio, 1, 0, 1, no
448207683,  smack_iabile, 1, 0, 1, no
413943853,  jimi_78, 1, 0, 1, no
549935132,  Zianana66, 1, 0, 1, no
104492086,  annarchica, 1, 0, 1, no
418809718,  Giuly0013, 3, 0, 3, no
2688365054,  Gsolls1, 1, 0, 1, no
783405945791578112,  Ros_bis90, 1, 0, 1, no
4635942508,  Sonia_Nesli, 1, 0, 1, no
452351631,  gianluigidellac, 2, 0, 2, no
803260661308555264,  akramshaby, 1, 0, 1, no
804977898369249280,  Valenti81803546, 1, 0, 1, no
4181995061,  stefanosorice2, 3, 0, 3, no
430137287,  GabrieleGozzoli, 1, 0, 1, no
552244447,  FrancescoDIntr, 1, 0, 1, no
465053408,  Christinamc1983, 1, 0, 1, no
305833247,  mincatas, 1, 0, 1, no
613804971,  Giuls_Moonlight, 2, 0, 2, no
128688814,  varionews, 4, 0, 4, no
316552150,  EJurlaro, 1, 0, 1, no
2931731932,  fdfc16832a484b6, 1, 0, 1, no
513217439,  anaclems, 2, 0, 2, no
99916072,  GiuliaGibertoni, 2, 0, 2, no
2320420238,  walterscarcella, 2, 0, 2, no
2837446354,  ciairo, 2, 0, 2, no
220992786,  DeboraSprock, 2, 0, 2, no
769498283756642304,  MarcoAtta77, 1, 0, 1, no
444504781,  misterviaggio, 1, 0, 1, no
86546315,  GiuseppeC1957, 2, 0, 2, no
728560322752188416,  valeriafaseb, 1, 0, 1, no
412372084,  frankybaroni, 1, 0, 1, no
295635514,  Gaspare965, 1, 0, 1, no
844509133,  maxcantatore, 1, 0, 1, no
188136909,  Choroukenzo, 2, 0, 2, no
1014091514,  PsicologiaSapep, 1, 0, 1, no
173439628,  auliner, 1, 0, 1, no
2812583886,  gialloo1, 1, 0, 1, no
1477343594,  Numeratore, 1, 0, 1, no
372779253,  amaranto64, 1, 0, 1, no
1966660543,  MarCaSere, 1, 0, 1, no
1188911720,  Baba54daki, 1, 0, 1, no
946529088,  massimofiori2, 1, 0, 1, no
270821168,  ibrahimyasacan, 1, 0, 1, no
1015588921,  leandronevola, 2, 0, 2, no
438385480,  PatriziaTerzoni, 3, 0, 3, no
1151495287,  violadelpensie, 5, 0, 5, no
783276237351489536,  barbaralu66, 1, 0, 1, no
529367193,  willis7277, 1, 0, 1, no
294756310,  davide79torino, 1, 0, 1, no
889666248,  Exanuskronos69, 5, 0, 5, no
3056592447,  marghec3, 1, 0, 1, no
2963152966,  Edoardo__1996, 4, 0, 4, no
2242408249,  CotugnoCarmine, 2, 0, 2, no
426460313,  pettinaripaolo, 1, 0, 1, no
500184959,  iabez2000, 1, 0, 1, no
2560820463,  LDegani, 1, 0, 1, no
1122686647,  Julian__Grieco, 1, 0, 1, no
721722836226871296,  Vera787147631, 1, 0, 1, no
63978273,  enricoviaggi, 2, 0, 2, no
602831906,  vecienz79, 1, 0, 1, no
1006028442,  EEvienia, 1, 0, 1, no
781222259558088704,  medi03441569, 1, 0, 1, no
570257633,  rosarioluongo74, 1, 0, 1, no
185144870,  annamaria_84, 1, 0, 1, no
234372708,  Sterombi, 1, 0, 1, no
791193793051721728,  gloriamazzeo77, 2, 0, 2, no
1016109914,  fargi34, 4, 0, 4, no
390342010,  NeriSassi, 1, 0, 1, no
444768003,  dani_srcnl, 1, 0, 1, no
2808699178,  nosferatum2014, 1, 0, 1, no
200288284,  qdellarosa, 2, 0, 2, no
2592149692,  iv3sixcaio, 1, 0, 1, no
483118529,  CannataRoberto, 2, 0, 2, no
152427789,  vegacraps, 1, 0, 1, no
96313736,  evos67, 1, 0, 1, no
4871332221,  nonsonogrillino, 1, 0, 1, no
812867930,  WriterJazz, 2, 0, 2, no
989456214,  Cronix72, 1, 0, 1, no
946295724,  vinceleonetti, 1, 0, 1, no
946447663,  GiampaoloLizza, 5, 0, 5, no
776734605353291776,  aprandini27, 1, 0, 1, no
799531993973325824,  yaropolovase, 1, 0, 1, no
3087165969,  M5sMarigliano, 2, 0, 2, no
1387856863,  MichaelArmanno, 2, 0, 2, no
2683460410,  natascia1994, 3, 2, 1, yes
472780497,  SaimonScaard, 1, 0, 1, no
484219561,  oswi1172, 2, 0, 2, no
3054098656,  GianlucaFerri13, 2, 0, 2, no
585892339,  stefanobravione, 2, 0, 2, no
2752259173,  schlef1a, 1, 0, 1, no
791611407762685953,  AntonellaPengue, 1, 0, 1, no
389611714,  LMonfrecola, 1, 0, 1, no
611597594,  giovannasici7, 2, 0, 2, no
1355517703,  lostehuelche, 1, 0, 1, no
831875880,  ele_missus, 1, 0, 1, no
753958367610146817,  marcomala77, 1, 0, 1, no
803871029080838144,  Luigi_lops, 2, 0, 2, no
4472007209,  FicarraLaura_bi, 2, 0, 2, no
751806809434980353,  cicci78511, 1, 0, 1, no
124273634,  Giurgitte, 1, 0, 1, no
4813403782,  luigides_1, 1, 0, 1, no
2395909131,  MazzuAlessandro, 2, 0, 2, no
497382403,  walker_anto, 2, 0, 2, no
364961388,  Stekrano, 1, 0, 1, no
1137413112,  sicignano_f, 1, 0, 1, no
2981519823,  adrimelchio, 2, 0, 2, no
1160212783,  Gabbianella1Blu, 3, 0, 3, no
794294828775473152,  FabrizioPintori, 1, 0, 1, no
259733750,  Silve_7, 1, 0, 1, no
832668218,  Ale_Capasso, 1, 0, 1, no
48614561,  AlexNapoli, 2, 0, 2, no
770234596839612416,  fera_alfonso, 1, 0, 1, no
1256574842,  Robertoruggine, 5, 0, 5, no
818013072,  CuoreAlto, 1, 0, 1, no
802237433395945476,  Flavia_Consonni, 1, 0, 1, no
49261294,  AREASciencePark, 2, 0, 2, no
792216138361016320,  3dbone, 3, 0, 3, no
2352118818,  pietropruneri, 1, 0, 1, no
331537566,  Np_Italia, 2, 0, 2, no
803526977231712256,  umbdago, 3, 0, 3, no
755286164731490305,  Stefano54655309, 2, 0, 2, no
341431151,  max_triplete, 1, 0, 1, no
2321104375,  SandroScandolo, 1, 0, 1, no
780879437218840579,  Maria_B_arbieri, 1, 0, 1, no
363795552,  BalbiMariano, 5, 0, 5, no
3187555726,  metrana, 4, 0, 4, no
2470618681,  immaginario_IS, 1, 0, 1, no
751028107944026112,  marco152925941, 2, 0, 2, no
1257106364,  sara_pasquale, 1, 0, 1, no
90718713,  iamgiulia_8, 1, 0, 1, no
274811473,  CarlosVCiampi, 3, 0, 3, no
27877758,  gibutino, 1, 0, 1, no
1116999974,  vdliguori, 4, 0, 4, no
1080941533,  robertopetrucca, 1, 0, 1, no
708746809032761344,  mimmmomig, 1, 0, 1, no
2247466280,  AntonioBubbo, 1, 0, 1, no
800008614136188928,  franko_gina, 2, 0, 2, no
4558218203,  massimopenna39, 1, 0, 1, no
1650023988,  miktwit23, 2, 0, 2, no
380359585,  serragiovanna, 1, 0, 1, no
1036846736,  sbigotti_to, 1, 0, 1, no
1675839859,  luca_dinicola, 1, 0, 1, no
3438644819,  marasca2015, 1, 0, 1, no
1244012304,  salvatorebecca, 3, 0, 3, no
467736212,  gianlucapuglis2, 1, 0, 1, no
504652328,  salvoguida23, 1, 0, 1, no
397942497,  danirodia, 1, 0, 1, no
759145283716538368,  pasale87, 1, 0, 1, no
778668476332474372,  Ecincoestrellas, 1, 0, 1, no
340877741,  angelinolanzino, 1, 0, 1, no
406509882,  Enzo_Abbagnale, 1, 0, 1, no
1058676752,  FraAniello, 2, 0, 2, no
1190590579,  adrianaadry56, 3, 0, 3, no
131867712,  kronebigxv8, 1, 0, 1, no
539637351,  jax9386, 2, 0, 2, no
488627298,  EmmETabaccheria, 1, 0, 1, no
702827736516190208,  Andiap04, 22, 0, 22, no
2299277402,  mat_polve, 2, 0, 2, no
3101916429,  DiemmegDi, 1, 0, 1, no
481487529,  Sofistio, 1, 0, 1, no
885190620,  LuisaEtramar, 6, 0, 6, no
832613244,  massimo271, 2, 0, 2, no
540264278,  annamariagig, 5, 0, 5, no
374743672,  FMartinello, 4, 0, 4, no
388190082,  Antop77, 1, 0, 1, no
118756273,  fgraniglia, 3, 0, 3, no
718368584360140800,  FerruLuciano, 2, 0, 2, no
732580256,  doctor_el86, 1, 0, 1, no
1011051636,  _milicenzio, 1, 0, 1, no
126883491,  a1lessandro, 24, 3, 21, no
333358286,  pipudrio, 1, 0, 1, no
562730933,  RakelLombardi, 2, 0, 2, no
2155726458,  M5SOleggio, 3, 0, 3, no
390644069,  Orsodan, 1, 0, 1, no
4033699635,  Sabrina70442637, 2, 0, 2, no
704134053,  CCasanova61, 2, 0, 2, no
1138200559,  karloleonardi, 6, 0, 6, no
893601463,  lessio61, 1, 0, 1, no
1165463461,  FedericaSclano, 1, 0, 1, no
765519857941110784,  catia_caporali, 7, 0, 7, no
2330754668,  maurofontana74, 1, 0, 1, no
463840173,  nimlot61, 1, 0, 1, no
378591855,  GiovanniAlesi, 2, 0, 2, no
446163232,  francescobevac1, 1, 0, 1, no
1053093684,  GiuliaSarti86, 1, 0, 1, no
3031025781,  tama07081947, 2, 0, 2, no
366769522,  marcobilleci, 1, 0, 1, no
118000836,  marco_lucisani, 2, 0, 2, no
438542009,  borghialex, 1, 0, 1, no
980610223,  rache_tonelli, 1, 0, 1, no
366639902,  david_sarra, 1, 0, 1, no
258400230,  ilsilvio, 3, 0, 3, no
208527329,  Pigio73, 1, 0, 1, no
553046883,  presascart1977, 4, 0, 4, no
4765393854,  MonicaPassalac4, 2, 0, 2, no
3248724731,  crismborella, 3, 0, 3, no
255018823,  hesky76, 1, 0, 1, no
3243222784,  broby65, 8, 0, 8, no
802593581210988545,  Niktasck, 1, 0, 1, no
1097778030,  CesareDamiani, 1, 0, 1, no
3208222643,  gmagliar, 2, 0, 2, no
392733410,  AgiproNews, 1, 0, 1, no
740625579108630533,  marcoluxlux, 1, 0, 1, no
782501678461358080,  simonet1970, 3, 0, 3, no
368247272,  Bradfszayn, 1, 0, 1, no
3299007346,  antonioalimenta, 3, 0, 3, no
754062941306122240,  andreadm131195, 1, 0, 1, no
85557887,  Poly_09, 2, 0, 2, no
391287768,  SANDRIXROMA, 1, 0, 1, no
85352908,  paristoria, 1, 0, 1, no
2715196346,  terrycoensurya, 1, 0, 1, no
4874766939,  pulce9296, 1, 0, 1, no
102013327,  lindacarfa, 1, 0, 1, no
464726162,  NicolaCubeddu, 1, 0, 1, no
499533706,  MMacrelli, 4, 0, 4, no
4902884411,  AlbasWorld, 2, 0, 2, no
81804418,  RenatoZampieri, 2, 0, 2, no
753571887314239488,  gaetanaccio, 1, 0, 1, no
294194412,  AidaRoldo, 1, 0, 1, no
3030526046,  IFalchero, 1, 0, 1, no
471173883,  RosalbaGrillo, 1, 0, 1, no
3864556223,  edoardo_taranto, 1, 0, 1, no
2725221087,  fulviaps, 1, 0, 1, no
862753490,  Giovannagioia68, 1, 0, 1, no
1069130844,  lagobrun0, 1, 0, 1, no
711929302183493632,  _littletess, 1, 0, 1, no
4647149236,  Ciro39730697, 2, 0, 2, no
382203329,  jena650, 1, 0, 1, no
400015385,  _heyjade_, 1, 0, 1, no
114539972,  Lombard5stelle, 6, 0, 6, no
1333660242,  nickbebimoretti, 1, 0, 1, no
551299529,  peppino255, 2, 0, 2, no
419456103,  CarusoSimona, 1, 0, 1, no
3322494874,  maurizia_lopez, 2, 0, 2, no
1101918108,  PeP_Magic, 2, 0, 2, no
1060195976,  massimopiccardi, 1, 0, 1, no
768572212819402752,  ida9997, 1, 0, 1, no
747172498945474561,  calavice3, 1, 0, 1, no
758274506829987840,  Frank31820994, 2, 0, 2, no
460450308,  GIUSYMARTALO, 2, 0, 2, no
585871107,  raffaele_tucci, 2, 0, 2, no
79005597,  luc4ut, 4, 0, 4, no
1042462844,  FabSpedale, 1, 0, 1, no
2230102908,  marsili_alberto, 1, 0, 1, no
2896777635,  GaleanoRiccardo, 1, 0, 1, no
1389022441,  PaparellaR0cc, 3, 2, 1, yes
2253267231,  StefanoMontana4, 2, 0, 2, no
1609938302,  Fbenincasa75, 1, 0, 1, no
456141356,  MarcoBenarrivo, 1, 0, 1, no
456988512,  eleonorapavesi, 2, 0, 2, no
1225067388,  carmenzerotto1, 1, 0, 1, no
1665884389,  parrinello42, 1, 0, 1, no
1601716938,  Forlenza_Vito, 16, 0, 16, no
1942284877,  VitoCreamy, 1, 0, 1, no
766299046378102784,  Lisa97790208, 6, 0, 6, no
440718150,  RIngegnoli, 1, 0, 1, no
215735111,  SalvoRGB, 2, 0, 2, no
781572318090915844,  VincenzaChiefa, 1, 0, 1, no
45415143,  Pusillanime00, 1, 0, 1, no
3925347557,  maTi_Pelli, 1, 0, 1, no
2878237587,  ValePuligheddu, 1, 0, 1, no
1865508474,  moto58rola, 1, 0, 1, no
318959018,  RobdecaDe, 1, 0, 1, no
1268009264,  ManuPontis, 4, 0, 4, no
1261967018,  NotaroAnna, 2, 0, 2, no
431483569,  granatamilo, 1, 0, 1, no
800648842752315393,  amedeomuoio, 1, 0, 1, no
3351609791,  taniatyrossa, 1, 0, 1, no
482147117,  MattiaLiPuma, 1, 0, 1, no
2746995422,  mattiabgl, 1, 0, 1, no
399346824,  patriziadelross, 1, 0, 1, no
12752012,  wizardino, 1, 0, 1, no
2195622679,  Isa_Adinolfi, 2, 0, 2, no
1364546478,  toghni83, 1, 0, 1, no
1454869160,  fiorellabenci, 1, 0, 1, no
1537579003,  MusicShared95, 1, 0, 1, no
2561977803,  gradang75, 1, 0, 1, no
256596290,  Marsch23, 1, 0, 1, no
2834233443,  52Fabio52, 2, 0, 2, no
2332486730,  RIJEKApartments, 3, 0, 3, no
822057882,  TomsonResta, 2, 0, 2, no
303929988,  PaoloCaponetto, 1, 0, 1, no
95441446,  iseddin, 1, 0, 1, no
434817153,  salvass78, 1, 0, 1, no
784105165079085057,  fefelab85, 1, 0, 1, no
755690195622699008,  lorenzocelic, 1, 0, 1, no
415514079,  cosimobarra, 1, 0, 1, no
1565351414,  DemaRegina, 3, 0, 3, no
497315201,  cbcarlito, 1, 0, 1, no
2334780685,  rillo66, 8, 0, 8, no
563687087,  Clamass68, 1, 0, 1, no
1854517788,  AntoninoMigliet, 4, 0, 4, no
399455627,  ArmandoNapoleta, 1, 0, 1, no
779648076,  FChiarucci, 3, 0, 3, no
2887152821,  FaceGianni, 1, 0, 1, no
1338795409,  centercallsaler, 2, 0, 2, no
105100430,  claudiorisi, 2, 0, 2, no
1015984172,  JanRudolfWaclaw, 1, 0, 1, no
3233036369,  carfonte, 1, 0, 1, no
2219790670,  SveviMarco, 1, 0, 1, no
1370602922,  PedRuggero, 1, 0, 1, no
917106613,  CiancittoC, 1, 0, 1, no
1267263205,  LuigiGennara, 4, 0, 4, no
1179036590,  IserniaGianluca, 1, 0, 1, no
1424197706,  KiurloR, 2, 0, 2, no
631151428,  Pier_joe1927, 1, 0, 1, no
720978207437144064,  Marco210964, 1, 0, 1, no
1504483819,  CadyLeeRock, 4, 0, 4, no
816951644,  matteotisco, 1, 0, 1, no
528507835,  EmilianoBasei, 10, 0, 10, no
591871935,  MarioMascellino, 3, 0, 3, no
409509069,  CeccAntonik, 2, 1, 1, neutral
412445498,  GesuinoCardu, 2, 0, 2, no
3031016373,  martina_gxx, 1, 0, 1, no
2416407784,  bilionare63, 2, 1, 1, neutral
365770924,  lfrankkk, 1, 0, 1, no
481567489,  SaraMarcozzi, 1, 0, 1, no
1250680993,  Francesmart, 1, 0, 1, no
852437864,  MatteoFossati74, 1, 0, 1, no
804062148137779201,  Tito11423960, 1, 0, 1, no
227431559,  antonjo_, 3, 0, 3, no
1462586190,  emilianoandreo, 1, 0, 1, no
51058089,  AntonioSabetta, 1, 0, 1, no
724012565467148288,  vertefjodorov20, 1, 0, 1, no
802243109291749376,  CoscienzaDiZelo, 1, 0, 1, no
260375532,  pinkyalby, 1, 0, 1, no
231141862,  mauriziomc, 1, 0, 1, no
65373148,  parapapu, 4, 0, 4, no
787800174328414208,  vincenzozappon, 3, 0, 3, no
471912361,  bafius73, 1, 0, 1, no
525285013,  AndreaMoriello, 1, 0, 1, no
3314778179,  m5sumbria, 1, 0, 1, no
2840126938,  roberpiu, 2, 0, 2, no
2339135738,  gabcecchini, 1, 0, 1, no
497119569,  SasaCaiazza, 1, 0, 1, no
717355882342981633,  BertucciGabrie2, 1, 0, 1, no
291643455,  Simone_Giamp, 1, 0, 1, no
1137078259,  marinellamantov, 1, 0, 1, no
495899677,  calimerando, 2, 0, 2, no
1017325987,  josef_oddo, 1, 0, 1, no
187280264,  MarioMicillo, 1, 0, 1, no
215602422,  Igor_76, 1, 0, 1, no
445648044,  MolinariDavide, 1, 0, 1, no
2199633606,  BrunoZito2, 2, 0, 2, no
2370221592,  jacberti, 2, 0, 2, no
2386238362,  LoskoPiero, 1, 0, 1, no
4445896233,  Silvano43689208, 3, 0, 3, no
1465483002,  marta_prova, 3, 0, 3, no
22059942,  Incerti, 3, 0, 3, no
718454532070645760,  TizianaDeChiar2, 1, 0, 1, no
2868975208,  massimopad, 1, 0, 1, no
75244473,  musicAndri, 1, 0, 1, no
778647667039690752,  IoVotoForse, 1, 0, 1, no
560540704,  AlicePrimofiore, 1, 0, 1, no
234371367,  Giuseppe988, 2, 0, 2, no
338277664,  fra_gentile, 1, 0, 1, no
29949938,  Fantalisa11, 1, 0, 1, no
2808612898,  alcmq, 1, 0, 1, no
3027663464,  tonimor52, 1, 0, 1, no
295458873,  StefanoTasquier, 3, 0, 3, no
2321252292,  MgmMele, 1, 0, 1, no
1034927581,  FraVegan, 1, 0, 1, no
553567662,  ce_orla, 4, 0, 4, no
974551627,  filomenacotti, 1, 0, 1, no
105890490,  mghignatti, 1, 0, 1, no
436153188,  sciancomat, 1, 0, 1, no
4743147495,  SSalvatore66, 1, 0, 1, no
296507003,  ErnyMilan9, 2, 0, 2, no
4083585255,  iannantuono_a, 1, 0, 1, no
743513444926787586,  Asuka_Kano_, 1, 0, 1, no
1026900505,  Aclyssia, 1, 0, 1, no
784055854236573696,  TupackLeo, 1, 0, 1, no
307260980,  giovannisal91, 5, 0, 5, no
307920458,  Strama_manchi, 2, 0, 2, no
460099696,  LuciaLazzeri77, 1, 0, 1, no
175044831,  analphabeta, 1, 0, 1, no
2753391711,  yabuki68, 3, 0, 3, no
2525740797,  AlfSen82, 1, 0, 1, no
751547228,  totobaby77, 1, 0, 1, no
3310846805,  gianluca_tufano, 1, 0, 1, no
427476449,  proffiforever, 1, 0, 1, no
3405492419,  Alfredo10395079, 1, 0, 1, no
764435675227774976,  salvo7358, 2, 0, 2, no
14410869,  pianozero, 1, 0, 1, no
834242162,  SattaStt, 1, 0, 1, no
2883152433,  idnorep, 2, 0, 2, no
1716718334,  lorenzo291078, 1, 0, 1, no
753174758087331840,  celario_paola, 1, 0, 1, no
2789363694,  mariagiardina5, 7, 0, 7, no
588208330,  AnnaIacomelli, 1, 0, 1, no
625856670,  MicheleVitale22, 1, 0, 1, no
2319505332,  carroneandrea, 6, 0, 6, no
747071486482055168,  CristinaLongin2, 1, 0, 1, no
435137464,  cretellam, 1, 0, 1, no
426918412,  Trixie2405, 3, 0, 3, no
465584625,  valegenn, 1, 0, 1, no
395525660,  BonciMarco, 1, 0, 1, no
1446911749,  mk_stefy, 1, 0, 1, no
2442172829,  LuckyGarofalo, 1, 0, 1, no
2501148630,  MarginInversi, 2, 0, 2, no
1014946904,  CammerCarolina, 3, 0, 3, no
718197754242142209,  chieco961, 1, 0, 1, no
1385272040,  moretto333, 3, 0, 3, no
328168761,  Alesss77, 3, 0, 3, no
264116115,  60LG, 2, 1, 1, neutral
2771382189,  OriginOfQueen, 1, 0, 1, no
495033529,  mariosboobs, 3, 0, 3, no
437630901,  Laura_McFly95, 2, 0, 2, no
70086035,  salstan123, 1, 0, 1, no
67286398,  phoebehw, 1, 0, 1, no
2676363277,  hadgebest, 1, 0, 1, no
717579320,  RobertoMontana8, 2, 0, 2, no
805035489371815936,  ToniniVioletta, 1, 0, 1, no
797738652499582977,  BarbaraThebress, 1, 0, 1, no
791361224252489728,  Butterf63421403, 2, 0, 2, no
1236652220,  AlessioGrottola, 2, 0, 2, no
4398733419,  costcri, 2, 0, 2, no
408406196,  BarileGiuseppe, 2, 0, 2, no
2591510034,  serenamia5, 1, 0, 1, no
536140387,  giannitinelli2, 1, 0, 1, no
726847158,  angelicozenone, 1, 0, 1, no
98813859,  SportsLitWriter, 1, 0, 1, no
158106087,  brutaleo, 2, 0, 2, no
2981820371,  Thecubepr, 1, 0, 1, no
1728704371,  MPorzioCatone5S, 1, 0, 1, no
3029974462,  nunziaargenzia1, 2, 0, 2, no
778703684054097920,  Pot_1981, 1, 0, 1, no
4069278623,  GiovanniMonca10, 2, 0, 2, no
774968109002358784,  Francydes95, 1, 0, 1, no
409291868,  GianniFabi, 1, 0, 1, no
1915390190,  PietroAusano, 1, 0, 1, no
841723272,  antonio_sannia, 1, 0, 1, no
2780234221,  MarcoZullo, 5, 0, 5, no
766208199917703168,  pa_gelsomino, 1, 0, 1, no
424087659,  alexandroscialo, 2, 0, 2, no
2957376141,  carmagnola67, 1, 0, 1, no
3026266861,  PorruRosa, 1, 0, 1, no
787663494183260161,  Christi61286849, 1, 0, 1, no
407878518,  Sal861, 4, 0, 4, no
1149376610,  Fer81P, 1, 0, 1, no
617171996,  cercinico, 1, 0, 1, no
3072562972,  AgataLiggieri, 1, 0, 1, no
1386423176,  AndreaVallascas, 3, 0, 3, no
1162767474,  vive0101, 1, 0, 1, no
113456813,  dogio81, 3, 0, 3, no
378157055,  AndreaDibi, 1, 0, 1, no
425643681,  3sfazzari, 1, 0, 1, no
2162905795,  riomare56, 2, 0, 2, no
97228214,  Andrea__Vitale, 1, 0, 1, no
2818986705,  unochepensa, 1, 0, 1, no
1084152606,  ginko600, 2, 1, 1, neutral
228321602,  ennio79, 2, 0, 2, no
711099043,  FortunatoGmail, 1, 0, 1, no
1047652207,  Anna161514, 2, 0, 2, no
1392316111,  Gia_mina, 1, 0, 1, no
746615602513612800,  michelamastr, 1, 0, 1, no
1029356240,  AngyAuroraTh, 1, 0, 1, no
3065729321,  darllngkeatonn, 1, 0, 1, no
742000041305505792,  afragola5stelle, 1, 0, 1, no
2745351881,  trilliblu17, 1, 0, 1, no
93440777,  doriano1950, 4, 0, 4, no
554319615,  RobertoDArrigo, 1, 0, 1, no
805509092689190912,  turiuk1801, 1, 0, 1, no
496843205,  AgroLanDesigner, 1, 0, 1, no
424092979,  ramarroart, 1, 0, 1, no
177504451,  AlpTungaGoktug, 1, 0, 1, no
375721518,  lancill86magnum, 1, 0, 1, no
961043671,  ErcSantsMon, 2, 0, 2, no
3024109528,  Tiziano06111983, 1, 0, 1, no
1416142333,  sylviaheat, 1, 0, 1, no
565519280,  Alessia_DAmico, 1, 0, 1, no
464850279,  MarcoFasano88, 1, 0, 1, no
417404028,  DixonJrdc, 1, 0, 1, no
469519349,  RamiAkremi, 1, 0, 1, no
861246444,  Paolo_Rosetti, 1, 0, 1, no
3234316363,  andpacca, 1, 0, 1, no
435026743,  GuaprovTron, 8, 3, 5, no
1134732668,  elenagluc, 4, 0, 4, no
319093216,  zuozo_, 1, 0, 1, no
2692705233,  BrunoDonatella, 1, 0, 1, no
1285313371,  Tototris, 1, 0, 1, no
997943606,  AngelaAngeliqu1, 3, 0, 3, no
582717492,  aluigi86, 1, 0, 1, no
47555976,  z_michel, 4, 0, 4, no
1462107829,  AscanioFerraro, 1, 0, 1, no
380838056,  JessicaDAltilia, 1, 0, 1, no
3231826833,  tweemelk, 1, 0, 1, no
477934480,  jourdan975, 1, 0, 1, no
2984387777,  DibiaseTafuri, 1, 0, 1, no
1072331106,  FrancBusinarolo, 2, 0, 2, no
719542156126498816,  PASQUALECOLICC6, 2, 0, 2, no
2179542069,  zoroinfbo, 1, 0, 1, no
2447136595,  Alina34334849, 1, 0, 1, no
3906755599,  ivanalealini, 15, 0, 15, no
341729250,  AntonioMarchi10, 1, 0, 1, no
40216987,  micck66, 3, 0, 3, no
1899976812,  WalterVerona, 3, 0, 3, no
1522918213,  CarloGibertoni, 1, 0, 1, no
635283342,  BestettiMassimo, 3, 0, 3, no
1043140386,  MBalderi, 1, 0, 1, no
965980400,  TittiDN, 1, 0, 1, no
382141768,  ginosaru, 1, 0, 1, no
3009523493,  fabgogna, 1, 0, 1, no
1460749387,  ZauliSara, 1, 0, 1, no
1398174300,  AntoLari1986, 2, 0, 2, no
3070122863,  alebsct, 1, 0, 1, no
3336497591,  piga_martina, 2, 0, 2, no
2611121314,  jessagnese, 1, 0, 1, no
3997300246,  mpastore181, 1, 0, 1, no
706977832,  sam2itta, 2, 0, 2, no
2356354474,  CorvinoDaniele, 1, 0, 1, no
3093644236,  alesdigennaro, 1, 0, 1, no
397902445,  musichetta_82, 2, 0, 2, no
194916610,  EleonoraLaura, 2, 0, 2, no
113707488,  alinoski, 1, 0, 1, no
4875918567,  eribertomazza, 1, 0, 1, no
400228971,  LovethehoneyB, 1, 0, 1, no
164255352,  Aquila6, 1, 0, 1, no
2277299122,  GinevrinoF, 1, 0, 1, no
797546504709881856,  massimogbonanno, 1, 0, 1, no
517367400,  MicheleFumarol1, 1, 0, 1, no
805621619381116928,  Ci_Siamo_Quasi, 6, 0, 6, no
204362369,  fanzfeng, 2, 0, 2, no
72653116,  chille82, 1, 0, 1, no
410796950,  thenc83, 2, 0, 2, no
492868812,  Stefy_61, 1, 0, 1, no
4093194160,  ilmasco, 1, 0, 1, no
1342378488,  Laura_hioops, 1, 0, 1, no
2864655706,  laurasatta67, 1, 0, 1, no
155175769,  limone86, 1, 0, 1, no
418301345,  SuperErmy, 7, 0, 7, no
3001315397,  dcortes217, 2, 0, 2, no
786291541560164353,  luciaarioli, 1, 0, 1, no
725267992490201089,  MirkoHashtag, 1, 0, 1, no
1735413050,  GiuVik, 1, 0, 1, no
370317402,  riccardolino97, 1, 0, 1, no
508542444,  AdamartArt, 2, 1, 1, neutral
487350871,  Noodles_70, 3, 1, 2, no
497067598,  Zinno_Anto777, 1, 0, 1, no
3110991701,  nanni_antonio, 1, 0, 1, no
3233822843,  LCasuc, 2, 0, 2, no
893322829,  giuseppedibel11, 2, 0, 2, no
1444057844,  donatelladt, 2, 0, 2, no
424232469,  Mari_iuso, 1, 0, 1, no
115125066,  omarcip, 2, 0, 2, no
1259876935,  pierowatchdog, 1, 0, 1, no
739464739848327168,  aldocivello, 1, 0, 1, no
163973932,  GENOA69, 1, 0, 1, no
1140585595,  GiovaFalcone, 1, 0, 1, no
2358239955,  STuozzi, 1, 0, 1, no
713488995267776512,  leonardo_car_90, 1, 0, 1, no
2802565126,  SasyCuturi, 1, 0, 1, no
411587862,  Zimo1976, 1, 0, 1, no
1907788800,  GASPARETITONE92, 1, 0, 1, no
192277509,  gxausa, 4, 0, 4, no
404038986,  PaoloVaccarello, 1, 0, 1, no
701978031,  Tatmattat, 1, 0, 1, no
4076789541,  Nanasupergirls, 1, 0, 1, no
2534832186,  brinopuzzul, 1, 0, 1, no
790016995,  All80Alogna, 2, 1, 1, neutral
728289066169606144,  respectRESPECTo, 4, 0, 4, no
49592235,  a_colonello, 1, 0, 1, no
1241512020,  EmilioCenturio, 1, 0, 1, no
524427275,  LeoBellucci68, 1, 0, 1, no
418532282,  Alessandro_mic, 1, 0, 1, no
19791924,  Matteo84, 1, 0, 1, no
768361830049775616,  NelloLombardo87, 1, 0, 1, no
98875860,  materlun, 2, 1, 1, neutral
4895277075,  zvezda_int, 1, 0, 1, no
445727059,  marcellomolina1, 4, 0, 4, no
96368478,  depot36, 1, 0, 1, no
784756576229978112,  sandrolindirix, 1, 0, 1, no
389329973,  FabioBramati, 2, 0, 2, no
401573417,  WiAnselmo, 1, 0, 1, no
1036785966,  LuciusEvil85, 1, 0, 1, no
2807355797,  DiBallista, 1, 0, 1, no
711937157234106369,  KorianLXX, 1, 0, 1, no
621945762,  GENNAR0ACANFORA, 5, 0, 5, no
734404005544251392,  politisonia9, 3, 0, 3, no
1008846302,  AlexMelicchio, 2, 0, 2, no
3151774115,  CardoneGaspare, 2, 0, 2, no
1576436762,  brook1285, 1, 0, 1, no
347879345,  itsmiry, 1, 0, 1, no
3564664455,  vittorio83101, 2, 0, 2, no
498746167,  Deviduan, 1, 0, 1, no
97512948,  michele1375, 1, 0, 1, no
1234070258,  LuigiTrib, 2, 0, 2, no
510441663,  LFestolai, 2, 0, 2, no
3079004361,  blackskies81, 1, 0, 1, no
2686763793,  antonio_podda, 1, 0, 1, no
208792626,  7Claus, 1, 0, 1, no
795170913759232000,  MassimoPiam, 3, 0, 3, no
796633775908200448,  bonacina_milvia, 1, 0, 1, no
1223938933,  IgnazioMarchett, 1, 0, 1, no
97654241,  ibadiagne1, 3, 0, 3, no
2860387389,  FabFaberrimo, 1, 0, 1, no
3669161052,  iOpPiXQ, 1, 0, 1, no
2407292225,  viaggioasudest, 4, 0, 4, no
960709286,  PSalutij, 2, 0, 2, no
272444320,  ziogio84, 1, 0, 1, no
193093990,  StefanoLimido, 7, 0, 7, no
401270818,  VoltoliniSergio, 1, 0, 1, no
424887657,  _mirylisa_, 1, 0, 1, no
546146776,  emma_montilla, 1, 0, 1, no
409401116,  jaureguicrushes, 1, 0, 1, no
488228389,  Alamroste, 1, 0, 1, no
1104800478,  antoninofiorel2, 1, 0, 1, no
2715490961,  giovannimiobor, 1, 0, 1, no
324937940,  LucaCialone, 1, 0, 1, no
471288163,  dbaldoli, 2, 0, 2, no
997961833,  Jikkol, 3, 0, 3, no
538352513,  justlikeaswan, 1, 0, 1, no
257600699,  danieleamadei1, 1, 0, 1, no
868842919,  motardknight, 2, 0, 2, no
4011769781,  AleCaimano95, 1, 0, 1, no
2230687067,  RenziValentino, 1, 0, 1, no
398777579,  Ferdinando_R, 1, 0, 1, no
789473196974235648,  figiovanibari, 1, 0, 1, no
2403109144,  amato_ea, 1, 0, 1, no
916122110,  Bala_mazeh, 1, 0, 1, no
418585940,  daniele_bungaro, 1, 0, 1, no
433157453,  daniele_delgiu, 2, 0, 2, no
1300336105,  carlo_rodini, 1, 0, 1, no
2490453968,  ITnewsAQ, 1, 0, 1, no
4593402796,  nadiagennaio, 1, 0, 1, no
70914477,  paolo_rainone, 1, 0, 1, no
1367554068,  MarcoCheck, 1, 0, 1, no
2189123792,  noviello_m, 1, 0, 1, no
4744364495,  sdp230170, 1, 0, 1, no
4897441318,  Peppe15850, 1, 0, 1, no
421940382,  morgante_ant, 1, 0, 1, no
854995166,  lucamerlo1961, 1, 0, 1, no
114541381,  FlavioParis, 1, 0, 1, no
1546601714,  FilippoCorbetta, 3, 0, 3, no
3601765336,  LallaAnedda, 1, 0, 1, no
386605670,  mmcastellana, 1, 0, 1, no
1007379228,  DaniCancellaro, 2, 0, 2, no
412371227,  AngieCalabria, 2, 0, 2, no
425154943,  sindacoascoli, 2, 0, 2, no
743901080,  RiccardoSerino, 1, 0, 1, no
4121762391,  OgnibeneAntoni0, 2, 0, 2, no
533298709,  ItsMsBeatrice, 4, 0, 4, no
821279118,  savinovurchio, 3, 2, 1, yes
3664513217,  PaolaJadeluca, 1, 1, 0, yes
236346513,  illetterati, 1, 0, 1, no
2223424171,  dileboss, 1, 0, 1, no
538979322,  Al3xI98O, 2, 0, 2, no
516425565,  alessan14409230, 1, 0, 1, no
2810483745,  salvodenaro969, 1, 0, 1, no
2972138392,  ZQuaglia, 1, 0, 1, no
3152326126,  mmoviedreamer, 2, 0, 2, no
2247033698,  nicomorreale, 1, 0, 1, no
1022297180,  seminavento, 1, 0, 1, no
55205815,  danibarison, 2, 0, 2, no
1086392940,  judyset, 2, 0, 2, no
2198055140,  esarpieri, 2, 0, 2, no
198237141,  CruthABhais, 2, 0, 2, no
3395698721,  possibileTO, 16, 0, 16, no
958385528,  berardi_berry, 1, 0, 1, no
1075851336,  mazzodirosa, 5, 0, 5, no
3304312095,  Cesenati, 1, 0, 1, no
2489783098,  InchesMarina, 1, 0, 1, no
3429792322,  Sinibaldo2, 2, 0, 2, no
832781346,  elleflo, 1, 0, 1, no
17623945,  gfailli, 1, 0, 1, no
2886188501,  sarah_fagnani, 1, 0, 1, no
2663879552,  gnofforosy, 1, 0, 1, no
923054467,  grosciarelli, 1, 0, 1, no
133657565,  callthewild, 2, 0, 2, no
361378092,  ele_MP, 1, 0, 1, no
1254914232,  Vaperonzolo, 1, 0, 1, no
403690384,  gghrrrr, 3, 0, 3, no
402200260,  ilariaeffe_, 6, 1, 5, no
612573173,  AntoniaFerri96, 1, 0, 1, no
247726328,  yes_political, 61, 0, 61, no
50773283,  quillyx, 7, 0, 7, no
787557789908492288,  KiraPossibile, 12, 0, 12, no
475922296,  lucatrent, 1, 0, 1, no
714376418055073793,  rosabiancage, 40, 0, 40, no
3394568602,  bria_daniela, 4, 0, 4, no
1300370167,  gmarcoc, 12, 0, 12, no
4237848425,  AstiPossibile, 12, 0, 12, no
3579613995,  CantoniAndrea3, 4, 0, 4, no
972656305,  graziellabonazz, 2, 0, 2, no
519587814,  claudiasuman, 1, 0, 1, no
415474316,  ChiaraBen1, 1, 0, 1, no
113092215,  robertodiloreto, 5, 0, 5, no
27076736,  Gianuario, 1, 0, 1, no
596242494,  GobbatoOmar, 1, 0, 1, no
4895171374,  maria_atza, 1, 0, 1, no
84114885,  Scisciolina, 1, 0, 1, no
103850600,  annadicosmo, 1, 0, 1, no
14743741,  federicabianchi, 1, 0, 1, no
336091189,  LucaBortot, 24, 0, 24, no
352286129,  CicoGiattini, 3, 0, 3, no
2358389201,  DavipasquaD, 1, 0, 1, no
587385901,  giuliana_63, 3, 0, 3, no
615369614,  sonosempregraz, 3, 0, 3, no
291299121,  AkanumaSaburo, 1, 0, 1, no
1927609350,  FAttiani, 1, 0, 1, no
482937083,  Retedellereti, 3, 2, 1, yes
993828108,  carmelo03355935, 1, 0, 1, no
710856118,  RealiAlice, 1, 0, 1, no
2493300512,  gui_sann, 15, 0, 15, no
1857916189,  Pablobrado, 2, 0, 2, no
340206383,  marge78s, 4, 1, 3, no
72123412,  longghost, 1, 0, 1, no
256448479,  valeriaderosa, 1, 0, 1, no
180519887,  cibe68, 5, 0, 5, no
2414965448,  FamaNelMondo, 1, 0, 1, no
714364362320912385,  Fullmonty_Ge, 12, 0, 12, no
504900046,  SaraSarita1978, 5, 0, 5, no
739555684379992064,  armando_ciraci, 1, 0, 1, no
486146467,  fra__alice, 10, 0, 10, no
285012814,  Dat4BIT, 1, 0, 1, no
322933929,  ellyesse, 21, 0, 21, no
54912548,  mattianocchi, 1, 0, 1, no
307312384,  sheispale, 1, 0, 1, no
549362239,  paolopedrollo, 2, 0, 2, no
765596923,  kappalvia, 1, 0, 1, no
537571703,  pola6565, 2, 0, 2, no
3906873494,  DocZocc, 1, 0, 1, no
765607412778893312,  MarcisRosa, 3, 0, 3, no
51752772,  stefanocatone, 65, 0, 65, no
993545408,  AvvAMaestri, 16, 1, 15, no
721992704,  CocchiaraA, 1, 0, 1, no
402821533,  Blunaturale, 22, 0, 22, no
802346387056848896,  Mattia_Piac, 1, 0, 1, no
2295054346,  Luisa_Zu, 1, 0, 1, no
2290581567,  martola_ba, 1, 0, 1, no
752109345333182464,  RobynH711, 1, 0, 1, no
400271467,  ziacoco_, 1, 0, 1, no
3145545058,  RomaPossibile, 6, 0, 6, no
87500470,  fepop, 3, 0, 3, no
791983374890070017,  FrancescoLabri5, 4, 0, 4, no
3381931395,  ElenaSeroni, 1, 0, 1, no
14203530,  alberto_e_fabio, 3, 0, 3, no
418164976,  rosario_deluca, 1, 0, 1, no
3676258635,  mainardi_c, 1, 0, 1, no
1017310213,  EmanuelaAmendo1, 45, 0, 45, no
555223117,  SerenaMatata, 1, 0, 1, no
219283583,  ennionicolucci, 1, 0, 1, no
297353414,  LeoBrattoli, 5, 0, 5, no
1040112655,  PescioA, 1, 0, 1, no
4296909862,  PossibileRimini, 2, 0, 2, no
343557294,  betascia, 7, 0, 7, no
107832131,  monicaborgonovo, 1, 0, 1, no
2357348337,  MarcoManJazz, 2, 0, 2, no
1660188204,  AlbaVallone, 2, 0, 2, no
1026285708,  antonacci_s, 1, 0, 1, no
218170928,  babethin, 1, 0, 1, no
745654987,  SandraQuellen, 4, 0, 4, no
2867411482,  ervalax, 2, 0, 2, no
744104941,  TamaraVitelli, 1, 0, 1, no
92093560,  Annansr, 1, 0, 1, no
322644117,  lamberto50, 1, 0, 1, no
227326545,  enricomariam42, 1, 0, 1, no
83905283,  EleonoraBellini, 5, 0, 5, no
570043126,  CHCEmsden, 1, 0, 1, no
2980651536,  Aleky88_, 1, 0, 1, no
908644910,  IndipenDancing, 3, 0, 3, no
3246308829,  GBertaiola, 5, 0, 5, no
425198347,  maxrobmax, 2, 1, 1, neutral
272473332,  rupof, 4, 0, 4, no
4105925825,  SpettinatiPisa, 105, 0, 105, no
2778839548,  totibusc, 1, 0, 1, no
2471307470,  MariaGi45409317, 4, 0, 4, no
18074964,  riccardosusigan, 4, 0, 4, no
134043295,  springcornfield, 4, 0, 4, no
68464543,  _C1P8, 5, 0, 5, no
472149764,  lucapasto71, 5, 0, 5, no
3980123284,  ZaraPossibile, 9, 0, 9, no
2385387728,  thunder_Luna, 1, 0, 1, no
3141830668,  b6f85a4e93924c7, 5, 0, 5, no
368938633,  paologabri, 2, 0, 2, no
432659382,  fraturca, 1, 0, 1, no
995538919,  rossipaoloborg, 2, 0, 2, no
2452845047,  SernesiAnna, 2, 0, 2, no
829100496,  emanuele_delca, 1, 0, 1, no
514862063,  gmbadalucco, 8, 0, 8, no
1012718378,  otto_gerbotto, 7, 0, 7, no
3372564964,  Ann14256154, 1, 0, 1, no
1650257054,  LaStefi_P, 6, 0, 6, no
409780693,  beck2009, 1, 0, 1, no
2789716509,  36Antignani, 1, 0, 1, no
356979186,  morenaragone, 1, 0, 1, no
1388012268,  adrianadanielis, 1, 0, 1, no
228092863,  iparchia, 1, 0, 1, no
216722162,  robertobraibant, 4, 1, 3, no
1747593649,  sseruenah, 1, 0, 1, no
455091874,  EnzoSpano, 10, 0, 10, no
2788775085,  LiviDaniela, 1, 0, 1, no
2745073989,  fabiolabernar12, 1, 0, 1, no
2258720305,  frances1724, 1, 0, 1, no
553489727,  Pikkkets, 4, 0, 4, no
379606499,  pachir1, 1, 0, 1, no
2586934926,  grrsarafe, 1, 0, 1, no
864298688,  my_fugaro, 1, 0, 1, no
2438113823,  da_angelini, 1, 0, 1, no
61253013,  valelelli, 3, 0, 3, no
3345399412,  lorenzmetr, 1, 0, 1, no
2245662505,  pdeffe, 18, 0, 18, no
1228301834,  FrancoMusiani, 2, 0, 2, no
969981643,  ES1670, 1, 0, 1, no
449929150,  Zziagenio78, 1, 0, 1, no
736738094,  dakota_rain1986, 1, 0, 1, no
413452932,  chiccotassi, 33, 0, 33, no
396708812,  Samuelpk88, 4, 0, 4, no
1153870734,  pucciopucci, 4, 0, 4, no
2467854313,  CrippaCristiano, 1, 0, 1, no
2942489579,  robespierre1102, 1, 0, 1, no
2505069530,  azarb56, 1, 0, 1, no
2365629604,  Itapop3, 1, 0, 1, no
711840434922905601,  wberor, 1, 0, 1, no
4754588073,  PatrizioRossi68, 1, 0, 1, no
299591494,  aurelionoto, 2, 0, 2, no
716296157501251584,  11Anna33, 2, 0, 2, no
2859584915,  ElisabettaLapa, 6, 0, 6, no
2256825849,  RCavalleris, 1, 0, 1, no
28311464,  newyorker01, 4, 0, 4, no
483921025,  stefanotenenti, 1, 0, 1, no
963357198,  solosamp52, 1, 0, 1, no
952525316,  sgiangra69, 4, 0, 4, no
868495848,  FerminaTardiola, 1, 0, 1, no
314704846,  Valeriadionisi, 1, 0, 1, no
1371364542,  GiorgioCassiani, 1, 0, 1, no
374492014,  edo_cavalieri, 4, 0, 4, no
556279234,  ValeJim78, 1, 0, 1, no
195570374,  ManuelNegri1, 1, 0, 1, no
423764654,  Manuelitas3, 1, 0, 1, no
765272653,  marco_piotti, 1, 0, 1, no
368251893,  PopperPro, 1, 0, 1, no
328728398,  FrCarrozza, 4, 0, 4, no
315206080,  MassimoBorin, 1, 0, 1, no
1901726846,  acollocola, 3, 0, 3, no
1162777183,  MAcquisto, 1, 0, 1, no
2180838160,  ir8lotus, 14, 1, 13, no
498950135,  DaBraveSquirrel, 1, 0, 1, no
424953319,  luca74alba, 1, 0, 1, no
548339636,  Gerardo6481, 1, 0, 1, no
1338533124,  bgassistenza, 1, 0, 1, no
759087906698952705,  salvolacquisto, 1, 0, 1, no
1056261745,  cadore31, 1, 0, 1, no
753897017479458816,  Re_Sambuco, 5, 0, 5, no
354437152,  romugio, 1, 0, 1, no
546883200,  Orsito57, 3, 0, 3, no
146990130,  Bisont19, 1, 0, 1, no
4904886465,  FrancescomerloI, 3, 0, 3, no
573026318,  MicheleOkuto79, 1, 0, 1, no
434245648,  jg88london, 1, 0, 1, no
4204846048,  Sima_luse, 1, 0, 1, no
734978406,  martascelto, 1, 0, 1, no
417987965,  cintamtam, 4, 0, 4, no
616006828,  DjProfC, 1, 0, 1, no
467800902,  M6Massimiliano, 1, 0, 1, no
3155599023,  Ser_Otonin, 1, 0, 1, no
170662528,  Roby1893, 2, 0, 2, no
55290343,  Cirillo71, 3, 0, 3, no
2341857585,  mixmichy, 2, 0, 2, no
2948819674,  PSgces, 3, 0, 3, no
2707696839,  giagc1, 1, 0, 1, no
465494905,  Ale_Il_Cica, 2, 0, 2, no
325434933,  lajeje13, 3, 0, 3, no
993658128,  holdenboerina, 4, 0, 4, no
585007734,  ErmenautaE, 1, 0, 1, no
524960159,  lucapontani1, 1, 0, 1, no
453913656,  StefBadi, 1, 0, 1, no
2820137385,  chiauzza, 1, 0, 1, no
708633075190775808,  lucia_speciale, 1, 0, 1, no
731917270369357824,  alessandra_fata, 4, 0, 4, no
2825937448,  GiankarlinoP, 2, 0, 2, no
701001362688057344,  ChiccaC5, 1, 0, 1, no
2752633492,  ftoscano45, 2, 0, 2, no
3124892121,  vivo8001, 1, 0, 1, no
201383425,  ilMalf, 1, 0, 1, no
3861211695,  NicolettaAnton6, 2, 0, 2, no
1960996136,  Boukols, 1, 0, 1, no
94096311,  silariucci, 3, 0, 3, no
4909961751,  ritabiabi, 2, 0, 2, no
222031257,  mamalu01, 1, 0, 1, no
484111651,  PietroPinna77, 2, 0, 2, no
484710448,  tedbeebundy, 4, 0, 4, no
49400917,  Daniele_Brundu, 2, 0, 2, no
296556636,  Megistone90, 1, 0, 1, no
371984063,  CorradoDeMori_, 2, 0, 2, no
2723526534,  consuldati, 4, 0, 4, no
534158772,  AllanKafka, 1, 0, 1, no
1464772885,  VenetoPossibile, 1, 0, 1, no
898362882,  pasolinisel, 1, 0, 1, no
354192905,  andreferto, 2, 0, 2, no
267649803,  LuigiGrimaldi19, 2, 0, 2, no
2508822164,  elifiniguerra, 1, 0, 1, no
1456957934,  donbicenzo, 1, 0, 1, no
52887994,  signro, 1, 0, 1, no
2528310757,  max75arvat, 2, 0, 2, no
1697331835,  salvo092z105, 2, 0, 2, no
1363738694,  nicgconti, 1, 0, 1, no
252472868,  delotwitt, 3, 0, 3, no
407777608,  GPGiampi, 18, 0, 18, no
3907053811,  marco_sberla, 3, 0, 3, no
475785102,  MariaLuisaCamma, 1, 0, 1, no
86396588,  manutrentasan, 1, 0, 1, no
795413094306578432,  fra_calia, 5, 0, 5, no
743476400447959040,  MaraSpagn, 1, 0, 1, no
50755916,  Pelagatti, 1, 0, 1, no
114332714,  DinoGiarrusso, 1, 0, 1, no
4023777869,  natonel1965, 1, 0, 1, no
2604413069,  framaio82, 4, 0, 4, no
724908158813102080,  sicuruslan, 1, 0, 1, no
1063187516,  AngeloFrezzotti, 1, 0, 1, no
3674593815,  PossibileFR, 1, 0, 1, no
144924917,  Chicca7066, 1, 0, 1, no
95655966,  simod87, 2, 0, 2, no
1643202524,  enzastroscio, 1, 0, 1, no
2242134295,  RaskolnikovGio, 1, 0, 1, no
703690480333279232,  ardit_bardho, 1, 0, 1, no
2360067140,  Nubulina, 1, 0, 1, no
136243366,  LucaGaveglia, 3, 0, 3, no
438382792,  dinataled, 2, 0, 2, no
2318726325,  GiuseppeSarao, 1, 0, 1, no
2912674654,  mberguer369, 1, 0, 1, no
465870411,  FranziskanerC, 3, 0, 3, no
404289086,  ilmichelaccio, 1, 0, 1, no
99547552,  saria_mba, 1, 0, 1, no
1601049578,  IsabellaMessa, 1, 0, 1, no
2401546563,  iris_emg, 1, 0, 1, no
267278702,  lasceltadisofie, 1, 0, 1, no
357351456,  sempliciter, 2, 1, 1, neutral
840408042,  ChristianConte_, 1, 0, 1, no
746108643792257025,  OpenGDB, 2, 0, 2, no
1367959076,  markinob, 2, 0, 2, no
488774565,  EulaliaGrillo, 4, 0, 4, no
316376052,  alessandracatsi, 1, 0, 1, no
3197562329,  FerroSte, 4, 0, 4, no
2318623488,  speleogasp, 1, 0, 1, no
1360232630,  europaviva21, 1, 0, 1, no
462974581,  fborsotti, 4, 0, 4, no
496882326,  GrazianoValobon, 2, 0, 2, no
559360022,  NenziTre, 1, 0, 1, no
840139694,  dario_benetti, 2, 0, 2, no
2495046013,  61206bff2fe44a1, 1, 0, 1, no
505731055,  arantza0909, 1, 0, 1, no
1311315589,  vascogeminiani, 2, 0, 2, no
2194346187,  francioni81, 1, 0, 1, no
1239185874,  peppinaines, 4, 0, 4, no
2183118052,  lindamaria61, 1, 0, 1, no
738895631897530368,  bringbacksardon, 1, 0, 1, no
342663113,  SusannaPellis, 1, 0, 1, no
8672302,  ElisAceto, 6, 0, 6, no
2347151255,  paoloparenti9, 2, 1, 1, neutral
1063095882,  Ninnige, 1, 0, 1, no
706017040272859136,  tomicictatjana, 2, 1, 1, neutral
367768283,  anna_navarra, 1, 0, 1, no
723065022,  pomponellacassa, 2, 0, 2, no
489421757,  EFurbini, 1, 0, 1, no
617476851,  angelacasciaro, 1, 0, 1, no
701318641,  chiamaago, 1, 0, 1, no
376435133,  VFocarini, 4, 0, 4, no
548527501,  hiddenyears, 1, 0, 1, no
482157683,  salvatorecalda2, 3, 0, 3, no
278558220,  rob_salentino, 10, 0, 10, no
2267498320,  Morandini44P, 1, 0, 1, no
34666215,  Mister_Mustard_, 10, 0, 10, no
957115429,  GiuliaVB7, 2, 0, 2, no
3297004216,  fcaruso77, 1, 0, 1, no
383392161,  DepaulisLidia, 2, 0, 2, no
41102501,  massimobolzoni, 1, 0, 1, no
33197952,  danikina, 1, 0, 1, no
751709328495828992,  ChiaraNic2000, 2, 0, 2, no
1004351580,  mare_egeo, 1, 0, 1, no
877284637,  esynedd, 1, 0, 1, no
543775709,  BarbanoD, 1, 0, 1, no
405498866,  MoriThinkgreen, 3, 0, 3, no
10305682,  Ennio_Ammatuna, 1, 0, 1, no
16718357,  ilfrance, 4, 0, 4, no
1546075458,  ClaraApi, 2, 0, 2, no
1422707112,  vdisalvo61, 1, 0, 1, no
599317794,  iato4347, 1, 0, 1, no
82389388,  glr_69, 11, 0, 11, no
361097511,  61scacorte, 1, 0, 1, no
1094672911,  rossellabea, 2, 0, 2, no
846308478,  Ctrl0101, 4, 2, 2, neutral
391505537,  AleQuinto1, 1, 0, 1, no
447059765,  anita_lombardi, 1, 0, 1, no
2765465397,  AgostaClaudia, 1, 0, 1, no
985260338,  GiuseppeB3, 1, 0, 1, no
115821691,  EmanueleVitale8, 1, 0, 1, no
1392414307,  LStregatta, 1, 0, 1, no
3728578817,  comp1111, 4, 0, 4, no
1958726070,  MCaua87, 5, 1, 4, no
916889676,  ameranieri, 1, 0, 1, no
3398794235,  PossibileTN, 2, 0, 2, no
3919762222,  gina_longobardi, 1, 0, 1, no
398846237,  babavigano, 1, 0, 1, no
53025983,  mauro_ciociari, 3, 0, 3, no
96736190,  AleFry93, 1, 0, 1, no
362697385,  carocchia_gm, 1, 0, 1, no
2361311542,  mimmoporcaro, 1, 0, 1, no
1111825675,  SbaragliaE, 1, 0, 1, no
2173408514,  matilderossi14, 4, 0, 4, no
97636338,  NazzaroGioia, 1, 0, 1, no
1093674200,  Fragile_ivy, 2, 0, 2, no
390370399,  rita_larita, 2, 0, 2, no
250615118,  baronebarolo, 1, 0, 1, no
708604566414168064,  LeoCusseau, 3, 0, 3, no
430921472,  giorgiobrusa, 1, 0, 1, no
99360043,  GiuseppeMilano, 13, 0, 13, no
323712890,  eireenM, 3, 0, 3, no
421987528,  PaolaGattini1, 2, 0, 2, no
1603537111,  LuccaPossibile, 16, 0, 16, no
597546745,  RobertoOmodei, 2, 0, 2, no
507858408,  mrnlla, 1, 0, 1, no
1528013437,  is0bzr, 6, 0, 6, no
455732838,  giannioriporap, 1, 0, 1, no
1238563154,  nocciola68, 2, 0, 2, no
159428186,  Luisi_36, 1, 0, 1, no
262300343,  CAPTAlNERD, 1, 0, 1, no
181907487,  Piero8211, 3, 0, 3, no
1374627000,  ProssimaPR, 3, 0, 3, no
439907099,  FabSciarratta, 7, 0, 7, no
3143038229,  IpocritaUtopia, 1, 0, 1, no
404232151,  selmabellomo, 5, 0, 5, no
326225431,  francescagibs, 1, 0, 1, no
989780574,  concettagentili, 1, 0, 1, no
2260532036,  gemmapontini, 1, 0, 1, no
82301254,  sonia_star, 1, 0, 1, no
119442405,  MacKlavious, 2, 0, 2, no
407864601,  MasFerrario, 1, 0, 1, no
5660552,  venetianspring, 1, 0, 1, no
518822244,  Melissa_Di_Sano, 1, 0, 1, no
561198013,  pasto_ema, 1, 0, 1, no
16120863,  sinigagl, 9, 0, 9, no
401222371,  SLiberatori, 1, 0, 1, no
620409243,  Giraffa50, 1, 0, 1, no
2219307076,  simotumiotto, 1, 0, 1, no
2902660673,  fabfor53, 1, 0, 1, no
123943257,  fabioiov, 5, 0, 5, no
345413548,  cateferri, 3, 0, 3, no
798264883062206469,  sunneversets100, 3, 1, 2, no
4244506073,  paperallarancia, 1, 0, 1, no
56959678,  Alyssa_77, 1, 0, 1, no
36112151,  eenrico, 8, 0, 8, no
406612713,  SSnaporaz, 1, 0, 1, no
3946857573,  115_marinax, 1, 0, 1, no
485841893,  Speziale11, 5, 0, 5, no
1292233951,  DomenicoSetola, 1, 0, 1, no
4062849807,  ChRiStIaN1987_, 3, 1, 2, no
782203229375438848,  pigna1897, 2, 0, 2, no
1086423912,  klarakic, 2, 0, 2, no
504625929,  FranzFoti, 16, 0, 16, no
600493716,  GianvaM, 1, 0, 1, no
3241670374,  MiraPossibile, 8, 0, 8, no
889554902,  domenicoditell1, 1, 0, 1, no
406074969,  RVilonna, 4, 0, 4, no
393298498,  LaSgarella, 1, 0, 1, no
486764261,  pliniocaocche, 4, 0, 4, no
2269224186,  MarcoAmbra, 1, 0, 1, no
14257328,  Giuseppe_Conte, 2, 0, 2, no
781097255793295361,  APPASSIONAT, 1, 0, 1, no
416602053,  tiramagda, 1, 0, 1, no
61769061,  robboos, 2, 0, 2, no
2268022753,  MariaGraziaLaGr, 1, 0, 1, no
1736856739,  elstitico, 1, 0, 1, no
248600291,  Varrons, 1, 0, 1, no
502040368,  map_pina, 2, 0, 2, no
133661112,  Fabioder, 2, 0, 2, no
421986520,  DavAstolfiGreen, 1, 0, 1, no
14146095,  doonie, 1, 0, 1, no
1416334759,  xsara91x, 1, 0, 1, no
3312600789,  Sarabraghira, 1, 0, 1, no
463819571,  AdriPantera111, 1, 0, 1, no
422900035,  CeciliaDelFreo, 1, 0, 1, no
580072300,  robi_wan_kenoby, 1, 0, 1, no
2735436460,  LeyvaFrancesco, 2, 0, 2, no
70074473,  gaietti, 1, 0, 1, no
3037069073,  giordano_bindi, 1, 0, 1, no
29241203,  ludojona, 1, 0, 1, no
39827736,  entropia2009, 3, 0, 3, no
329655105,  tinellissima, 1, 0, 1, no
904225238,  MascheriniM, 1, 0, 1, no
407827638,  mariadp59, 2, 0, 2, no
2153540972,  jesixcivati, 1, 0, 1, no
96323735,  aliossandro, 1, 0, 1, no
470527296,  MrSkoglio, 1, 0, 1, no
241521416,  fdrctnzz, 1, 0, 1, no
90597064,  Giaimeddu, 7, 0, 7, no
4705737143,  claudiagri89, 2, 0, 2, no
22604022,  AkiFzero, 1, 0, 1, no
101783889,  phr23, 2, 0, 2, no
135640839,  ElfoBruno, 4, 0, 4, no
522636610,  FrankSlade5, 1, 0, 1, no
805150779929722880,  Benedet35791130, 2, 0, 2, no
256888973,  marcocacchioli, 3, 0, 3, no
269723753,  politikavi, 3, 0, 3, no
1362895116,  BaMantiero, 1, 0, 1, no
264429967,  incontestabile, 1, 0, 1, no
96236264,  irpannocchia, 20, 0, 20, no
434743018,  emerge67, 2, 0, 2, no
1657867358,  carusopascoski_, 2, 0, 2, no
258294816,  Frantz75, 7, 1, 6, no
466809596,  Riccardo_Carpa, 1, 0, 1, no
2851657444,  valentina_mulas, 1, 0, 1, no
82319300,  LotarSan, 1, 0, 1, no
1519470108,  Namalo97, 1, 0, 1, no
108061631,  aliciasbb, 3, 0, 3, no
1209302970,  m_decaria, 1, 0, 1, no
389388850,  danny_mancini, 1, 0, 1, no
289844002,  elisapunto, 1, 0, 1, no
2992059808,  Pa_Gug, 1, 0, 1, no
363854578,  AntoPalombi, 2, 0, 2, no
573306944,  ClaudioBocci2, 1, 0, 1, no
3614129489,  napolipossibile, 8, 0, 8, no
259068501,  mariush79, 1, 0, 1, no
708875522,  MicheleSpinella, 2, 0, 2, no
1115796702,  RobySpedicato, 1, 0, 1, no
3301082218,  possibileav, 1, 0, 1, no
2820415427,  Filcafree, 6, 2, 4, no
2660717879,  drya_fly, 2, 0, 2, no
703178296255643648,  Fuori_conTROLL, 1, 0, 1, no
722256877,  dsabbadini, 1, 0, 1, no
3300827655,  AllegraElisa, 1, 0, 1, no
177321655,  mininightingale, 1, 0, 1, no
84030207,  CalzeBucate, 1, 0, 1, no
2357919636,  Trekker1978, 1, 0, 1, no
2291495448,  TizianaNov, 3, 0, 3, no
344890156,  Amanauzzi, 1, 0, 1, no
1929792140,  CastelloPoss, 1, 0, 1, no
3784366697,  chiara_scott_gb, 1, 0, 1, no
124114948,  bure74, 1, 0, 1, no
720938640302600193,  semabluposs, 1, 0, 1, no
1460831760,  brianzapercivat, 1, 0, 1, no
1278796585,  catiacan61, 2, 0, 2, no
1357999944,  MacchiaFilomena, 1, 0, 1, no
363766849,  ulisse470, 1, 0, 1, no
429291540,  zeghes, 1, 0, 1, no
2347407895,  silvanag56, 1, 0, 1, no
304406977,  ida_bauer_, 2, 0, 2, no
763785605713199105,  costituzionesp, 19, 2, 17, no
83427420,  Tobolo73, 1, 0, 1, no
106768331,  watmour, 1, 0, 1, no
1561360807,  DanieleLorenze2, 1, 0, 1, no
205654050,  daniele_varotto, 1, 0, 1, no
2795360609,  WBKimmoto, 1, 0, 1, no
726085176,  piedipalmati, 1, 0, 1, no
722410225161125888,  msgaiafalanga, 1, 0, 1, no
225920702,  Signorina_Wonka, 1, 0, 1, no
927321409,  MapOfMe, 1, 0, 1, no
3375685769,  ffranci9, 1, 0, 1, no
142239687,  robertoambro, 2, 0, 2, no
481109998,  elelua, 1, 0, 1, no
426106037,  pamelarossilli, 1, 0, 1, no
31499492,  caniodica, 2, 0, 2, no
3306815747,  hannalena17m, 1, 0, 1, no
55549791,  JMonicaHD, 8, 3, 5, no
448070647,  aPIcult, 3, 0, 3, no
450911836,  betty_castelli, 1, 0, 1, no
155305005,  DonPippoUnico, 1, 0, 1, no
212885237,  robgar80, 3, 0, 3, no
762423451,  Prospmusicali, 3, 0, 3, no
3006171915,  JulesValmont, 1, 0, 1, no
1926128882,  fabrilapa, 1, 0, 1, no
569069021,  RaffRoma, 1, 0, 1, no
123064822,  seiya80, 1, 0, 1, no
326414232,  giulia_pagano, 2, 0, 2, no
432551402,  AndreaBiacca, 2, 0, 2, no
3120931079,  pierpietroalfo1, 1, 0, 1, no
579840890,  laziadiKant1, 1, 0, 1, no
425050042,  vuricc, 1, 0, 1, no
265363157,  seiosonoio, 1, 0, 1, no
2610078162,  AnnaMaat, 1, 0, 1, no
634331572,  LuigiPiazza1985, 2, 0, 2, no
1295655181,  Splenetico, 1, 0, 1, no
2248731075,  catespero81, 1, 0, 1, no
449786912,  yakob38, 1, 0, 1, no
32848844,  AB00L, 2, 0, 2, no
12921092,  broogo, 1, 0, 1, no
1202469937,  BaldoniPa, 3, 1, 2, no
2661672875,  nicofabricatore, 1, 0, 1, no
47096857,  Henrybah, 1, 0, 1, no
17250886,  mess_one, 1, 0, 1, no
302495838,  ElisaPolli, 1, 0, 1, no
431681063,  evrachiarucci, 2, 0, 2, no
983202188,  pTribaudino, 1, 0, 1, no
1176617984,  Katia_Spano, 1, 0, 1, no
373834391,  IvanGualandri, 1, 0, 1, no
726004458400960512,  cuiet_, 3, 2, 1, yes
995163235,  EMoggi, 1, 0, 1, no
291617943,  alex1967_italy, 2, 0, 2, no
74193544,  giorgi0_, 1, 0, 1, no
82194916,  r_coluccio, 3, 0, 3, no
847326918,  santotnas, 2, 0, 2, no
778622611144183808,  benedettauglian, 1, 0, 1, no
9214802,  antronella, 1, 0, 1, no
898446354,  cpneglia, 1, 0, 1, no
3826528468,  forteetaigue, 1, 0, 1, no
212760937,  viseph, 1, 0, 1, no
86612717,  eccezion_ale, 1, 0, 1, no
754820684036145153,  greic0c0c0, 1, 0, 1, no
437849910,  valonzia, 2, 1, 1, neutral
70116825,  monicarodigari, 1, 0, 1, no
1314715572,  antodoctor66, 1, 0, 1, no
4886097705,  PossibileMilano, 2, 0, 2, no
91175866,  Piciulina3, 1, 0, 1, no
491461632,  LelezX, 3, 0, 3, no
2603702354,  ValerioBonfrate, 1, 0, 1, no
488684786,  NestSilvia, 1, 0, 1, no
1031302704,  FenixVince, 1, 0, 1, no
212870758,  Sfigataavita, 1, 0, 1, no
249131360,  splendenzo, 4, 0, 4, no
1022117018,  ApprodoSicuro, 2, 0, 2, no
2193942701,  CheMagdalena, 1, 0, 1, no
147469640,  GabrieleAdani, 2, 0, 2, no
633077662,  8papere, 1, 0, 1, no
75746749,  lescatterbraine, 1, 0, 1, no
843502922,  ListaLuciano, 1, 0, 1, no
244180943,  michele0904, 2, 0, 2, no
133790890,  ilpost, 1, 0, 1, no
1123481,  Cafeponci, 1, 0, 1, no
2869658737,  fery1378, 1, 0, 1, no
128495447,  SentaScusiProf, 1, 0, 1, no
24145590,  pierpaolodcanto, 3, 0, 3, no
469756701,  Admancinelli, 1, 0, 1, no
554483491,  dodo_nicolai, 1, 0, 1, no
524355966,  alessandro2412, 1, 0, 1, no
88072055,  filecc, 4, 0, 4, no
100462127,  dreaminhogwarts, 1, 0, 1, no
3801646635,  zsuperfrengo, 3, 1, 2, no
801687648448479232,  katyatk6, 1, 0, 1, no
542697215,  ClaudiaDIppolit, 2, 0, 2, no
1648735543,  regaale58, 2, 0, 2, no
473355517,  PeppeCuzzola, 1, 0, 1, no
312249402,  Celest1982, 1, 0, 1, no
2413871801,  massidesimo, 1, 0, 1, no
61140194,  oet1978, 1, 0, 1, no
392828316,  verobellin, 1, 0, 1, no
2180032739,  cheluzza, 1, 0, 1, no
1627693741,  Eemanfredi, 1, 0, 1, no
450945586,  AGiorgy, 1, 0, 1, no
18250015,  canemajico, 3, 0, 3, no
770272591814750208,  Non_proprioSana, 2, 0, 2, no
22417397,  quimichela, 1, 0, 1, no
831166219,  VitaMarko83, 1, 0, 1, no
995703769,  SimoBalzani, 1, 0, 1, no
186737365,  aledipa1990, 1, 0, 1, no
16132761,  flyingb, 1, 0, 1, no
1165545368,  BarberisFa, 1, 0, 1, no
140866381,  esalu57, 1, 0, 1, no
425332035,  MeryPavoni, 1, 0, 1, no
739547121095966720,  BuzzDeKemp, 2, 0, 2, no
37005475,  iervil, 1, 0, 1, no
479894019,  falkendoc, 1, 0, 1, no
720935684010336257,  andrea_lavolpe, 1, 0, 1, no
1073824771,  MonicaMonicaxx, 1, 0, 1, no
1459664820,  isa_nigro, 1, 0, 1, no
207738727,  hernancrisci, 1, 0, 1, no
1362881412,  LeonardusKook, 3, 1, 2, no
496628286,  fiammetta75, 1, 0, 1, no
464538447,  oliofucktory, 5, 2, 3, no
409172119,  proietta, 1, 0, 1, no
2726780518,  framichelon, 1, 0, 1, no
414660035,  robdellaseta, 2, 1, 1, neutral
499651865,  Arciclaudio, 1, 0, 1, no
797043217766223873,  ComitatoRomaNO, 1, 0, 1, no
532233305,  mirkoconlak, 1, 0, 1, no
1729080907,  Riccardo_1979, 1, 0, 1, no
288192300,  FantAlessio, 1, 0, 1, no
1160032458,  MariPiredda, 2, 0, 2, no
2227099600,  1968Neri, 1, 0, 1, no
462507663,  GiDiFenza, 2, 0, 2, no
287674459,  federica_dL, 1, 0, 1, no
155329181,  a_Pis4niello, 1, 0, 1, no
3664116256,  ColibriRavenna, 7, 0, 7, no
1048503306,  chiara_nardo, 2, 0, 2, no
150185600,  faberandfaber, 2, 0, 2, no
4361587528,  LaiLaivalentina, 2, 0, 2, no
43082547,  dancherous, 1, 0, 1, no
447158871,  grazianocama, 1, 0, 1, no
552619515,  Saporidielisa, 1, 0, 1, no
475064906,  cristinacipria1, 1, 0, 1, no
371443264,  MatildeGianesin, 1, 0, 1, no
810866180,  andremaggio, 1, 0, 1, no
134419764,  mina359, 1, 0, 1, no
2919375467,  lemmeleo, 2, 0, 2, no
2426870045,  GruppoPiva, 1, 0, 1, no
140759025,  fillofillofillo, 1, 0, 1, no
4865623204,  MarcoPepi79, 1, 0, 1, no
374775777,  emilioferrucci, 1, 0, 1, no
282267783,  realgiugallo, 2, 0, 2, no
540269865,  PmBartolotta, 1, 0, 1, no
729430742787338240,  Tinas_17, 1, 0, 1, no
3217788777,  a02ed0c2e0df4b4, 1, 0, 1, no
1006160659,  DadoSgr, 3, 0, 3, no
539465072,  jfmoriche, 1, 0, 1, no
402627400,  MassimoGenini, 2, 0, 2, no
170747792,  ivanvadori, 4, 0, 4, no
150291895,  kiakube, 2, 0, 2, no
17398391,  roccorossitto, 1, 0, 1, no
2183205763,  ValeriaNatalizi, 1, 0, 1, no
417751713,  SALVATOREVITAL3, 1, 0, 1, no
418968176,  sa_valas, 2, 0, 2, no
513312094,  cukigio, 3, 0, 3, no
2361970348,  FMarchu, 1, 0, 1, no
274494468,  LaChessina, 4, 0, 4, no
1242178308,  StefanoGarello1, 1, 0, 1, no
482995387,  EMeglioli, 1, 0, 1, no
14931302,  framusa, 1, 0, 1, no
2856994017,  TiaMarks, 1, 0, 1, no
1169662310,  z4erre, 1, 0, 1, no
1917266941,  orlando_salvati, 1, 0, 1, no
461410400,  EttoreAnselmo, 1, 0, 1, no
432674051,  MicheleFenzl, 1, 0, 1, no
133641226,  gabrieletorr, 3, 0, 3, no
42399072,  dierema82, 2, 0, 2, no
1060611614,  paoladec72, 1, 0, 1, no
492588231,  cillinant, 1, 0, 1, no
2200279033,  GiacomoSantrevi, 1, 0, 1, no
199275935,  France_91, 1, 0, 1, no
1172580031,  D_Gianolla, 2, 1, 1, neutral
398565982,  MimmoSanto17, 1, 0, 1, no
430130897,  seposto, 3, 0, 3, no
507591568,  maxtalini, 1, 0, 1, no
195433093,  michelemerluzzi, 1, 0, 1, no
185999770,  Gio_Signorini, 1, 0, 1, no
146037020,  omerovitali, 1, 0, 1, no
269253670,  alegavax, 1, 0, 1, no
196495709,  robertofabbrini, 1, 0, 1, no
3310877290,  VolpiPvolpi99, 3, 1, 2, no
288918417,  _DaviDX, 1, 0, 1, no
2275678571,  waitSoloGodot, 1, 0, 1, no
759648125019680768,  Alagon1964, 1, 0, 1, no
729967134311337984,  MicSogari, 1, 0, 1, no
1017149450,  FedericoSala6, 1, 0, 1, no
137387338,  deetnick, 1, 0, 1, no
598550153,  FABIOLAFr85, 1, 0, 1, no
52538651,  Menoccina, 1, 0, 1, no
2247061773,  IArtioli, 1, 0, 1, no
30309333,  UntitledOne, 1, 0, 1, no
35216252,  DarioDolce, 1, 0, 1, no
2271850251,  estrafata, 1, 0, 1, no
571543756,  aliceferrari12, 1, 0, 1, no
1370084306,  GianlucaRaffi, 1, 0, 1, no
491337323,  MenDavideAto, 1, 0, 1, no
2559969658,  Giulizzi3, 1, 0, 1, no
297374938,  FrancescaBF, 1, 0, 1, no
244510499,  ImNoritaka, 1, 0, 1, no
2240743859,  Sancho979, 1, 0, 1, no
472306174,  Gabriele_gabgas, 1, 0, 1, no
4842404398,  latteepeperoni, 1, 0, 1, no
3890198715,  lusalvemini, 1, 0, 1, no
36461066,  MayhemH, 1, 0, 1, no
857873809,  andreabarolini, 2, 0, 2, no
1482938376,  luca_miotti, 1, 0, 1, no
335997914,  emalabro, 1, 0, 1, no
773630350308286464,  blablale, 1, 0, 1, no
1117451029,  frncsclgt, 1, 0, 1, no
2815017419,  MarcoVi18, 1, 0, 1, no
29489829,  bettamarangoni, 1, 0, 1, no
217833162,  P3nny_, 1, 0, 1, no
275702246,  taipatk, 1, 0, 1, no
261231185,  gnaidi, 1, 0, 1, no
339855032,  LuanaGala, 1, 0, 1, no
186976135,  Vin_themusicdoc, 2, 0, 2, no
281977782,  pimboc, 2, 0, 2, no
36954868,  elfodavide, 1, 0, 1, no
1330103137,  LidiaCar28, 1, 0, 1, no
1017154668,  gilupada, 1, 0, 1, no
1417782745,  em_brandolini, 1, 0, 1, no
3171055223,  filtcgilcatania, 1, 0, 1, no
1633482697,  EnzoFo87, 1, 0, 1, no
21268052,  Nadif, 1, 0, 1, no
2225350735,  SFlaviafs, 1, 0, 1, no
603521508,  Route__24, 1, 0, 1, no
506364886,  orbun5, 2, 0, 2, no
2399218862,  consolefirmin, 2, 0, 2, no
748616061474512896,  ceciolin, 1, 0, 1, no
264047932,  Luca_Preziosi, 1, 0, 1, no
22170921,  Consuelo_Motta, 1, 0, 1, no
22345073,  LadySbatSnow, 2, 0, 2, no
14376973,  michele_menard, 7, 2, 5, no
337559945,  vallycolombari, 6, 0, 6, no
582518710,  amicarellaeligi, 1, 0, 1, no
1074654600,  AntonioMagno13, 2, 0, 2, no
751264609,  DeMarchiAlice, 1, 0, 1, no
1638112500,  GonzellettoEMM, 1, 0, 1, no
445808056,  flaviabianchi6, 2, 0, 2, no
68702585,  axelbologna, 2, 1, 1, neutral
2644885920,  FiomMilano, 1, 0, 1, no
355819031,  AlocciRoberto, 1, 0, 1, no
781964484244074496,  LeoDelloIacono, 1, 0, 1, no
2070321,  gustomela, 3, 0, 3, no
266134679,  alessio_pagani, 1, 0, 1, no
2934024047,  cfa34f865e3d4a7, 1, 0, 1, no
1155231451,  agnese_70, 1, 0, 1, no
3298515478,  ea85vr, 1, 0, 1, no
498096650,  s3nt1, 2, 0, 2, no
3727937895,  sartozza, 1, 0, 1, no
1658550259,  Giusgood, 1, 0, 1, no
1015246008,  CerutiGino, 1, 0, 1, no
133657058,  r_u_f_f_, 1, 0, 1, no
2785721938,  fabbriclau, 4, 0, 4, no
2933615739,  Subcomandante8, 1, 0, 1, no
735382877639184384,  AMarcoBottone, 1, 0, 1, no
971574992,  MarthaPisa, 1, 0, 1, no
49634423,  fabietto1975, 2, 1, 1, neutral
226607706,  Kimicohippy, 1, 0, 1, no
237336622,  pasy75, 1, 0, 1, no
554361688,  Laura6976, 1, 0, 1, no
414430905,  Pierdupon, 1, 0, 1, no
711234545576714241,  rootofarrow, 1, 0, 1, no
956094938,  spirritta, 1, 0, 1, no
1166904667,  rebeccabruno97, 1, 0, 1, no
497892219,  VirgiSigno, 1, 0, 1, no
3438688090,  LOPPEI2, 1, 0, 1, no
575350675,  cacioman, 1, 0, 1, no
2988179457,  PPirajno, 1, 0, 1, no
251167680,  annaBusca, 2, 0, 2, no
2576165373,  DRossecco, 1, 0, 1, no
107537459,  mondeban, 2, 0, 2, no
61174500,  robbienico, 1, 0, 1, no
2357747324,  tubal2002, 1, 0, 1, no
2185641244,  francesco20uri, 1, 0, 1, no
43758048,  laBalza, 1, 0, 1, no
81105552,  VBazzarin, 2, 1, 1, neutral
483014874,  GabMorra, 1, 0, 1, no
2915743943,  matt_stefanelli, 1, 0, 1, no
1948845974,  Catia_twit, 1, 0, 1, no
423452651,  Aimo52Antonio, 1, 0, 1, no
531353736,  Brisamistral, 2, 0, 2, no
800059142434070528,  MofidGhunaim, 1, 0, 1, no
403071809,  max_mans, 1, 0, 1, no
56184462,  pierluigi1972, 1, 0, 1, no
1394750035,  MarcoBaggioli, 2, 0, 2, no
2878208153,  zabusa6, 2, 0, 2, no
503583739,  Simo_Gera, 1, 0, 1, no
1383804116,  FraFuganti, 4, 0, 4, no
186472351,  martinlor, 3, 0, 3, no
791728633,  bearsayshello, 1, 0, 1, no
1441922222,  m4alfoy, 1, 0, 1, no
1248424860,  LindaP_9, 2, 0, 2, no
2277923293,  savinastiz, 1, 0, 1, no
705386674096832514,  possibileFi, 23, 0, 23, no
1077110833,  massimilianimrc, 1, 0, 1, no
866082667,  GioDallAvo, 2, 0, 2, no
2542694957,  biancamirka, 1, 0, 1, no
1271173591,  TassBurrfoot, 4, 0, 4, no
394004577,  concettaconsoli, 1, 0, 1, no
431868464,  dibolo70, 2, 0, 2, no
1211979302,  anirgigi, 1, 0, 1, no
513544196,  lamortevito, 1, 0, 1, no
436632575,  AlbertoCameroni, 3, 0, 3, no
42472392,  SamDiamante, 1, 0, 1, no
442988779,  PiaCovre, 2, 0, 2, no
39705114,  metapapero, 1, 0, 1, no
2768984488,  Ipocontro, 1, 0, 1, no
858461498,  PatriziaFaro, 1, 0, 1, no
710484705561464833,  Hombre_2_0, 1, 0, 1, no
3378635435,  lorislazzarini, 1, 0, 1, no
48652450,  Stade84, 1, 0, 1, no
40205144,  mariziller, 1, 0, 1, no
472813329,  fafo149, 5, 0, 5, no
89745601,  antoniobrunetto, 1, 0, 1, no
1449811436,  antonellabagnai, 1, 0, 1, no
1060584918,  virginiataffuri, 1, 0, 1, no
482565463,  maximo965, 1, 0, 1, no
121189666,  TitusPetronius, 1, 0, 1, no
259667046,  egaio90, 1, 0, 1, no
3238919583,  didiacca, 1, 0, 1, no
2841219569,  fragmentship, 1, 0, 1, no
554333061,  Gere_Luca, 13, 0, 13, no
805551382132649988,  Alesitta77, 1, 0, 1, no
2232059383,  WestKimi, 1, 0, 1, no
199226452,  AlbertoPrina, 2, 0, 2, no
149271071,  Dark_tex, 1, 0, 1, no
475910427,  universosordo, 1, 0, 1, no
3096441706,  FilippoPiron, 4, 0, 4, no
30840771,  fvalieri58, 1, 0, 1, no
724334180935589888,  cinziasinisi1, 1, 0, 1, no
533179045,  AndreaTroiani13, 1, 0, 1, no
2509807266,  TravisBickleJK, 1, 0, 1, no
382817123,  claudialopedote, 2, 0, 2, no
3576591082,  bellaciaoRE, 4, 0, 4, no
1054911576,  soniap1975, 9, 2, 7, no
46755068,  iltwitdimarco, 1, 0, 1, no
385304137,  matteoventurin1, 1, 0, 1, no
3404366332,  LudovisiGiovan1, 1, 0, 1, no
81871800,  claudiodinapoli, 1, 0, 1, no
3992833575,  EnricoCattaneo6, 1, 0, 1, no
1316490913,  emmeguidi, 1, 0, 1, no
3037134647,  dimarby, 1, 0, 1, no
228052591,  melenabig, 1, 0, 1, no
14570884,  rsta, 1, 0, 1, no
299642449,  ddaloisi, 1, 0, 1, no
423421424,  Boris_Grushenko, 1, 0, 1, no
254032141,  mausassi, 1, 0, 1, no
512116327,  lisetta1986, 3, 0, 3, no
65791929,  MrMegu, 1, 0, 1, no
118770273,  gresleri, 2, 0, 2, no
1459455080,  StefanoLonati1, 2, 0, 2, no
593590410,  lele_lombardi, 1, 0, 1, no
945762720,  lapicci72, 1, 0, 1, no
4817602365,  rossana_corti, 1, 0, 1, no
2951309483,  NonSonoMicaBond, 1, 0, 1, no
438507165,  FulvioIchestre, 1, 0, 1, no
35060058,  ferris60, 1, 0, 1, no
801060646699855872,  ilSindacalista_, 1, 0, 1, no
254710766,  AnnaTChe, 1, 0, 1, no
405239257,  dcolarossi76, 1, 0, 1, no
859630482,  gregoriomassi, 4, 3, 1, yes
3006726093,  angelog42925331, 1, 0, 1, no
2320612201,  DecayedBoson, 1, 0, 1, no
1298482453,  lmfiameni, 1, 0, 1, no
794689116277526528,  valsteff, 1, 0, 1, no
55819049,  ilbaku, 3, 0, 3, no
1092054787,  belladelli960, 1, 0, 1, no
793705615914856448,  HamaKitama, 5, 1, 4, no
908765210,  CanaliNatalia, 1, 0, 1, no
594859010,  bepimobile, 1, 0, 1, no
3913210511,  miranda_cossu, 1, 0, 1, no
772962268157968384,  possibile_ra, 3, 0, 3, no
1002800005,  emiliovellandi, 2, 0, 2, no
192235112,  bipuntoemme, 1, 0, 1, no
22643979,  gelofred, 1, 0, 1, no
1897525356,  LapiDaria2, 1, 0, 1, no
747245468,  tizianacampodon, 2, 0, 2, no
494453703,  giovmitra, 1, 0, 1, no
2479080795,  vetusmanga, 1, 0, 1, no
313172472,  sewingprincess1, 1, 0, 1, no
850998049,  GillesRegoli, 1, 0, 1, no
1536559470,  maurizi01238636, 1, 0, 1, no
2899564629,  CanalMartino, 1, 0, 1, no
762310425249771521,  cervignano_no, 3, 0, 3, no
266642198,  stefanorlandini, 1, 0, 1, no
578838113,  AntonelloMolin1, 8, 0, 8, no
264153613,  gpcossu, 8, 0, 8, no
750193133871325184,  LauraLaciccia18, 1, 0, 1, no
15342585,  simopg71, 1, 0, 1, no
480740992,  francescosimmar, 4, 0, 4, no
969030108,  RobiGent_7, 1, 0, 1, no
1073472072,  mariateresam66, 1, 0, 1, no
196345013,  TheRomeoAntonio, 1, 0, 1, no
220607993,  FraMilione, 1, 0, 1, no
3954296663,  Mycroft74, 1, 0, 1, no
593101773,  CronacheLucane, 1, 0, 1, no
333297861,  giorgio1706, 1, 0, 1, no
1225737806,  NicolaValluzzi, 2, 1, 1, neutral
149217394,  rosmerypelle, 1, 0, 1, no
391039251,  C_Cirigliano, 1, 0, 1, no
101220634,  Johnnyutah74200, 1, 0, 1, no
435297353,  mikycollarile, 4, 0, 4, no
934575858,  MikiMagri, 1, 0, 1, no
434071914,  mlimuli, 2, 0, 2, no
461227143,  GLComandini, 1, 0, 1, no
385356024,  millytucci, 1, 0, 1, no
2183716922,  AngeloDeianaTW, 1, 0, 1, no
464983744,  FabioTemporiti, 5, 4, 1, yes
380232689,  GiovanniNacci, 1, 1, 0, yes
337892660,  sannyfly68, 1, 1, 0, yes
2204805173,  dtbru, 1, 1, 0, yes
1349039166,  NoBancheArmate, 2, 2, 0, yes
418169513,  emilio7912, 1, 1, 0, yes
79814913,  PrimaPaginaNews, 1, 1, 0, yes
965105874,  abyss7777, 1, 1, 0, yes
3016727058,  stefanodelcol, 2, 2, 0, yes
367091934,  cotoelgyes, 1, 1, 0, yes
3813276377,  Angelika1520, 4, 4, 0, yes
778304305434595331,  ABR24News, 3, 3, 0, yes
31140125,  RattiMar, 1, 1, 0, yes
24152905,  nelloscavo, 1, 1, 0, yes
71217188,  DarioButtitta, 2, 2, 0, yes
47281168,  EuRobo36, 1, 1, 0, yes
2980684566,  beretta_gio, 2, 2, 0, yes
105597458,  mimmocortese, 1, 1, 0, yes
2737983467,  GiuseppeMerotta, 1, 1, 0, yes
523301381,  pippoprovenza, 1, 1, 0, yes
70399918,  diemmeti, 2, 2, 0, yes
2374268173,  pavoneangela00, 1, 1, 0, yes
3067479886,  S_Zoppellaro, 1, 1, 0, yes
1416194413,  OpalBrescia, 1, 1, 0, yes
2463642644,  prayforBahrain, 2, 2, 0, yes
798598045709516800,  NicoloAlfio, 1, 1, 0, yes
2398177411,  ermydago, 1, 1, 0, yes
725262366867378176,  Capodimonte_mus, 1, 1, 0, yes
1170138542,  Alessandro_Nat1, 1, 1, 0, yes
788697472461832192,  Riccard676767, 1, 1, 0, yes
3136165793,  masiellocar, 2, 2, 0, yes
1137916604,  FilippoCalore, 1, 1, 0, yes
1919237072,  SM_Difesa, 17, 17, 0, yes
1504034676,  parkermaccaroni, 4, 4, 0, yes
281956301,  Follow5Fitness, 1, 1, 0, yes
2402255788,  gia_maz, 1, 1, 0, yes
431030232,  llbbyhaynes, 1, 1, 0, yes
4208790952,  vincenzogfg, 1, 1, 0, yes
491091848,  miki70a, 1, 1, 0, yes
54190624,  porlandi05, 1, 1, 0, yes
1091413250,  MaurizioMiscia, 1, 1, 0, yes
733637460308168704,  songenap, 1, 1, 0, yes
2471096019,  annapolico, 3, 3, 0, yes
978769022,  ANGELOPOLICO, 4, 4, 0, yes
3230597396,  yerlinin, 1, 1, 0, yes
2356684361,  cosmo_valeria, 1, 1, 0, yes
2560689715,  sandromonesi, 1, 1, 0, yes
149805027,  Flaviuspapirius, 1, 1, 0, yes
2292610962,  konradkschubert, 2, 1, 1, neutral
2562535288,  nemoergosum, 1, 1, 0, yes
3228329063,  KeneDtMS, 1, 1, 0, yes
868645789,  Comunico_70, 9, 9, 0, yes
1399002776,  marco_leoncini, 3, 3, 0, yes
439232715,  Ergipa, 1, 1, 0, yes
1381489063,  CIsmaele, 1, 1, 0, yes
736249730561409024,  Gloriapress1, 1, 1, 0, yes
1173410504,  DonnaPaola1, 1, 1, 0, yes
4011586876,  flavia_niscola, 1, 1, 0, yes
801747294131515392,  Luna_Cip, 2, 1, 1, neutral
3381698278,  daniele_congia, 1, 1, 0, yes
716309259,  claudiapetrini9, 1, 1, 0, yes
2871039395,  tinimusumeci, 2, 2, 0, yes
1887722600,  pierblengy, 1, 1, 0, yes
2186974913,  MieiPeirettia, 1, 1, 0, yes
3302186728,  BelindaDi, 1, 1, 0, yes
3256433748,  lfarfusnvm, 1, 1, 0, yes
353296553,  enzino910r1, 1, 1, 0, yes
1249400552,  franperk, 1, 1, 0, yes
4924175543,  lucio63th, 1, 1, 0, yes
470668449,  marcomordenti1, 1, 1, 0, yes
431815401,  monsemanz, 1, 1, 0, yes
345219705,  the04piero, 1, 1, 0, yes
524354089,  futilimotivi, 1, 1, 0, yes
3979916494,  PaPiccinelli, 1, 1, 0, yes
2647427506,  vagabonda1973, 1, 1, 0, yes
489818698,  CanonicoA, 1, 1, 0, yes
777516903619321856,  HugeBelin, 1, 1, 0, yes
703299102965108737,  DBons4e6, 1, 1, 0, yes
437337751,  Esercito, 3, 3, 0, yes
3834791235,  MatteoLualdi, 1, 1, 0, yes
802163291921543168,  mattiadipino, 2, 1, 1, neutral
2452618380,  DanUrrutiIIIa, 1, 1, 0, yes
2170098151,  MaekVlm, 1, 1, 0, yes
1191172297,  sandro_daniela, 2, 1, 1, neutral
1365478231,  ruggero_tr, 2, 1, 1, neutral
2359353306,  kekko2015, 1, 1, 0, yes
1401911906,  marco_moggio, 1, 1, 0, yes
399135189,  morillino, 1, 1, 0, yes
2534934933,  GabriellaCared1, 2, 1, 1, neutral
281518153,  IsidoroPiarulli, 1, 1, 0, yes
1079774172,  Ste_1D, 1, 1, 0, yes
83941845,  enzomongelli, 2, 2, 0, yes
4894576517,  SEreNA1385, 1, 1, 0, yes
480611717,  AssuntaRossetti, 1, 1, 0, yes
2960384141,  merchiorri, 1, 1, 0, yes
704654480445468673,  LymnPaR, 1, 1, 0, yes
2361510583,  BeppeBoniRdc, 1, 1, 0, yes
503215196,  RoccuPignata, 1, 1, 0, yes
1450286413,  ciav_luc, 1, 1, 0, yes
2172497368,  angelodamore73, 1, 1, 0, yes
1140259146,  WPadoan, 1, 1, 0, yes
571136099,  maxmelpy, 1, 1, 0, yes
1260005623,  maludo85, 1, 1, 0, yes
516916433,  bezker1, 2, 2, 0, yes
186097633,  AlgerioStefania, 1, 1, 0, yes
486907657,  gmurz, 1, 1, 0, yes
2543293925,  fdcea04dc0ad4d7, 1, 1, 0, yes
804114256174137346,  edmefopoor1970, 1, 1, 0, yes
476912360,  rapa1971, 1, 1, 0, yes
433751734,  Dre_Dinero_148, 1, 1, 0, yes
4488729981,  veertigdertig, 2, 2, 0, yes
481161412,  AlSigismondi, 1, 1, 0, yes
4147640841,  CantonettiBruno, 1, 1, 0, yes
3257596531,  adamcdeinns, 1, 1, 0, yes
196109748,  Aleparmeggiani, 1, 1, 0, yes
47944565,  marianogallovet, 1, 1, 0, yes
287895587,  LaCorsaraOscura, 1, 1, 0, yes
2482505043,  pujithareddy162, 1, 1, 0, yes
430237926,  78Berto, 1, 1, 0, yes
398959536,  giuseppemolino2, 4, 4, 0, yes
766235199545937920,  FedericaFabbra1, 2, 1, 1, neutral
972027182,  Davidecalandrin, 1, 1, 0, yes
2487035381,  thereaiCarsonS, 1, 1, 0, yes
421905875,  alexa81af, 1, 1, 0, yes
466534723,  aiadcin, 1, 1, 0, yes
1113935108,  WandaPardini, 1, 1, 0, yes
2558686037,  VAlivernini, 2, 1, 1, neutral
271510857,  josenivelo, 1, 1, 0, yes
1006510022,  RobertoMinerdo, 1, 1, 0, yes
1169430086,  masamas08840504, 1, 1, 0, yes
2478013027,  CdN09, 1, 1, 0, yes
318852504,  Chris_du_Limon, 1, 1, 0, yes
774888350314561536,  BUBIROC, 1, 1, 0, yes
3031943085,  ItalyinVietnam, 1, 1, 0, yes
1006183458,  LoreSeregni, 1, 1, 0, yes
4839081676,  elio_babbo, 1, 1, 0, yes
455840858,  IJennydorica, 3, 1, 2, no
704598502,  RobertoErrebi, 5, 5, 0, yes
147496924,  PdBasilicata, 3, 3, 0, yes
29956463,  clodcop, 1, 1, 0, yes
1007261041,  CarolaRusso_, 1, 1, 0, yes
51198800,  itsdede, 4, 0, 4, no
852990302,  mariobianco20, 1, 0, 1, no
2760351771,  dario_rigobello, 1, 0, 1, no
786304612420714496,  SoniaPoliti2, 1, 0, 1, no
4899231777,  leone9849, 6, 0, 6, no
396991861,  magyc95, 1, 0, 1, no
2370357600,  Leonardo_Bel, 1, 0, 1, no
802217884760023040,  luchin45325470, 1, 0, 1, no
3554465607,  mino_dinoi, 6, 6, 0, yes
1129353018,  denissottile, 1, 1, 0, yes
75739790,  dianaseverati, 1, 1, 0, yes
786571157411540992,  ala_puglia, 2, 2, 0, yes
3317816961,  antonellolivi, 1, 1, 0, yes
704601949304459264,  alacalabria, 1, 1, 0, yes
550883497,  PietroStanizzo, 1, 1, 0, yes
3392212198,  LibPopAut, 1, 1, 0, yes
785492607493369856,  fanta_rachel, 1, 0, 1, no
811414452,  mara_mucci, 1, 0, 1, no
330962609,  marcellalogli, 1, 0, 1, no
101030849,  nicomarti0, 1, 0, 1, no
292250600,  EnricoCapiozzo, 1, 0, 1, no
594041298,  MCFerradini, 1, 0, 1, no
2787787988,  ProgrammaFuturo, 3, 0, 3, no
312242186,  alebiafora, 1, 0, 1, no
397187753,  LucaPalestra, 1, 0, 1, no
22484478,  mmguru, 1, 0, 1, no
778939382707458048,  Roma_Semplice, 1, 0, 1, no
575347900,  tizianamedici, 3, 1, 2, no
252565001,  MarcoAlici, 3, 1, 2, no
2677397216,  osd_it, 1, 0, 1, no
337394074,  marianda70, 1, 0, 1, no
775639896841195520,  roma_roc, 1, 0, 1, no
774661708396781570,  ninefix, 1, 0, 1, no
1213604838,  MaxApi, 1, 0, 1, no
16362643,  ascoscia, 1, 0, 1, no
1887395294,  GrazianoGian, 1, 0, 1, no
411432358,  aleCattaneo79, 2, 0, 2, no
414972626,  futuroitaliano, 1, 0, 1, no
1056094116,  RoccoTodero, 5, 0, 5, no
2612551,  chermaz, 1, 0, 1, no
14979671,  la_franci, 1, 0, 1, no
5676402,  vincos, 2, 0, 2, no
4727631509,  stefano_dimeo, 2, 2, 0, yes
128543506,  manageritalia, 1, 1, 0, yes
805068435763904513,  ComunicatoS, 3, 2, 1, yes
472049405,  pharma_bag, 1, 1, 0, yes
574310014,  CatiusciaMarini, 2, 2, 0, yes
267247302,  LaSoniaMigliore, 1, 1, 0, yes
3437744675,  NikeDonis, 1, 1, 0, yes
339038165,  glgalletti, 2, 2, 0, yes
421322239,  DeliaPagliuca, 2, 2, 0, yes
631795216,  ansa_ambiente, 1, 1, 0, yes
4030889537,  parchimareapp, 1, 1, 0, yes
257850075,  LucaNatale70, 1, 1, 0, yes
23920366,  parco5terre, 1, 1, 0, yes
720686484,  crd_prt, 7, 4, 3, yes
501818633,  StefanoCiafani, 2, 2, 0, yes
3127719536,  info_cisba, 1, 1, 0, yes
2776118607,  coinger, 4, 4, 0, yes
264176371,  Frak82, 1, 1, 0, yes
282719746,  BolognaBSchool, 1, 1, 0, yes
124167705,  vincebaccari, 1, 1, 0, yes
1949543874,  ANMIL_nazionale, 1, 1, 0, yes
533042914,  Ecoera_it, 2, 2, 0, yes
425426261,  ayumartini45, 1, 0, 1, no
514848412,  luigibille1, 1, 0, 1, no
444240837,  lavander55, 1, 0, 1, no
435367434,  TarylorMartin4, 1, 0, 1, no
476339196,  sety0pra, 1, 0, 1, no
22127498,  Donzelli, 1, 0, 1, no
444241960,  ReeseAndrews6, 1, 0, 1, no
433578599,  SmithDavid5612, 1, 0, 1, no
529247064,  Antonio_Tajani, 1, 1, 0, yes
777963073,  Potenza5Stelle, 1, 1, 0, yes
803625598895656960,  EDICTrentino, 1, 1, 0, yes
332096208,  Luca_Menesini, 1, 1, 0, yes
3064043155,  Arpan_Dhali, 1, 1, 0, yes
1846267603,  colinelavorel, 1, 1, 0, yes
276233894,  MaximoBXL, 1, 1, 0, yes
503605535,  giulianalongi, 1, 1, 0, yes
1024520136,  PresLucaMarsico, 1, 1, 0, yes
577098234,  RossellaSobrero, 2, 2, 0, yes
2798103882,  MATRECsrl, 1, 1, 0, yes
4008172121,  circularitaly, 1, 1, 0, yes
625092660,  marco_capellini, 2, 2, 0, yes
2850104139,  MRinnovabile, 1, 1, 0, yes
244551370,  BalduFra, 1, 1, 0, yes
616466190,  xeniaperan, 1, 0, 1, no
391531110,  birraesalsicce, 1, 0, 1, no
2485008400,  SoSglySolid, 1, 0, 1, no
82119861,  manuelgentile75, 1, 0, 1, no
1175934182,  bracconiere67, 2, 0, 2, no
62364690,  poffare, 1, 0, 1, no
10934032,  comunitazione, 1, 0, 1, no
196945505,  boa82, 2, 0, 2, no
804996282913878016,  kartika40396, 2, 1, 1, neutral
618277233,  loremada81, 1, 0, 1, no
112981049,  RattoGiustina, 4, 0, 4, no
407561109,  rinaldoromanell, 1, 1, 0, yes
702445104,  sisi_marco, 1, 1, 0, yes
500123843,  Alessandrotuit, 1, 1, 0, yes
1471759051,  FondazioneNenni, 1, 1, 0, yes
94793551,  ElenaUrbinati, 2, 2, 0, yes
3262192089,  orru02, 3, 2, 1, yes
1130984874,  DiegoTartari77, 3, 3, 0, yes
32931825,  Mominleftfield, 1, 1, 0, yes
796032241323347968,  AnnaMariaCris11, 1, 1, 0, yes
1035777258,  biusland, 1, 1, 0, yes
261233991,  isottaross, 2, 2, 0, yes
3430176939,  SuperVallish, 2, 1, 1, neutral
803910342061490177,  veglie_polo2, 2, 2, 0, yes
840284011,  GLucaLucchetti, 1, 1, 0, yes
3008150537,  StefanoCorniani, 2, 2, 0, yes
283193017,  MatteoBoneschi, 2, 1, 1, neutral
3335604496,  xavierdaniel999, 1, 1, 0, yes
2768214803,  laurarossi25, 2, 2, 0, yes
1213253244,  DDavidederrico, 1, 1, 0, yes
475847259,  emma_franc_b, 1, 1, 0, yes
635274427,  Enrica080452, 1, 1, 0, yes
421796745,  DarioCorso, 2, 2, 0, yes
711651132628672515,  penvenitalia, 22, 22, 0, yes
1295641639,  CAPITANARLOCCO, 3, 3, 0, yes
388203039,  mariocipriani1, 2, 2, 0, yes
1236595922,  briguzia, 1, 1, 0, yes
783659585278242817,  marziacstnz, 1, 1, 0, yes
1048083020,  CarraraDante, 3, 1, 2, no
1653037368,  roberto_bani, 1, 1, 0, yes
2614768016,  OfficialAgm075, 2, 2, 0, yes
560907259,  enzablundo1, 1, 1, 0, yes
305272959,  GesuKrishna, 2, 1, 1, neutral
1640653410,  MiokSensei, 2, 1, 1, neutral
2449051860,  KlmHeadley, 1, 1, 0, yes
716177567481524224,  frankoebasta, 1, 1, 0, yes
614658253,  Torry_8unz, 1, 1, 0, yes
2557030890,  SerLuiLocatelli, 1, 1, 0, yes
436171792,  GiaMolino, 1, 1, 0, yes
3326012500,  pitwalk1, 16, 1, 15, no
447277419,  giorgio_grandi, 1, 1, 0, yes
1175587957,  filola_, 1, 1, 0, yes
298164175,  MarinaVoudouri, 5, 1, 4, no
113722582,  actainrete, 1, 1, 0, yes
4797961169,  FrulliM, 1, 1, 0, yes
455678206,  Xueza_00, 2, 1, 1, neutral
770366587522191360,  dibbax, 1, 1, 0, yes
585606015,  lcastagneti, 1, 1, 0, yes
611783055,  mariellamarocca, 3, 3, 0, yes
382791473,  Danielick1, 1, 1, 0, yes
121544552,  irecavarren, 1, 1, 0, yes
4187059228,  GrassiSimonetta, 2, 2, 0, yes
1476977323,  LucaAlberti88, 2, 2, 0, yes
31412490,  emmalene8, 1, 1, 0, yes
4151844345,  PoliticaPer, 1, 1, 0, yes
50998796,  rkinz, 2, 2, 0, yes
449006108,  MassimoMatini, 2, 2, 0, yes
3105224145,  LoredanaIlardi, 1, 1, 0, yes
434141603,  EleonoraMosco, 1, 1, 0, yes
735554833323859969,  Patrizia19653, 2, 2, 0, yes
242030228,  chicco37twi, 1, 1, 0, yes
727144959988649984,  daniela_dinora, 1, 1, 0, yes
2893699486,  CislFerrara, 1, 1, 0, yes
1063917404,  silvana_spusch, 4, 3, 1, yes
205245319,  Giuxgiu, 1, 1, 0, yes
342256558,  miau_haus, 1, 1, 0, yes
430430408,  kellieForTrump, 1, 1, 0, yes
3328712788,  leggioluciano, 2, 2, 0, yes
496043380,  Antongiulio2, 3, 2, 1, yes
125375055,  bar_biturico, 1, 1, 0, yes
1194410048,  wonderema, 1, 1, 0, yes
540975327,  caroljuve, 1, 1, 0, yes
496876586,  segi88vale, 2, 1, 1, neutral
2800841139,  mlatini6, 3, 1, 2, no
936260438,  LalaHu9, 1, 1, 0, yes
1488053930,  JpMputu, 1, 1, 0, yes
1317310818,  salvo_tranchida, 3, 1, 2, no
2210503347,  GiacomoMoreali, 2, 1, 1, neutral
405745496,  francesco92m, 1, 0, 1, no
799985228789977088,  ludoorsmocdi191, 1, 0, 1, no
450726242,  conteduca48, 1, 0, 1, no
209300173,  QdSinistra, 2, 0, 2, no
2501654327,  RobertoViccaro, 4, 0, 4, no
621968725,  m_angella14, 1, 0, 1, no
947689230,  JackySimoncelli, 2, 0, 2, no
943603681,  p_possamai, 1, 1, 0, yes
510061525,  luigi_ortuso, 1, 1, 0, yes
192165619,  TheMac78, 1, 1, 0, yes
323301626,  rubenstowanda, 2, 2, 0, yes
398049819,  bollaroscavi, 1, 1, 0, yes
439222158,  DanieleRossett2, 2, 2, 0, yes
768385224375959552,  HammerAsks, 1, 1, 0, yes
356058863,  DanieleBarbone, 1, 1, 0, yes
179863954,  ulck31, 1, 1, 0, yes
134120144,  Axel1376, 1, 1, 0, yes
2802691047,  questaempoli, 1, 1, 0, yes
2362449623,  marghemiaao, 1, 1, 0, yes
32469851,  Canch1, 4, 4, 0, yes
1127417839,  lcasore51, 2, 1, 1, neutral
2165021431,  mcdocmac, 1, 1, 0, yes
565619932,  LeoSchingaro82, 1, 1, 0, yes
172899512,  Pierpaolo_Turco, 1, 1, 0, yes
1852186380,  PaolaBacchini, 3, 2, 1, yes
1109274266,  ClavisMagna, 1, 1, 0, yes
2244597633,  Rania74love, 2, 1, 1, neutral
295742279,  faustodesanti, 2, 2, 0, yes
1275197720,  53norman09, 1, 1, 0, yes
594049874,  dieaca, 1, 1, 0, yes
187185454,  ivan_iraci, 3, 3, 0, yes
943544286,  pablito86c, 1, 1, 0, yes
32367243,  RudyBecciolini, 1, 1, 0, yes
82092701,  Elio_D, 1, 1, 0, yes
1045722114,  renatovergoni, 2, 1, 1, neutral
2913450111,  Claudio63708251, 2, 1, 1, neutral
336835921,  dsabatinelli, 2, 2, 0, yes
25732270,  adilmauro, 1, 1, 0, yes
162780582,  ElisKoro, 1, 1, 0, yes
4860909838,  Emamin77, 1, 1, 0, yes
470076864,  fagall1973, 1, 1, 0, yes
110460218,  ale_alfieri, 1, 1, 0, yes
2231674388,  DeboraRoucyDeb1, 2, 2, 0, yes
396583648,  AntoCiviletti, 4, 4, 0, yes
82881849,  laurolini, 3, 3, 0, yes
3393854572,  FabriMaina, 5, 4, 1, yes
3131338144,  srubino0, 1, 1, 0, yes
203007837,  philipdisalvo, 1, 1, 0, yes
4332140086,  Ladysilvia7, 3, 1, 2, no
212596495,  anthonyscialdo, 1, 1, 0, yes
408557520,  GeremiaBombino, 3, 3, 0, yes
2296784245,  SabinaDeRosis, 1, 1, 0, yes
529755861,  MICHELEBORTOLU1, 1, 1, 0, yes
320246595,  JohnHorsemoon, 2, 1, 1, neutral
248618345,  SalvaAquilina, 1, 1, 0, yes
3025353801,  lucaarz65, 1, 1, 0, yes
84402518,  demiliani, 1, 1, 0, yes
390891101,  __LaBenny, 2, 1, 1, neutral
434259018,  Iri_Iris_, 3, 3, 0, yes
8505512,  sclair, 4, 3, 1, yes
299220837,  PeppeZambito, 1, 1, 0, yes
536520917,  sgat76, 1, 1, 0, yes
123598693,  Cos53, 1, 1, 0, yes
418609092,  MatteoNincheri, 1, 1, 0, yes
582666999,  PasqualeMancus2, 1, 1, 0, yes
216700271,  Cruzzo90, 1, 1, 0, yes
384881122,  andreademaria_, 20, 20, 0, yes
53377491,  davidedevido, 1, 1, 0, yes
431638725,  FIntrona, 2, 2, 0, yes
802528237586972672,  martinaBpagani, 1, 1, 0, yes
475136413,  FraDoganieri, 1, 1, 0, yes
586434365,  felicianobaioc1, 1, 1, 0, yes
103563667,  SantoWhisky, 1, 1, 0, yes
133771592,  chiarazucconi, 1, 1, 0, yes
898256695,  GiuseppeRicci66, 2, 2, 0, yes
840400950,  SRubinato, 1, 1, 0, yes
78264598,  alfiotondelli, 2, 2, 0, yes
52820599,  bezgiacomo, 1, 1, 0, yes
56431845,  ale_iorfida, 2, 1, 1, neutral
372191158,  _martaslove, 1, 1, 0, yes
65853667,  inescaloisi, 1, 1, 0, yes
1134411866,  Gianfy61, 1, 1, 0, yes
1194476036,  mariolinoDL, 1, 1, 0, yes
567382670,  umbalvi, 2, 1, 1, neutral
491156990,  rubbish79, 4, 1, 3, no
229483217,  TweeTAcchAN, 1, 1, 0, yes
753731592,  chiara_tronc, 1, 1, 0, yes
815469620,  Sam_Mois, 1, 1, 0, yes
439222604,  ndreabellini, 2, 2, 0, yes
601062168,  davidefigoli, 1, 1, 0, yes
2940752734,  mclaudio1960, 1, 1, 0, yes
547730771,  Elvisia89, 1, 1, 0, yes
105697772,  davidecolella, 1, 1, 0, yes
804727916684857344,  Rocco68719172, 1, 1, 0, yes
426563108,  Mary_Cavallaro, 1, 1, 0, yes
1125698682,  MarcoGalvi, 1, 1, 0, yes
593859533,  lcschiaffino, 1, 1, 0, yes
143777057,  Andre_Schieppaz, 1, 1, 0, yes
3843650115,  MichidelPra, 10, 1, 9, no
4012526097,  mdelpra1, 7, 1, 6, no
306089827,  GioFantoni, 1, 1, 0, yes
1529579312,  andbra52, 1, 1, 0, yes
96618058,  gabriellavitale, 1, 1, 0, yes
175491220,  AndreaMuraro, 1, 1, 0, yes
739157799343693824,  PeppinoNazional, 1, 1, 0, yes
110962256,  pdumbria, 1, 1, 0, yes
135572389,  paxlandia, 1, 1, 0, yes
46949740,  rmatteo, 1, 1, 0, yes
227606641,  ValerioBarbini, 2, 2, 0, yes
801884847790817285,  2c7b54de31354cc, 3, 1, 2, no
449632280,  TheMrSpina, 2, 1, 1, neutral
595723577,  LucaDiGuardo, 1, 1, 0, yes
149057490,  muccafa, 1, 1, 0, yes
111627996,  hgraph7, 2, 2, 0, yes
1079436319,  Leviathan2010, 1, 1, 0, yes
216779702,  pupp_ina, 3, 3, 0, yes
200030323,  tscalera, 1, 1, 0, yes
14962297,  sunriseb2_0, 1, 1, 0, yes
2706599804,  Tigresiberiana7, 1, 1, 0, yes
72014417,  Aris004, 1, 1, 0, yes
4897518861,  masgiord, 4, 1, 3, no
1315341079,  OsservatorioS, 1, 1, 0, yes
16110741,  luca_c, 1, 1, 0, yes
296484280,  naikelulu, 1, 1, 0, yes
2362515186,  Tormar76, 1, 1, 0, yes
768099622338322432,  LucianoAntonel2, 2, 1, 1, neutral
224349666,  cesarelazzari, 1, 1, 0, yes
2652781914,  MaurizioStanic, 1, 1, 0, yes
524799391,  pannutini, 1, 1, 0, yes
524741958,  roccogiannattas, 1, 1, 0, yes
77547232,  andreaoteri, 2, 1, 1, neutral
1066481407,  gualtieroberto, 1, 1, 0, yes
709483469592793090,  Loshiatsudianna, 1, 1, 0, yes
316730579,  twi_sabino, 1, 1, 0, yes
407828000,  benio66, 1, 1, 0, yes
733456147353640960,  LadySaffo79, 1, 1, 0, yes
376861483,  arcobalenoceano, 3, 1, 2, no
298438919,  NardiAlessandro, 1, 1, 0, yes
83661586,  Ilaria_26, 1, 1, 0, yes
514388722,  Formoso43, 1, 1, 0, yes
2349860995,  PDMolise, 1, 1, 0, yes
272929503,  AmnesiaFe, 1, 1, 0, yes
730455579827785728,  betto_edo, 1, 1, 0, yes
2319559369,  furibonda44, 3, 0, 3, no
327728308,  Cinepanettoni, 1, 1, 0, yes
792365211755933696,  zaairalecce, 1, 1, 0, yes
786718830001328128,  Pablo55839451, 1, 1, 0, yes
181684989,  babbuzzi75, 7, 2, 5, no
15535691,  rhpk, 1, 1, 0, yes
744476703175643136,  ilV3rMePiDDInO, 1, 1, 0, yes
3638926461,  o3fro, 1, 1, 0, yes
515222889,  gianmaria_sono, 2, 2, 0, yes
266493673,  rodillas69, 2, 1, 1, neutral
4074620896,  Perseco_, 1, 1, 0, yes
2305311114,  tackleduro, 1, 1, 0, yes
800744277974208512,  MarioFastani, 1, 1, 0, yes
111009571,  Giupoz, 1, 1, 0, yes
491666102,  RiccardoBal, 3, 2, 1, yes
2283317006,  notiziebuone, 1, 1, 0, yes
179939814,  daniel7official, 1, 1, 0, yes
612984125,  garmin1939, 2, 1, 1, neutral
910502540,  Ghibli380, 1, 1, 0, yes
801754674877628416,  talfekaterina, 1, 1, 0, yes
3146865975,  eletto_piera, 5, 5, 0, yes
886502462,  MASSIMOPITTUI, 2, 2, 0, yes
374002264,  nanni_dinoia, 1, 1, 0, yes
481636772,  70ZY, 2, 1, 1, neutral
306412249,  Caracciolo93, 1, 1, 0, yes
975755820,  fuscoantonio3, 2, 2, 0, yes
600931689,  officinadgitale, 1, 1, 0, yes
537517335,  angelo_battista, 2, 2, 0, yes
91289901,  mauromaster_, 2, 2, 0, yes
208643062,  MirkoFr, 2, 2, 0, yes
66884102,  __Lambda, 1, 1, 0, yes
329775233,  Oltremedianews, 1, 1, 0, yes
994798482,  marckuck, 2, 1, 1, neutral
800125454,  zara_sergio, 2, 1, 1, neutral
776166990146834432,  Ani14128321, 1, 1, 0, yes
2303117828,  EAuci, 1, 1, 0, yes
121054999,  myzzib, 1, 1, 0, yes
580189954,  AlekCicero, 1, 1, 0, yes
3238973781,  Daniloarru, 1, 1, 0, yes
463400590,  msnets29, 1, 1, 0, yes
104554329,  antoniusblock4, 1, 1, 0, yes
3027247043,  Fivy1974Sil, 1, 1, 0, yes
556905830,  gcsavona, 1, 1, 0, yes
2290556026,  TodiscoMario, 1, 1, 0, yes
1452017839,  Tardelli83, 1, 1, 0, yes
288810562,  ClauBozza, 1, 1, 0, yes
361981418,  FlavioPellacani, 1, 1, 0, yes
1728519446,  dist_fabio, 1, 1, 0, yes
482875571,  MinoGriffo, 1, 1, 0, yes
3023245491,  GiovannaSerra3, 1, 1, 0, yes
775750439883182081,  OnlyPatroclo, 1, 1, 0, yes
2452728714,  elenafree95, 1, 1, 0, yes
3054282126,  Dantesw17, 1, 1, 0, yes
115706591,  El_Pinta, 2, 2, 0, yes
136386226,  dbarbarelli, 1, 1, 0, yes
148786489,  pierka70, 1, 1, 0, yes
532546099,  simonefarmeschi, 1, 1, 0, yes
2885037524,  IlFalco89, 1, 1, 0, yes
1697007133,  ottavionotaro, 4, 2, 2, neutral
224541473,  nextbobby, 1, 1, 0, yes
747136768579936257,  _ControTendenza, 1, 1, 0, yes
489633908,  Ile2S, 2, 2, 0, yes
116007952,  simonebruni, 1, 1, 0, yes
1540876740,  SimoneCaiello1, 1, 1, 0, yes
748012106,  LoSchiallo, 4, 4, 0, yes
423252377,  kimgor76, 1, 1, 0, yes
268915064,  cristinaiori, 1, 1, 0, yes
3403212148,  EZalambani, 1, 1, 0, yes
467831417,  andrealecchi, 1, 1, 0, yes
543555677,  nigro_vito, 1, 1, 0, yes
85812206,  ZAndrea82, 1, 1, 0, yes
3335343958,  SGerolita, 1, 1, 0, yes
260739559,  terenim, 2, 1, 1, neutral
3296335373,  SoloMicky, 1, 1, 0, yes
101188410,  metalplax, 2, 1, 1, neutral
26727333,  ilcigno, 1, 1, 0, yes
3052908091,  Ty93_DaKid, 1, 1, 0, yes
1568871624,  bofra70, 1, 1, 0, yes
36803665,  sforaz, 1, 1, 0, yes
3879766835,  RomanoBenedetti, 3, 2, 1, yes
436189641,  marione6363, 5, 2, 3, no
704023287,  traslatore, 1, 1, 0, yes
810958284,  OdiosoOdio, 1, 1, 0, yes
51458099,  Wrustel, 1, 1, 0, yes
159985010,  MaNuElaJUVE34, 5, 1, 4, no
2943727037,  CivisEtico, 1, 1, 0, yes
518540282,  CortesiDa, 1, 1, 0, yes
2498231275,  melaniaebasta, 1, 1, 0, yes
1668833310,  Dottorchini, 2, 2, 0, yes
800233889574727680,  Montaigne76, 2, 2, 0, yes
248728821,  F_Lupi, 1, 1, 0, yes
2996797988,  Cinpola, 1, 1, 0, yes
96354914,  andreapalladino, 1, 1, 0, yes
485967218,  CristianaZeggio, 1, 1, 0, yes
769622179835154432,  monarchistaa, 1, 1, 0, yes
1044908389,  LCiampiconi, 1, 1, 0, yes
3090919382,  MalacariaNino, 1, 1, 0, yes
2564249699,  Laura_Vis, 1, 1, 0, yes
2319408829,  LucreziaMadama, 1, 1, 0, yes
2918679371,  anomis_anomis70, 1, 1, 0, yes
104107919,  hrAndreaStella, 1, 1, 0, yes
3630091335,  GrFtvVi, 1, 1, 0, yes
4135892957,  GrFotovoltaico, 1, 1, 0, yes
180865192,  LaCalibro9, 1, 1, 0, yes
2315864770,  DanP7711, 1, 1, 0, yes
4217007153,  vitomonaco77, 1, 1, 0, yes
793738959276929024,  sognoct, 1, 1, 0, yes
139681650,  NicolaMelloni, 1, 1, 0, yes
232882013,  b0rnstub0rn, 1, 1, 0, yes
445201884,  dottorbarbieri, 1, 1, 0, yes
407741225,  GiusiMar, 1, 1, 0, yes
262745999,  DavideAguglia, 1, 1, 0, yes
3295064068,  FabioDepetrillo, 1, 1, 0, yes
575543901,  FerragutiFrance, 1, 1, 0, yes
2414269818,  RosarioGiovandi, 1, 1, 0, yes
1593610880,  martisamu, 1, 1, 0, yes
15929806,  mpietro, 1, 1, 0, yes
366450466,  tonymn93, 2, 2, 0, yes
452401757,  ilSignorLupo, 3, 3, 0, yes
435677042,  Umberto_Ba, 1, 1, 0, yes
3292873475,  TgrVeneto, 2, 1, 1, neutral
2757467279,  006c7437d234465, 1, 1, 0, yes
748154038370377728,  g_boemio, 11, 11, 0, yes
408152974,  peppevoltarelli, 1, 1, 0, yes
398811959,  livcartman, 1, 1, 0, yes
61724689,  ivansaracino, 2, 1, 1, neutral
3343035869,  Ruirech, 1, 1, 0, yes
4887041525,  aquiladorata, 1, 1, 0, yes
731825276603224064,  lucylu7882, 3, 3, 0, yes
989116608,  BelcastroIrene, 1, 1, 0, yes
752444213682470912,  laura_racchi, 3, 3, 0, yes
1227627204,  silvanamusti, 1, 1, 0, yes
1276256071,  DOcchini, 3, 1, 2, no
501051588,  nomesandro, 1, 1, 0, yes
387355132,  salvolapiana, 1, 1, 0, yes
220737700,  albolivieri, 2, 1, 1, neutral
57428323,  Vincerl, 1, 1, 0, yes
1249898532,  UnDauno, 2, 1, 1, neutral
3065762195,  thx__jamdavis, 1, 1, 0, yes
1159619754,  oliviacentelli, 2, 2, 0, yes
796409487213133829,  LaliradiVico, 4, 0, 4, no
2261631554,  Sto_con_Putin, 1, 0, 1, no
895909506,  SognoStupendo, 1, 0, 1, no
2371698337,  giorgiaef, 8, 0, 8, no
2567121758,  ITnewsPV, 3, 0, 3, no
467536279,  stefanovaresi, 2, 0, 2, no
3610762348,  tagadala7, 4, 0, 4, no
485044249,  temisaba95, 3, 0, 3, no
1178812555,  Zarathustra_8, 1, 0, 1, no
1886161784,  SenatoRagazzi, 2, 0, 2, no
1073842549,  chango_75, 3, 1, 2, no
96303460,  bezzigiacomo, 2, 0, 2, no
117070567,  augustoairoldi, 3, 3, 0, yes
11129252,  lvitellio, 1, 1, 0, yes
1498547887,  AchillePalermo, 2, 1, 1, neutral
562063761,  islamlie2, 15, 0, 15, no
169387991,  magdicristiano, 2, 0, 2, no
56465432,  vik305, 2, 2, 0, yes
792427445232214016,  GranoSalus, 3, 3, 0, yes
603728110,  AssParcoSud, 2, 2, 0, yes
3009155722,  ilovebirra, 1, 1, 0, yes
709390501649186816,  birraBUZZ, 1, 1, 0, yes
425344887,  StudioCalarco, 2, 2, 0, yes
504179607,  Luca95Di, 2, 2, 0, yes
710904795717042176,  MeridioneUnito, 2, 2, 0, yes
775407698426953728,  GabryBenjiPiano, 2, 2, 0, yes
59831068,  LucaLazzaro, 1, 1, 0, yes
295754318,  DarioStefano, 1, 1, 0, yes
212321005,  FCavarra, 2, 2, 0, yes
3438504027,  FedericoRenzet1, 2, 2, 0, yes
2829961320,  RoboticLearning, 1, 1, 0, yes
484893458,  NextNewMedia, 1, 1, 0, yes
1533848563,  Edwards1Angela, 2, 2, 0, yes
2781429287,  Ms__W, 2, 2, 0, yes
171412654,  fieragricola, 1, 1, 0, yes
319156051,  DrTraverso, 1, 1, 0, yes
277375609,  GianniFava, 3, 3, 0, yes
744625920313536512,  itticaitalia, 1, 1, 0, yes
1377185270,  IteNovas, 1, 1, 0, yes
936405937,  lorenzaghidini, 1, 1, 0, yes
712016368816812032,  laRistorAzione, 2, 2, 0, yes
50796369,  gdefilippis, 1, 1, 0, yes
3072354119,  alfiobellardit1, 1, 1, 0, yes
381436159,  MTV_Italia, 1, 1, 0, yes
3309870544,  and_dl89, 1, 1, 0, yes
1076251369,  mcserse, 1, 1, 0, yes
2334086092,  teresa67441986, 3, 3, 0, yes
3904501518,  FilippoTalarico, 1, 1, 0, yes
541648588,  SergeyUsatchev, 1, 1, 0, yes
2169027857,  amcarloni, 1, 1, 0, yes
1229510588,  pvercesi65, 2, 1, 1, neutral
493319195,  frabitondo, 2, 2, 0, yes
3753251897,  MassalongoDiego, 2, 1, 1, neutral
1222269840,  LimoneLuigi, 1, 1, 0, yes
409906244,  g_savoldi, 1, 1, 0, yes
347141545,  OcraMeliti, 1, 1, 0, yes
58417032,  EllaLoprete, 1, 1, 0, yes
40736331,  ARCCosta, 1, 1, 0, yes
2989641561,  ch_heinemann, 2, 2, 0, yes
212407067,  DLF, 2, 2, 0, yes
1564964384,  giulia_lar, 1, 1, 0, yes
1360737936,  MariaC_Pisani, 1, 1, 0, yes
526807943,  Giuls_GF, 1, 1, 0, yes
407032948,  Fiaip, 1, 1, 0, yes
339073452,  Confcommercio, 1, 1, 0, yes
401056069,  algieri_klaus, 1, 1, 0, yes
498044532,  RPietrantuono, 1, 1, 0, yes
300806305,  RobertaPecora, 1, 1, 0, yes
4895620589,  xlasinistra, 1, 1, 0, yes
4185599644,  SiBasilicata, 1, 1, 0, yes
1105743474,  MarchesiDario, 1, 1, 0, yes
3159487427,  Kikka7Kikka, 1, 1, 0, yes
1073802740,  massimopiemonti, 2, 2, 0, yes
3148302437,  CCitalorussa, 1, 1, 0, yes
584666400,  ABellingardi, 2, 2, 0, yes
2521083201,  greco19ema, 1, 1, 0, yes
2484016061,  timmark238, 1, 1, 0, yes
402652510,  ABDELAZIZELKHAD, 1, 1, 0, yes
477779229,  cristina_parodi, 1, 1, 0, yes
2461077055,  davideagazzi70, 1, 1, 0, yes
440382143,  paris_valentina, 1, 1, 0, yes
3043983597,  AblyazovInfo, 1, 1, 0, yes
2797939824,  DrTytty, 3, 0, 3, no
574808723,  FScamuzzi, 1, 0, 1, no
2984732475,  Gennibi2015, 9, 0, 9, no
3107819271,  leliofranceschi, 3, 0, 3, no
2933315099,  ornella_zito, 9, 1, 8, no
462069435,  CatoneGiampiero, 4, 0, 4, no
800412781899956224,  mariatangredi1, 2, 0, 2, no
807625544,  KrisBrasilZumba, 1, 0, 1, no
418173864,  PanuccioAndrea, 2, 0, 2, no
841665998,  roberta_ru, 2, 0, 2, no
4144638929,  gmencini1, 1, 1, 0, yes
3303785920,  ClaudioAMonzi, 1, 1, 0, yes
546015869,  MariannaGianfor, 1, 1, 0, yes
51483405,  marianetty, 1, 1, 0, yes
2693731514,  angelalupo10, 1, 1, 0, yes
2827148957,  fmazzulla1, 2, 1, 1, neutral
851318875,  Beppeley, 12, 8, 4, yes
452251557,  enzo_robino, 3, 3, 0, yes
1511735094,  lauramanzini_it, 3, 2, 1, yes
422497429,  ETicaNews, 1, 1, 0, yes
252979181,  fcancellato, 1, 1, 0, yes
752496236993900544,  _mattiamattia_, 1, 1, 0, yes
2448147738,  MsScorplo12, 1, 1, 0, yes
571906881,  NuccioIovene, 1, 1, 0, yes
812956885,  andreafazio93, 1, 1, 0, yes
915362096,  gitLazioBE, 1, 1, 0, yes
393494421,  wganapini, 1, 1, 0, yes
715843852842713088,  LVulpiani, 1, 1, 0, yes
1007131807,  IoliAndrea, 1, 1, 0, yes
121451902,  Cittadinanzatti, 3, 2, 1, yes
589999382,  StefaniaTrapani, 1, 1, 0, yes
826085713,  Rosa_Ala45, 1, 1, 0, yes
1020248442,  NeXteconomia, 1, 1, 0, yes
2304962382,  Morglab, 1, 1, 0, yes
72869556,  unioncamere, 1, 1, 0, yes
2923501798,  GITBancaEticaBO, 1, 1, 0, yes
154082185,  abaranes, 1, 1, 0, yes
710528801206345729,  carmena24960902, 2, 2, 0, yes
383646205,  GiuNotar, 1, 1, 0, yes
1259665080,  QuasidiRosaria, 1, 1, 0, yes
1099363334,  giugiulone, 1, 1, 0, yes
3155098746,  a_bernardoni, 1, 1, 0, yes
804086589559291904,  volpi_giulio, 1, 1, 0, yes
248674195,  Gadamico20, 1, 1, 0, yes
857710178,  AngeloSemerano, 1, 1, 0, yes
2343894636,  SEC_Loppiano, 1, 1, 0, yes
619121298,  ahmedSsafdar603, 1, 1, 0, yes
2476110046,  Yanquistlc, 1, 1, 0, yes
328406433,  janfigel, 1, 1, 0, yes
418789148,  CitiesforLife, 2, 2, 0, yes
68435756,  provexis, 1, 1, 0, yes
1393160702,  moniksmadrid, 1, 1, 0, yes
1001447467,  LorenzaBadiello, 1, 1, 0, yes
63674368,  MatteoSeraceni, 1, 0, 1, no
77540948,  quigleyp, 2, 0, 2, no
2879539541,  FranCast755, 1, 0, 1, no
518391983,  fatagnomo, 1, 0, 1, no
381439267,  FabioGulotta, 1, 0, 1, no
3377577663,  RotaCostantino, 2, 0, 2, no
3345106587,  CapitanArbano, 1, 0, 1, no
3429131512,  napolicalciovid, 1, 0, 1, no
73854874,  wallflower_85, 2, 0, 2, no
626753423,  MSDivytoski, 3, 0, 3, no
720332902320467968,  Valeria196550, 2, 0, 2, no
386065714,  MattiAnti, 1, 0, 1, no
3803802809,  boerianrhapsody, 1, 0, 1, no
239002248,  M5Savellino, 1, 0, 1, no
1010781937,  IngVarob, 4, 0, 4, no
796375652165357568,  Naiandiv, 1, 0, 1, no
2157198452,  AliceTerenzola, 3, 0, 3, no
718399714325094400,  maestraless, 4, 0, 4, no
1451532528,  giumilis, 2, 0, 2, no
1482201595,  FightTheStroke, 1, 0, 1, no
85820733,  Mario_Rossano, 1, 0, 1, no
397346687,  MaxCerof, 7, 6, 1, yes
415665457,  rita3ferr, 1, 0, 1, no
799999773818363905,  SamFoxBot, 1, 0, 1, no
356497258,  dominicipi, 1, 0, 1, no
1001793721,  ConfagriAL, 1, 1, 0, yes
285585877,  Ecomondo, 1, 1, 0, yes
1430646937,  KeyEnergyit, 1, 1, 0, yes
2982897975,  LucaTonarelli, 1, 1, 0, yes
553592736,  robertoblando, 1, 1, 0, yes
558031406,  LiPerni, 2, 0, 2, no
796638809580589056,  FRCastellini, 1, 0, 1, no
58845374,  fabriziogallo, 1, 0, 1, no
323951434,  AndreaBoeris, 3, 0, 3, no
58719148,  nellocats, 3, 0, 3, no
2517639023,  francescostep84, 6, 0, 6, no
3066014739,  Luc4b, 1, 0, 1, no
45410367,  otellopinata, 1, 0, 1, no
45301618,  supermariobos, 2, 0, 2, no
476782210,  andrea_pelosi, 1, 0, 1, no
2895724737,  senecafilosof0, 1, 0, 1, no
328701052,  FBuonora, 1, 0, 1, no
51166909,  bitolgius, 1, 0, 1, no
476811892,  robynud1, 7, 0, 7, no
156729839,  comilara, 1, 0, 1, no
15790363,  varesenews, 1, 1, 0, yes
785072491563810816,  SICILIASTUPEND1, 2, 0, 2, no
477855618,  sbirroguy, 1, 1, 0, yes
777969112232390656,  ClaSbiru, 1, 1, 0, yes
2482455051,  pertasperllted, 1, 1, 0, yes
780375134146355200,  ROBERTO18134518, 1, 1, 0, yes
2482812285,  RUCiubbaseball, 1, 1, 0, yes
2449963778,  brian__alarie, 1, 1, 0, yes
1346261641,  CamComReggioEmi, 1, 1, 0, yes
2448341191,  KelseyKovai, 1, 1, 0, yes
614978918,  AilPubAndy, 1, 1, 0, yes
3091259295,  CiaoEmilia, 2, 2, 0, yes
1049805164,  raoulmosconi, 2, 2, 0, yes
2290074215,  AndreaBricchi77, 2, 2, 0, yes
2537872207,  mbarbibersel, 1, 1, 0, yes
2574113117,  amicidiBerselli, 1, 1, 0, yes
1140200162,  pignatti1, 1, 1, 0, yes
559822009,  alexmengozzi, 1, 1, 0, yes
304034393,  edizionimulino, 1, 1, 0, yes
377894223,  GSqueri, 1, 1, 0, yes
2869474456,  meanton_meli, 1, 1, 0, yes
172255005,  Markollen, 1, 1, 0, yes
492017129,  Guidopolis_RN, 1, 1, 0, yes
545102676,  mirkocasadei1, 3, 3, 0, yes
35708869,  BolognaFiere, 1, 1, 0, yes
62186113,  lsainta, 1, 1, 0, yes
210821811,  RositaRijtano, 1, 1, 0, yes
1079909342,  EnteCaRiFirenze, 1, 1, 0, yes
37674847,  ilCINZIO, 1, 1, 0, yes
728277306570067968,  MarinaBerrino, 1, 0, 1, no
98947753,  ligureapuano, 1, 0, 1, no
1227177884,  primo_lato, 8, 0, 8, no
2548045884,  UglAvellino, 11, 0, 11, no
3078100444,  UglMetalm, 17, 0, 17, no
2619985539,  sandro4911, 1, 0, 1, no
1040251176,  GiovannidiBiton, 1, 0, 1, no
2383565354,  AliceSavelli, 1, 0, 1, no
1252330836,  14Bisconti, 2, 0, 2, no
261757783,  uglfoggia, 6, 0, 6, no
527886495,  Alca147, 7, 0, 7, no
38340760,  ladydiedgar, 2, 0, 2, no
799574075291140101,  AndreaR93873022, 1, 0, 1, no
139339339,  maxmagri, 2, 0, 2, no
2236419782,  RubinoPino1, 1, 0, 1, no
401704325,  a_melchionno, 11, 0, 11, no
537051193,  UglSicilia, 1, 0, 1, no
759886508220309505,  ciroBorrelli75, 2, 0, 2, no
3230539624,  pasqualegianga1, 1, 0, 1, no
111410606,  AcquavivaAngelo, 3, 0, 3, no
431859432,  Ilario1964, 1, 0, 1, no
3330193977,  ficulle39, 1, 1, 0, yes
3090970077,  vin_giorgio, 2, 1, 1, neutral
734764188162248704,  bastaunsibas, 1, 1, 0, yes
724094935,  lucchettobis, 1, 1, 0, yes
1238514295,  danidongio, 1, 1, 0, yes
2334070474,  MarcoGFM, 9, 9, 0, yes
24393879,  pkuiper, 1, 1, 0, yes
465408039,  RobertaBruzzone, 2, 2, 0, yes
894245563,  Buttial59, 1, 1, 0, yes
845733672,  5_minuti, 1, 1, 0, yes
701704953572806657,  aQara_pisa, 1, 1, 0, yes
398329628,  quico80, 1, 1, 0, yes
470572668,  Ensi2000, 1, 1, 0, yes
38732034,  p33racy, 1, 1, 0, yes
790596681989550080,  Alebat9, 1, 1, 0, yes
1490775878,  emilifox89, 1, 1, 0, yes
1005839168,  LadyAutoItalia, 1, 1, 0, yes
783403955917389824,  MaryMattiucci, 1, 1, 0, yes
118011775,  Lo62renzo, 1, 1, 0, yes
4382443697,  LNN999, 1, 1, 0, yes
772208652040151041,  MaggioRLIPz, 2, 2, 0, yes
821872394,  balossu, 3, 3, 0, yes
591319709,  RaissaCordella, 1, 1, 0, yes
804401099046326272,  Matteo46209669, 2, 2, 0, yes
1136494033,  mauropiv, 1, 1, 0, yes
1017142682,  EmiliaMPezzini, 1, 1, 0, yes
2794273817,  allindustriesit, 2, 2, 0, yes
2352090465,  GaninoSg, 1, 1, 0, yes
781534758291509250,  moroby69, 1, 1, 0, yes
2675432278,  Sumo976, 5, 5, 0, yes
793500285574455296,  economiavita, 2, 1, 1, neutral
528722204,  GuidoAlieno, 1, 1, 0, yes
1007464825,  ari1412, 2, 1, 1, neutral
485573399,  AlessandroT88, 1, 1, 0, yes
2949013762,  SandroBrizzola4, 1, 1, 0, yes
1606595466,  santodubito, 3, 1, 2, no
42055969,  _gmgo, 1, 1, 0, yes
2771507320,  MaxSixtyseven, 1, 1, 0, yes
220763153,  antonellasant, 1, 1, 0, yes
428541455,  2Mariella, 1, 1, 0, yes
593625090,  Francaelena, 1, 1, 0, yes
2978458125,  luisaclarissa, 1, 0, 1, no
68984285,  mauryhappy, 1, 0, 1, no
872452502,  cittadinanzaatt, 2, 0, 2, no
985076126,  StCarnevale, 1, 0, 1, no
2412990049,  MrValesan, 1, 0, 1, no
432264645,  alba_ins, 2, 0, 2, no
110990122,  200664, 1, 0, 1, no
1416548016,  Darioeyes, 1, 0, 1, no
1610203530,  antoschiAv, 1, 0, 1, no
2617636336,  asinorosso76, 1, 0, 1, no
1605405253,  gp_fiore, 5, 0, 5, no
10774862,  gpcerri, 1, 0, 1, no
2370772835,  MassimoPaolucc6, 1, 0, 1, no
784138144870457344,  MariantoniaMic3, 1, 0, 1, no
401492287,  GiannoloLuca, 1, 0, 1, no
408546766,  G1Abate, 2, 0, 2, no
253639943,  sbrando72, 1, 0, 1, no
417392878,  MdGOfficial, 1, 0, 1, no
636390373,  Domenicotammar2, 1, 0, 1, no
2906705362,  annaconte81, 1, 0, 1, no
3322751109,  BComuGlobal, 1, 0, 1, no
1475312670,  Riscattoazzurro, 1, 0, 1, no
4136435007,  roccomaz, 1, 0, 1, no
3772927402,  massa_critica_, 1, 0, 1, no
20021712,  BLACKFLAGchi, 1, 0, 1, no
2592480058,  dosmesdoscinc, 1, 0, 1, no
3159339067,  ilTestMagazine, 1, 0, 1, no
526589536,  PLinItalia, 1, 0, 1, no
1132405543,  ale_clem, 1, 0, 1, no
469747259,  simopax82, 1, 0, 1, no
1056109082,  mamauro1, 1, 0, 1, no
837370934,  giuseppegrassi9, 32, 0, 32, no
4556208021,  TranchiFanchi, 1, 0, 1, no
138364373,  loposeper, 42, 0, 42, no
776357522,  EgonMichelle, 10, 0, 10, no
2171916782,  runninglo, 1, 0, 1, no
94594903,  malucy2, 60, 0, 60, no
2396676379,  Silvio22410511, 30, 0, 30, no
432329081,  rosalbapereira1, 4, 0, 4, no
613567201,  BritIann007, 2, 0, 2, no
1160616948,  danitwix, 1, 0, 1, no
720266765650014208,  cecco170, 21, 0, 21, no
4229963363,  MarkoLemma, 42, 0, 42, no
497906852,  Alexpi69, 4, 0, 4, no
2902589133,  bepper875, 1, 0, 1, no
471369382,  coscenzioso6, 13, 0, 13, no
194766923,  aledam87, 2, 0, 2, no
2385369457,  elettra1970, 1, 0, 1, no
422962166,  ASSO1M, 1, 0, 1, no
3277940725,  09058659313m07, 1, 0, 1, no
71545876,  superantos, 1, 0, 1, no
422646193,  marioseby57, 13, 0, 13, no
799195890749730816,  vicentacarla3, 2, 0, 2, no
463864783,  FabioM63, 1, 0, 1, no
4924737299,  GiorgiaTartagl1, 1, 0, 1, no
1175672102,  miclosweb, 1, 0, 1, no
532577856,  giovannacaluri, 4, 0, 4, no
2183863684,  giusiary, 4, 0, 4, no
29063880,  dbdebs, 1, 0, 1, no
3233336236,  pippuzzo5stelle, 34, 0, 34, no
319846232,  posterit, 7, 0, 7, no
2772740636,  resistenzam5s, 31, 0, 31, no
502195501,  albertoGroff, 2, 0, 2, no
446616638,  AlessandraLeon8, 1, 0, 1, no
781201656532926464,  giulianopluto, 3, 0, 3, no
4927619332,  megven7, 1, 0, 1, no
694875836411990016,  LouisCelestino, 1, 0, 1, no
1235353459,  dbasezz, 3, 0, 3, no
1004504533,  harrodugo, 1, 0, 1, no
2281118124,  MoralistaDelCax, 1, 0, 1, no
3145332994,  emilybronte85, 1, 0, 1, no
2870658190,  GBognandi, 2, 0, 2, no
2942486068,  VitulloDv, 4, 0, 4, no
291417844,  djtaglierino, 1, 0, 1, no
247775090,  nennaornella, 4, 0, 4, no
3011065835,  Mov5StelleNoto, 1, 0, 1, no
2289452816,  renatomarotta, 1, 0, 1, no
802824517219479553,  Grazia19688377, 1, 0, 1, no
526478079,  aldobini, 1, 0, 1, no
733032143530696704,  lorri744, 2, 0, 2, no
203827028,  mrbitlinus, 5, 0, 5, no
290093767,  N36volpe1973, 45, 0, 45, no
4787676166,  antonellab67, 3, 0, 3, no
761928076397834240,  Angelodimichel4, 1, 0, 1, no
461839912,  PasqualeRea1, 1, 0, 1, no
425067394,  lauraserloni, 1, 0, 1, no
1346566790,  RobertoAllegret, 38, 0, 38, no
415440185,  LucaBrivio73, 2, 0, 2, no
3304637962,  lauraantonell19, 1, 0, 1, no
2755069611,  gianlucacapell2, 2, 0, 2, no
404283215,  FabioFedericiF, 1, 0, 1, no
446307797,  biagioscol, 2, 0, 2, no
2726832817,  maumizi, 1, 0, 1, no
4895893847,  veryfabryyuri, 2, 0, 2, no
1968997549,  giovanniborci, 1, 0, 1, no
706392027278217216,  francesca_quatt, 1, 0, 1, no
1458889328,  LauraKiss15, 2, 0, 2, no
410077670,  FrannicoC, 1, 0, 1, no
1409045616,  manlio_greco, 1, 0, 1, no
205638223,  acquamarina62, 3, 0, 3, no
2179309175,  sorce52, 2, 0, 2, no
562968203,  loredanaceruso, 1, 0, 1, no
415129119,  orchidea62009, 1, 0, 1, no
35000018,  dbussetti, 3, 0, 3, no
2353554590,  cadamuro_gino, 2, 0, 2, no
736168858898337792,  robygamba70, 1, 0, 1, no
2303315316,  Fabioleon777, 2, 0, 2, no
1415231497,  Alexein222, 1, 0, 1, no
64002024,  AlpineCairn, 1, 0, 1, no
499676949,  andreatheblando, 2, 0, 2, no
398603525,  Emanuela_Corda, 1, 0, 1, no
966502022,  salape2, 8, 0, 8, no
1639836846,  o_franco_aleman, 1, 0, 1, no
3357277319,  peac4love, 1, 0, 1, no
401546671,  verodilo, 1, 0, 1, no
39976483,  areaizzo, 12, 0, 12, no
2729690231,  PatriziaProbo, 1, 0, 1, no
734115846495305728,  francescotruck, 1, 0, 1, no
866432192,  Salvatoreilpira, 4, 0, 4, no
86336577,  for_michina, 1, 0, 1, no
787922343784046592,  DomenicoSimini, 4, 0, 4, no
3919219541,  lancianews, 1, 0, 1, no
732125961412612097,  dariokuno, 2, 0, 2, no
2219448182,  PasqualeCarola, 7, 0, 7, no
706060041254780928,  Egaleonis, 2, 0, 2, no
801560814696144896,  AndreaFraNchin0, 1, 0, 1, no
2850141704,  playeronline1, 1, 0, 1, no
289806001,  carlosdebo, 1, 0, 1, no
408780630,  tedescogennaro, 1, 0, 1, no
3026776164,  ardarcangelo_d, 1, 0, 1, no
998895174,  exprofcasapens, 1, 0, 1, no
3834882442,  casillo_alfonso, 1, 0, 1, no
20939436,  mostquiet, 1, 0, 1, no
2525039696,  concett95520392, 15, 0, 15, no
1264018218,  francescomila18, 16, 0, 16, no
2959917485,  ornellamarzilli, 68, 0, 68, no
796381889326153729,  Giovann35203596, 3, 0, 3, no
2506958514,  EnricoMatteazzi, 2, 0, 2, no
1120383019,  Beppe__Grillo, 1, 0, 1, no
18280831,  papiriki, 1, 0, 1, no
2328858254,  PaoloQuera, 2, 0, 2, no
3143144909,  Beppetonini, 3, 0, 3, no
3370650735,  fuldapa, 4, 0, 4, no
1024365672,  GiovanniPigio, 1, 0, 1, no
552976390,  GianlucaTC, 3, 0, 3, no
2892226235,  66comiNotti, 1, 0, 1, no
802601571427225600,  gianpiero_246, 1, 0, 1, no
3261069747,  DessiSelvaggia, 2, 0, 2, no
93197485,  massimoneri90, 26, 0, 26, no
385704361,  ermesgirotto, 1, 0, 1, no
1848967950,  GerardoPergamo1, 6, 0, 6, no
951593118,  PierDomenicoSal, 4, 0, 4, no
703318645,  rfalco49, 8, 0, 8, no
802580873753350144,  leastmgdr, 1, 0, 1, no
300083934,  giovannicroce1, 4, 0, 4, no
2780485292,  AxelOffic, 2, 0, 2, no
860296220,  bonanno_massimo, 1, 0, 1, no
1100294395,  crisenza_paola, 1, 0, 1, no
1144953769,  gianniskipper, 8, 0, 8, no
359493082,  ermannobombelli, 1, 0, 1, no
1015819494,  RenatoNarcisi, 20, 0, 20, no
3700266675,  osma_rido, 2, 0, 2, no
2361488227,  M2013smMaria, 2, 0, 2, no
791360681815728129,  paolocar12, 5, 0, 5, no
802211792764207105,  mr_gatti61, 1, 0, 1, no
801843258183786496,  scafettafabio, 1, 0, 1, no
55509918,  paspro2, 1, 0, 1, no
1352301782,  drfrancocapuani, 27, 0, 27, no
2156562691,  PalmiscianoL, 3, 0, 3, no
1365084235,  crimaxim, 1, 0, 1, no
2342539890,  patriziabaldi1, 1, 0, 1, no
531265189,  EmmaMorbini, 1, 0, 1, no
400602706,  DiegoVinciguerr, 1, 0, 1, no
1566318876,  MasstevMusic, 1, 0, 1, no
1418841108,  vespiri, 3, 0, 3, no
769256675719180288,  Salvato40840541, 3, 0, 3, no
284683090,  naripac, 5, 0, 5, no
1265550168,  GiuseppeCrow, 4, 0, 4, no
2858795351,  jocker1975, 1, 0, 1, no
501599823,  giorgio84605180, 1, 0, 1, no
400393067,  MM_Ambrogi, 3, 0, 3, no
841387776,  DiegoForoni, 1, 0, 1, no
799000131483770880,  Xandarmm, 1, 0, 1, no
94788246,  Alien1it, 14, 0, 14, no
802587183186116608,  marcojesolo46, 1, 0, 1, no
712212243757322241,  Frankhox, 3, 0, 3, no
331093272,  walter1711, 1, 0, 1, no
2336391177,  luisastar63_lu, 2, 0, 2, no
2494327693,  MarcoValliM5S, 4, 0, 4, no
1023802202,  1950Cristiano, 2, 0, 2, no
148545440,  rciafardone, 1, 0, 1, no
88019719,  Adriano_Sora, 3, 0, 3, no
786871131114528769,  greentaak, 2, 0, 2, no
2310271175,  GmNunzio, 2, 0, 2, no
2784347102,  io05296397, 1, 0, 1, no
1420323073,  GiuliaPozzuoli, 4, 0, 4, no
396864162,  Pavel_Ferrari, 1, 0, 1, no
3231787383,  guerino1988, 3, 0, 3, no
594773318,  ZainebMornagui, 1, 0, 1, no
1089513403,  MarioGregu, 30, 0, 30, no
196508522,  Italianamente, 2, 0, 2, no
99885525,  Dreyfus72, 1, 0, 1, no
622270454,  udeaugustinis, 1, 0, 1, no
2318181395,  pier_grecchi, 1, 0, 1, no
2899280399,  ThornXYZ, 1, 0, 1, no
1941112045,  pastore72149760, 2, 0, 2, no
1045531866,  umberto772, 2, 0, 2, no
1229782501,  ALESarch, 1, 0, 1, no
197937732,  gillezfred, 3, 0, 3, no
3303556480,  pastore_arturo, 2, 0, 2, no
781439771017109504,  SilvanaForlini, 1, 0, 1, no
483729331,  MarcelloBBB, 1, 0, 1, no
421017807,  MicheleMileto, 2, 0, 2, no
966297074,  MarriPaolo, 6, 0, 6, no
14638233,  Africanasoul, 4, 0, 4, no
2799326845,  campanedda51, 1, 0, 1, no
170660330,  OrtegaJordi, 1, 0, 1, no
539721796,  NormanDeArmond, 2, 0, 2, no
1563877585,  Cometa1963, 7, 0, 7, no
1434758118,  GtMerrywife, 1, 0, 1, no
393689013,  catribe, 1, 0, 1, no
3034201259,  Franco3falbo, 19, 0, 19, no
742029008146210816,  anniballe_d, 1, 0, 1, no
1076294167,  990910MBI, 1, 0, 1, no
1109873544,  maurocnt, 1, 0, 1, no
409998602,  lucioriccetti, 1, 0, 1, no
447413010,  odlat, 1, 0, 1, no
423578767,  paololocascio1, 3, 0, 3, no
1167113408,  carmelo_1970, 4, 0, 4, no
573881279,  5simo_simo3, 1, 0, 1, no
62383022,  lucacolantonio, 1, 0, 1, no
204078845,  Marco_J_Ferrari, 1, 0, 1, no
706524248106524673,  steorun, 1, 0, 1, no
170423526,  FlorisSerra, 3, 0, 3, no
1692143298,  MikyAloisio, 2, 0, 2, no
4383940095,  sasaks_s, 1, 0, 1, no
2833896585,  alangio22, 2, 0, 2, no
2151049389,  rivi_davide, 1, 0, 1, no
380183508,  carlorinaldi1, 1, 0, 1, no
869445680,  FconteC, 1, 0, 1, no
801464592836755456,  crepaldi_1024, 1, 0, 1, no
3155492620,  gianfrancogian5, 2, 0, 2, no
952393700,  LaPoliticaChe, 1, 0, 1, no
119127143,  epico69, 1, 0, 1, no
383632630,  Folpo66, 1, 0, 1, no
1077797754,  flavio_fantino, 1, 0, 1, no
3134015573,  Balilla17, 1, 0, 1, no
1061062754,  internaz1, 1, 0, 1, no
787673845738115077,  girgenticristin, 1, 0, 1, no
1146192529,  giovannasarto10, 1, 0, 1, no
397512732,  PinelliPier, 5, 0, 5, no
607368233,  aluca1970, 1, 0, 1, no
1147430462,  LetoPompilio, 1, 0, 1, no
290724470,  chiesa_stefano, 1, 0, 1, no
970849686,  StefanoPallavic, 2, 0, 2, no
1036863938,  SalvatorePazzol, 1, 0, 1, no
2587790685,  linov00, 1, 0, 1, no
2356202642,  ALeCause, 1, 0, 1, no
499890226,  Milodiremigio, 5, 3, 2, yes
2256809326,  francesconi70, 2, 0, 2, no
802363365771378688,  moipoxyhyd1973, 1, 0, 1, no
2426116776,  doripacca, 1, 0, 1, no
31521666,  paolodriussi, 2, 0, 2, no
886686836,  AntonioMaterdom, 4, 0, 4, no
2992825821,  sandrodeambrog1, 1, 0, 1, no
792627890395418624,  AngyCatarinella, 2, 0, 2, no
783767997018177536,  AngelaCasu2, 1, 0, 1, no
3170257623,  roberta8111, 1, 0, 1, no
1143193639,  lorenzociccaron, 1, 0, 1, no
2283924266,  giovannizzo2, 1, 0, 1, no
428476147,  nicola_corona, 2, 0, 2, no
780699672276905984,  AuroraSpurio, 1, 0, 1, no
595338478,  cilie79, 1, 0, 1, no
3377889609,  PreduRuju, 1, 0, 1, no
1513495909,  DinardoRaffaele, 1, 0, 1, no
297971382,  doraespo, 3, 0, 3, no
2366121870,  AnbigAngy, 2, 0, 2, no
319307045,  RivafiRita, 1, 0, 1, no
516890828,  mancinifabio1, 3, 0, 3, no
194144770,  itfaari, 1, 0, 1, no
739443565198204928,  MarcantonioCl, 1, 0, 1, no
726083054,  SoloTrePi, 2, 0, 2, no
1384371824,  CIRODESANTO1, 1, 0, 1, no
697968492050522112,  Oriana34177611, 1, 0, 1, no
3135640856,  ae972, 2, 0, 2, no
405837281,  lodifab, 1, 0, 1, no
791208910623506432,  gionickleo, 3, 0, 3, no
110278009,  stefanoforgione, 1, 0, 1, no
904798681,  saveJACKo, 1, 0, 1, no
1852012634,  HALTEREGO28, 1, 0, 1, no
231118677,  MIKISCO, 19, 0, 19, no
721766411937411072,  DamianoPignate1, 1, 0, 1, no
22616851,  panzarotto, 1, 0, 1, no
779544980012556288,  jokermax71, 1, 0, 1, no
3986857846,  geomfrancodifa1, 2, 0, 2, no
2184761907,  Fadda14, 3, 0, 3, no
1146148506,  RobertoDimaggio, 2, 0, 2, no
470081458,  camezza72, 2, 0, 2, no
733566498,  GorrasiLino, 1, 0, 1, no
1070413645,  giosimo74, 1, 0, 1, no
1054666776,  fulkat2, 1, 0, 1, no
1039501538,  ernesto_diana, 2, 0, 2, no
348502260,  loryianni, 2, 0, 2, no
566136857,  stefanocasalec, 1, 0, 1, no
420624994,  claudiodipas, 7, 0, 7, no
415047353,  euka1gianni, 1, 0, 1, no
4251258976,  camandrea80, 1, 0, 1, no
232132456,  atamau77, 2, 0, 2, no
61816119,  terryvale, 1, 0, 1, no
478601909,  Fiffo78, 1, 0, 1, no
4186870516,  Manodivento, 2, 0, 2, no
3079657612,  DLF_Paris16, 1, 0, 1, no
449865440,  carlodeleo, 1, 0, 1, no
478520272,  marcellomastice, 3, 0, 3, no
787276746819330048,  mario65523797, 1, 0, 1, no
29851314,  reroll, 2, 0, 2, no
791577594227458048,  Francescoarm71, 1, 0, 1, no
752727902559625216,  rosario231206, 2, 0, 2, no
715125585,  ToppiCom, 1, 0, 1, no
345384153,  safilippelli, 1, 0, 1, no
1853678790,  FragoleMature, 9, 0, 9, no
2223123756,  Poto86, 1, 0, 1, no
87893299,  GrippoAlex, 1, 0, 1, no
2348278097,  candyenne22, 1, 0, 1, no
64275595,  VictySight, 2, 0, 2, no
416586096,  ollagfra, 1, 0, 1, no
1916736956,  serramanuela5, 7, 0, 7, no
34572076,  familyhousemag, 1, 0, 1, no
442906173,  Cleopatra3300, 1, 0, 1, no
375255136,  IvanoLandi, 1, 0, 1, no
964698278,  ORESTEFERRO, 1, 0, 1, no
176053884,  monteur_tv, 1, 0, 1, no
747863299555995650,  pattobaratto, 4, 0, 4, no
3065938786,  NotiziarioDN, 1, 0, 1, no
1109984041,  gianlucameconi, 1, 0, 1, no
3303758080,  Ozbahh, 1, 0, 1, no
800810400983883776,  francescoburra7, 4, 0, 4, no
1219904792,  ilpartigiano, 1, 0, 1, no
822067778,  PaoloFruttero, 2, 0, 2, no
396417613,  danimiele1, 1, 0, 1, no
735060410215346176,  dimar_dimarzo, 3, 0, 3, no
1166428405,  vittoriavitali1, 3, 0, 3, no
117064713,  Chiaruttini, 1, 0, 1, no
92236282,  donatellapavone, 1, 0, 1, no
4355382796,  1m_mario, 1, 0, 1, no
782258395382423556,  alberto_andria, 2, 0, 2, no
803629689856229376,  754_339, 2, 0, 2, no
401703102,  GMendix, 1, 0, 1, no
3268499779,  MatRan15, 1, 0, 1, no
318440967,  johnnycev, 1, 0, 1, no
201691601,  Didimighi, 1, 0, 1, no
810395744,  romani_1976, 3, 0, 3, no
3937311809,  PattiLu76, 2, 0, 2, no
1001745906,  patriziaf59, 1, 0, 1, no
2987511106,  lotusdiego1, 1, 0, 1, no
459248135,  Isor53, 1, 0, 1, no
178155347,  MartinaColas, 1, 0, 1, no
483028649,  LauraIavarone, 1, 0, 1, no
3320495819,  PalermoTurismo, 1, 0, 1, no
186388096,  fraguarino, 3, 0, 3, no
96198967,  Sp4rd4, 1, 0, 1, no
852569226,  albass58, 1, 0, 1, no
1913784829,  GrGabris, 1, 0, 1, no
4216964932,  biobba20155, 1, 0, 1, no
2474046728,  aggielli, 3, 0, 3, no
90124895,  pippoj, 7, 0, 7, no
1230788334,  linndamas, 1, 0, 1, no
3117872572,  RitaVaccaro8, 2, 0, 2, no
330529365,  FrancyPetra, 1, 0, 1, no
992834858,  caterinafrazzet, 1, 0, 1, no
1286873820,  86pac, 1, 0, 1, no
2329159892,  DeFabbris, 1, 0, 1, no
4128961174,  Manubiasin, 1, 0, 1, no
19422447,  tamburrano, 6, 0, 6, no
424966108,  antonivalentino, 1, 0, 1, no
182586235,  marcobinotto, 1, 0, 1, no
3252980355,  BenMariemben, 1, 0, 1, no
2385584221,  ChryAllegra, 1, 0, 1, no
768448873048178689,  Yves_Florence, 1, 0, 1, no
3412398478,  dennibellomo, 1, 0, 1, no
738828239599226880,  patrizia_maffei, 1, 0, 1, no
38027529,  gabs_catalano, 4, 0, 4, no
1314338900,  MrWhite57734166, 1, 0, 1, no
2664104673,  AprodiProdi, 1, 0, 1, no
993551622,  mine090966, 1, 0, 1, no
3480858933,  Perikle181, 1, 0, 1, no
752973843422208003,  cangiovan65, 1, 0, 1, no
9568772,  g_bertoncello, 2, 0, 2, no
1262690820,  fumatanera56, 2, 0, 2, no
1069078807,  orsibruno, 1, 0, 1, no
94690071,  ABCletta, 1, 0, 1, no
781222767807070208,  mecuccia, 1, 0, 1, no
956180245,  monikventu, 1, 0, 1, no
503124705,  MAXBEAUTYFULL, 4, 0, 4, no
429140220,  BarattoMattia, 1, 0, 1, no
555469454,  ivan0305, 1, 0, 1, no
390912718,  Dnl84le, 1, 0, 1, no
2452231707,  GRosadiroma82, 11, 0, 11, no
2432954326,  DiTonydifresco, 1, 0, 1, no
143178638,  alfbrunow, 1, 0, 1, no
2220089080,  pietroa67, 1, 0, 1, no
3388830129,  f03685f00e3e499, 2, 0, 2, no
428192006,  namepaolo, 2, 0, 2, no
2243103750,  vergugnos, 6, 0, 6, no
99390218,  acesarini, 1, 0, 1, no
940072826,  mrt3074, 1, 0, 1, no
2442175797,  maurizio79rs, 2, 0, 2, no
506236862,  NandoCipollino, 1, 0, 1, no
398607885,  lucavilla75, 1, 0, 1, no
223405753,  raimondolu, 2, 0, 2, no
794235436935892992,  emmalinn75, 1, 0, 1, no
573749510,  antonmax67, 1, 0, 1, no
2783636812,  grgfrln91, 1, 0, 1, no
1875113508,  sebendinelli, 1, 0, 1, no
2917517319,  1f23c698eaf74bd, 1, 0, 1, no
759768288381382656,  Tosca16613733, 1, 0, 1, no
255747388,  Praticante85, 1, 0, 1, no
762981306586324992,  DepauRita, 1, 0, 1, no
2924632104,  flapanteriore, 1, 0, 1, no
2475118937,  thomas__mcclain, 1, 0, 1, no
768385300355743744,  salvatorevalle8, 1, 0, 1, no
1220690641,  AndreaBelvedere, 1, 0, 1, no
513424484,  apidicecco, 4, 0, 4, no
782209691787071488,  20033101_150, 1, 0, 1, no
509703882,  merlinoatwork, 1, 0, 1, no
2463483414,  RinnovabiliBiz, 1, 0, 1, no
3088893988,  Lia61877161, 1, 0, 1, no
17018967,  NormalBooking, 1, 0, 1, no
1570059619,  LelioPetiva, 1, 0, 1, no
589899714,  FRANCESCOBURRA1, 13, 0, 13, no
395887529,  aakashOgleby, 1, 0, 1, no
1192340953,  PBitti, 1, 0, 1, no
403038998,  DeTursi, 1, 0, 1, no
60705171,  renatopasini, 1, 0, 1, no
1230108756,  PPiergi, 1, 0, 1, no
1277947736,  francescoviti64, 1, 0, 1, no
706835606232555520,  giacomogc270968, 1, 0, 1, no
602897043,  FVonThurn, 1, 0, 1, no
375106694,  stefanoguarni, 1, 0, 1, no
299660754,  fampillo, 1, 0, 1, no
3225202246,  MichelaCarota, 1, 0, 1, no
2902748278,  Sikulo72, 2, 0, 2, no
805821153554169860,  sculacciatope, 1, 0, 1, no
11055732,  aubreymcfato, 1, 0, 1, no
2994392625,  maddoxx55, 1, 0, 1, no
318940473,  NicolaMacr, 1, 0, 1, no
2361032367,  ottaviani192, 1, 0, 1, no
481416521,  Arpa__net, 15, 0, 15, no
417271851,  chiccazzo, 1, 0, 1, no
795263769261772800,  michele00110, 2, 0, 2, no
4611996742,  Elisabettafabbr, 3, 0, 3, no
1389377954,  CristianoDemart, 1, 0, 1, no
4882021971,  MignanoRoberta, 1, 0, 1, no
710355800,  AlessandroDP21, 1, 0, 1, no
718376903099432961,  MimmoSgura1, 1, 0, 1, no
770249747252781056,  cascella_matteo, 1, 0, 1, no
804979919788933120,  Seby5779, 2, 0, 2, no
1007997080,  akab50, 4, 0, 4, no
1201957429,  dario25091962, 5, 0, 5, no
1079112506,  MrsJuliette93, 1, 0, 1, no
804195631493509120,  Teresa86564986, 3, 0, 3, no
763430495514423296,  kisimaio, 1, 0, 1, no
478976747,  lafedeibibetti, 1, 0, 1, no
108592050,  giamaga, 3, 0, 3, no
784331797496631296,  cosimocalabres5, 7, 0, 7, no
772349570,  MBuccarella, 1, 0, 1, no
397162844,  Tonigno82, 2, 0, 2, no
1234864148,  TommasoWom7, 1, 0, 1, no
2351835684,  gbadteach, 2, 0, 2, no
740586516049735680,  claudio_zamb, 1, 0, 1, no
437627701,  edoagnese, 1, 0, 1, no
731917588247220227,  immaginemozion1, 1, 0, 1, no
725686916918722560,  andrea5stelle87, 1, 0, 1, no
1219163587,  Pulguiteam, 3, 0, 3, no
4593533705,  carmelo_vicario, 1, 0, 1, no
3054957747,  donato_alfiniti, 1, 0, 1, no
2177094569,  ScottoMa, 1, 0, 1, no
107246102,  paolo7891, 1, 0, 1, no
1220896010,  alessan32814990, 6, 0, 6, no
171040838,  robertaestop, 1, 0, 1, no
1259480484,  vecevending, 1, 0, 1, no
2855057866,  mgdicapua, 1, 0, 1, no
577928462,  filippo_maini, 1, 0, 1, no
1048508089,  paolopaolo57, 1, 0, 1, no
980985488,  tercamma, 2, 0, 2, no
2184456353,  BeppeChiappini, 1, 0, 1, no
1122635904,  cmuzzetto, 3, 0, 3, no
2387298926,  caterinacorda1, 1, 0, 1, no
4110680129,  TroiaGiulio, 1, 0, 1, no
4240911946,  Genzicipo, 2, 0, 2, no
55403948,  lucaRiggio, 1, 0, 1, no
525636772,  antoniovinci8, 5, 0, 5, no
631851653,  BabisSpanos, 1, 0, 1, no
408580036,  giankurt, 4, 0, 4, no
304005346,  CoachDade, 1, 0, 1, no
1612919144,  MarcoDarth, 5, 0, 5, no
1219454078,  BruscaSalvatore, 1, 0, 1, no
880754108,  FiumeMarinella, 1, 0, 1, no
800493184363024384,  Michael55024366, 1, 0, 1, no
103596196,  ilmengo, 2, 0, 2, no
391919014,  mikiarny, 1, 0, 1, no
52185645,  massivale, 1, 0, 1, no
2414797352,  pompili43106623, 2, 0, 2, no
120272449,  giusypop, 1, 0, 1, no
2729099096,  teodorogerico, 1, 0, 1, no
554296369,  rickycam78, 1, 0, 1, no
404550647,  gilengil59, 1, 0, 1, no
973576950,  acornacchione1, 1, 0, 1, no
449850313,  PolAlberto, 6, 0, 6, no
457937702,  marer62, 1, 0, 1, no
921591691,  AntnioSenes, 6, 0, 6, no
1035666272,  MattiaFiammengh, 1, 0, 1, no
337869423,  MarinaCeccarel, 1, 0, 1, no
2740845106,  fabriziofabri14, 1, 0, 1, no
1394592542,  giuseppes1967, 1, 0, 1, no
343370530,  leonardocava, 11, 0, 11, no
742616018636406784,  Sabrizav, 1, 0, 1, no
432148641,  calosibilla, 1, 0, 1, no
942042836,  djZioJoe, 1, 0, 1, no
1227817225,  FalconeMf, 1, 0, 1, no
2894418435,  BrunoBSAT, 2, 0, 2, no
359908699,  aquila1962, 1, 0, 1, no
2895742594,  IreneDx1, 1, 0, 1, no
1273161506,  laura151168, 1, 0, 1, no
803322305610940417,  filippo_saggi, 4, 0, 4, no
213408314,  Fa_Pe, 1, 0, 1, no
791374453926166529,  twittemyx, 2, 0, 2, no
2168865698,  achab_1966, 1, 0, 1, no
1225205178,  gianlucagreco74, 1, 0, 1, no
397245294,  gianlucarizzo46, 3, 0, 3, no
177726923,  PokeChubby, 1, 0, 1, no
2186988510,  annaVattucci, 1, 0, 1, no
90902777,  Vagnerd_7, 1, 0, 1, no
500915160,  Terian_Dimmi, 2, 0, 2, no
144557195,  sOoNicola, 1, 0, 1, no
456936722,  condorr72, 2, 0, 2, no
101194334,  Pier_Cannito, 2, 0, 2, no
784116405981544451,  PatriziaBorghi2, 2, 0, 2, no
1849342003,  CarmeloRicupero, 2, 0, 2, no
949767170,  GiustinoAndria, 1, 0, 1, no
1157792384,  scarcozzo, 1, 0, 1, no
258006600,  junkiebba, 1, 0, 1, no
800836660682440705,  FrancescoDeFr17, 1, 0, 1, no
465518198,  StefyBijoux1, 1, 0, 1, no
2385752304,  LenxCamera, 13, 0, 13, no
1380718032,  Digio36, 13, 0, 13, no
2421023606,  Renemargot1, 2, 0, 2, no
1004973133,  Parigino2, 1, 0, 1, no
2708544953,  Paapois, 3, 0, 3, no
729064394567651330,  Frances45444278, 3, 0, 3, no
2361236242,  vincemes70, 1, 0, 1, no
1395049230,  danielariely, 1, 0, 1, no
1351750926,  MonellaSerrenti, 1, 0, 1, no
2402803553,  alessan75956809, 1, 0, 1, no
66783709,  43gabriele, 1, 0, 1, no
1143419132,  musalinoo, 1, 0, 1, no
2948729416,  sissyandtony, 1, 0, 1, no
2504881172,  giotto_62, 3, 0, 3, no
523314125,  daber85, 1, 0, 1, no
432684012,  EmiliaLoscalzo, 1, 0, 1, no
767936783237644292,  ejaculations, 1, 0, 1, no
709985365206106112,  em_bov, 4, 0, 4, no
2910734045,  edilefranchini, 1, 0, 1, no
3014138272,  d1b9e9059f2c493, 1, 0, 1, no
4193789127,  dott_busa, 1, 0, 1, no
3295652280,  afradoc, 1, 0, 1, no
2264476401,  GsalvaSCARFO, 4, 0, 4, no
1113905276,  OreginaMeteo, 3, 0, 3, no
394095897,  ElenaPannyLane, 2, 0, 2, no
970255340,  SantarlasciMaur, 4, 0, 4, no
2688397197,  favapippo, 1, 0, 1, no
2956501541,  BuonaiutoG, 2, 0, 2, no
458445168,  santinimaura, 1, 0, 1, no
3480199816,  Ale_scandone, 1, 0, 1, no
3661485195,  Rituzza60gmail1, 1, 0, 1, no
453964141,  RoberCacchi, 3, 0, 3, no
4105846605,  Fernand58357945, 4, 0, 4, no
451652033,  Alex7Liberti, 1, 0, 1, no
557128044,  Nembomario, 1, 0, 1, no
793610243922071553,  TWezycki, 1, 0, 1, no
2376911012,  M5S_Albairate, 1, 0, 1, no
1456848812,  brucer58, 1, 0, 1, no
757283763797778432,  mariolo16084562, 1, 0, 1, no
429174475,  ascalavido, 1, 0, 1, no
773959279,  LayonNiki, 1, 0, 1, no
3427533177,  rosy_genduso, 1, 0, 1, no
433553500,  frikfrak46, 1, 0, 1, no
447846362,  marcomiccoli1, 3, 0, 3, no
1428729751,  tiavulone, 1, 0, 1, no
3407782672,  Adele35111364, 1, 0, 1, no
222375064,  ilcorriereblog, 2, 0, 2, no
1173006894,  emanueleo73, 1, 0, 1, no
413151078,  MarioZPunterco, 1, 0, 1, no
1698574146,  gladiatore987, 2, 0, 2, no
1621614835,  TommasinAndrea, 1, 0, 1, no
192118395,  baldix2, 3, 0, 3, no
3349971568,  cirascafur, 1, 0, 1, no
418657078,  Nino_Effe, 1, 0, 1, no
2176107184,  Max46Oldmax, 1, 0, 1, no
387511056,  FrancescoSicil1, 1, 0, 1, no
501809742,  raffaelesarnell, 1, 0, 1, no
622317402,  EmmaPrencipe, 1, 0, 1, no
930579210,  mariarosaconca1, 1, 0, 1, no
515171492,  luigibreak, 1, 0, 1, no
251638195,  IURONE, 2, 0, 2, no
488821140,  stefano_mitello, 1, 0, 1, no
785953647188447232,  jelideflow, 1, 0, 1, no
4208849560,  Giusepp31129863, 1, 0, 1, no
265456866,  pacal1973, 1, 0, 1, no
4643004927,  MatteoLeprini, 1, 0, 1, no
1723277772,  antonellabye, 1, 0, 1, no
105277013,  TheSuburbsGuy, 1, 0, 1, no
1370364667,  fulvio_libero, 1, 0, 1, no
546701313,  taita74, 1, 0, 1, no
1102199018,  giuliovodola, 1, 0, 1, no
1457469680,  dani_vallekano, 1, 0, 1, no
2184911833,  biancoelena4, 1, 0, 1, no
1289667200,  Miramaremara, 3, 0, 3, no
764414759261315072,  ApiCelline, 1, 0, 1, no
1314661519,  TiNilde, 1, 0, 1, no
1933565744,  luigimalindi, 1, 0, 1, no
354844811,  Mau_rigno, 1, 0, 1, no
805714518294806528,  sandra_vescovi, 1, 0, 1, no
791735680732913664,  Re_di_Hokuto, 1, 0, 1, no
4699430514,  malumsmile_, 1, 0, 1, no
2383635908,  claudiofastell1, 1, 0, 1, no
915704730,  s_venco, 3, 0, 3, no
3270094128,  backtoWaterloo, 1, 0, 1, no
543291999,  nardomi62, 1, 0, 1, no
2474193206,  SuperChataigne, 2, 0, 2, no
3073086526,  salvecla, 1, 0, 1, no
223748747,  agnosticIT, 1, 0, 1, no
752238344118083584,  Dalila_Verardi, 1, 0, 1, no
872251675,  sbspena, 1, 0, 1, no
3232147305,  bogliascom5s, 1, 0, 1, no
1283820974,  massimo_1955, 1, 0, 1, no
279422631,  sharpbeauty, 1, 0, 1, no
789955010331369472,  ellymcape, 1, 0, 1, no
127595699,  francescavallo, 1, 0, 1, no
2735547946,  contynium73, 1, 0, 1, no
797563370,  mariabevilacqu2, 1, 0, 1, no
378159279,  ianadru, 1, 0, 1, no
489195928,  miccantarella, 1, 0, 1, no
502865342,  leolozito, 1, 0, 1, no
49612888,  AndreasTT, 1, 0, 1, no
47946596,  stringbeanjean0, 1, 0, 1, no
765240828,  LMudadu, 1, 0, 1, no
4899802323,  franca672, 1, 0, 1, no
806057771468734464,  otreblic, 1, 0, 1, no
392730397,  Skardosa, 1, 0, 1, no
2359996649,  Fo11Maini, 1, 0, 1, no
3031058761,  tonio9191, 1, 0, 1, no
722161837383540736,  LovableCaro, 1, 0, 1, no
2324857372,  danymo54, 1, 0, 1, no
366135277,  4gattiaroma, 1, 0, 1, no
430599289,  TurkoYeah, 1, 0, 1, no
513184347,  Bono1952, 1, 0, 1, no
426958299,  Salvo7676, 2, 0, 2, no
484220471,  Gio_Cecchinato, 1, 0, 1, no
4632995241,  AndreaStimilli, 1, 0, 1, no
2359157445,  giacchetti2000, 1, 0, 1, no
267966135,  NatalinaFarano, 1, 0, 1, no
803312587362496518,  Diego_Modenini, 1, 0, 1, no
4768174949,  ujonathan70, 1, 0, 1, no
4124138679,  GerBa73, 1, 0, 1, no
210389532,  mysteven66, 1, 0, 1, no
400904268,  PINUCCI0, 4, 0, 4, no
369179336,  diegoscognamigl, 2, 0, 2, no
1368850908,  FMCastaldo, 9, 0, 9, no
758299566093500416,  Miskokovac, 2, 0, 2, no
782264091389857792,  frrslv, 1, 0, 1, no
756143225165840388,  Alessan97411423, 1, 0, 1, no
804000933994786816,  Bellunum, 1, 0, 1, no
802932138601484288,  pietropolara, 2, 0, 2, no
4105723264,  maopasquinelli, 2, 0, 2, no
1386409051,  simoneb57, 1, 0, 1, no
1108513123,  Duke_LetoII, 1, 0, 1, no
3301844175,  _alberto_bosco_, 1, 0, 1, no
2418898621,  cristin62471285, 1, 0, 1, no
3004063252,  MelloniManuele, 1, 0, 1, no
1114383950,  pasqualesanto11, 1, 0, 1, no
3156492300,  Antony28776432, 1, 0, 1, no
2738783405,  mauro_ebe, 1, 0, 1, no
729776809575907329,  borgo_grazia, 1, 0, 1, no
135932493,  DjMorsan, 1, 0, 1, no
382304436,  uomodipace, 1, 0, 1, no
599219874,  GILAS60, 4, 0, 4, no
73420263,  micverde, 3, 0, 3, no
629274064,  kekkolett, 1, 0, 1, no
471975571,  marlon1340, 1, 0, 1, no
773533953521311744,  JonathanKrist77, 2, 0, 2, no
377374276,  camelvino, 3, 0, 3, no
3385590159,  777s777s, 2, 0, 2, no
2169507597,  BrosioG, 1, 0, 1, no
148723959,  Turi1982, 1, 0, 1, no
1515980365,  domi732013, 3, 0, 3, no
2557144432,  PietroRubini, 1, 0, 1, no
475578901,  fabrirusso68, 1, 0, 1, no
489735587,  LorenzoMalevolt, 1, 0, 1, no
791943046396940288,  AngelaPanella65, 2, 0, 2, no
397554898,  DomenicaVerrico, 1, 0, 1, no
3135198681,  pratesi_s, 1, 0, 1, no
3336603742,  AndreaVerza15, 1, 0, 1, no
703606661412474887,  StaniMesisca, 1, 0, 1, no
448750282,  adlucc, 1, 0, 1, no
1082407140,  Teach8686, 1, 0, 1, no
2614227554,  vuoisaperedi, 10, 0, 10, no
760387692958015488,  SIMONA14084790, 3, 0, 3, no
2837988653,  SilvyRossini, 1, 0, 1, no
710521199584006144,  ilacqua_franco, 4, 0, 4, no
475577032,  ceratiandrea, 3, 0, 3, no
353666078,  conte_maria, 2, 0, 2, no
3069465819,  aleandrozeccas1, 1, 0, 1, no
361809583,  LorettaPasta, 1, 0, 1, no
48066008,  bacao, 1, 0, 1, no
2245355560,  AngeloPolly, 1, 0, 1, no
625802529,  Gospodimilostiv, 4, 0, 4, no
2860048756,  ageloj26, 1, 0, 1, no
81296978,  lujatube, 1, 0, 1, no
139831560,  Max_Ragusa, 1, 0, 1, no
487463041,  RossanaDonati, 1, 0, 1, no
1039599080,  Cimabue_, 1, 0, 1, no
4164602849,  ArmenioMaria57, 1, 0, 1, no
762337563025760257,  chiesarena3, 3, 0, 3, no
116685125,  almascien, 3, 0, 3, no
2183161219,  moviradiotwitt, 3, 0, 3, no
3084210021,  AielliRiccardo, 1, 0, 1, no
778938594622894080,  roby1761, 1, 0, 1, no
372760787,  giughost, 1, 0, 1, no
1437581690,  enzagianna, 1, 0, 1, no
396513566,  muffatoandrea, 1, 0, 1, no
793909945351700481,  cloman849, 1, 0, 1, no
157131465,  Argo16, 1, 0, 1, no
33039034,  cod4anto, 1, 0, 1, no
991309093,  CristinaRulfi, 1, 0, 1, no
375709660,  Loredanarossone, 2, 0, 2, no
198832735,  AlessioLoGaglio, 1, 0, 1, no
330490956,  franco4574, 1, 0, 1, no
745659215881076736,  IlariaAndreucc1, 1, 0, 1, no
254076311,  Quortshirts, 2, 0, 2, no
801505964633554944,  MatteoGabucci12, 1, 0, 1, no
2262944341,  rosalella_, 1, 0, 1, no
418048339,  andrevr46, 3, 0, 3, no
124132193,  ninodiberardino, 1, 0, 1, no
705820717556834304,  Frances55205713, 2, 0, 2, no
473128255,  steoscali, 1, 0, 1, no
378014511,  campipaolo, 3, 0, 3, no
1262709276,  francescosapia3, 2, 0, 2, no
544424960,  nesrinkiziltepe, 2, 0, 2, no
221786542,  MassimoBugani, 1, 0, 1, no
4863973245,  AntonioPerrel12, 1, 0, 1, no
791658298521055232,  Silvio01239757, 1, 0, 1, no
785240677466644482,  onlypipa, 1, 0, 1, no
505924362,  ElyDen1, 1, 0, 1, no
72777391,  space_lord_mofo, 1, 0, 1, no
428423623,  IOLANDADOCIMO, 1, 0, 1, no
2359562326,  Enr1coVallarola, 2, 0, 2, no
794500668027445248,  matteongnt71, 1, 0, 1, no
2786973323,  BroggiElisa, 1, 0, 1, no
804261576761081860,  LinguaFraFranca, 1, 0, 1, no
3535552281,  guidosky38, 1, 0, 1, no
5593172,  saneirot, 1, 0, 1, no
411849829,  holealienonvolo, 1, 0, 1, no
2896487589,  traverso1234, 3, 0, 3, no
2748826143,  MirtaMirmilla, 3, 0, 3, no
707281602351648769,  albertom5storo, 2, 0, 2, no
541659611,  dangul81, 2, 0, 2, no
2332191414,  Franckorlando69, 1, 0, 1, no
15144611,  gianlucasassi, 3, 0, 3, no
609167584,  niclapodesta, 2, 0, 2, no
265348883,  AronBoele, 1, 0, 1, no
237392330,  marco11985, 20, 0, 20, no
4898162783,  tiffano1983, 4, 0, 4, no
374499857,  TheLordSeth, 2, 0, 2, no
421302747,  GiancarloRizzo, 2, 0, 2, no
3053205142,  MicheleVincigu8, 1, 0, 1, no
770519510138941440,  ciuef, 1, 0, 1, no
2223169266,  DonJoseLaSida, 3, 0, 3, no
205888140,  mr_kaizen, 1, 0, 1, no
802218277372039168,  ElBona67, 1, 0, 1, no
260683267,  sordacchione, 1, 0, 1, no
1943352259,  Danaesse, 2, 0, 2, no
800240133974855680,  ComeCazzoTePare, 1, 0, 1, no
1278210284,  Ale_C_Carrozzo, 1, 0, 1, no
761449763296477184,  GiuseppeAdaglio, 1, 0, 1, no
417094749,  titanokid, 4, 0, 4, no
703020132,  ia08773, 1, 0, 1, no
1225018712,  pierlu_73, 2, 0, 2, no
703019927,  FrancescoVlad, 1, 0, 1, no
3715386076,  pica_emanuele, 1, 0, 1, no
1201564051,  CinquiniC, 1, 0, 1, no
1142989243,  Fr2174, 1, 0, 1, no
800743787068735488,  Vet_RMaffey, 3, 0, 3, no
2389413932,  Megalommatis, 1, 0, 1, no
1588631677,  sghiso79, 1, 0, 1, no
801542736222572544,  jurycesar1, 1, 0, 1, no
2508021147,  Toniapatty, 1, 0, 1, no
2546713458,  EDYDIBONITO, 3, 0, 3, no
2277860888,  GiusGiuliani, 1, 0, 1, no
425276399,  MapleRedFire, 1, 0, 1, no
1355401399,  LUCIANOPANGALLO, 1, 0, 1, no
253135962,  MarcoBrollo, 1, 0, 1, no
236523500,  FrancescaBudano, 1, 0, 1, no
36307715,  ilSarty, 1, 0, 1, no
2709338195,  AVannello, 1, 0, 1, no
716598542572396544,  Luana22939585, 1, 0, 1, no
793933362582978561,  EnzoD84, 1, 0, 1, no
914564990,  GabrieleBatoni, 2, 0, 2, no
800707848191647744,  beautifulboat, 1, 0, 1, no
423281726,  bobocraxi, 2, 0, 2, no
472404545,  paoloemb, 1, 0, 1, no
700733903372492800,  bennypll, 1, 0, 1, no
529790138,  pgborgini, 1, 0, 1, no
272961989,  Pierber2011, 1, 0, 1, no
2376774356,  sidney08507633, 1, 0, 1, no
305830378,  DanielePiazza2, 1, 0, 1, no
498975787,  Fox74ita, 1, 0, 1, no
625969647,  MayerNorbert, 1, 0, 1, no
892687952,  GiorgioDeCagna, 1, 0, 1, no
1618737265,  89londoner, 1, 0, 1, no
255085427,  iFulvo, 1, 0, 1, no
1395987182,  xgianc, 1, 0, 1, no
380371435,  lorelay_868, 1, 0, 1, no
313401706,  Mirko1971m, 1, 0, 1, no
591598115,  prosperi_andrea, 3, 0, 3, no
3222530686,  ZardoElisa, 1, 0, 1, no
789845752910647296,  63Pegh, 1, 0, 1, no
958529605,  roberto251960, 1, 0, 1, no
1300769053,  1959martina1111, 1, 0, 1, no
516238138,  leliozeta, 3, 0, 3, no
440207914,  Atenaide_Arpone, 2, 0, 2, no
785405593330802688,  Daniela46309541, 2, 0, 2, no
58159094,  JackMariner, 1, 0, 1, no
217634365,  IcqusIxoye, 1, 0, 1, no
792133535024967680,  Angelo51250826, 1, 0, 1, no
796123967853654020,  MaternityVictor, 1, 0, 1, no
2971880133,  giovannidipiaz1, 1, 0, 1, no
1035009296,  47_nunzio, 1, 0, 1, no
2809802006,  Miky796, 1, 0, 1, no
1114722992,  Paxpartout, 2, 0, 2, no
729253554196713472,  RaffaeleViscone, 1, 0, 1, no
791946392981745666,  DiariPolitici, 1, 0, 1, no
52773121,  Geromedia, 1, 0, 1, no
797186498911203328,  giodaez, 1, 0, 1, no
716631504,  SuteraAngela, 4, 0, 4, no
574403169,  rosalb64, 1, 0, 1, no
419084673,  Alesciamano, 1, 0, 1, no
582111037,  Michele4mento, 1, 0, 1, no
497263437,  natachaartdecor, 1, 0, 1, no
2293711096,  Angelopaxia, 1, 0, 1, no
1140566040,  vivianalomonaco, 1, 0, 1, no
1548457902,  M5S_Veneto, 1, 0, 1, no
140116780,  _WinstonWolf, 1, 0, 1, no
1322244361,  Giulucantoni, 1, 0, 1, no
383311383,  LFlorimonte, 1, 0, 1, no
802878612521226240,  adricanarelli, 1, 0, 1, no
2472041283,  SianoAngelo, 1, 0, 1, no
488369670,  nicolacioffo1, 3, 0, 3, no
791356702977323008,  LisantiLuca, 1, 0, 1, no
144128481,  pickwick80, 1, 0, 1, no
732678450,  giocle1, 1, 0, 1, no
408676382,  fioro78, 1, 0, 1, no
2273421414,  SCHIAVONEAMALIA, 1, 0, 1, no
703295272265367552,  neviolino75, 2, 0, 2, no
2207978535,  MarinellaNap, 1, 0, 1, no
576369057,  massimo15691, 1, 0, 1, no
754718657880678400,  maximilianthegr, 2, 0, 2, no
1857194689,  ilmietitore85, 3, 0, 3, no
296179562,  Andrea3_t, 2, 0, 2, no
4032603616,  sim1ste, 1, 0, 1, no
4076933254,  mauriziomadaro1, 2, 0, 2, no
784679732034080768,  Mik21132626, 1, 0, 1, no
571914703,  gygi77, 1, 0, 1, no
1314728936,  NicolaMorra63, 2, 0, 2, no
3065216445,  Dr____Nash, 1, 0, 1, no
801396324428038144,  statesereni, 1, 0, 1, no
2798763527,  daniea_daniela, 2, 0, 2, no
169042404,  ClaudioVING, 1, 0, 1, no
728850746871971840,  mika0275109112, 1, 0, 1, no
143576761,  mekengi, 1, 0, 1, no
763349615458578433,  f166cbda35e34f7, 1, 0, 1, no
58478445,  fraff1, 1, 0, 1, no
538300806,  stefanolisci, 1, 0, 1, no
2179447205,  ghito49, 1, 0, 1, no
47969711,  gabriella_roux, 3, 0, 3, no
1464976362,  Pedro_Maria88, 1, 0, 1, no
1477131018,  fabrimoon, 2, 0, 2, no
803648232144433152,  Mariate93357083, 1, 0, 1, no
1627601215,  FrancoDiGiammar, 1, 0, 1, no
124236178,  GianlucaVacca, 7, 0, 7, no
1142647476,  robiflash61, 2, 0, 2, no
541988677,  claudiosimeoni, 2, 0, 2, no
788744375249633284,  nonnabrigitta, 2, 0, 2, no
526213147,  maurybonazzi, 2, 0, 2, no
3434287768,  Buio99, 1, 0, 1, no
182113694,  francyguff, 1, 0, 1, no
2331775274,  antonino3531967, 1, 0, 1, no
2978361604,  emacat3, 1, 0, 1, no
3075282753,  ArgieriEllen, 2, 0, 2, no
795324018178093056,  VikiVitt60, 1, 0, 1, no
159412548,  MaxCaramazza, 1, 0, 1, no
1092248448,  TCaldarella, 1, 0, 1, no
1236535783,  giacomo_carso, 1, 0, 1, no
3321758853,  nella125830, 1, 0, 1, no
229884867,  EliGiova74, 2, 0, 2, no
39018914,  belacivetta, 1, 0, 1, no
1555166234,  c_cangiano, 1, 0, 1, no
558110892,  IvanoRipani, 1, 0, 1, no
2320504019,  giando1962, 1, 0, 1, no
804119991524225024,  satiricamento, 1, 0, 1, no
425391665,  Braluc81, 1, 0, 1, no
1412775048,  paperopoli2003, 1, 0, 1, no
2219545025,  missioni0, 2, 0, 2, no
3126534947,  CeliLid, 1, 0, 1, no
621383690,  NapoGi17, 1, 0, 1, no
277015964,  Caru88, 2, 0, 2, no
449717780,  MariaDFonti, 4, 0, 4, no
1862886032,  enzoromanovr, 1, 0, 1, no
1861652984,  EugenioVerdinel, 2, 0, 2, no
3295023377,  salviccio60, 1, 0, 1, no
3410355807,  LorisBergamini, 2, 0, 2, no
2178130104,  pepgatto, 2, 0, 2, no
747583665056718848,  sperandiomario1, 3, 0, 3, no
79287190,  Scardreamer, 1, 0, 1, no
180005622,  Antonio180760, 1, 0, 1, no
315687815,  LuisBelvedere, 1, 0, 1, no
798202174190866432,  bruno76533638, 3, 0, 3, no
772770225670459392,  recchiabellisa1, 1, 0, 1, no
2414683945,  Sergiodp69, 2, 0, 2, no
804497097869393920,  GianpietroFagg2, 1, 0, 1, no
800421412682874882,  Riccardo0972, 2, 0, 2, no
2169042164,  AglDall, 1, 0, 1, no
902519029,  ilbonzaturatti7, 1, 0, 1, no
922906549,  FabioMaritano, 1, 0, 1, no
3433975120,  FF28_11, 1, 0, 1, no
741570412895739904,  rivoli111, 1, 0, 1, no
2974399810,  AntoSoraggi, 1, 0, 1, no
181684018,  renatodelledonn, 1, 0, 1, no
1662108194,  KnzKunz, 8, 0, 8, no
2720575342,  CrBarbarini, 1, 0, 1, no
234291821,  miriagenga, 2, 0, 2, no
256627292,  MickyNardella, 1, 0, 1, no
3940078893,  morgan_lelii, 1, 0, 1, no
702804571656167428,  antfasan, 1, 0, 1, no
2680186468,  rosadamato634, 1, 0, 1, no
4845019959,  feelzena, 1, 0, 1, no
222436482,  ToscanAntiqua, 1, 0, 1, no
3064716183,  AthelstBeard, 1, 0, 1, no
2969699331,  ravera_fernando, 1, 0, 1, no
429910422,  LelloChiarello, 1, 0, 1, no
149054148,  zazzetto, 2, 0, 2, no
171690967,  G_net75, 2, 0, 2, no
360485722,  Vanganel, 2, 0, 2, no
200661860,  RubinoMauro, 1, 0, 1, no
2733575715,  mr_1516, 1, 0, 1, no
3182766357,  Domenic32826810, 1, 0, 1, no
441233690,  giannicocozza, 2, 0, 2, no
711589458529882113,  gennysiervo, 2, 0, 2, no
71031958,  Bailardo, 2, 0, 2, no
3233888700,  TommyCinisello, 2, 0, 2, no
2830095710,  safarandola, 2, 0, 2, no
16145985,  Giorgiolaporta, 1, 0, 1, no
799265737202405376,  brossdjtop, 2, 0, 2, no
3130683383,  umbimilot, 1, 0, 1, no
802606702805876736,  robertinakkk, 1, 0, 1, no
236350643,  renataortolani, 1, 0, 1, no
163103141,  andreserant, 1, 0, 1, no
913545247,  fraccomoda, 2, 0, 2, no
2512542022,  ABombardino, 1, 0, 1, no
23920614,  Gasinfo, 1, 0, 1, no
1367962406,  argonauuta, 1, 0, 1, no
35176190,  journeyman2009, 1, 0, 1, no
781955788130684928,  Silva900000, 1, 0, 1, no
347122369,  NickSloth, 1, 0, 1, no
335331575,  gabry969, 1, 0, 1, no
412601910,  maxcolt64, 3, 0, 3, no
506221043,  GiovanniTamburi, 3, 0, 3, no
2376808347,  StranoAlex, 1, 0, 1, no
425682891,  FMoscarella, 1, 0, 1, no
756230260971012096,  EleonoraMeloni7, 1, 0, 1, no
762341424310411265,  armerino72, 1, 0, 1, no
420255846,  AntonioFlorio3, 1, 0, 1, no
354780310,  PinoSica, 1, 0, 1, no
2942129068,  Luciana81715565, 1, 0, 1, no
2188026987,  DarioCirillo8, 1, 0, 1, no
3547995913,  mesho2244551, 1, 0, 1, no
804245492959952896,  robertavivi21, 1, 0, 1, no
421052754,  matteog82, 1, 0, 1, no
738067590212378624,  giulioscavonge1, 1, 0, 1, no
609406199,  luca_danese, 1, 0, 1, no
880434931,  ferrettideluca, 1, 0, 1, no
2880024419,  lazzareschideb1, 1, 0, 1, no
1458010693,  HuckFra, 2, 0, 2, no
2266309267,  DepalmasM, 4, 0, 4, no
4170375988,  EnricaGrassi75, 3, 0, 3, no
132833937,  alescan86, 1, 0, 1, no
172278444,  i_essio, 1, 0, 1, no
1154188134,  Alice1Salvatore, 1, 0, 1, no
409819035,  AimeAlessandro, 2, 0, 2, no
456664059,  snulfo, 1, 0, 1, no
442615473,  Max_Ruffoni, 1, 0, 1, no
1280950585,  MoloroseT, 4, 0, 4, no
363629679,  VeroRPederzani7, 1, 0, 1, no
221066689,  cinci04, 1, 0, 1, no
3918540497,  giuseppe2125, 1, 0, 1, no
801323798716968960,  Miriam91332749, 1, 0, 1, no
398542406,  Finez27, 1, 0, 1, no
495275440,  Alberto__San, 1, 0, 1, no
402658881,  ema_astolfi, 1, 0, 1, no
704071958951022592,  Massimi28477096, 1, 0, 1, no
2763812068,  peppe_trapani, 3, 0, 3, no
1037212327,  antoninodurzo, 1, 0, 1, no
415473030,  CostantinoNr1, 1, 0, 1, no
800721722123034624,  prestera_arta, 1, 0, 1, no
882495276,  rcentaz, 1, 0, 1, no
28571384,  blueskyinmind, 1, 0, 1, no
390665502,  martino_marco, 1, 0, 1, no
801388615175700480,  pastaesuriaca, 1, 0, 1, no
141258073,  tartavilma, 1, 0, 1, no
791224292918919169,  redegliscacchi, 1, 0, 1, no
460933532,  albagamba72, 1, 0, 1, no
3130803092,  7804Simo, 1, 0, 1, no
3243124235,  ForesiMarco, 1, 0, 1, no
717762449886355456,  Domenic15675431, 2, 0, 2, no
1077066470,  tapisiglav, 1, 0, 1, no
432704179,  CorradinStefano, 1, 0, 1, no
761697672789098496,  obsoleto___, 1, 0, 1, no
4507733613,  LupinSettimo, 1, 0, 1, no
3065784040,  smoothgirl10, 1, 0, 1, no
185794895,  alessandro_972, 4, 0, 4, no
2979884158,  CondinaIt, 2, 0, 2, no
772075962938908672,  paganoantonio59, 1, 0, 1, no
803119207256883200,  Alessandro7111, 3, 0, 3, no
497797578,  PaolaTavernaM5S, 1, 0, 1, no
527584702,  ellechianti, 1, 0, 1, no
62003557,  vitocrimi, 1, 0, 1, no
801016452455219200,  MoreferarumClan, 1, 0, 1, no
33914149,  smothc, 1, 0, 1, no
4358295022,  PietroManca7, 1, 0, 1, no
2949224753,  bepitosin58, 1, 0, 1, no
483145404,  marchese413, 1, 0, 1, no
480251724,  DegaMau, 1, 0, 1, no
4196781983,  GiuseppeSilvag2, 1, 0, 1, no
785540780568014849,  SergioGuido8, 1, 0, 1, no
353115688,  paolo_buda, 1, 0, 1, no
1157677256,  lollo94Lfgl, 1, 0, 1, no
1431408690,  LauraVlasic, 2, 0, 2, no
1474111062,  cirosellini, 1, 0, 1, no
89407105,  amxstudio, 1, 0, 1, no
766261457881337856,  Db00201_, 2, 0, 2, no
612470382,  ilCriticante, 1, 0, 1, no
754774133796433920,  maistrak70, 1, 0, 1, no
549205128,  bernardi94c, 1, 0, 1, no
2824584058,  Kaio1987, 1, 0, 1, no
506003067,  Zebra73Curci, 1, 0, 1, no
140975577,  ttt6988, 2, 1, 1, neutral
328916356,  StefanoLuzi, 1, 0, 1, no
738811488,  BargiggiaFranco, 1, 0, 1, no
4853428299,  amanojayana, 3, 0, 3, no
710085412577026048,  Carmelo2980, 1, 0, 1, no
773134022369275904,  renato_battisti, 2, 0, 2, no
426978385,  MastrodonatoR, 3, 0, 3, no
1031049613,  Ross23Stefano, 1, 0, 1, no
792422546813620228,  Rossell69382168, 1, 0, 1, no
4441012180,  Massimo22213339, 1, 0, 1, no
2989954665,  FabrizioNoli, 1, 0, 1, no
396831702,  PeddRaam, 1, 0, 1, no
784721199838457856,  NewForEverybody, 1, 0, 1, no
276230660,  wenceslao71, 1, 0, 1, no
411696442,  biancalaura70, 1, 0, 1, no
534057893,  micheleprincip1, 2, 0, 2, no
585475210,  Barbi58C, 4, 0, 4, no
1282619952,  peppe76giuseppe, 1, 0, 1, no
275993167,  darkshad0w, 1, 0, 1, no
3064476580,  davidetiro82, 4, 0, 4, no
4174051582,  monipo71, 1, 0, 1, no
3064862597,  abarone_barone, 1, 0, 1, no
771761141295026177,  s4Xswb0Pv5fmonS, 1, 0, 1, no
994012712,  AngeloScavone, 1, 0, 1, no
2879187077,  giovannipetruc9, 1, 0, 1, no
29190332,  caldozza, 1, 0, 1, no
477639684,  Danielem5s, 1, 0, 1, no
704976168525668352,  JTeesdale1, 1, 0, 1, no
17836555,  mummygirl, 3, 0, 3, no
383563779,  poviapaola, 1, 0, 1, no
2719953051,  sabribellucci, 1, 0, 1, no
3187495264,  marce67e, 1, 0, 1, no
1305316945,  FraAndreozzi, 2, 0, 2, no
291683439,  Frexitrump, 1, 0, 1, no
724687182653480960,  MalataDi, 2, 0, 2, no
1360108453,  rhysgrinstead, 1, 0, 1, no
47696186,  joliemaman, 1, 0, 1, no
798740533,  virgy_bieber15, 2, 0, 2, no
1419002360,  JonasMartelli, 1, 0, 1, no
1010705413,  JuanyGar63, 1, 0, 1, no
448332490,  Lluisgarciacala, 1, 0, 1, no
149141687,  Andy__80, 1, 0, 1, no
3303076979,  BlackLilium87, 1, 0, 1, no
1882934695,  dreihochneun, 1, 0, 1, no
741972779499720704,  maxpalax80, 1, 0, 1, no
580692065,  ElenaIncarnato, 2, 0, 2, no
802833038220677120,  _simonad, 1, 0, 1, no
437480927,  GiuDayLorDie, 1, 0, 1, no
367592425,  CICCIOSF, 1, 0, 1, no
1548525307,  efsi2365, 1, 0, 1, no
27302295,  derossimichele, 1, 0, 1, no
753591304886579200,  sacchetti_paola, 1, 0, 1, no
2272299786,  Freedom_4_GB, 1, 0, 1, no
2716880374,  sabrinaomar8, 1, 0, 1, no
4794808410,  tanino756, 4, 0, 4, no
805706453608701953,  PietroMorielli, 1, 0, 1, no
2900973699,  Martinodissiden, 1, 0, 1, no
365420803,  new__luca93, 2, 0, 2, no
1448085942,  EufraboEugenio, 1, 0, 1, no
588424885,  gargano5stelle, 2, 0, 2, no
569817587,  RobotGufo, 5, 4, 1, yes
785397787995303936,  mastro9610, 1, 0, 1, no
1491291140,  Magi88Alex, 1, 0, 1, no
254508514,  EmmeCity, 1, 0, 1, no
564628722,  dariodedi, 1, 0, 1, no
15098906,  darkfender, 1, 0, 1, no
4427347264,  xbiebsvoice, 1, 0, 1, no
978547374,  GiusyTartamella, 1, 0, 1, no
302506591,  consuelo_lopez, 2, 0, 2, no
2330261468,  sfnlcd, 2, 0, 2, no
480451727,  kriofed, 1, 0, 1, no
393383204,  Cecetto_, 1, 0, 1, no
2945843549,  Bisca68Lucio, 1, 0, 1, no
1035351402,  f_bertaglia, 1, 0, 1, no
470824201,  Geraldina56, 1, 0, 1, no
1026730362,  DanielPaun23, 1, 0, 1, no
2215711553,  berry15465, 1, 0, 1, no
2937411783,  Sony91S, 2, 0, 2, no
760571713553858560,  MardyTC, 1, 0, 1, no
469248451,  Fausto1311, 1, 0, 1, no
161060415,  IngritDauti, 1, 0, 1, no
21039204,  joeypurple, 1, 0, 1, no
361378885,  jonsindreu, 1, 0, 1, no
367785617,  GBordieri, 1, 0, 1, no
185810059,  IvanLeoDomine, 1, 0, 1, no
407817837,  LatinaGaia, 2, 0, 2, no
2733212308,  EricYesyev, 1, 0, 1, no
4824182254,  atodotrapo, 1, 0, 1, no
335246224,  luca_surace, 1, 0, 1, no
124651309,  normacarballo, 1, 0, 1, no
135922191,  susveray28, 1, 0, 1, no
101053662,  marcigliano, 1, 0, 1, no
485569820,  SemeriaMarco, 3, 1, 2, no
4881041223,  Trix69Luisma, 1, 0, 1, no
536285838,  CRoggiero, 1, 0, 1, no
1351595492,  jeffs_araujo35, 1, 0, 1, no
2472367403,  TirelliMirella, 1, 0, 1, no
2272851296,  M5Sestero, 1, 0, 1, no
564217156,  lucman60, 1, 0, 1, no
1607062016,  InfoDalParlam5S, 1, 0, 1, no
385007356,  Zenoborean, 1, 0, 1, no
81867518,  Resistance2_0, 1, 0, 1, no
770995119185076224,  margheazzurra74, 2, 0, 2, no
62270930,  frankaguido, 1, 0, 1, no
502201170,  acab2372, 1, 0, 1, no
4853162061,  michelatommaso2, 1, 0, 1, no
100795724,  david_ld, 1, 0, 1, no
224799449,  k0r3nd, 1, 0, 1, no
397943480,  AnnaGiacovazzo, 1, 0, 1, no
285144362,  rentaquill, 1, 0, 1, no
805731798512795648,  crozzoli_andrea, 1, 0, 1, no
720349689808293888,  GiovanniGiuber1, 1, 0, 1, no
1052614238,  gabcillo, 1, 0, 1, no
1091488650,  PozzifPozzi, 2, 0, 2, no
792334186057170944,  Emanuela310770, 1, 0, 1, no
3400136117,  RenatoMilanesi, 1, 0, 1, no
1564068662,  alisiaderi, 2, 0, 2, no
4824901653,  leogiubila, 9, 0, 9, no
866491718,  giancarmine4, 1, 0, 1, no
363618910,  marellamitica, 1, 0, 1, no
84534810,  _DiLeZ_, 1, 0, 1, no
1274322852,  UmbVass, 1, 0, 1, no
469694002,  agroasx, 1, 0, 1, no
591009919,  ciunciullai, 3, 0, 3, no
2980871206,  MassaRomano, 3, 0, 3, no
194270726,  aequano, 1, 0, 1, no
4004573717,  M5SArezzo, 1, 0, 1, no
143805886,  GianlucaGodani, 1, 0, 1, no
1159625930,  ClaudioPiuri, 1, 0, 1, no
446495082,  francescomusell, 1, 0, 1, no
1665392198,  giudici60, 1, 0, 1, no
4738694260,  snarkbubble, 1, 0, 1, no
1011390390,  alessandrogiro5, 2, 0, 2, no
2882381601,  LorenzoSarmi13, 1, 0, 1, no
237448162,  ElisabettaBoop, 1, 0, 1, no
430697740,  Bissi99, 1, 0, 1, no
476866628,  pipposcifo1, 2, 0, 2, no
210876091,  soniabouzas, 1, 0, 1, no
1004883073,  danieledem75, 1, 0, 1, no
1900091946,  Anto70Croce, 1, 0, 1, no
770748061,  IlGio85, 1, 0, 1, no
2906329295,  magnanimarco8, 1, 0, 1, no
2383408304,  lauralamaletto1, 1, 0, 1, no
165968066,  _MHofmeister, 1, 0, 1, no
803358237441527809,  SeveTheRino, 1, 0, 1, no
802858978988457984,  Raptor_2024, 1, 0, 1, no
104129726,  VanessaEffect, 1, 0, 1, no
1275867079,  gabrielmarin82, 1, 0, 1, no
2613431981,  lucacardarelli5, 1, 0, 1, no
801916664426205185,  mockasmagazine, 1, 0, 1, no
976823918,  micheledelgobbo, 1, 0, 1, no
2582843789,  79Carrozza, 1, 0, 1, no
3395736707,  pina_mancarella, 2, 0, 2, no
918459463,  maxsabatini5, 1, 0, 1, no
1217871432,  liviobordone, 1, 0, 1, no
4461419740,  cleziano72, 1, 0, 1, no
1008697176,  ivanozecchino, 1, 0, 1, no
157801847,  ayelenoliva, 1, 0, 1, no
1884357642,  M5SBellinzago, 1, 0, 1, no
3172387397,  DavideMardegan, 1, 0, 1, no
705968575,  locvnguyen1, 1, 0, 1, no
2574236356,  Valina_slide, 1, 0, 1, no
413972552,  antartleo, 1, 0, 1, no
714921875789504513,  madalina_solo, 1, 0, 1, no
2294223179,  lumo82, 1, 0, 1, no
1729631174,  rossi_2016, 1, 0, 1, no
4134176566,  Dick_Berts, 1, 0, 1, no
722460614858260480,  silvano1149, 1, 0, 1, no
471057183,  peterofgoos, 2, 0, 2, no
716688712579489792,  ChuckLN1, 1, 0, 1, no
2878110759,  FranFratt7, 1, 0, 1, no
1142397870,  lavocedelcarro, 1, 0, 1, no
802878390357426176,  CharryMayles06, 1, 0, 1, no
3457666769,  lucylla73, 1, 0, 1, no
402887931,  phillipmicallef, 1, 0, 1, no
2281953847,  CDHVDS, 1, 0, 1, no
212496035,  marcello57, 1, 0, 1, no
2519063076,  tammywalt61, 1, 0, 1, no
3152403305,  petti97, 1, 0, 1, no
2361814984,  lanicoseio, 4, 0, 4, no
3037264439,  carlomascia8111, 1, 0, 1, no
461026785,  attilabian, 1, 0, 1, no
741721091723415552,  RobertoTonell11, 1, 0, 1, no
802487031121244160,  gelmas1, 1, 0, 1, no
93462521,  polkiev, 1, 0, 1, no
2540241518,  BucetiPaola, 1, 0, 1, no
4817816537,  mirkosansone98, 1, 0, 1, no
471491176,  LucaMorass, 2, 0, 2, no
23785829,  gianlucazandini, 2, 0, 2, no
405467369,  ChristianCangia, 1, 0, 1, no
486411760,  BeatriceSavasta, 1, 0, 1, no
905847060,  MaclukAir, 4, 0, 4, no
398987806,  giummy67, 3, 0, 3, no
1039713476,  iarsetiem, 1, 0, 1, no
548515058,  udei194, 1, 0, 1, no
2242921584,  enzobuk1967, 1, 0, 1, no
4685894052,  LaStrega1974, 1, 0, 1, no
160255385,  MarcelloFoa, 1, 0, 1, no
442665187,  giovannatosi, 1, 0, 1, no
189555728,  LourdesTrenado, 1, 0, 1, no
4827701787,  salvomatarazzo, 1, 0, 1, no
291202396,  RealLosky, 1, 0, 1, no
792271702117982208,  GloriaDoneda, 1, 0, 1, no
521484394,  SilviaS71, 4, 0, 4, no
44611280,  VincenzoSorus, 2, 0, 2, no
2704713284,  lorenzo_calisti, 1, 0, 1, no
790650964004970496,  luciatara30, 3, 0, 3, no
409526553,  AlexGalazzi, 1, 0, 1, no
204471980,  edemo1500, 2, 0, 2, no
561268870,  HankSantarelli, 1, 0, 1, no
499780097,  DanieleVitturi, 1, 0, 1, no
841600790,  Disincanto_, 1, 0, 1, no
409370677,  CatiaS5, 1, 0, 1, no
60006673,  jaraparilla, 1, 0, 1, no
805376249468252161,  ChrisDringoli, 1, 0, 1, no
2263688823,  vitoleri, 1, 0, 1, no
2508141822,  elisina1986, 1, 0, 1, no
847540710,  SimoneAllegrini, 1, 0, 1, no
31666323,  MadonnaDP, 1, 0, 1, no
479804548,  patrytorto, 2, 0, 2, no
279130207,  agazzotto, 10, 0, 10, no
440145254,  MagicNaples1926, 1, 0, 1, no
710436342,  aldobagnialdo, 1, 0, 1, no
545965916,  SavinoPetilli, 1, 0, 1, no
90998435,  NapoliCalcioNET, 1, 0, 1, no
3244880728,  anonye2222, 1, 0, 1, no
800058792197193728,  fiammyp74, 2, 0, 2, no
1848105750,  Linus74Angelini, 1, 0, 1, no
105074240,  bollino79, 3, 0, 3, no
611802120,  PeppeProvenza, 1, 0, 1, no
314828018,  monograficotwit, 2, 0, 2, no
3247971833,  EnricoCelio, 1, 0, 1, no
805580926868717569,  GuglielmoMohi, 1, 0, 1, no
325423122,  julia_panna, 1, 0, 1, no
493564644,  sigilama66, 1, 0, 1, no
357402742,  marco22882, 1, 0, 1, no
2401210895,  AlgeriElena, 1, 0, 1, no
348125702,  florylulucia, 1, 0, 1, no
923766392,  AntilioA, 1, 0, 1, no
4199852639,  angelaaversa1, 1, 0, 1, no
1203781273,  sofiapieffe, 1, 0, 1, no
4030584351,  Fabiopica6, 1, 0, 1, no
29503204,  rloci, 1, 0, 1, no
3050030399,  fiorenzoriciop1, 1, 0, 1, no
585014645,  BesVog, 1, 0, 1, no
710404894826631169,  EguhlLort, 1, 0, 1, no
708415869513293825,  bsavage82, 1, 0, 1, no
738003923508826112,  Jennyunonove, 1, 0, 1, no
2195327711,  IntProcurement, 1, 0, 1, no
315262547,  Sas_Dalt, 1, 0, 1, no
716290497325694981,  MRicciardetto, 2, 0, 2, no
3093330052,  xnelsonrhx, 1, 0, 1, no
128518508,  yuubou600, 1, 0, 1, no
2327645726,  PappaletteraF, 1, 0, 1, no
3836329043,  max691926, 1, 0, 1, no
993717192,  KertushaIsmail, 1, 0, 1, no
232330384,  Ultimaoasi, 1, 0, 1, no
453012493,  carlosarracino, 1, 0, 1, no
729704055107391489,  minobottiglieri, 1, 0, 1, no
426270966,  Ale_B_88_FCIM, 1, 0, 1, no
314040976,  VariniMassimo, 1, 0, 1, no
493140640,  dalessandroM5S, 1, 0, 1, no
27413507,  fakeedbutler, 1, 0, 1, no
803762368761073665,  edofalso, 1, 0, 1, no
460200408,  LUCIOCIOTOLA, 1, 0, 1, no
225982309,  faidr, 1, 0, 1, no
796494022265147392,  Truth_Liberty_, 2, 0, 2, no
4884950417,  steuc2, 1, 0, 1, no
3228023541,  AngeloSgueglia2, 2, 0, 2, no
739493617,  schillsandrea, 1, 0, 1, no
4192067253,  franca_carletti, 2, 0, 2, no
428094539,  oldmay, 1, 0, 1, no
297315402,  Andreap971, 1, 0, 1, no
2920160650,  lucillacsl1, 1, 0, 1, no
179088440,  pepeponte88, 2, 0, 2, no
1257906091,  polzellanico1, 3, 0, 3, no
59805168,  ECantoni, 1, 0, 1, no
434851422,  EffeFevola, 2, 0, 2, no
272591058,  GiusyBarbatonyc, 1, 0, 1, no
386224912,  Filidiste, 1, 0, 1, no
96207679,  fABri_LT, 1, 0, 1, no
405642966,  pierpaolozzz, 1, 0, 1, no
4570414113,  rosicam101, 1, 0, 1, no
149842922,  guidolavoe, 1, 0, 1, no
740631932086652928,  roblag90, 1, 0, 1, no
3863196447,  Rosariozazza, 1, 0, 1, no
790917295279337472,  beafiore97, 1, 0, 1, no
398230105,  MynheerPeeper, 1, 0, 1, no
3307092292,  Jollarn, 1, 0, 1, no
274214893,  newsholo, 1, 0, 1, no
83893155,  PatrickParis88, 1, 0, 1, no
1275874194,  RavalCorvino, 2, 0, 2, no
708680401796132864,  lcnamato71, 1, 0, 1, no
260398745,  ElissaGodoy, 1, 0, 1, no
341641915,  malatestafabriz, 1, 0, 1, no
382945665,  MrSalamoSays, 1, 0, 1, no
301515439,  JonScotBurns, 1, 0, 1, no
77299913,  DonDraperClone, 2, 0, 2, no
2891332109,  stefanellistef1, 2, 0, 2, no
2558319999,  jank20669, 1, 0, 1, no
2211444264,  ElPapu1023, 1, 0, 1, no
4911378279,  jorgeomar1958, 1, 0, 1, no
2325435205,  LuigiNoveli, 1, 0, 1, no
1619846047,  Andrea74_aho, 1, 0, 1, no
1474865598,  MdeSaintMichel, 1, 0, 1, no
2676887991,  paolobassi166, 1, 0, 1, no
430216359,  francescocarre1, 1, 0, 1, no
470352642,  ACazzar, 2, 0, 2, no
305258223,  paolomarek17, 1, 0, 1, no
338471527,  bassalti, 1, 0, 1, no
196484069,  SaimonTx, 1, 0, 1, no
1216798586,  SolloFrancesco, 1, 0, 1, no
839406008,  deugenioe, 2, 0, 2, no
2455064133,  isitara61, 1, 0, 1, no
177812997,  CurtMills, 1, 0, 1, no
605943487,  m2matthijs, 2, 1, 1, neutral
943315728,  mirco_magri, 1, 0, 1, no
439524666,  MarcoVuolo, 1, 0, 1, no
265478136,  PhilipBertrand, 1, 0, 1, no
1596356294,  seria_paolo, 1, 0, 1, no
1897406329,  samantarivello, 1, 0, 1, no
3333400919,  BianchiM4rco, 1, 0, 1, no
805423479474573312,  therealdinz, 1, 0, 1, no
1470498758,  AleCromOfficial, 1, 0, 1, no
369974934,  MauroMeloni89, 1, 0, 1, no
805553850128224256,  tronkyhallo, 1, 0, 1, no
228426881,  GreenMonsterah, 1, 0, 1, no
243425394,  LuigiPizzimenti, 1, 0, 1, no
285801295,  peppeanastasio, 1, 0, 1, no
1960745941,  z_a_v_m, 1, 0, 1, no
1446790993,  francescamel2, 2, 0, 2, no
761326142834040832,  alefantasy2016, 1, 0, 1, no
20635695,  DavideIppolito, 1, 0, 1, no
373228693,  franko_twt, 1, 0, 1, no
351901876,  SilvOz, 3, 0, 3, no
3425603783,  balole67, 1, 0, 1, no
4474334841,  giofa63, 1, 0, 1, no
2911603197,  IlPresidente84, 1, 0, 1, no
804379944,  ferdinandodisan, 1, 0, 1, no
721340174781804544,  mdionne7237231, 1, 0, 1, no
2767843313,  costellodaniel1, 1, 0, 1, no
918565273,  04102009_, 1, 0, 1, no
705758030508507141,  625bbd1b73e74c5, 1, 0, 1, no
80008326,  marco2288, 1, 0, 1, no
1145194201,  getiton6, 2, 0, 2, no
910304714,  dbddany, 1, 0, 1, no
803315900304723968,  zuswar, 1, 0, 1, no
2244403339,  Drammis1, 1, 0, 1, no
1356311990,  RossellaPG, 1, 0, 1, no
802207699664535552,  paola_iaboni, 2, 0, 2, no
2467750806,  EmanueleForlano, 1, 0, 1, no
151400061,  Mimmoto, 4, 0, 4, no
210182258,  Emanuelepetrali, 1, 0, 1, no
1598763572,  UK_Right, 1, 0, 1, no
1157798953,  karmafeliz, 1, 0, 1, no
245480277,  cicciopedace, 1, 0, 1, no
469519219,  ALBERTO_1977_, 1, 0, 1, no
1336235796,  denver72201328, 2, 0, 2, no
53137137,  polly_puff, 1, 0, 1, no
153436041,  ninignaregina, 1, 0, 1, no
1225736772,  LolaGanzarolli, 1, 0, 1, no
424538812,  TexasDollar, 1, 0, 1, no
4873533245,  simon_p82, 1, 0, 1, no
500090809,  fabiovigolo, 1, 0, 1, no
476883328,  dellorcopino, 1, 0, 1, no
2970098309,  AndreaZedda78, 1, 0, 1, no
981259128,  marcochio94, 1, 0, 1, no
740595177128071168,  pinoBosco2, 1, 0, 1, no
424953085,  PeppePorzio22, 1, 0, 1, no
186108238,  giulianodellape, 2, 0, 2, no
3264537088,  anagacom, 1, 0, 1, no
803695642778464257,  Adriana5999, 1, 0, 1, no
1218705558,  GiovanniScarpa_, 1, 0, 1, no
750024055990910976,  Bluethirty1, 1, 0, 1, no
2589868045,  cursin54, 4, 0, 4, no
418506913,  mauro_perri, 1, 0, 1, no
213771291,  mialberti, 1, 0, 1, no
19408759,  M5Sviareggio, 1, 0, 1, no
2530931419,  83Antonietta, 1, 0, 1, no
1283427912,  redrosso2, 1, 0, 1, no
1194659419,  cri49763971, 1, 0, 1, no
2973163389,  joppi1980, 3, 0, 3, no
353660487,  Pepnano, 1, 0, 1, no
327536757,  aleprincipi, 2, 0, 2, no
1037285754,  fabcostantini, 1, 0, 1, no
768299806888386560,  droneventure1, 4, 0, 4, no
1162106042,  sabbatex, 3, 0, 3, no
368920797,  SMaurizi, 1, 0, 1, no
2733966208,  1234Giles, 1, 0, 1, no
923883992,  pirronenunzio, 1, 0, 1, no
264637878,  ghibbli, 1, 0, 1, no
80307651,  nikusvitrani, 1, 0, 1, no
1145355552,  ciotola80, 3, 0, 3, no
3121152852,  ridocate, 1, 0, 1, no
386046711,  mister_spaik, 1, 0, 1, no
722534157512011778,  Claudio_Rallo, 1, 0, 1, no
413205249,  sre_la, 1, 0, 1, no
535516497,  DeRosaIolanda, 1, 0, 1, no
29907028,  Charles_Grillo, 1, 0, 1, no
745691882,  Giamma971, 1, 0, 1, no
2753394142,  M5sM5spi, 2, 0, 2, no
797775638358847489,  ivanlazz1, 1, 0, 1, no
497246384,  rino19711, 1, 0, 1, no
740748164,  propellente, 1, 0, 1, no
2182885554,  FaustoLerda, 1, 0, 1, no
485814780,  elenafabio, 1, 0, 1, no
745212254111469568,  FraTeo83, 1, 0, 1, no
754953683385851904,  AntonioMontres1, 1, 0, 1, no
2545660573,  CyrilGiraud79, 1, 0, 1, no
2762654597,  pn5stelle, 2, 0, 2, no
1103245380,  gabrielelivieri, 2, 0, 2, no
804806665040175104,  Stefano_Santese, 1, 0, 1, no
1534732470,  HK__49_3, 1, 0, 1, no
1061897502,  arronaquaudrt, 1, 0, 1, no
475722471,  RScarfato, 1, 0, 1, no
111599680,  dramaloveitalia, 1, 0, 1, no
392588429,  marialuisadurs1, 1, 0, 1, no
412501366,  Ariannadodero, 1, 0, 1, no
460917858,  elena_zagni, 1, 0, 1, no
797918697595793408,  Zagorkurac, 1, 0, 1, no
305795673,  tinatabo, 1, 0, 1, no
3124621439,  MarcoGalanteM5S, 2, 0, 2, no
738285320760885248,  haydude0, 1, 0, 1, no
2565509048,  GianlucaBozzett, 2, 0, 2, no
320676094,  PeperitaChili, 1, 0, 1, no
777421732219129856,  AndreaFerraroNa, 1, 0, 1, no
4049039237,  andrea_cottons, 1, 0, 1, no
96523135,  aleen77, 1, 0, 1, no
1015904244,  CiacchiR, 1, 0, 1, no
1284268466,  Francesco1311, 2, 0, 2, no
574630639,  FFoxylion, 1, 0, 1, no
3710949677,  gilmour681, 2, 0, 2, no
803377573711478784,  dariomarino19, 1, 0, 1, no
470188127,  NicoleScarlato, 1, 0, 1, no
104861617,  Sanremomeetup, 1, 0, 1, no
152035250,  dusvaleo, 3, 0, 3, no
588278416,  Sanremo5stelle, 1, 0, 1, no
450037663,  SilviaFarci, 1, 0, 1, no
81297458,  criboc, 1, 0, 1, no
1671704071,  EMocellini, 1, 0, 1, no
365003757,  TizianaGeraci, 1, 0, 1, no
3496115361,  mancini_gaetano, 1, 0, 1, no
380918320,  EliElisabetta, 1, 0, 1, no
3641175736,  MCandeliere, 1, 0, 1, no
1221361957,  ComandanteRico, 1, 0, 1, no
455843920,  luigib4, 1, 0, 1, no
2799598061,  EraTuttoScritto, 1, 0, 1, no
217072021,  soozikins, 1, 0, 1, no
4819490909,  EdoardoMazzant1, 1, 0, 1, no
2659593264,  Stella_Dio2, 1, 0, 1, no
202768204,  lorysem, 1, 0, 1, no
2548434750,  bartiol, 1, 0, 1, no
430566450,  MicheleGhiani, 1, 0, 1, no
3842509876,  berenicebskll, 1, 0, 1, no
26054461,  elisascipioni, 2, 0, 2, no
372196035,  EMIDEMA, 1, 0, 1, no
778599415007150080,  stebartols, 2, 0, 2, no
17583317,  FZucchi, 1, 0, 1, no
797549147628904448,  anilius24, 1, 0, 1, no
1235315634,  MassimoGiaquin1, 1, 0, 1, no
220179342,  EdgarMP96, 1, 0, 1, no
179503167,  S_Rabinal, 1, 0, 1, no
82092954,  starrysky4MJ, 1, 0, 1, no
1330940196,  StefanoMonk, 1, 0, 1, no
527518785,  GianniPGiov, 1, 0, 1, no
1349179320,  rofesti, 1, 0, 1, no
709304761628139520,  lacarognaofwend, 1, 0, 1, no
1030603327,  pescatore9, 2, 0, 2, no
2236122296,  beinasco5stelle, 1, 0, 1, no
591041659,  truth_bho_truth, 1, 0, 1, no
77455596,  laauraestrada, 1, 0, 1, no
3056591183,  MarianneHilte, 1, 0, 1, no
370283122,  inezvanderbijl, 1, 0, 1, no
454676270,  teo_7474, 1, 0, 1, no
822343399,  FabioPavia1, 1, 0, 1, no
466678175,  videoUP_, 1, 0, 1, no
354680601,  fedelink7, 1, 0, 1, no
709378917241589760,  GaetanoLeonard3, 1, 0, 1, no
255037440,  cileland, 3, 0, 3, no
210916152,  federico_capone, 1, 0, 1, no
416351352,  FABIOVCA, 3, 0, 3, no
755080499605999616,  AngeloColonna8, 1, 0, 1, no
2290224324,  MaxGarg1962, 1, 0, 1, no
1191099788,  parvizphoto, 1, 0, 1, no
341951128,  MBasciu, 1, 0, 1, no
496009313,  leslie5691, 2, 0, 2, no
433669797,  il_vins, 1, 0, 1, no
103265981,  carlomartinello, 1, 0, 1, no
425469249,  mcsacco, 1, 0, 1, no
1084256905,  VRobiri, 1, 0, 1, no
288246866,  Il_basilisco, 2, 0, 2, no
1286047106,  Teonoe31, 1, 0, 1, no
788699015609192448,  ricucci2016, 2, 0, 2, no
186058332,  giovanniscalaca, 1, 0, 1, no
518439847,  francyperrone92, 1, 0, 1, no
745349348,  brunodallavalle, 1, 0, 1, no
459256707,  DarioF72, 1, 0, 1, no
421817125,  gam1957, 1, 0, 1, no
1009192315,  Frmartin60, 1, 0, 1, no
448826586,  cassius429, 1, 0, 1, no
54880025,  VelhoEstilo, 1, 0, 1, no
2876375319,  diegoimbriani, 1, 0, 1, no
22612494,  Polliandre, 1, 0, 1, no
576371613,  PrancoLeoz93, 1, 0, 1, no
159775615,  paoloroma2010, 1, 0, 1, no
116204007,  marcepautassi, 1, 0, 1, no
769588195977723904,  carlocavallar0, 1, 0, 1, no
1011978120,  alcarbo2, 1, 0, 1, no
67879486,  CaptHaddock83, 1, 0, 1, no
728955175369621505,  Quirina_Cantini, 1, 0, 1, no
816969265,  Dandreolet, 1, 0, 1, no
746785459,  NicolaSABATELLI, 1, 0, 1, no
2904482489,  medori_jr, 1, 0, 1, no
3862422675,  rams236, 1, 0, 1, no
1111052448,  jalatom, 1, 0, 1, no
805575661083643904,  PieroBarzanti, 1, 0, 1, no
2752920977,  WindyLFC5, 1, 0, 1, no
22122033,  jvasili, 1, 0, 1, no
41611616,  GiovanniTambu, 1, 0, 1, no
3119387615,  EVRORENAISSANCE, 1, 0, 1, no
89938366,  fabiobottino, 1, 0, 1, no
770163040172015616,  antonellanovie2, 2, 0, 2, no
707900718208970752,  stevizam, 1, 0, 1, no
702110167320698884,  FilipsAndrea, 1, 0, 1, no
322362334,  Peppe_D_11, 1, 0, 1, no
116842247,  emirmontoya, 2, 0, 2, no
557871804,  agostinodalio, 1, 0, 1, no
719563341115584512,  itsmenphis, 1, 0, 1, no
1252985322,  Danielysuchepa, 1, 0, 1, no
458580695,  jjaxshin, 1, 0, 1, no
1011173563,  00frenky00, 1, 0, 1, no
3058950893,  nikopuffa, 2, 0, 2, no
1079977711,  mattiafresi, 1, 0, 1, no
777814211636461568,  stefcosta26, 1, 0, 1, no
2931926547,  DeniseGandi, 1, 0, 1, no
715849387906310146,  Mar_Tre60, 1, 0, 1, no
361280438,  controilpotere, 1, 0, 1, no
2152673555,  BiudyB, 2, 0, 2, no
378053594,  mariameloni, 1, 0, 1, no
804189439228596224,  opesurga1984, 1, 0, 1, no
196229406,  Viagem_Italia, 1, 0, 1, no
378833661,  GiannaMangia, 1, 0, 1, no
805450038990217216,  natorerenato, 1, 0, 1, no
2285463353,  noismeker2, 1, 0, 1, no
1280967290,  AntoDiLu, 1, 0, 1, no
2592925431,  Moby7122013, 1, 0, 1, no
471559066,  joeyDeMarco12, 1, 0, 1, no
3233255813,  FreddragonZen, 1, 0, 1, no
580825596,  superseba_juve, 1, 0, 1, no
259128394,  TarkokAj, 1, 0, 1, no
469639681,  Pabatt, 1, 0, 1, no
3353369697,  alexkid11301157, 1, 0, 1, no
358111700,  NunziaCerroneMD, 2, 0, 2, no
102398509,  lovon32, 1, 0, 1, no
94103025,  gbenciolini, 1, 0, 1, no
992601505,  IuriSassetti, 1, 0, 1, no
3781248801,  vale_bellettini, 1, 0, 1, no
2636971536,  realStaiti, 1, 0, 1, no
21303464,  alykhansatchu, 1, 0, 1, no
764884779590451200,  Pietro01164944, 1, 0, 1, no
736331226496258050,  draventhecrow11, 1, 0, 1, no
405107680,  annascotto1, 1, 0, 1, no
459397842,  minaventura, 1, 0, 1, no
826878486,  SebastianiGuido, 1, 0, 1, no
4873507006,  Tyranosaure2, 1, 0, 1, no
20609404,  smarcopoulos, 1, 0, 1, no
705007777106804736,  salvotesta1978, 1, 0, 1, no
508562002,  Tamara_s_f_t, 1, 0, 1, no
246038998,  paulfuckinhell, 4, 0, 4, no
431168185,  danyrizza, 1, 0, 1, no
1955313932,  2000Stile, 2, 0, 2, no
482858620,  Stefano9259, 1, 0, 1, no
257859835,  a_zzurra, 2, 0, 2, no
2412665353,  mimmolacorazza, 1, 0, 1, no
1234449386,  refrefref22, 1, 0, 1, no
483297165,  ninopirri, 4, 0, 4, no
2347645222,  mllmrc84, 1, 0, 1, no
3081210317,  DurazzoC, 1, 0, 1, no
190696281,  donato_m, 1, 0, 1, no
4838631045,  MicheleLaRosa6, 1, 0, 1, no
800331406656217088,  rosario_cascio, 1, 0, 1, no
2162042326,  SalvatoreImper9, 1, 0, 1, no
3050191671,  12345Gennarino, 1, 0, 1, no
703827041,  AngelisLda, 2, 1, 1, neutral
603634400,  fernandotornese, 1, 0, 1, no
1306718947,  15998667, 2, 0, 2, no
1548994123,  DeserioDe, 1, 0, 1, no
199444190,  Erminiog, 1, 0, 1, no
328750567,  ManuCorradini, 1, 0, 1, no
417294081,  MariaRTatullo, 1, 0, 1, no
2998520939,  Miki59Michele, 1, 0, 1, no
576568612,  MarioBraga6, 1, 0, 1, no
2419034826,  Claudia15861818, 1, 0, 1, no
2478737879,  MassimoMoggio, 2, 0, 2, no
462918342,  StefaTOno, 1, 0, 1, no
220330731,  Francopozza, 2, 0, 2, no
271477889,  aculnaig80, 1, 0, 1, no
2401317738,  Fu_s_er, 1, 0, 1, no
2610078732,  5stelletoscana, 1, 0, 1, no
2336674700,  RedMCristina, 1, 0, 1, no
3144219153,  Dino21808709, 1, 0, 1, no
4696278104,  diffancesco41, 1, 0, 1, no
3370370428,  MaxGiachetto, 1, 0, 1, no
419006507,  frans381, 1, 0, 1, no
4847345513,  antonellapepe_, 1, 0, 1, no
518856916,  Orrudamiano, 3, 0, 3, no
261879481,  simonaansani, 1, 0, 1, no
2480462256,  pizzi1974, 1, 0, 1, no
3841950443,  alvise68, 1, 0, 1, no
4885991987,  RovitiKatia, 1, 0, 1, no
789782675292815364,  PontederaM5S, 4, 0, 4, no
422085981,  federicci1, 1, 0, 1, no
969698706,  BorsatoGiuliano, 1, 0, 1, no
701270809,  konstantinosc12, 1, 0, 1, no
4580895461,  papalia_fabio, 1, 0, 1, no
2944718859,  MeccMichele, 1, 0, 1, no
2801714098,  mastracc56, 1, 0, 1, no
1039453975,  buciass, 1, 0, 1, no
1032573726,  MocelliGiovanni, 1, 0, 1, no
791632456784936960,  _Occhialissimi_, 1, 0, 1, no
3973068471,  TeoKardec, 1, 0, 1, no
97249537,  mobilethumb, 1, 0, 1, no
946546771,  extrahomnes, 1, 0, 1, no
1405256342,  GMarini0680, 1, 0, 1, no
2288431546,  vincenzinacarbo, 2, 0, 2, no
2905455231,  galliotello49, 1, 0, 1, no
1509825860,  baffone5stelle, 1, 0, 1, no
755915551910879236,  Luigi18119325, 2, 0, 2, no
3124933529,  toninoacquario, 2, 0, 2, no
709491817633472512,  XILOXATO, 1, 0, 1, no
470261387,  ferrini_nicola, 1, 0, 1, no
1264410564,  onAir74, 1, 0, 1, no
744620207365328897,  soffiodi_luce, 1, 0, 1, no
722824948482375680,  Gloriabianco201, 3, 0, 3, no
3482551995,  LaviniaBon1986, 3, 0, 3, no
1279924916,  lucianagarbugli, 2, 0, 2, no
2181217378,  66_mush, 1, 0, 1, no
4889189339,  LaCasaDelPonte, 1, 0, 1, no
1085580902,  FGiona, 1, 0, 1, no
759376363434471424,  Philippe55623, 1, 0, 1, no
424123129,  gancitano66, 1, 0, 1, no
213603186,  MatteoMeo, 2, 0, 2, no
3826564636,  swm175, 1, 0, 1, no
423785351,  MarinaRitzla, 1, 0, 1, no
4907545497,  Mandrogna, 1, 0, 1, no
313740683,  francescomioli, 1, 0, 1, no
129748089,  ririmazz, 1, 0, 1, no
755359,  marcobg, 1, 0, 1, no
220997167,  theparxman, 1, 0, 1, no
788384602960297984,  ArtilesDana, 1, 0, 1, no
1283090984,  AveryChasten, 1, 0, 1, no
182038243,  aer974, 1, 0, 1, no
786897273678598144,  emiliopapeete, 1, 0, 1, no
2888255921,  domenip, 1, 0, 1, no
246791045,  gae_pp, 1, 0, 1, no
234954139,  nunziodb, 1, 0, 1, no
2402307408,  pepmaio, 1, 0, 1, no
747461500546220032,  SaschaMazzini, 3, 0, 3, no
801338550671331329,  LucaPicariello3, 1, 0, 1, no
485608060,  AnBalestra, 1, 0, 1, no
791076407036215296,  MaicLebon, 2, 0, 2, no
1275120396,  GIORGIOFERLANTI, 1, 0, 1, no
703893580503511040,  Ciccio19662004, 1, 0, 1, no
4351104375,  Iz2Nzu, 1, 0, 1, no
452338676,  SandroTeodori, 1, 0, 1, no
633866067,  iacon3, 1, 0, 1, no
577082208,  antoine965, 1, 0, 1, no
938878644,  perticaraluca, 1, 0, 1, no
303267275,  irri65, 1, 0, 1, no
406857025,  ContuPaolo, 1, 0, 1, no
1502210575,  LandoriPaolo, 2, 0, 2, no
2882367318,  cianflone_luca, 1, 0, 1, no
470996274,  GiuseppeSpider, 1, 0, 1, no
974439270,  ale_milanes, 1, 0, 1, no
771886311062007808,  stelledellasera, 1, 0, 1, no
794271096543580160,  innopol65, 1, 0, 1, no
500882938,  Lantidiplomatic, 2, 0, 2, no
3477759437,  stephnapoli1, 1, 0, 1, no
2279159738,  nikoskanellopou, 1, 0, 1, no
611777238,  RobertoFantoni1, 7, 0, 7, no
695998919059361793,  GianniMurania, 1, 0, 1, no
743204949606174722,  chiaraenazauro, 1, 0, 1, no
2849577231,  AnnalisaCast, 2, 0, 2, no
808852884,  ninogiordi, 1, 0, 1, no
608366393,  lorenzogenchi1, 1, 0, 1, no
759827175360962560,  GiovannaGiovin2, 1, 0, 1, no
2446847762,  fugardiroberto, 1, 0, 1, no
788670895665610752,  FilippoAntonio9, 1, 0, 1, no
1650796159,  ulisse0001, 1, 0, 1, no
516743613,  IvyRoncon, 1, 0, 1, no
49639316,  umbertosulla, 1, 0, 1, no
3205107655,  AssuntinaMo67, 1, 0, 1, no
4769336596,  _ilpaolino, 1, 0, 1, no
555960810,  FBattel, 1, 0, 1, no
376101198,  giucav1964, 1, 0, 1, no
2879350949,  salvatorescog10, 1, 0, 1, no
515850471,  27lucale, 1, 0, 1, no
2919549233,  artemisia133, 1, 0, 1, no
1067613672,  DiscannoGia, 1, 0, 1, no
735004009296232448,  annaadriana108, 1, 0, 1, no
518803927,  da_ni2005, 1, 0, 1, no
2871351407,  MazzaraFluo, 1, 0, 1, no
618540945,  RobertoMerlino1, 1, 0, 1, no
423032766,  GiuseppeLimoli, 1, 0, 1, no
774757874304253953,  Formicaio1, 1, 0, 1, no
719608945418092544,  Giovacresce59, 1, 0, 1, no
419959672,  ALEADRIANI, 1, 0, 1, no
420078767,  sandruccio72, 1, 0, 1, no
3062283743,  PirroElisa, 1, 0, 1, no
4875964570,  efficienzaener1, 1, 0, 1, no
2363421477,  balmirra75, 1, 0, 1, no
4568121035,  RSpadafina, 1, 0, 1, no
880993466,  claudiorossi919, 1, 0, 1, no
217419880,  Gepe64, 1, 0, 1, no
837437688,  giomanuele1, 2, 0, 2, no
792682371673980928,  ArmandoVesuvio, 1, 0, 1, no
533252389,  FedericaChecchi, 1, 0, 1, no
848808390,  LorenzoMorlini, 1, 0, 1, no
701036352897474561,  turinic18891, 1, 0, 1, no
280959875,  vitalbaandrea, 2, 0, 2, no
577362844,  aghe74, 1, 0, 1, no
910266067,  EmilianusD, 5, 0, 5, no
787973235417686016,  Bobragosta, 2, 0, 2, no
2780166346,  MirellaTany, 1, 0, 1, no
753748221315473408,  serenafantini00, 1, 0, 1, no
1565597845,  nerone81, 1, 0, 1, no
302652032,  simuno23, 1, 0, 1, no
421184161,  AugustoCantelmi, 1, 0, 1, no
497175650,  ap_elle, 1, 0, 1, no
813738259,  fulviomartuscie, 1, 0, 1, no
2993943651,  giammauro95, 1, 0, 1, no
541523662,  rico74roma, 1, 0, 1, no
130616191,  PGatling, 1, 0, 1, no
56646271,  nonnageca, 1, 0, 1, no
2782537521,  AntonellaAte, 2, 0, 2, no
3028492330,  BarbaraMateraUe, 3, 0, 3, no
249220275,  guarinofrancesc, 1, 0, 1, no
493543780,  giovacalcagni, 1, 0, 1, no
2380603569,  BaiuncoM, 1, 0, 1, no
2464175796,  francoforesi11, 1, 0, 1, no
485205700,  l_serino, 1, 0, 1, no
279668112,  MauriBassa, 1, 0, 1, no
799758427308388352,  valentina_italy, 1, 0, 1, no
3717390135,  bompensam1, 4, 3, 1, yes
710018592494981120,  dnamarateacont1, 1, 0, 1, no
75994558,  marcocampione, 2, 0, 2, no
137030093,  guarinom, 1, 0, 1, no
1957352750,  alfonsodiiorio, 2, 0, 2, no
3071096152,  magianchi, 3, 0, 3, no
951586740,  GfBernazzani, 1, 0, 1, no
2412371535,  ChiesaRoch59, 1, 0, 1, no
390236998,  ciocca2003, 3, 0, 3, no
4235527991,  andymanca62, 1, 0, 1, no
798690218,  alessiofigoli, 1, 0, 1, no
1851677838,  Neo_atterre, 1, 0, 1, no
593495537,  Cogfil, 1, 0, 1, no
1148831466,  SERGIOFS1, 1, 0, 1, no
385413672,  umbertocrabbia, 2, 0, 2, no
267438204,  19francys79, 1, 0, 1, no
4877535244,  RosyMennell, 1, 0, 1, no
3314885681,  Giuliaardito12, 1, 1, 0, yes
123505527,  _AnnaTatangelo_, 1, 1, 0, yes
4745793076,  SognatriceMaria, 1, 1, 0, yes
1861469826,  emanueladam1, 1, 1, 0, yes
4738000708,  Danieladansica, 1, 1, 0, yes
284405358,  FedeRoss70, 1, 1, 0, yes
3068706844,  Colmoschin90, 1, 1, 0, yes
3793406595,  Roxana48951639, 1, 1, 0, yes
1702906368,  ChiaraGruosso, 1, 1, 0, yes
6439122,  Radio105, 1, 1, 0, yes
750090721978449921,  MauraAdelaide, 1, 1, 0, yes
421365585,  andreapalazzo2, 1, 1, 0, yes
524453038,  LucindaRuiu, 1, 1, 0, yes
1073841882,  BornToD91554812, 1, 1, 0, yes
4869633387,  MaryNapoli10, 1, 1, 0, yes
227750616,  Francesco96at, 1, 1, 0, yes
18933441,  dariospada, 1, 1, 0, yes
4016361339,  rmariact, 6, 0, 6, no
48274346,  francyst, 2, 0, 2, no
2441705471,  e_devita84, 1, 0, 1, no
264320070,  stefanomgr, 1, 0, 1, no
3326829687,  MeandMyself1968, 1, 0, 1, no
4229348392,  erguerrieri, 1, 0, 1, no
293096194,  CamilloRedaelli, 1, 0, 1, no
712625582723502080,  indignaziosRM, 3, 0, 3, no
4901807531,  lauradalfollo1, 3, 0, 3, no
471221488,  valentinoorfeo, 1, 0, 1, no
1095548834,  FILOTICOA, 1, 0, 1, no
752043232264085505,  ceinoc1, 1, 0, 1, no
410047799,  Cly2460, 7, 0, 7, no
51289966,  tizianaguerrucc, 10, 0, 10, no
500230476,  pontmaxx, 3, 0, 3, no
3041331885,  piccolorex79, 1, 0, 1, no
140966820,  Enriko82, 1, 0, 1, no
2587763006,  AngelaApostoli, 2, 0, 2, no
386810205,  RM_marco01, 2, 0, 2, no
4016845217,  lucasagran, 4, 0, 4, no
828880422,  SanNuvola, 1, 0, 1, no
1114525730,  marilenacarrisi, 1, 0, 1, no
744160048352497664,  giamilli, 1, 0, 1, no
2845934806,  aleffemartini, 1, 0, 1, no
517496971,  kettolandia, 1, 0, 1, no
378671125,  TeaCastiglione, 1, 0, 1, no
2921386997,  Valanakin, 1, 0, 1, no
3447717202,  bernypuffa, 2, 0, 2, no
790456782263054336,  ladyemmacucc, 1, 0, 1, no
3100181957,  Massimi20143712, 1, 0, 1, no
526919768,  __DaniOK, 1, 0, 1, no
3054053176,  piropepi, 1, 0, 1, no
767125761308389376,  _agostino2003_, 1, 0, 1, no
1891638931,  canny_99, 1, 0, 1, no
2353389346,  car_mirko, 2, 0, 2, no
3367928763,  Naruto4316, 1, 0, 1, no
1441836270,  admirehar, 1, 0, 1, no
757654248519860225,  INeedBenji, 1, 0, 1, no
3609848506,  federicasimeol1, 1, 0, 1, no
4174159642,  mary_dreamers, 1, 0, 1, no
705779961290948608,  rosafilannino, 1, 0, 1, no
4740052216,  youtubeitaliati, 2, 0, 2, no
550416702,  radio_zek, 1, 0, 1, no
769485711712083968,  set_wingedtrash, 1, 0, 1, no
797886760940355584,  francyj333, 1, 0, 1, no
760132107666587648,  sasycatauro, 1, 0, 1, no
4834898891,  Blasteem_mtc, 2, 0, 2, no
337122176,  MatteoPelusi, 1, 0, 1, no
1630346022,  benjishappiness, 1, 0, 1, no
1938400746,  FadelliGiulia, 1, 0, 1, no
418215630,  ValeBise, 1, 0, 1, no
4726516035,  _giusy_16, 1, 0, 1, no
764668857382477824,  AbateMarika02, 2, 0, 2, no
3087142229,  druvkzain, 2, 0, 2, no
2954741927,  Ariana_372, 1, 0, 1, no
2585077275,  Ale13ssia14, 2, 0, 2, no
2888355995,  16a00e51a0bd460, 1, 0, 1, no
2892417849,  jessica_masucci, 1, 0, 1, no
712690061616291840,  MayasDandN, 1, 0, 1, no
2922689037,  Lodomyalways, 1, 0, 1, no
3099809855,  fr_enr7que305, 1, 0, 1, no
405618183,  93ANDERVSON, 1, 0, 1, no
2823742011,  ManuelaConsolo, 1, 0, 1, no
177396194,  Thetoyboy86, 1, 0, 1, no
1715570095,  studiozambon, 1, 0, 1, no
756521237438926848,  ale26borre, 1, 0, 1, no
2949027568,  giada_tini, 1, 0, 1, no
3289979162,  Checkwsel, 1, 0, 1, no
787382344202260480,  giusisgu, 1, 0, 1, no
4791467655,  decarlihug_, 1, 0, 1, no
845764760,  erikapace1d, 2, 0, 2, no
1586357036,  GiadabL, 1, 0, 1, no
705762730410708992,  claires_11, 1, 0, 1, no
3804790043,  c4363d3b8ca0441, 1, 0, 1, no
786284020988579840,  lu_130516, 1, 0, 1, no
1620333764,  Enzuccio831, 1, 0, 1, no
754283001341763584,  Alessia___27, 2, 0, 2, no
3334699492,  piccolasasha99, 1, 0, 1, no
8486912,  funnyg, 1, 0, 1, no
2671150011,  gcapodacqua79, 1, 0, 1, no
746721628843819008,  mattebiselover, 1, 0, 1, no
4300561103,  AleMonzi05, 1, 0, 1, no
757853744851660800,  giulypuffarossi, 1, 0, 1, no
2494334149,  geracitano_rob, 3, 0, 3, no
1002437894,  frAnnyhs, 1, 0, 1, no
874278259,  Daniele_AL_, 2, 0, 2, no
712994593269219329,  elenamerlino01, 1, 0, 1, no
1927758452,  PayneHoran16, 1, 0, 1, no
587783553,  RobertaNapo_, 1, 0, 1, no
221131476,  anexplodedview, 2, 0, 2, no
2747678938,  agraziosi69, 1, 0, 1, no
2754859972,  chiany_meme17, 1, 0, 1, no
3520510275,  d3arfra, 1, 0, 1, no
773850968844795904,  _Syria_Mascolo_, 1, 0, 1, no
3716663013,  twilight_laura, 1, 0, 1, no
569197950,  MontanaroCiro, 1, 0, 1, no
1005878934,  gabrielebusso, 1, 0, 1, no
2758116250,  stefanocavagnol, 3, 0, 3, no
2508291052,  CavalliOttavio, 1, 0, 1, no
39608445,  Genefab, 3, 0, 3, no
481857687,  Donatello39, 1, 0, 1, no
90493962,  carlettab, 3, 0, 3, no
2569588048,  aguazzotto, 3, 0, 3, no
800652730058477568,  piani_lorenzo, 1, 0, 1, no
1535003959,  liberaeforte, 2, 0, 2, no
1080966086,  denisheaven, 1, 0, 1, no
703657320874647552,  Whitestorm01, 1, 0, 1, no
729339188,  clinicaben, 1, 0, 1, no
2301271656,  way2learnitalia, 1, 0, 1, no
421885466,  RobMordenti, 1, 0, 1, no
1170252949,  lori_vullo, 1, 0, 1, no
552156917,  DanyCaon, 1, 0, 1, no
1103968124,  FaustinaLovesK3, 1, 0, 1, no
2282228803,  LeoGarnet1, 1, 0, 1, no
1378946276,  s3rpe, 1, 0, 1, no
2802425242,  jagermeistaaahh, 1, 0, 1, no
426112597,  carcke, 1, 0, 1, no
377522292,  gaetanogi, 4, 0, 4, no
800073124402204672,  uovo_bluff, 1, 0, 1, no
2743416479,  domedele, 1, 0, 1, no
2869346830,  Lelleri, 1, 0, 1, no
877900650,  EstManuel, 1, 0, 1, no
747035862626668544,  CossoAnna, 3, 1, 2, no
140392732,  cukke, 1, 0, 1, no
772092626107457536,  ElioElio2709, 2, 0, 2, no
797536939280834560,  n0rdmerda, 1, 0, 1, no
510494062,  DomyLocos, 1, 0, 1, no
1053123146,  ali12345658, 1, 0, 1, no
388739839,  Lemillemila, 2, 0, 2, no
8017142,  davide_vernizzi, 2, 0, 2, no
405917731,  ClaudioPasqua, 1, 0, 1, no
1872270133,  Zoo3Dprinting, 1, 0, 1, no
1595499780,  Cami_Grandi, 1, 0, 1, no
2911136777,  __martinaa99__, 1, 0, 1, no
1107227606,  CGianoglio, 1, 0, 1, no
3067877405,  anitaemma20, 1, 0, 1, no
3250680004,  Albertobfc, 1, 0, 1, no
1216009520,  magnomiche, 3, 0, 3, no
363304621,  antoniovis1, 1, 0, 1, no
1735792825,  PaganoAlexander, 2, 1, 1, neutral
1345951099,  brugiova, 1, 0, 1, no
394085064,  S_Lor75, 1, 0, 1, no
1296276722,  GiantGiaimo, 1, 0, 1, no
1183376743,  dinapoliroberto, 1, 0, 1, no
1492293990,  boialadra, 1, 0, 1, no
85083790,  deusadapaz, 1, 0, 1, no
3147522502,  famila76, 1, 0, 1, no
299606922,  telepavia, 1, 0, 1, no
480264639,  SalRando, 2, 1, 1, neutral
235204181,  FiammettaDV, 1, 0, 1, no
566888485,  FilippoFacci1, 4, 0, 4, no
2851118121,  FaraoneValent, 1, 0, 1, no
522078771,  cjmimun, 1, 0, 1, no
903853592,  PasqualeCiaccia, 9, 0, 9, no
729765344278122497,  Matteo_Maspero, 1, 0, 1, no
306318181,  Fara1_, 4, 0, 4, no
709125831512231936,  GabriellaSplen1, 1, 0, 1, no
1086500294,  StefanoGallus, 1, 0, 1, no
111990324,  frapla, 1, 0, 1, no
3067517889,  GiuseppinaMannu, 1, 0, 1, no
790857103544049664,  niccoeffe1, 1, 0, 1, no
247343955,  gfreeforever, 1, 0, 1, no
230170195,  Vale_Eva, 3, 0, 3, no
2868803500,  ClemensMarella, 2, 0, 2, no
3049978111,  gfraccastoro, 1, 0, 1, no
427734966,  bangandblame82, 1, 0, 1, no
1052521086,  CdegDe, 1, 0, 1, no
728905817194418176,  mazzaramau, 1, 0, 1, no
1104743840,  lazuddasa, 1, 0, 1, no
515332055,  casalex26, 1, 0, 1, no
42392050,  lucapennati, 3, 0, 3, no
75563024,  gbongiorno300, 1, 0, 1, no
286756094,  npanda96, 1, 0, 1, no
960086424,  capitandaddy, 1, 0, 1, no
566326933,  KarlPar78, 2, 0, 2, no
332864857,  GeppiC, 1, 0, 1, no
747907860777041920,  IoredanaSelce, 1, 0, 1, no
1852353606,  tourist_77, 1, 0, 1, no
2412895226,  simonabuonaiut1, 1, 0, 1, no
729615752752447490,  AltrenativaGo, 1, 0, 1, no
738731784859455488,  GraziosiAdriano, 1, 0, 1, no
103232978,  rosannalamalfa, 1, 0, 1, no
620218947,  tefrasi, 2, 1, 1, neutral
2948848245,  a_moreni, 2, 1, 1, neutral
3992320834,  FigPesaroUrbino, 1, 0, 1, no
4551716415,  FIGiovaniFano, 1, 0, 1, no
4738062017,  SConfidenziale, 2, 0, 2, no
626096538,  GretasenzaGarbo, 1, 0, 1, no
130240930,  andpellegrino, 3, 1, 2, no
800329779710808064,  IvanBunin_, 1, 0, 1, no
2982653979,  guadavitt, 1, 0, 1, no
497279830,  ldigiov, 1, 0, 1, no
713107266552139776,  designer_italy, 1, 0, 1, no
231036993,  mondobalneare, 1, 0, 1, no
792183529442516992,  scopofobico, 1, 0, 1, no
851768600,  tommasocastoldi, 1, 0, 1, no
254154874,  MarcelloConc, 2, 0, 2, no
529261734,  DomeDellaValle, 1, 0, 1, no
257490569,  valemy77, 1, 0, 1, no
96228101,  GhostdogRunner, 1, 0, 1, no
3852866595,  mammone09, 2, 1, 1, neutral
1229384556,  d_ercolani, 1, 0, 1, no
618868174,  ZuccaOscar, 1, 0, 1, no
1813344996,  pgiusy135, 1, 0, 1, no
1637888420,  PietroJoser, 1, 0, 1, no
772125245796970496,  liviozeta67, 5, 1, 4, no
1876984472,  antonellodz, 1, 0, 1, no
171955241,  Robbb85, 2, 1, 1, neutral
706434058016976896,  donald_love40, 1, 0, 1, no
2614353244,  ccgc_claudio, 1, 0, 1, no
94183480,  Renatambu, 2, 0, 2, no
902483371,  elenafutura_, 2, 0, 2, no
995160108,  ficsal, 1, 0, 1, no
1189154994,  Nico__Ber, 1, 0, 1, no
3075547941,  AlessCasano, 2, 0, 2, no
730081615804796928,  6difirenzese, 1, 0, 1, no
474822588,  sruz1977, 1, 0, 1, no
461292685,  gierre1984, 1, 0, 1, no
70728608,  Aldighieri, 1, 0, 1, no
417008522,  salvoitori, 2, 1, 1, neutral
705356388,  2STRONZ4U, 1, 0, 1, no
3154358021,  luca_siligato, 1, 0, 1, no
3840572321,  Heddymordicus, 1, 0, 1, no
286264929,  alfredo1883, 2, 0, 2, no
702171804417323011,  AN_EURTORRINO, 2, 0, 2, no
1100813652,  CrcXmGA, 2, 0, 2, no
803582666411048960,  rossellaberti1, 1, 0, 1, no
4147056975,  An_AzNazionale, 2, 0, 2, no
515310308,  FOrsomarso, 2, 0, 2, no
732559986778374144,  airone333, 1, 0, 1, no
729339570182066177,  peeyonkou, 1, 0, 1, no
2731631416,  BarbaraDamelia, 2, 0, 2, no
415083378,  EmanueleSalvo, 1, 0, 1, no
226511693,  otuscops, 2, 0, 2, no
302648075,  SiMancinelli, 1, 0, 1, no
2292329137,  DartSirius, 2, 0, 2, no
724723402968276992,  Co94819547Costa, 1, 0, 1, no
879974216,  francoisengo, 2, 0, 2, no
212962983,  marconati1971, 2, 0, 2, no
28793945,  MassimoBozza, 1, 0, 1, no
564876371,  giuliaciapparon, 2, 0, 2, no
826642668,  LiaStaropoli, 1, 0, 1, no
798109389928431616,  domenic_moretta, 1, 0, 1, no
3994936216,  dangipiro, 1, 0, 1, no
503847121,  pinotocco, 1, 0, 1, no
2289671119,  mirazef, 1, 0, 1, no
4805442333,  Giovannetti_E, 2, 0, 2, no
3727952835,  GruppoCEIS, 1, 1, 0, yes
1933657962,  pierdalpino, 1, 1, 0, yes
3566722876,  Gentedimare20, 1, 1, 0, yes
30624944,  robmonti, 1, 1, 0, yes
429057395,  barbarabattist2, 1, 1, 0, yes
1040093880,  dirrep, 1, 1, 0, yes
1860031908,  17VLR, 1, 1, 0, yes
419822201,  cesare_romeo, 1, 1, 0, yes
791745751818858496,  gioppangia, 1, 1, 0, yes
1016040828,  AlessandriniM70, 1, 1, 0, yes
1120422488,  SpoggiG, 1, 1, 0, yes
1222409353,  ibnaham, 1, 1, 0, yes
607544044,  max_zap, 1, 1, 0, yes
415723110,  SandroAddario, 2, 2, 0, yes
2627015590,  silviacz05, 3, 3, 0, yes
1510132044,  annalisa__russo, 2, 2, 0, yes
131486385,  pinocomparato, 3, 3, 0, yes
1556259583,  Gambling_365, 1, 1, 0, yes
4901850893,  AnceGiovaniPiem, 1, 1, 0, yes
1343971794,  ANCEgiovani, 1, 1, 0, yes
931746146,  AtuttoGass, 1, 1, 0, yes
936424968,  Panisciora, 1, 1, 0, yes
2767074196,  ciullilorenzo, 1, 1, 0, yes
3791432775,  EbePierini, 1, 1, 0, yes
2727311987,  Navynewsnet, 1, 1, 0, yes
793700795078287360,  RiccardoOrsi3, 1, 1, 0, yes
796301273792389120,  mauriziocoggia1, 1, 1, 0, yes
236516892,  vogliolapace, 1, 1, 0, yes
2787274936,  rosaspina75, 1, 1, 0, yes
1118887171,  appdegustazione, 3, 2, 1, yes
730795311849975808,  GrBenedetto, 1, 1, 0, yes
432305935,  MattiaCivico, 1, 1, 0, yes
61624078,  robertorace, 3, 2, 1, yes
54199374,  niccolonatali, 3, 3, 0, yes
1222642760,  Gianlucacarp75, 3, 3, 0, yes
418176545,  GiuliLornat, 1, 1, 0, yes
1406101670,  eyerus96, 1, 1, 0, yes
3193843480,  POPEisPOP, 1, 0, 1, no
62004025,  callimaco74, 7, 0, 7, no
161765309,  antobel73, 1, 0, 1, no
1106034919,  Amghelo, 1, 0, 1, no
2321245704,  marinopst, 1, 0, 1, no
2185783204,  Sarottola_, 14, 0, 14, no
8733352,  seaan, 1, 0, 1, no
16698143,  daniloausiello, 1, 0, 1, no
709809875002507266,  silvana_toni, 6, 0, 6, no
34616768,  egostino, 2, 0, 2, no
795345196665946113,  arabo_fenice, 2, 0, 2, no
558377336,  alegab77, 1, 0, 1, no
168123547,  iNebux, 1, 0, 1, no
3884255603,  soarez1611, 1, 0, 1, no
4530088653,  ales_carr, 1, 0, 1, no
402881758,  cdellaciana, 2, 0, 2, no
272463673,  ortensiotomaino, 1, 0, 1, no
3425468613,  GraziaRegina, 1, 0, 1, no
1360084927,  paolanegr, 1, 0, 1, no
557549753,  sil_toff, 1, 0, 1, no
3050446159,  LMossal, 1, 0, 1, no
438222914,  giordanosarta, 2, 1, 1, neutral
362049613,  albanselmi, 1, 0, 1, no
1336847760,  cironoja, 1, 0, 1, no
282268099,  Lory_novabbe, 1, 0, 1, no
2152793202,  hounnickname, 1, 0, 1, no
425360041,  mauroconsolo, 1, 0, 1, no
1389693396,  FabioAnastasia, 2, 0, 2, no
4068347902,  squit1993, 1, 0, 1, no
1734368941,  annanastibella, 1, 0, 1, no
368886611,  Ginger_UgoQZ, 1, 0, 1, no
1467331304,  g92005957, 1, 0, 1, no
279935305,  raffaele1947, 1, 0, 1, no
384851495,  StefanoCisale, 1, 0, 1, no
1846097041,  cristinatassin1, 1, 0, 1, no
957079213,  emiliocaggiano, 1, 0, 1, no
155687352,  tonipute, 1, 0, 1, no
598416940,  MauroMaraschin1, 1, 0, 1, no
361503963,  Fabio_Munafo, 1, 0, 1, no
466809826,  bortolotti52, 1, 0, 1, no
36469575,  _GianLuca_, 2, 0, 2, no
2450182814,  Andreina_Ulissi, 1, 0, 1, no
2363390223,  PafSamu, 2, 1, 1, neutral
3369328163,  d492bc175717491, 1, 0, 1, no
1098619812,  DegrassiG, 2, 0, 2, no
2787707316,  GioveGino, 3, 0, 3, no
4909784507,  MarziaDall, 1, 0, 1, no
3959313952,  PiacenzaCgil, 1, 0, 1, no
290174323,  ilBizza, 1, 0, 1, no
891569430,  CiroManigrasso, 3, 0, 3, no
2884046195,  silvian352, 2, 0, 2, no
781443342798381056,  DemXilNo, 3, 0, 3, no
390139303,  ArciNazionale, 4, 0, 4, no
218995078,  jkanzir, 1, 0, 1, no
1215945505,  mauroloconsolo, 1, 0, 1, no
1122457656,  DCambi, 1, 0, 1, no
400825181,  leonardomellon1, 1, 0, 1, no
1242095941,  cavallaromari, 1, 0, 1, no
70695596,  faberlaser, 1, 0, 1, no
2188896114,  Sara_Beatrix, 1, 0, 1, no
884174870,  PRCAsti, 1, 0, 1, no
799916451134132225,  ROBERDAN38, 1, 0, 1, no
3053325887,  CgilImola, 2, 0, 2, no
1241582108,  CgilFerrara, 1, 0, 1, no
1377069744,  maurizzi_mau, 2, 0, 2, no
485594129,  CGILParma, 3, 0, 3, no
553752390,  mirto_bassoli, 4, 1, 3, no
272887017,  chiaraorgantini, 1, 0, 1, no
477713777,  maggiore71, 1, 0, 1, no
232575488,  cigna69, 1, 0, 1, no
2464540421,  Cricrimilano, 1, 0, 1, no
507378569,  giacmoraGiacomo, 2, 0, 2, no
140378824,  alevacca, 1, 0, 1, no
344620401,  chiaracance, 1, 0, 1, no
261804112,  luvarras, 2, 0, 2, no
1632804410,  NewsExpoMi2015, 1, 0, 1, no
531461308,  LucaFer76, 1, 0, 1, no
200866509,  scarabellimauro, 1, 0, 1, no
3005974641,  vincenzoconsol2, 1, 0, 1, no
1522966285,  Minam54, 1, 0, 1, no
1180049252,  AndreaBozio, 1, 0, 1, no
621953244,  TaguidaSan, 1, 0, 1, no
201876604,  gianlucamancini, 1, 0, 1, no
1696330177,  MuccioliniG, 3, 0, 3, no
561476720,  LpBlanc, 1, 0, 1, no
3342101075,  Prima_In, 1, 0, 1, no
593681019,  graziarossi4, 1, 0, 1, no
4213069258,  ciotolina2004, 1, 0, 1, no
487899058,  santangelo_s, 2, 0, 2, no
596551434,  alesansoni, 1, 0, 1, no
582189209,  Erato2dot0, 1, 0, 1, no
4839799744,  francesca__m88, 1, 0, 1, no
1033618758,  angelo_bri, 1, 0, 1, no
567115810,  Marcello_FRB, 1, 0, 1, no
761965418395336704,  cavarra32, 1, 0, 1, no
757373697741185024,  LucaForti11, 1, 0, 1, no
340215261,  RenatKuenzi, 1, 0, 1, no
284487337,  democracy_intl, 1, 0, 1, no
2244603493,  people2power, 1, 0, 1, no
1346996612,  darioconte66, 3, 1, 2, no
2197153563,  AngeleriMassimo, 3, 3, 0, yes
3155617749,  G_LaLicata, 1, 1, 0, yes
738408018916868096,  FondUmbraArch, 1, 1, 0, yes
739031454919823360,  RobertoArki, 1, 1, 0, yes
338509443,  RForcellini, 1, 1, 0, yes
1218487406,  ildanipinto, 1, 1, 0, yes
4001039807,  EnergieRin, 1, 1, 0, yes
4441984469,  rudii_ortiz, 1, 1, 0, yes
490617625,  acamagna64, 1, 1, 0, yes
793899717532983296,  lipu_varese, 1, 1, 0, yes
2203168022,  EuropeDirectVen, 1, 1, 0, yes
29687693,  gonufrio, 1, 1, 0, yes
758914472744398848,  soerb09, 1, 1, 0, yes
336539469,  IVANblinko, 1, 1, 0, yes
27600561,  mcorradino, 2, 2, 0, yes
707663840989806593,  Angelo170663, 1, 1, 0, yes
703292399934644224,  KawserShuvo, 1, 1, 0, yes
385897719,  cesarebrogi1, 2, 0, 2, no
1441673010,  mad_astronaut, 1, 0, 1, no
712308565541855234,  Luce_Roma, 7, 0, 7, no
783366272071397377,  onofrio52, 1, 1, 0, yes
723439271726575616,  GFEancona, 1, 1, 0, yes
977274002,  canaglia_dear, 1, 1, 0, yes
184423838,  rosaria62, 3, 3, 0, yes
802148052412862468,  enzobeacfalls, 1, 1, 0, yes
88450137,  grumpyshield, 1, 1, 0, yes
860102160,  rocco_derosa, 1, 1, 0, yes
381023925,  MASenor, 1, 1, 0, yes
14611247,  cignum, 1, 1, 0, yes
452913812,  LoRDoria, 2, 2, 0, yes
443562481,  Carlotta_0, 1, 1, 0, yes
3379341238,  JStringo, 1, 1, 0, yes
743016846052491264,  Meryrose970, 1, 1, 0, yes
531137551,  Artventuno, 4, 4, 0, yes
380841575,  ElletLaura, 1, 1, 0, yes
231590078,  ffloccari, 1, 1, 0, yes
976952545,  ida_baldi, 1, 1, 0, yes
1131771522,  aerdnaelle, 1, 1, 0, yes
312538069,  dimmalo, 1, 1, 0, yes
4762935855,  RobertaPierall3, 4, 2, 2, neutral
4850657711,  alessandra_ursi, 1, 1, 0, yes
2290252449,  GBroleri, 1, 1, 0, yes
869620945,  stefaniacst, 1, 1, 0, yes
475856875,  silviaindump, 1, 1, 0, yes
38664454,  s_corradino, 1, 1, 0, yes
2318085971,  MScacc, 1, 1, 0, yes
1482515816,  ftartoni03, 1, 1, 0, yes
89732448,  Gianpz, 1, 1, 0, yes
1369327219,  tizpiac, 1, 1, 0, yes
970964743,  lor_bat, 1, 1, 0, yes
270000027,  Bionda791, 1, 1, 0, yes
934884240,  raffasabb, 1, 1, 0, yes
119796222,  bassosimone, 1, 1, 0, yes
59219903,  rfc1459, 1, 1, 0, yes
1705414922,  eurotrashbarzaj, 1, 1, 0, yes
1093017487,  CgCinzia, 1, 1, 0, yes
30218060,  gvespucci, 1, 1, 0, yes
303903928,  CRISTINAMAZZA1, 1, 1, 0, yes
127606280,  lauralaposta, 1, 1, 0, yes
2733685859,  dseinsmybae, 1, 1, 0, yes
2798056604,  Lingua_genere, 1, 1, 0, yes
809632310,  simocalvo, 1, 1, 0, yes
606622217,  MartaValenza, 1, 1, 0, yes
2187201314,  simomagg, 1, 1, 0, yes
122155790,  matteomarocco_, 1, 1, 0, yes
431583486,  pakoshape, 1, 1, 0, yes
23309699,  tedeschini, 1, 1, 0, yes
546024964,  AntonioDeky71, 1, 1, 0, yes
716212988500434944,  DansXe2, 1, 1, 0, yes
68926378,  fpmicozzi, 3, 3, 0, yes
794583732778921985,  poLLinter, 2, 2, 0, yes
799397755705786368,  Sabrinamos1974, 1, 1, 0, yes
2744423703,  sar1ta71, 1, 1, 0, yes
469153,  webgol, 1, 1, 0, yes
3053830265,  delgiudicepeppe, 1, 1, 0, yes
390170197,  dralesorre, 1, 1, 0, yes
823400821,  EtaBetaRadio1, 12, 12, 0, yes
1597783214,  lechatnoir2016, 1, 1, 0, yes
3403986760,  giordimarti, 1, 1, 0, yes
618756262,  ayoonlna, 1, 1, 0, yes
103062117,  greatnanni, 3, 3, 0, yes
395404441,  fabiofagio, 1, 1, 0, yes
559802659,  MircoMj, 1, 1, 0, yes
2366074189,  _evuzza, 1, 1, 0, yes
1277311314,  LisiaDipaola, 1, 1, 0, yes
1267798790,  sergiobertoldo, 3, 3, 0, yes
2569816533,  valessandra59, 2, 2, 0, yes
288766142,  EugenioNatale, 1, 1, 0, yes
1099108873,  IsabellaDaragon, 1, 1, 0, yes
738011483934752768,  SGarbatini, 1, 1, 0, yes
788734452528717824,  fra30698, 1, 1, 0, yes
2315738313,  cec_robustelli, 1, 1, 0, yes
1288610612,  luisa_enna, 1, 1, 0, yes
786220483863687168,  c_coros, 2, 2, 0, yes
3053216627,  MazzaGiacinto, 1, 1, 0, yes
2204460909,  metropolitani, 2, 2, 0, yes
953859294,  23Acu, 1, 1, 0, yes
331251621,  marcobendini, 1, 1, 0, yes
2873157276,  doromati78, 1, 1, 0, yes
427000620,  _gidp, 1, 1, 0, yes
105136186,  selva56, 1, 1, 0, yes
723654227051073540,  1989aleksan1m, 1, 1, 0, yes
1869093392,  sasciasforza, 5, 5, 0, yes
2353095689,  icicosadici, 1, 1, 0, yes
3333577139,  SelenaVirgilio, 1, 1, 0, yes
884774786,  MikePiedimonte, 1, 1, 0, yes
1833720450,  marco_cacioli, 1, 1, 0, yes
27228728,  Abraxas_365, 2, 2, 0, yes
84644743,  vicinolontano, 1, 1, 0, yes
7278992,  AndreaNepori, 2, 1, 1, neutral
441706424,  francescasolmi, 1, 1, 0, yes
1401612740,  FumodiChina, 1, 1, 0, yes
2649069526,  ballanballando, 1, 1, 0, yes
621831392,  ValentinaTora, 2, 2, 0, yes
2783540673,  CesareMinghini, 1, 1, 0, yes
532320235,  FondBellisario, 1, 1, 0, yes
462692817,  LiriKopaci, 1, 1, 0, yes
3907805718,  webgenitori, 1, 1, 0, yes
2729554988,  pissi_marini, 2, 2, 0, yes
2901242702,  GiuliaMaccagli, 1, 1, 0, yes
493912799,  FerraraGiuliana, 2, 2, 0, yes
43498338,  narbon, 2, 1, 1, neutral
1540462218,  doc_isa, 1, 1, 0, yes
2497086351,  FrancescoD_G_, 1, 1, 0, yes
2244900916,  cecilia_angelis, 1, 1, 0, yes
2786244362,  FranzNRG, 1, 1, 0, yes
461948046,  man_giu, 2, 1, 1, neutral
4882297509,  gfevibo, 1, 1, 0, yes
752796690063695872,  0501Wendy72, 1, 1, 0, yes
501174359,  moranduzza, 1, 1, 0, yes
577331362,  lago_como, 2, 2, 0, yes
2764309042,  maxsusani, 1, 1, 0, yes
802981083264483329,  ClaudioRavasi3, 1, 1, 0, yes
269196059,  cyberparelli, 1, 1, 0, yes
3313002219,  marcotttp, 4, 4, 0, yes
1038022410,  RiccardoCARB, 1, 1, 0, yes
426531095,  gcuredda, 1, 1, 0, yes
1129384052,  giorgiasucci1, 1, 1, 0, yes
761272152217808900,  Lrnztglfrr, 1, 1, 0, yes
81808899,  paologandolfi, 1, 1, 0, yes
3302564410,  eugenio_gerva, 1, 1, 0, yes
451003918,  meridio61, 1, 1, 0, yes
440475439,  MaricaValvo, 2, 2, 0, yes
1878946734,  alessandrora1, 1, 1, 0, yes
2263879145,  Brickstonesti, 2, 2, 0, yes
128259714,  EM1LIANO, 1, 1, 0, yes
80690245,  medeoTL, 6, 1, 5, no
95270448,  mfioretti_it, 1, 1, 0, yes
524248745,  PierbiagioS, 2, 2, 0, yes
4112467042,  TorinoDonna, 1, 1, 0, yes
535367158,  laurabiondani, 1, 1, 0, yes
415185894,  lucabarrel, 1, 1, 0, yes
348024917,  beniaminatarga, 1, 1, 0, yes
1045915729,  ground_broken, 1, 1, 0, yes
757154320009822208,  Loredana270807, 1, 1, 0, yes
274580306,  isa2503, 1, 1, 0, yes
787595292,  uil_va, 1, 1, 0, yes
230402050,  liscadipesce, 1, 1, 0, yes
2891077925,  RavazziMl, 2, 1, 1, neutral
2821862670,  CycleThink, 1, 1, 0, yes
794676572263432192,  simonetta__9, 1, 1, 0, yes
5579402,  IusOnDemand, 1, 1, 0, yes
538134680,  mbuccola, 1, 1, 0, yes
731214043969671168,  giuseppebelli16, 1, 1, 0, yes
2226989317,  carinadonofrio, 2, 2, 0, yes
468760927,  MarzioBorsoi, 1, 1, 0, yes
295648894,  Ilvy75, 1, 1, 0, yes
69271827,  _robyb_, 1, 1, 0, yes
3243825899,  fontanaangela98, 1, 1, 0, yes
709003050137075712,  gorfla49, 1, 1, 0, yes
1061051426,  giuScarlato, 1, 1, 0, yes
50589162,  roberiez, 4, 3, 1, yes
2482490152,  ArmentanoNic, 1, 1, 0, yes
1892883824,  Silca83Re, 2, 1, 1, neutral
485067677,  pingu_73, 4, 4, 0, yes
790535575782748161,  moniaazzalini, 1, 1, 0, yes
276662615,  lazhartwin, 1, 1, 0, yes
4846684161,  KostTa60, 1, 1, 0, yes
115493128,  tizianapro, 1, 1, 0, yes
2534718178,  giannialshub, 1, 1, 0, yes
485186966,  GiuliaRupi, 1, 1, 0, yes
417119001,  CesariElena, 1, 1, 0, yes
3247519743,  Blogdelledonne, 1, 1, 0, yes
479805144,  piamariani, 1, 1, 0, yes
2494099190,  hesammohammad95, 1, 1, 0, yes
591763573,  Luxabeat, 5, 5, 0, yes
3324606040,  francyrol, 1, 1, 0, yes
482866515,  CardaniLaura, 1, 1, 0, yes
3120474387,  d1aVoL0, 4, 4, 0, yes
726022286717927424,  suddegenere, 1, 1, 0, yes
1274595828,  rovacchigiorgio, 1, 1, 0, yes
2445534931,  UmbertoFracassi, 1, 1, 0, yes
366684418,  capriovince, 1, 1, 0, yes
97538677,  masardu, 1, 1, 0, yes
2569177823,  HopeSarout, 1, 1, 0, yes
1474066110,  75_francesco, 1, 1, 0, yes
2386946916,  SchulerBeat, 1, 1, 0, yes
1670279694,  VFondi, 1, 1, 0, yes
2250615505,  ing_Baldrascani, 1, 1, 0, yes
26287595,  Roxdcitaly, 1, 1, 0, yes
805406124434485248,  radioestraibile, 1, 1, 0, yes
496159385,  MartinVenator13, 1, 1, 0, yes
37955134,  UNISG, 1, 1, 0, yes
425117279,  annasoniad, 1, 1, 0, yes
460034102,  josephlobianco, 1, 1, 0, yes
740856615415472128,  Ulixes43, 1, 1, 0, yes
710066832552628224,  alessandro_giar, 1, 1, 0, yes
1036981194,  GFE_FIRENZE, 1, 1, 0, yes
1610282048,  EdoCav90, 1, 1, 0, yes
3332129379,  1b2cd742b29846b, 2, 2, 0, yes
1372917788,  BellaviaClaudio, 1, 1, 0, yes
197157593,  andpieroni, 1, 1, 0, yes
539013455,  Javac82, 1, 1, 0, yes
864546176,  dan2cil, 2, 1, 1, neutral
127916193,  brasitalia100, 2, 2, 0, yes
147148538,  Andygobbo, 1, 1, 0, yes
222311955,  Salvo_Parisi, 2, 1, 1, neutral
21757709,  AlessAbbona, 1, 1, 0, yes
1192442587,  FOCSIV, 2, 2, 0, yes
2795848579,  UCSIToscana, 1, 1, 0, yes
242183322,  carlaciampalini, 1, 1, 0, yes
707959452020899843,  SauraSermenghi, 1, 1, 0, yes
183320673,  _DanieleG_, 1, 1, 0, yes
374992126,  Barbe1981, 1, 1, 0, yes
3051394269,  mama_sees, 1, 1, 0, yes
192848202,  CIRSDe, 1, 1, 0, yes
747640457312743425,  DavidFordyce10, 1, 1, 0, yes
1539042794,  Steve_Resler, 1, 1, 0, yes
763391744314634241,  Edoras1990, 1, 1, 0, yes
857893950,  antek1907, 1, 1, 0, yes
3308560736,  vivelafra, 1, 1, 0, yes
1448082108,  IsabellaDeiana7, 6, 6, 0, yes
515595732,  gabriellabruno8, 1, 1, 0, yes
411608254,  vatonutti, 2, 2, 0, yes
2619940330,  mturrini66, 1, 1, 0, yes
624511807,  LauraBellicini, 2, 1, 1, neutral
46151350,  gvgrandi, 1, 1, 0, yes
140099146,  dommaus, 1, 1, 0, yes
619890667,  GHapix, 1, 1, 0, yes
925600032,  MassimobBonaldo, 1, 1, 0, yes
791638184178442244,  SGuarner1, 1, 1, 0, yes
458712981,  vcalzolaio, 1, 1, 0, yes
730120275115814912,  Ste_Marra, 1, 1, 0, yes
1229340666,  donabianchi1, 1, 1, 0, yes
2726609210,  maurimizzi, 1, 1, 0, yes
309005868,  stefaniagalimba, 1, 1, 0, yes
2396075075,  IenziIenzi, 2, 2, 0, yes
2960908437,  frenkmatte99, 1, 1, 0, yes
1183718185,  RosalbaNardelli, 1, 1, 0, yes
2999934836,  serestella22, 1, 1, 0, yes
412371395,  Catchiav, 1, 1, 0, yes
438921677,  SBretini, 1, 1, 0, yes
614572996,  SoulTaker39, 1, 1, 0, yes
617228017,  jaime2353, 1, 1, 0, yes
799776892664614912,  danielonesan, 1, 1, 0, yes
2482432463,  Stefanie__Storm, 1, 1, 0, yes
2155583656,  snuff1964, 1, 1, 0, yes
291902330,  Torbatura5, 1, 1, 0, yes
449678892,  AngeliEdizioni, 1, 1, 0, yes
1145634865,  X_m_a_r_c_o_X, 1, 1, 0, yes
2513415118,  Gilda24263670, 1, 1, 0, yes
136621489,  pacobelo, 3, 3, 0, yes
1466611034,  Donaflor9, 2, 2, 0, yes
445736388,  EmanuelaMortari, 1, 1, 0, yes
2436449369,  MnemonlcFactory, 1, 1, 0, yes
2757620145,  luanacinquina, 1, 1, 0, yes
34272560,  Emmapia, 1, 1, 0, yes
22122572,  valeriodistefan, 1, 1, 0, yes
2437647053,  nlcholecrossley, 1, 1, 0, yes
1035262315,  UcsiSocial, 1, 1, 0, yes
4927697577,  NoHateSpeech_IT, 1, 1, 0, yes
2706219342,  cristmarrs, 1, 1, 0, yes
519702233,  Laura_Paragona, 2, 1, 1, neutral
82314799,  Wolfanger, 1, 1, 0, yes
29388186,  direttore100, 1, 1, 0, yes
445889943,  BrendanBHLI311, 1, 1, 0, yes
367952682,  danzaspighe, 1, 1, 0, yes
2902410964,  OrazioZoccolan, 1, 1, 0, yes
1485002496,  BenitoRomanoVio, 1, 1, 0, yes
723606205,  GBertolottii, 1, 1, 0, yes
445822246,  francopizzetti, 1, 1, 0, yes
61435918,  FredianoFinucci, 2, 0, 2, no
2346535719,  lo_sparviero, 1, 0, 1, no
226995153,  FrancescaNevis, 2, 0, 2, no
770604000676835328,  B_R_1977, 1, 0, 1, no
1447030830,  gabrielemarch10, 3, 0, 3, no
476047791,  vitopic, 2, 2, 0, yes
802932378327019520,  GianfrancoGril4, 1, 1, 0, yes
750013757691224064,  chiamamicitta, 1, 1, 0, yes
422907930,  Profsantini, 2, 2, 0, yes
474829757,  GLaface, 1, 1, 0, yes
724160639153909760,  QuiProQuo_, 1, 1, 0, yes
2361610476,  AleZampaglione, 2, 1, 1, neutral
531200826,  Lily7137, 1, 1, 0, yes
226064588,  simoneboero, 1, 1, 0, yes
705787845844320256,  VivereNelSalent, 1, 1, 0, yes
2868040007,  prgoleador, 1, 1, 0, yes
395385134,  RaffaCaterino91, 1, 1, 0, yes
756413285365325825,  paolomanuel2013, 6, 6, 0, yes
55533513,  Petruntisisto, 2, 2, 0, yes
728297954193362945,  contir67, 2, 2, 0, yes
722895123432886272,  LukeTheDrifterZ, 2, 2, 0, yes
2489675953,  Fra_Cass94, 3, 1, 2, no
714792663308976128,  gloriabertolot2, 2, 2, 0, yes
2467123125,  MPaolaDAndrea, 1, 1, 0, yes
415706033,  FaiSempBurdell, 1, 1, 0, yes
138716400,  antodelprino, 1, 1, 0, yes
123018601,  carlinohugo, 3, 1, 2, no
728178382006005760,  rita_manco, 2, 2, 0, yes
211486618,  Adena82, 2, 2, 0, yes
2478005629,  carloscarabeo, 2, 2, 0, yes
72541442,  KarenNahum, 1, 0, 1, no
617158024,  Iilwlng, 1, 0, 1, no
615845701,  R68Shaun, 1, 0, 1, no
2478094665,  corinamariex7, 1, 0, 1, no
735778354280861696,  ExpertiseOn, 1, 1, 0, yes
24061217,  MauMarinelli, 1, 1, 0, yes
198270417,  PaoloPal3, 1, 1, 0, yes
1510650962,  Filippo_Paini, 2, 2, 0, yes
1039580413,  zenazena67, 1, 0, 1, no
1498494175,  uuhumax, 2, 0, 2, no
1146101496,  alealexse, 2, 0, 2, no
905577096,  iostoconCOMI, 1, 0, 1, no
1487727384,  newsfrae, 2, 0, 2, no
961108988,  calrogiBG, 2, 0, 2, no
709004227,  mgiavini, 1, 1, 0, yes
363103777,  LezzaGiuseppe, 8, 4, 4, neutral
1598493312,  trullinet, 2, 0, 2, no
102114992,  paciolina, 1, 0, 1, no
199790331,  andrea091967, 1, 0, 1, no
448754383,  brunomeduri, 1, 0, 1, no
601316915,  bagnolina, 1, 0, 1, no
174978820,  rosannarizzi, 1, 0, 1, no
2955233225,  ALisimberti, 1, 0, 1, no
1397960005,  _girando, 1, 0, 1, no
712638482569625600,  Ninoc12, 8, 1, 7, no
14170643,  Vaccaro_G, 1, 0, 1, no
157917956,  PietroGalati, 1, 0, 1, no
433232662,  sabrinamassaro, 1, 0, 1, no
99807484,  felicebalsamo, 1, 0, 1, no
227412044,  GINOANTONACCI, 2, 0, 2, no
103823672,  PGDL, 1, 0, 1, no
751595845,  Aomidn6019, 3, 0, 3, no
330327779,  Luer_1o4, 1, 0, 1, no
3093857141,  noscaricoamare, 1, 0, 1, no
1610183600,  Betazoide, 3, 0, 3, no
3291544978,  danielecorrao66, 1, 0, 1, no
2163607505,  darioshaula, 1, 0, 1, no
394562705,  GiacomoZanna, 1, 0, 1, no
2970293500,  53_lone, 1, 0, 1, no
1089705342,  ManigrassoG, 1, 0, 1, no
391946870,  rossellinaohara, 1, 0, 1, no
406472403,  MaurizioMichele, 1, 0, 1, no
45861942,  LucaSucci, 1, 0, 1, no
415750859,  ccclacar, 1, 0, 1, no
415039798,  alcibiade68, 1, 0, 1, no
4698860869,  SydraKleps, 1, 0, 1, no
313813349,  CosimoMicelli, 1, 0, 1, no
4156848515,  Mariang61340356, 3, 1, 2, no
1538750090,  KompagnaTeresa, 1, 0, 1, no
3126643192,  george_walker68, 1, 0, 1, no
2766402312,  ConzaEmilio, 1, 0, 1, no
4131646755,  luposolo1, 2, 1, 1, neutral
3117680235,  loreto_lu, 1, 0, 1, no
46346704,  g4l1l30, 1, 0, 1, no
3189709065,  PaesArchLetizia, 1, 0, 1, no
472013122,  francometta, 1, 0, 1, no
456713204,  atoiitoa, 2, 0, 2, no
801365046597132289,  AnzhelikaTyur, 1, 0, 1, no
394014388,  MariaApossamai, 2, 0, 2, no
450846026,  ivanapittella, 2, 0, 2, no
952472629,  OrlandoAgrusta, 2, 1, 1, neutral
1747178024,  cla217, 2, 0, 2, no
441556239,  konomoronao, 1, 0, 1, no
291729417,  GMilanese, 1, 0, 1, no
1460529026,  maryuanna79, 1, 0, 1, no
2157207460,  ZeroGaia, 1, 0, 1, no
4872878914,  VMG_volpe, 1, 0, 1, no
244546028,  saromica, 1, 0, 1, no
193642197,  maurobertoTO, 1, 0, 1, no
398134246,  lumi_eventos, 2, 0, 2, no
199087253,  Siralexsantese, 1, 0, 1, no
479551600,  Mariaritamara, 1, 0, 1, no
479713128,  bertani_sandra, 1, 0, 1, no
53059344,  ferdilarizza, 1, 0, 1, no
59422983,  unipegaso, 2, 1, 1, neutral
414127308,  Maafushivaru69, 2, 1, 1, neutral
738135001347153924,  Antovi171, 1, 0, 1, no
3190082914,  decimomeridio67, 2, 0, 2, no
1007124930,  annamattii, 1, 0, 1, no
406856918,  GiusMAZZINI, 2, 0, 2, no
3828401872,  LTByronoriginal, 2, 0, 2, no
869801606,  Imprimaturedito, 3, 0, 3, no
793591515796934657,  yperdiving, 1, 0, 1, no
409817475,  claudiachelli, 2, 0, 2, no
978708510,  ombraeffe, 1, 0, 1, no
379022377,  EnzoCalabr, 1, 0, 1, no
1034710201,  LaFemministica, 1, 0, 1, no
387056404,  StoglJr, 1, 0, 1, no
781133589245198336,  LeonardoDanaro, 1, 0, 1, no
1340154259,  Marria13Maria, 1, 0, 1, no
771759671401181184,  ilmaltesediprat, 1, 0, 1, no
389974442,  stornaiolo, 1, 0, 1, no
2537281228,  donatellapolign, 1, 0, 1, no
2728490969,  mariagraziapet6, 1, 0, 1, no
564794492,  occhiverdiii, 1, 0, 1, no
2940913042,  ACiabocco, 1, 0, 1, no
2372271426,  Lamary4ever, 1, 0, 1, no
555195153,  FrancescaCiura, 1, 0, 1, no
1315046245,  TuriFilippo, 2, 0, 2, no
1090448503,  farfallarrubia, 2, 0, 2, no
1134644042,  Andrput, 4, 0, 4, no
801838832102547456,  Palato_Beato, 1, 0, 1, no
340928644,  LeoAbascia, 1, 0, 1, no
519318638,  torepaola, 3, 0, 3, no
524284548,  AldoCannoletta, 1, 0, 1, no
1196316816,  SerraVitaliano, 1, 0, 1, no
3307979603,  Deb44848748, 5, 0, 5, no
2532904492,  gianni_liviano, 1, 0, 1, no
546646837,  AdaElmini, 4, 0, 4, no
469826948,  ElisaGalletto, 3, 0, 3, no
782497924232142849,  gnometta84, 1, 0, 1, no
1300968402,  gm_marilena, 1, 0, 1, no
306997738,  LeenaMey, 1, 0, 1, no
273360215,  IsabellaBolo, 1, 0, 1, no
397556913,  vincenzopompeo, 2, 0, 2, no
1236246583,  giomasmic, 1, 0, 1, no
4209276022,  SimoneBottalico, 1, 0, 1, no
328022080,  LibertyAnna, 2, 0, 2, no
798813634432372736,  SostieneCafo, 1, 0, 1, no
724617007379931137,  86valentieg, 1, 0, 1, no
780816250066743297,  TSN_49, 1, 0, 1, no
799879122126336000,  talalaxinaggal, 1, 0, 1, no
800746715133284352,  Evucka65, 1, 0, 1, no
3246905050,  andreacapo1977, 1, 0, 1, no
1014034080,  GloriaNegramaro, 1, 0, 1, no
273377056,  operapadrepio, 2, 1, 1, neutral
1606661,  beppecolonna, 1, 0, 1, no
1491103976,  Eikpard, 1, 0, 1, no
3424352055,  BauleMargherite, 2, 1, 1, neutral
527179601,  paolarogora, 1, 0, 1, no
491417328,  umbertodott, 1, 0, 1, no
309083041,  gabri1903, 2, 0, 2, no
56460480,  vikingo2300, 1, 0, 1, no
291605081,  Nicholaus_it, 1, 0, 1, no
277951072,  CarloneMario, 1, 0, 1, no
443594304,  richimattei, 1, 0, 1, no
1585963512,  EPolisBari, 2, 1, 1, neutral
771429034504880128,  botteguccia16, 1, 0, 1, no
3259953670,  lucani2019, 1, 0, 1, no
252185251,  ilGuaro, 1, 0, 1, no
2327790560,  AnnamSignorile, 1, 0, 1, no
406126168,  MarellaRuta, 1, 0, 1, no
96104745,  santosalfi, 1, 0, 1, no
8709042,  Uncino, 1, 0, 1, no
3030336508,  GuareschiMarzia, 1, 0, 1, no
2206875744,  ClodiaTaras, 1, 0, 1, no
133076985,  nikbolik, 1, 0, 1, no
421273974,  albgiuseppe1, 1, 0, 1, no
534231650,  gidasarn, 1, 0, 1, no
1559842459,  no_tap, 1, 0, 1, no
1311830046,  PattyAshepit, 1, 0, 1, no
1731664436,  Basilicatamigl, 1, 0, 1, no
522445957,  ParcoGargano, 2, 0, 2, no
778503955,  danielecorradi7, 1, 0, 1, no
98188333,  D_Cassatella, 1, 0, 1, no
1198293565,  PEPPELICATA72, 6, 0, 6, no
765979700808286208,  guyfawkes2_0, 1, 0, 1, no
1178473466,  oldares, 1, 0, 1, no
316972451,  NicolaDiMare, 3, 0, 3, no
805199157627654144,  musicamare1, 1, 0, 1, no
143755904,  tittipati, 1, 0, 1, no
4069067369,  DeadzoneIrwing, 2, 0, 2, no
784980281266765824,  PhiBee7, 1, 0, 1, no
1246122157,  donatocassano1, 2, 0, 2, no
951390038,  CesarePalma, 2, 1, 1, neutral
1229409494,  pepilottame, 2, 0, 2, no
2851612031,  ellytundo, 2, 1, 1, neutral
105902569,  numshub, 1, 0, 1, no
2312306342,  AzioneCivileTV, 1, 0, 1, no
794231200269434880,  Vito10091960, 2, 0, 2, no
1533314910,  Emilioluccarell, 1, 0, 1, no
796796303103639553,  mariagrazia1154, 1, 0, 1, no
394641871,  malbensi, 1, 0, 1, no
407082246,  flaviosqu, 1, 0, 1, no
3241562675,  RicciatoM, 1, 0, 1, no
3069527349,  Cameraspia, 2, 1, 1, neutral
59872650,  Uvaozio, 1, 0, 1, no
598455937,  Spectator17, 2, 1, 1, neutral
2971867924,  cappellifranco, 2, 0, 2, no
560418489,  Franziskus_D, 1, 1, 0, yes
1073886242,  AnnaSavarese3, 2, 1, 1, neutral
787723562010435584,  ingfragomeni, 1, 0, 1, no
800315432569749504,  tizietta69, 1, 0, 1, no
784727821990105088,  antonio91486165, 1, 0, 1, no
14082257,  greatpinkflower, 1, 0, 1, no
408620732,  diego_mancino, 3, 0, 3, no
560156137,  geomaicol, 2, 0, 2, no
449922265,  roccomartorana, 1, 0, 1, no
4319356877,  utolupi, 1, 0, 1, no
712920058918543360,  giordanoadri1, 4, 4, 0, yes
985120944,  unipait, 7, 7, 0, yes
802301691165020160,  silcompchesel11, 1, 1, 0, yes
70909372,  AntoniodeLucia, 1, 1, 0, yes
234810779,  ManuelitaTFA, 3, 2, 1, yes
461090191,  SamEmiliano, 1, 1, 0, yes
1029633199,  ToninoMoscatt, 1, 1, 0, yes
798901523291967488,  LucianaBono3, 1, 1, 0, yes
1256554279,  creativa56, 1, 1, 0, yes
777131405616840704,  crissogna, 2, 2, 0, yes
794862166138646528,  Pietro23256, 1, 1, 0, yes
390985672,  recarlo20072007, 1, 1, 0, yes
165814836,  fefereds, 1, 1, 0, yes
782479854142943232,  liadepas, 1, 1, 0, yes
776327017440641024,  marygigante1981, 1, 1, 0, yes
3053773990,  neobule78, 3, 3, 0, yes
1053086102,  AnnaAbagnale5, 3, 3, 0, yes
175689077,  teatromassimo, 1, 1, 0, yes
774166047830061056,  so_tRicky_, 1, 1, 0, yes
930440149,  AdeleDAgostino, 1, 1, 0, yes
2598112424,  Ventilatore11, 1, 1, 0, yes
279018654,  giemmess, 1, 0, 1, no
1385518470,  SqualoGG, 2, 0, 2, no
2525968290,  adriobonomi, 1, 0, 1, no
517974089,  NapoliRaf, 2, 0, 2, no
1176954972,  NMangiacotti, 1, 0, 1, no
4248867753,  SocialPsicosi, 2, 2, 0, yes
1441666896,  alvarogarcia451, 1, 1, 0, yes
355369075,  mosugui7777, 1, 1, 0, yes
60241214,  Yeanett, 1, 1, 0, yes
382321529,  h501a, 1, 1, 0, yes
2919730121,  giovannibuono78, 1, 0, 1, no
722550098278879232,  oltreado, 2, 2, 0, yes
4244938137,  aureolo2015, 1, 0, 1, no
1339442802,  AnnaCurci2, 1, 0, 1, no
4844931544,  TgrMolise, 1, 1, 0, yes
2863819967,  LaFiammante, 1, 1, 0, yes
770940748065804289,  OpMediterraneo, 1, 1, 0, yes
496368844,  UVenexiani, 1, 1, 0, yes
89581413,  IngleseSartoria, 2, 2, 0, yes
367223470,  ValerioLDV, 3, 3, 0, yes
1026513577,  Magari_Mori, 1, 0, 1, no
2346832778,  GabrieleEliaCsm, 1, 0, 1, no
803704434815631362,  itschiara_d, 1, 1, 0, yes
1219880312,  tinusmjle, 1, 1, 0, yes
16994855,  kranz, 4, 4, 0, yes
1423857721,  FedericoBauMici, 2, 0, 2, no
132129411,  lelemubble, 1, 0, 1, no
884658194,  DavideLeonardi1, 1, 0, 1, no
2464385681,  Nicoladesilla, 1, 0, 1, no
47756372,  mgmaglie, 1, 0, 1, no
734805955985182720,  GrandeRufus, 1, 0, 1, no
334820496,  ibrbi, 1, 0, 1, no
796492542212767744,  SandroEramo, 1, 0, 1, no
789044728604061696,  FootwBall, 1, 0, 1, no
135862050,  IoSonoGianni, 1, 0, 1, no
1399140884,  domenicocuzzi, 1, 0, 1, no
472783137,  Giu_Gigliotti, 1, 0, 1, no
528642432,  nakys69, 2, 0, 2, no
805604343437291520,  giesepsoni1989, 1, 0, 1, no
703341653042601985,  Dubitoso, 2, 0, 2, no
1427377284,  ingiroxilmond0, 1, 0, 1, no
600483745,  LucianaPatrizia, 1, 0, 1, no
292271013,  PBonfigli, 1, 0, 1, no
1039127888,  stortora71, 1, 0, 1, no
385864055,  iwishtoberain, 2, 0, 2, no
2851502757,  massbini48, 1, 0, 1, no
297936044,  cagnuol, 2, 0, 2, no
3143527192,  figiovanimodena, 1, 0, 1, no
3065026630,  Pomp_c, 1, 0, 1, no
2306080108,  amcalexcap, 2, 0, 2, no
510685928,  ulba60, 1, 0, 1, no
397573326,  MarioScelzo1, 2, 0, 2, no
3384830219,  piccioni77, 1, 0, 1, no
2848115296,  Giustinianorex, 1, 0, 1, no
4243840054,  angela_iuliano, 1, 0, 1, no
2367112236,  olivozilio, 1, 0, 1, no
3259523579,  elisalalisa81, 1, 0, 1, no
138130394,  Tenkojak, 1, 0, 1, no
250667812,  bifedelomo, 1, 0, 1, no
3154530838,  giuli_valle, 3, 0, 3, no
480364996,  maurisa9, 1, 0, 1, no
708930840,  Massimodalcerro, 3, 0, 3, no
139743146,  mauriziozingoni, 1, 0, 1, no
1041890317,  Arman11Stefano, 1, 0, 1, no
395502958,  Marco_IlBudda, 1, 0, 1, no
463765364,  ClaudiaMancina, 1, 0, 1, no
781879938832068609,  AlbertiF81, 1, 0, 1, no
3353515834,  DanielaLongo25, 1, 0, 1, no
2609374654,  palumbo_emilio, 1, 0, 1, no
540763968,  Dischivolanti, 1, 0, 1, no
372777532,  giorgiozanchini, 1, 0, 1, no
96959346,  fguglieri, 1, 0, 1, no
600355032,  MarioBottosso, 1, 0, 1, no
2314569539,  maurizippo, 1, 0, 1, no
2262678820,  LoZerbino, 1, 0, 1, no
343895398,  MassimoBordin, 1, 0, 1, no
2221607530,  claudiocaruso77, 1, 0, 1, no
622808643,  luca_manz, 1, 0, 1, no
112764192,  stefaniamore65, 1, 0, 1, no
342206151,  Marco5Francia, 1, 0, 1, no
143852894,  SimoneBertu, 1, 0, 1, no
73057018,  cratete, 1, 0, 1, no
491634712,  annavigato, 1, 0, 1, no
4111041477,  annacastingtv12, 2, 0, 2, no
122695396,  lbrazzoli, 1, 0, 1, no
1384398409,  zf1964, 1, 0, 1, no
2230570336,  LenziniSonia, 1, 0, 1, no
3352855515,  bigiobigino, 1, 0, 1, no
455176265,  FrancoGgf, 1, 0, 1, no
66499939,  monterozunino, 1, 0, 1, no
518136723,  ciprycanovi, 1, 0, 1, no
490701564,  zeuxilverPA, 2, 0, 2, no
4832445695,  GRestaneo, 1, 0, 1, no
60866593,  adepatri, 1, 0, 1, no
793361599230861312,  DarioCorinto, 1, 0, 1, no
876503191,  AnnaFedele001, 1, 0, 1, no
1245745776,  marcellogorda, 2, 0, 2, no
1043151836,  alfredina7, 1, 0, 1, no
4605549200,  MatthewHrenak, 1, 0, 1, no
181206968,  alpibiancheit, 1, 0, 1, no
53198326,  carbonedg, 1, 0, 1, no
2335113854,  cecchirina, 2, 0, 2, no
203699702,  vitocontardo, 1, 0, 1, no
3279653075,  Gennaro68630820, 2, 0, 2, no
3336362219,  WLAPALERMO, 1, 0, 1, no
4827614413,  LaCla74, 1, 0, 1, no
776436951322943488,  pistillofilome1, 2, 0, 2, no
143900324,  peterzana, 1, 0, 1, no
1036825519,  leo_ster, 1, 0, 1, no
499807931,  gio_pellizzeri, 1, 0, 1, no
756552513483046912,  daniela_musina, 1, 0, 1, no
4156164196,  Piodaceto, 1, 0, 1, no
556033944,  dilcinico, 1, 0, 1, no
365514359,  Francemazza, 1, 0, 1, no
81829188,  gian_dal, 1, 0, 1, no
1037365346,  ComesIgnacio, 1, 0, 1, no
71005866,  frabiagiotti, 1, 0, 1, no
2322403651,  capojack67, 1, 0, 1, no
446607792,  LocatelliSte, 1, 0, 1, no
803947078590361601,  powergp2, 2, 0, 2, no
2582802381,  tizianateodosio, 1, 0, 1, no
498017973,  BoreaPaolo, 1, 0, 1, no
66473460,  Reddo_it, 1, 0, 1, no
10912362,  warkoholic, 1, 0, 1, no
349304660,  Olshany, 1, 0, 1, no
388341126,  GiuseppePasin, 1, 0, 1, no
3431444549,  TEnjeux, 1, 0, 1, no
269534239,  GMT_90, 1, 0, 1, no
1218997844,  Camille_fm, 1, 0, 1, no
39966411,  lucamoriconi, 2, 0, 2, no
346068070,  MarisaPancrazia, 1, 0, 1, no
2191180106,  Toremon50, 1, 0, 1, no
400663563,  dile_diletta, 1, 0, 1, no
71360623,  sirLac, 1, 0, 1, no
406130029,  carprato72, 1, 0, 1, no
382463247,  MarioRiccardiJr, 1, 0, 1, no
3479422576,  MikT18, 2, 0, 2, no
425880617,  andrea_natoli, 1, 0, 1, no
50574247,  gerrox, 1, 0, 1, no
365042365,  Mancuso_Mario, 1, 0, 1, no
1653121038,  NunzioParaggio, 1, 0, 1, no
546214663,  luccy8, 1, 0, 1, no
2541629306,  SabrinaGBernard, 1, 0, 1, no
405538337,  gigliolacaridi, 1, 0, 1, no
900175562,  VSerasin, 1, 0, 1, no
1341730716,  GiuliettaVanni, 2, 0, 2, no
191491710,  Sasycascone, 1, 0, 1, no
404650482,  alesmaffei, 1, 0, 1, no
167613639,  Filoreba, 1, 0, 1, no
760831854987583489,  ComitatoNOlomb, 1, 0, 1, no
803945815546925056,  ModaCfina, 2, 0, 2, no
2565231604,  MariaritaPolic1, 1, 0, 1, no
744169355806646276,  czritz80, 1, 0, 1, no
2986015264,  clama0912, 1, 0, 1, no
3053190841,  MrJean0, 1, 0, 1, no
55046674,  StephenDog, 1, 0, 1, no
4839452781,  PHJams, 1, 0, 1, no
745953463339737089,  sheep_floyd, 1, 0, 1, no
484617036,  kataroc, 1, 0, 1, no
2360804453,  gabriellacino, 2, 0, 2, no
2536585871,  Fabio_Cala, 2, 0, 2, no
506321342,  CorradiniLidia, 1, 0, 1, no
784082079877308417,  larawines, 2, 0, 2, no
106548241,  MarioFurore, 2, 0, 2, no
2978182583,  avanpostit, 2, 0, 2, no
3424014040,  48b59ce8215f418, 1, 0, 1, no
4236725416,  MaurizioCasu1, 1, 0, 1, no
121500784,  Viviana_cdl, 1, 0, 1, no
4080263177,  CosimocsS, 1, 0, 1, no
64025076,  roscura, 1, 0, 1, no
2282549490,  grecben, 1, 0, 1, no
844437781,  SaraBianchiHp, 1, 0, 1, no
428341973,  AngeloZaza, 1, 0, 1, no
1267171424,  Eposmail, 3, 0, 3, no
1585539301,  _platia, 1, 0, 1, no
891059384,  Dwalingen, 1, 0, 1, no
2585808948,  oude_lap, 1, 0, 1, no
786172092827914240,  adrianacacciop4, 3, 0, 3, no
753584798187257856,  gmrcmrg, 1, 0, 1, no
58211648,  AstioCiarlatani, 2, 0, 2, no
2394836599,  al_vicentini, 2, 0, 2, no
464076139,  SandraCasini, 1, 0, 1, no
376691595,  PaoloCaminiti1, 3, 0, 3, no
367231920,  anastasiamadam, 1, 0, 1, no
489243124,  gabrigiaci, 1, 0, 1, no
704446219079303169,  gmslongo, 7, 0, 7, no
2326687558,  Logyc0, 2, 0, 2, no
3053146135,  kurston__childs, 1, 0, 1, no
2359470090,  Muz_Riccardo, 1, 0, 1, no
2443995940,  dyam0n, 2, 0, 2, no
18899481,  wawos, 1, 0, 1, no
52738973,  sam71it, 2, 0, 2, no
4396381822,  Cloes86, 1, 0, 1, no
112266583,  ChiaraMaria1, 1, 0, 1, no
2223643491,  ctognoni69, 3, 1, 2, no
827285665,  raffidecar, 1, 0, 1, no
1247496404,  francacec, 2, 0, 2, no
3065888662,  slmplylovebook, 1, 0, 1, no
3053073007,  DamnImHands0m, 1, 0, 1, no
3298383251,  paravanie, 2, 0, 2, no
431517647,  CasanovaGabri, 1, 0, 1, no
558012025,  Aprile5404, 1, 0, 1, no
1355065410,  elviraqelly, 1, 0, 1, no
3363741953,  clacam52, 2, 0, 2, no
95899146,  alemichetti, 1, 0, 1, no
434839311,  antonioleotti1, 1, 0, 1, no
4830038927,  MariadelGaudio3, 1, 0, 1, no
453357659,  GianmarioNardi, 2, 0, 2, no
911236676,  JacopoFranchi87, 1, 0, 1, no
22604733,  gpiroddi, 1, 0, 1, no
702219779,  delfyn0, 3, 0, 3, no
148323458,  Toscanoirrivere, 1, 0, 1, no
15167463,  andrea_ciulu, 1, 0, 1, no
33464175,  escapista, 1, 0, 1, no
3881560054,  OrnellaGianni, 2, 0, 2, no
1069299457,  LauraArtt, 2, 0, 2, no
147669550,  stedubla, 2, 0, 2, no
2884205577,  marco_minari, 1, 0, 1, no
752617567,  FabrizioRho, 1, 0, 1, no
2394173556,  Vincenza81, 3, 0, 3, no
18483428,  giuseppecarlino, 3, 0, 3, no
3287666158,  ritabianco27750, 1, 0, 1, no
273466314,  hermzec, 1, 0, 1, no
1015915699,  prevoyancemusic, 1, 0, 1, no
485940959,  StefaniaRibaldi, 1, 0, 1, no
302157714,  emilio_longhi, 1, 0, 1, no
225535128,  ACTavecchio, 1, 0, 1, no
367192807,  PeterCiaccio1, 1, 0, 1, no
44423232,  Minimaki, 2, 0, 2, no
2562811728,  fillese, 1, 0, 1, no
779998996509102080,  Jovamd, 2, 0, 2, no
17674830,  Luigi57, 4, 0, 4, no
721639933199433728,  FDC_64, 1, 0, 1, no
460064675,  epizeusi, 1, 0, 1, no
391247874,  scaradozzis, 1, 0, 1, no
485629253,  GiamFalasca, 1, 0, 1, no
1657179714,  AngeloInfoposta, 1, 0, 1, no
3344737672,  MichelVietto, 1, 0, 1, no
427374134,  GennaroIaccari1, 1, 0, 1, no
2980810769,  KainaPi, 1, 0, 1, no
108700808,  nialltalk, 1, 0, 1, no
416890492,  Spinmads, 1, 0, 1, no
2611246133,  LeoPampana, 1, 0, 1, no
3601983563,  travellerino, 2, 0, 2, no
19358428,  Fondano, 1, 0, 1, no
630177246,  NCenti, 1, 0, 1, no
753715333173747712,  Martinaitaliana, 1, 0, 1, no
2317453454,  DanielP26616851, 1, 0, 1, no
483957067,  IperDave, 1, 0, 1, no
204858193,  totofalzo, 2, 0, 2, no
2844869322,  DreamescapePs, 2, 0, 2, no
44903309,  funkyoulow, 2, 0, 2, no
111141801,  lucameoli, 2, 0, 2, no
484771907,  lucianocapone, 6, 0, 6, no
111544472,  ziopippi, 1, 0, 1, no
27406951,  anto_giordano, 2, 0, 2, no
1007509333,  CongiuRita, 1, 0, 1, no
485060948,  RobertoSeri, 1, 0, 1, no
2414699069,  m_spagna, 1, 0, 1, no
469539285,  daffi15, 1, 0, 1, no
2492501665,  NoJobFactor, 1, 0, 1, no
2893850735,  me_musu, 1, 0, 1, no
1067991134,  FranciscoBaston, 6, 2, 4, no
237526834,  baronePino, 2, 0, 2, no
752768895031934977,  moraxestate, 2, 0, 2, no
3230638600,  leti1848, 1, 0, 1, no
748991771812724736,  Raffael52726274, 1, 0, 1, no
562058865,  marco_fabre, 1, 0, 1, no
437419192,  BadMoney1, 2, 0, 2, no
2986498385,  Dario44614299, 1, 0, 1, no
2439123325,  Strabicofilm, 2, 0, 2, no
3027511292,  guendalinazucc1, 1, 0, 1, no
492880987,  monika_gei, 2, 0, 2, no
460440475,  lucabelv, 1, 0, 1, no
416362189,  centrocopieplus, 1, 0, 1, no
430019208,  NataliaAugias, 1, 0, 1, no
742426208,  333Ludo, 1, 0, 1, no
615223,  antolo, 1, 0, 1, no
542549596,  ElisaFratangeli, 1, 0, 1, no
429881927,  PinballWizard69, 2, 0, 2, no
2385396421,  AngeParisi, 7, 0, 7, no
741454154355335169,  Bracle_Bracelet, 1, 0, 1, no
37512469,  sturli, 2, 0, 2, no
1269285138,  DanieleRuscetta, 4, 0, 4, no
500566096,  paolorm63, 1, 0, 1, no
1364490824,  FrancescSaba, 1, 0, 1, no
999870901,  LAgliottone, 1, 0, 1, no
1239893269,  Lorenzo_Lorenz_, 1, 0, 1, no
1062650718,  stenepoti, 1, 0, 1, no
2617478164,  liber13daniele, 1, 0, 1, no
29463669,  thomasfabbri, 2, 0, 2, no
1091619451,  Aldo_Marino1, 3, 0, 3, no
1242040304,  favaditopo, 1, 0, 1, no
487534247,  oberdan20, 1, 0, 1, no
746418917481000960,  coridastadio, 1, 0, 1, no
478036830,  bibbi77, 1, 0, 1, no
374549108,  PeppeLanzo, 1, 0, 1, no
2524395151,  Matteo_6alli, 1, 0, 1, no
359240143,  _lessimon, 1, 0, 1, no
222628269,  carlofavaretti, 1, 0, 1, no
314192197,  Giuseppe975, 1, 0, 1, no
1111564699,  FlorenzoDoino, 1, 0, 1, no
48768732,  ledep, 2, 0, 2, no
855282331,  federicod1vita, 1, 0, 1, no
2819021613,  RobVicaretti, 1, 0, 1, no
263086848,  daniel1981_, 1, 0, 1, no
348321186,  31clelia, 1, 0, 1, no
2831182421,  PrimianoCaputo, 1, 0, 1, no
2293406660,  gaspamari, 2, 1, 1, neutral
40419167,  enricabelli, 1, 0, 1, no
712194014376755204,  libericittadin1, 1, 0, 1, no
953923741,  RGagnor, 1, 0, 1, no
795028576903069697,  MenteAspra, 2, 0, 2, no
398609310,  DalilaDiGioia, 1, 0, 1, no
190400882,  willyroutard64, 1, 0, 1, no
504631659,  FrancescoCoccoT, 5, 1, 4, no
455285487,  raggiovioletto, 1, 0, 1, no
759071073447075840,  LaerteGrimani, 1, 0, 1, no
411401928,  isacatalano, 1, 0, 1, no
2319480523,  ducci_elena, 1, 0, 1, no
838370179,  Marcellovalent_, 1, 0, 1, no
520827419,  Bibosechi, 2, 0, 2, no
352421269,  lolloriva, 1, 0, 1, no
2407044221,  _Francesco21_, 1, 0, 1, no
2751098044,  0e5090f3add24cf, 1, 0, 1, no
3722853495,  c_forestier, 2, 0, 2, no
119896656,  h10pippuz, 1, 0, 1, no
581617316,  PelosiSimone, 2, 0, 2, no
132241120,  Talbame, 1, 0, 1, no
2758461707,  fernalon165, 1, 0, 1, no
914628558,  RaMaurizio, 1, 0, 1, no
302570062,  lincedibeozia, 1, 0, 1, no
201501452,  MU329ParcosudMI, 1, 0, 1, no
153086571,  PietroGFloris, 1, 0, 1, no
16237091,  SilviaBorrelli, 1, 0, 1, no
385522939,  PlazaBologna, 1, 0, 1, no
425366243,  GBeaujeu, 2, 0, 2, no
779073210,  gregoriorapis, 1, 0, 1, no
374392352,  gegeste, 1, 0, 1, no
1283872520,  NellyEnne, 1, 0, 1, no
214034070,  AndreaBettio, 1, 0, 1, no
4827279141,  nicociccio80, 2, 0, 2, no
401330392,  Gibimassidda, 1, 0, 1, no
539785618,  Aledebe87, 1, 0, 1, no
9796912,  p4r0d5, 1, 0, 1, no
611760872,  MattiaAliani, 1, 0, 1, no
224652345,  gushand77, 1, 0, 1, no
708385115,  LfLuisafernando, 1, 0, 1, no
747214833083285504,  gabiotakmay1, 1, 0, 1, no
1381419367,  mt_par, 1, 0, 1, no
1333927363,  arnapiero, 1, 0, 1, no
352869389,  palumbo_enzo, 1, 0, 1, no
586625915,  MarinoPaltani, 1, 0, 1, no
2749292998,  ebarbieri311, 1, 0, 1, no
2799227808,  niyscha38, 1, 0, 1, no
185378398,  Banimalu, 1, 0, 1, no
68799306,  clem1960, 1, 0, 1, no
632083173,  mterrych, 1, 0, 1, no
4698044293,  imbiancaturaon1, 1, 0, 1, no
289878978,  rod1164, 1, 0, 1, no
2831385909,  EMemelli, 1, 0, 1, no
326016690,  MarBingham, 1, 0, 1, no
2240925978,  jhvefer, 2, 0, 2, no
1874120773,  INCNews, 1, 0, 1, no
3347326925,  AntoMorly, 1, 0, 1, no
3012027837,  AfgilM, 1, 0, 1, no
27352002,  GarGamer89, 1, 0, 1, no
726913921186185217,  theartofinter, 1, 0, 1, no
632427322,  Ostrega_, 1, 0, 1, no
721371014697992192,  mellegrino981, 2, 0, 2, no
573406649,  Meg_Fra, 2, 0, 2, no
137785529,  LCasiraghi, 1, 0, 1, no
2875309297,  Clamaialove, 1, 0, 1, no
2904847577,  JulioCesare12, 1, 0, 1, no
291596806,  SerenaGori, 1, 0, 1, no
595317798,  gginopino, 1, 0, 1, no
1190936910,  robert_mang, 1, 0, 1, no
1568383296,  gerardo_americo, 2, 0, 2, no
463775932,  justgiuli, 1, 0, 1, no
225718519,  very_1988, 1, 0, 1, no
3077774103,  cristallisale, 3, 0, 3, no
768519104353427458,  claudiodiegotom, 1, 0, 1, no
471302156,  CamonitaNatale, 1, 0, 1, no
475142274,  Gioanfuso, 1, 0, 1, no
293016987,  ErcoleSpizzirri, 1, 0, 1, no
418505620,  dessoandre, 1, 0, 1, no
446106924,  Erre94, 2, 0, 2, no
1417869506,  federicasalvi3, 3, 0, 3, no
169326263,  Mondo245, 1, 0, 1, no
516736949,  vairoemiliomari, 1, 0, 1, no
482915224,  yule1957, 1, 0, 1, no
1420698048,  StephenStrano, 1, 0, 1, no
211194021,  daktales, 2, 0, 2, no
22179579,  arturosalerni, 1, 0, 1, no
1513695745,  adimaio47, 1, 0, 1, no
786538326438227968,  gaggeroemilia53, 2, 0, 2, no
22752409,  effeciemme, 2, 0, 2, no
1424029538,  Kelben_78, 2, 0, 2, no
2760719741,  cotina125, 1, 0, 1, no
3228057418,  corpippo1167, 1, 0, 1, no
4744844236,  LinoDimar, 1, 0, 1, no
461895249,  andreabobi, 2, 0, 2, no
759460766273695744,  mercvinugl, 2, 0, 2, no
3340971070,  UglEugenio, 2, 0, 2, no
466690162,  GScacciavill, 1, 0, 1, no
2392904948,  UGLLazio, 1, 0, 1, no
365511674,  GiardinoVito, 2, 0, 2, no
3138893175,  DDaucelli, 1, 0, 1, no
2677043751,  brunaroda_roda, 3, 0, 3, no
2571683155,  Segr_Costruz_CE, 1, 0, 1, no
754020946399420416,  amedeo_gismondi, 1, 0, 1, no
1088783053,  giannimus, 1, 0, 1, no
487681909,  Almerico62, 1, 0, 1, no
1079703907,  Alefrank73, 1, 0, 1, no
2889104050,  annacardamone80, 1, 0, 1, no
2291548278,  lorelui_fede, 1, 0, 1, no
421336323,  LeongitoEduardo, 2, 0, 2, no
176168558,  salvo_ferrauto, 1, 0, 1, no
289324170,  antoniodelcorso, 1, 0, 1, no
1557730285,  GiuseppeACM81, 1, 0, 1, no
477686599,  piemonte_is, 1, 1, 0, yes
714179021110714370,  lu19lucia, 4, 1, 3, no
968486509,  Cavicchioli_R, 1, 1, 0, yes
2358732424,  mimmetta18, 1, 1, 0, yes
2407992892,  damiano_dlz, 1, 1, 0, yes
949565683,  BarbaraAnton73, 2, 1, 1, neutral
1921210748,  gibiffella, 12, 5, 7, no
1322584279,  a_g_giuli, 2, 1, 1, neutral
804535763039907840,  corrado06021302, 2, 1, 1, neutral
2494342256,  ClaudiaGualdana, 2, 1, 1, neutral
1233585757,  paolino008, 6, 4, 2, yes
3066008697,  jeitoapp, 2, 0, 2, no
3154570593,  AngelaChinca, 1, 0, 1, no
757757642,  MicheleArcange7, 1, 0, 1, no
1071052908,  marcogallon84, 2, 0, 2, no
746703984,  therealtomtom1, 1, 0, 1, no
4882567287,  micettanera51, 7, 0, 7, no
340148698,  AlbanoAntonio, 1, 0, 1, no
2364035995,  spazioconsumato, 6, 0, 6, no
126344012,  CODICIassconsum, 6, 0, 6, no
546285344,  ItEsposito, 10, 0, 10, no
826764168,  isa_gianni, 2, 0, 2, no
336716592,  EdoardoRosina, 1, 0, 1, no
16222806,  massimo_russo, 1, 0, 1, no
531296288,  MafaldaraS, 2, 0, 2, no
364241357,  PeppeGoool, 1, 0, 1, no
473042699,  gracivaleria, 1, 0, 1, no
2811584671,  ghiotto68, 3, 0, 3, no
475930507,  FM_Emmegi, 1, 0, 1, no
519800270,  PTorchi, 2, 0, 2, no
4689813482,  appia_day, 9, 0, 9, no
789553715766300673,  minuzzo3, 2, 0, 2, no
27636080,  manzolf, 1, 0, 1, no
116450737,  pradhaus, 1, 0, 1, no
2359198747,  juanne78, 1, 0, 1, no
2894480764,  adiafora_, 1, 0, 1, no
2849661244,  keenaroma, 1, 0, 1, no
713001212535246848,  adrydeedee, 6, 0, 6, no
4200779861,  StefanoDeAnge16, 3, 0, 3, no
1462996453,  dad082, 2, 0, 2, no
146185718,  carletto1973, 1, 0, 1, no
744497332637548544,  ArbitElegan, 1, 0, 1, no
545522033,  Popopozau, 4, 0, 4, no
163866571,  SamCacciolo, 1, 0, 1, no
1039724564,  chiara_cecco, 1, 0, 1, no
2746542772,  tambojosef, 1, 0, 1, no
330260849,  Rob_Rondinelli, 3, 0, 3, no
492555590,  silvialeonzi, 2, 0, 2, no
494909390,  cristinascappa, 1, 0, 1, no
1510018086,  flaminiasabate1, 1, 0, 1, no
1332450144,  DePaoletto81, 3, 0, 3, no
254707653,  blend974, 1, 0, 1, no
500835651,  MarioBuonanno2, 2, 1, 1, neutral
776040035049152512,  KingscrossArts, 4, 0, 4, no
1011745790,  MicheleDesogus, 1, 0, 1, no
14127198,  Clutcher, 1, 0, 1, no
100327059,  sergiofarina, 2, 0, 2, no
802515513729568772,  alex_sukrat, 1, 0, 1, no
1270670695,  loreleo1, 1, 0, 1, no
433612192,  bubajenny, 2, 0, 2, no
163896252,  iltorodilascaux, 1, 0, 1, no
2822701804,  CicloMamaa70, 1, 0, 1, no
3059740810,  vale_bmb_, 1, 0, 1, no
313390906,  MatteoLanzafame, 1, 0, 1, no
256956548,  wikiale, 1, 0, 1, no
475922139,  gianlucanitti, 1, 0, 1, no
3128854252,  felicesgambati6, 1, 0, 1, no
1289425303,  _sil93_, 1, 0, 1, no
1632907651,  fr40452375, 1, 0, 1, no
610333042,  CorradoMoretti, 1, 0, 1, no
810571969,  MatteoCollacchi, 1, 0, 1, no
212402248,  ArtMarius2, 2, 0, 2, no
796340446221963264,  Manux1981, 1, 0, 1, no
2902746298,  SarettaAsR79, 2, 0, 2, no
2361486773,  ArthurMrNewton, 1, 0, 1, no
307531468,  MartaGiannini, 1, 0, 1, no
210760071,  Eib63, 1, 0, 1, no
2526806834,  Sabinella81, 1, 0, 1, no
2729815985,  tambotto1, 1, 0, 1, no
223926395,  fedebarba1, 2, 0, 2, no
401465326,  MarcoRosso3, 1, 0, 1, no
445403898,  MR_Hurricane76, 1, 0, 1, no
510681191,  NinaAcocella, 1, 0, 1, no
886667504,  andreapolelli, 1, 0, 1, no
758670892251672576,  vice_questore, 1, 0, 1, no
379169704,  dexgio, 5, 0, 5, no
1192428948,  gelsomina68, 1, 0, 1, no
1531677930,  AntoVampi, 3, 0, 3, no
2576729006,  carlo_fusi, 1, 0, 1, no
593111769,  ILmirtese, 1, 0, 1, no
422798757,  CacciottiMarco, 1, 0, 1, no
435199410,  seaofrome, 1, 0, 1, no
3080630010,  robybarbieri82, 1, 0, 1, no
479724026,  patriziav62, 1, 0, 1, no
2345274633,  GliubichLaStefy, 1, 0, 1, no
1280563567,  BeatriceGulino, 1, 0, 1, no
453444597,  ElenaPro1, 1, 0, 1, no
462226444,  morenophilips, 1, 0, 1, no
434232469,  FedericaTonolin, 1, 0, 1, no
2997506451,  antonio19523, 1, 0, 1, no
424385301,  valentinasovier, 1, 0, 1, no
2247685331,  Elenaguglielmo1, 1, 0, 1, no
1070780718,  elicrisa25, 2, 0, 2, no
34196694,  cottytorino, 1, 0, 1, no
19604974,  and_mic, 1, 0, 1, no
454463805,  AndreaAscolese, 1, 0, 1, no
539050403,  SilCap78, 1, 0, 1, no
2644978389,  andreasarti64, 5, 0, 5, no
471018832,  mlongo63, 1, 0, 1, no
511271721,  Polidorox, 1, 0, 1, no
342905172,  lallachic, 1, 0, 1, no
2430631222,  Lucressio, 1, 0, 1, no
542852191,  CrisPalazzini, 1, 0, 1, no
1249983906,  mapivi63, 1, 0, 1, no
432886301,  le7Grace, 3, 0, 3, no
1414866230,  emilianobarbo78, 3, 0, 3, no
2198396045,  BovoGb, 1, 0, 1, no
760915205064892416,  ivanacuscito72, 1, 0, 1, no
19590970,  AssiduoLettore, 1, 0, 1, no
419772240,  marisveva, 1, 0, 1, no
256508868,  pin_klo, 2, 0, 2, no
2360811240,  Mirkomik88, 1, 0, 1, no
442690376,  superss74, 1, 0, 1, no
195097613,  mrborn2lose, 1, 0, 1, no
1650097483,  DNesli91, 1, 0, 1, no
147280554,  alchemistyc, 2, 0, 2, no
2604763780,  donafreedom, 1, 0, 1, no
358671300,  MilMass, 1, 0, 1, no
619178676,  DrABernetti, 4, 0, 4, no
796287659106832384,  bettachoo, 2, 0, 2, no
87962698,  LeonardoCaffo, 1, 0, 1, no
471402866,  lucagent, 1, 0, 1, no
288656733,  whiteblusky, 1, 0, 1, no
1146459277,  superkelly74, 1, 0, 1, no
367712119,  erpo_mata, 1, 0, 1, no
22641010,  Ra_11, 1, 0, 1, no
4747752975,  nmasini75, 1, 0, 1, no
1316230242,  RiccardoRocca92, 1, 0, 1, no
292865253,  Luca_Masala, 1, 0, 1, no
441743492,  arcoincielo, 1, 0, 1, no
4893365613,  ladaniMilolli, 1, 0, 1, no
533305986,  LucaPentrella, 3, 0, 3, no
60882004,  GROSSYGROSSY, 1, 0, 1, no
611063655,  ScrittureRai, 1, 0, 1, no
1518621589,  fabiocavataio, 2, 0, 2, no
2294254286,  Ale_Muzi, 1, 0, 1, no
23049915,  mbeccantini, 1, 0, 1, no
4023291459,  patriccia66, 2, 0, 2, no
1018058756,  IoGeorgiaLepore, 1, 0, 1, no
2973415361,  giovanna_bellu, 1, 0, 1, no
746331587428638720,  odal_marek, 1, 0, 1, no
420538798,  francescoallori, 1, 0, 1, no
548471081,  albertariccardi, 4, 0, 4, no
461932634,  CultureRoma, 1, 0, 1, no
710519954,  EmilianaEmpa24, 1, 0, 1, no
458721979,  anmur2604, 2, 0, 2, no
384304658,  leob1one, 1, 0, 1, no
47896750,  THNK_different, 1, 0, 1, no
18163631,  gabcuc, 1, 0, 1, no
715521782787280896,  518576c22ce2411, 1, 0, 1, no
2982433636,  VIVINSTRADA, 2, 0, 2, no
1037851609,  MaxDG63, 4, 0, 4, no
147943641,  pavlov_813, 1, 0, 1, no
16948721,  vincenzo_brana, 1, 0, 1, no
1278858271,  Ri_Ghetto, 1, 0, 1, no
1043191939,  Alestu96, 1, 0, 1, no
335451671,  DenisePezzoli, 1, 0, 1, no
370705320,  7TonyStark7, 1, 0, 1, no
978186865,  LMalanotteno, 2, 0, 2, no
556447537,  bloom014, 1, 0, 1, no
203197985,  TeoFerra, 1, 0, 1, no
1200638798,  1000FSDanny, 1, 0, 1, no
4172244862,  Elisa18125672, 2, 0, 2, no
55551432,  RomaSette, 1, 0, 1, no
484958212,  MonicaCillario, 1, 0, 1, no
386501517,  Lolicchia, 1, 0, 1, no
12918562,  telaio, 2, 0, 2, no
368485266,  OmarAburgeiba, 1, 0, 1, no
17306340,  Marspezia, 1, 0, 1, no
552720518,  frapapas, 3, 0, 3, no
1930280630,  bettaserafini, 1, 0, 1, no
146477952,  TychoBrahe29, 1, 0, 1, no
752871654070575104,  Marina73116437, 1, 0, 1, no
1126184292,  claugasb, 1, 0, 1, no
299163354,  Laimawen, 1, 0, 1, no
3121197057,  phoenix_fabio, 1, 0, 1, no
581933637,  chicchese, 1, 0, 1, no
296318811,  LavaBarocca, 1, 0, 1, no
491302624,  Tasc_abile, 2, 0, 2, no
767397722857021442,  SStiletti, 1, 0, 1, no
800049301443506176,  Cris19112016, 4, 0, 4, no
16537991,  alexiarojas, 1, 0, 1, no
3599907255,  angheran70, 1, 0, 1, no
3215882349,  b_linardi, 1, 0, 1, no
2822232480,  neveintasca, 1, 0, 1, no
541741004,  Frra_Roma, 2, 0, 2, no
2936864140,  giandesan1, 3, 0, 3, no
3425678355,  callmejorjor, 3, 0, 3, no
3226534781,  steugo77, 1, 0, 1, no
3334909204,  RBascoccia, 1, 0, 1, no
702175480905076736,  Mako76_, 2, 0, 2, no
247856797,  Silvia_D_A, 1, 0, 1, no
205210776,  lady_xanax, 1, 0, 1, no
407898601,  targeno, 11, 0, 11, no
491173848,  marcofratta, 1, 0, 1, no
490798068,  Frbarberini, 1, 0, 1, no
753725376036237314,  Fabrizi59139932, 1, 0, 1, no
144490047,  masaless, 1, 0, 1, no
747315391,  CalzolariG, 1, 0, 1, no
716208405459902464,  santited93, 2, 0, 2, no
553844061,  loretocapaldi, 1, 0, 1, no
497349209,  DOC_83_, 1, 0, 1, no
398090760,  giulyJules, 1, 0, 1, no
2393674071,  tonimercuri, 1, 0, 1, no
307999300,  la_gatti, 1, 0, 1, no
2347274438,  ilRottamatore, 2, 0, 2, no
989147641,  ManekiStra, 1, 0, 1, no
296733937,  EnricoStefano, 1, 0, 1, no
13282462,  sampietrino, 2, 0, 2, no
10059372,  bastet, 2, 0, 2, no
715785486,  KillerWhaleDE, 1, 0, 1, no
4551451042,  ERicrescita, 1, 0, 1, no
2767883764,  goblin380, 4, 0, 4, no
413430844,  ValerioCurcio, 1, 0, 1, no
1684468244,  AglioVestito, 2, 0, 2, no
1323216032,  mauro_bazzani, 1, 0, 1, no
1288257872,  snorristorluson, 3, 0, 3, no
1650047688,  ElgaBaviera, 1, 0, 1, no
796996456561442816,  tatina8909, 2, 0, 2, no
565784508,  MercurioPsi, 6, 0, 6, no
795987761622827008,  CittaMetroRoma, 1, 0, 1, no
36801345,  vgibertini, 1, 0, 1, no
2761842103,  RFontebuoni, 1, 0, 1, no
1585424048,  urbiker, 1, 0, 1, no
484168007,  TrabuccoGiorgio, 1, 0, 1, no
2936087235,  scerbopierre, 1, 0, 1, no
1722590094,  EmaMenichetti, 1, 0, 1, no
54913840,  AleCima, 1, 0, 1, no
2393684735,  nazgul_mikk983, 1, 0, 1, no
2878068448,  valesecisei, 1, 0, 1, no
1161059923,  Brunissimo2007, 1, 0, 1, no
229848654,  AleRBW, 1, 0, 1, no
4655664915,  FrSocialista, 1, 0, 1, no
195427066,  claudiodalpiaz, 1, 0, 1, no
703622291746398208,  JDeLaCouronne, 2, 0, 2, no
492474319,  JantasOO, 2, 0, 2, no
719098026434945025,  VivMilano, 1, 0, 1, no
23735287,  massi_tm, 1, 0, 1, no
309064441,  LogikSEO, 1, 0, 1, no
192850838,  AlanTheCrow, 2, 0, 2, no
3386953695,  martaleonardi63, 1, 0, 1, no
3960264747,  OsservatriceRM, 1, 0, 1, no
317858250,  AdoFRANZO, 1, 0, 1, no
1098132554,  AccAccoglienza, 1, 0, 1, no
2363796541,  listamarchini, 1, 0, 1, no
264674074,  78alexb, 3, 0, 3, no
156780554,  mr_pac, 1, 0, 1, no
382657928,  andrearomeod, 12, 0, 12, no
244530269,  giochini, 1, 0, 1, no
1093056480,  DesyNieves, 1, 0, 1, no
1681033327,  PdP_Cipo, 1, 0, 1, no
158139361,  ranierioffice, 1, 0, 1, no
428369864,  asrandrea82, 1, 0, 1, no
1227823358,  RInfascelli, 1, 0, 1, no
362353528,  MartaCoccoluto, 2, 0, 2, no
1225690944,  OpusPaulicium, 1, 0, 1, no
84030659,  SignoraAquilone, 1, 0, 1, no
821577050,  elinssen, 1, 0, 1, no
43339170,  Fgranese, 1, 0, 1, no
396857578,  Il_Reca, 3, 0, 3, no
3795663855,  Val_Gentili, 1, 0, 1, no
68460492,  aledardes, 1, 0, 1, no
14115225,  francesca_defeo, 1, 0, 1, no
1210858525,  TCampomori, 1, 0, 1, no
476743488,  patriziabiagin1, 1, 0, 1, no
803412473420402688,  bamalighmo1970, 1, 0, 1, no
525268787,  reporterfreelen, 1, 0, 1, no
569218257,  MichaelMurphyKO, 1, 0, 1, no
802996331426054145,  tzaridojdig1981, 1, 0, 1, no
54203549,  nicolerimbaud, 1, 0, 1, no
1704187662,  stellina_66, 1, 0, 1, no
3069593560,  24zampe, 1, 0, 1, no
486786904,  dasivo, 1, 0, 1, no
2634426862,  roximom56, 1, 0, 1, no
457391007,  tombac77, 1, 0, 1, no
1061331960,  sildavbarman, 1, 0, 1, no
4212260849,  Ever_Let_Me_Go, 4, 0, 4, no
1170199861,  AnniBoros, 2, 0, 2, no
1219654200,  silviapinci, 5, 0, 5, no
1277525125,  fedegregs, 1, 0, 1, no
380788364,  Voca92, 1, 0, 1, no
170455300,  Loislane6576, 4, 0, 4, no
444510706,  claudiorizza1, 2, 0, 2, no
434184878,  brutigan, 1, 0, 1, no
1288497643,  Matteo_Munno, 1, 0, 1, no
479005527,  CeratoIvana, 1, 0, 1, no
2876453600,  _AntonioMartone, 1, 0, 1, no
706051793843843072,  stregattaccio, 1, 0, 1, no
795382845413920769,  ParoleStampate, 1, 0, 1, no
799582147392798720,  LibriPer, 1, 0, 1, no
785143654805598208,  scrivolandia_st, 1, 0, 1, no
768422036758794240,  scrivolandia, 1, 0, 1, no
798180093520740352,  lamusicafa, 1, 0, 1, no
795413849381998592,  notturnoselvag1, 1, 0, 1, no
799579655808446464,  NelmioD, 1, 0, 1, no
3879275914,  Michel_7104, 1, 0, 1, no
1175066310,  LicyaVari, 1, 0, 1, no
2369493982,  Daniele80Londra, 1, 0, 1, no
901807579,  PauloRoberto5F, 1, 0, 1, no
2390872007,  nevalbarlas, 1, 0, 1, no
421863300,  fperuginipz, 1, 0, 1, no
478979804,  nanogelato, 6, 0, 6, no
594767012,  davideferrocom, 1, 0, 1, no
27874207,  andrewbags, 2, 1, 1, neutral
2583974283,  Mecmao, 1, 0, 1, no
3868881574,  nanapiza1, 1, 0, 1, no
1231193545,  Ranici91, 1, 0, 1, no
410038651,  Piestef1941, 2, 0, 2, no
110769331,  giuliaviolante, 1, 0, 1, no
390955003,  maurafrasca, 2, 0, 2, no
4502259255,  GangemiLaura, 1, 0, 1, no
780154819,  BrunoMossa, 1, 0, 1, no
2946220173,  divitocinema, 2, 0, 2, no
51772481,  lu_garg, 1, 0, 1, no
1204749252,  amiriangie, 6, 3, 3, neutral
747307420276264960,  Cmfrtan, 5, 0, 5, no
1351938944,  Wanderlust_94, 1, 0, 1, no
235318725,  Carla_Canale_74, 1, 0, 1, no
2874870303,  neurosergio, 1, 0, 1, no
92749046,  davidecancarini, 1, 0, 1, no
4019514868,  sisterofnight85, 1, 0, 1, no
1979545116,  giorgioborghett, 1, 0, 1, no
80875024,  kyraitaly, 2, 0, 2, no
333960904,  fedeskier, 1, 0, 1, no
2397805103,  Vojka5, 1, 0, 1, no
2804052821,  liboni83, 11, 0, 11, no
574709708,  volpini_laura, 1, 0, 1, no
2821779182,  8MaryLeaf, 1, 0, 1, no
50950136,  m4nzi, 1, 0, 1, no
78592366,  iCeccio, 1, 0, 1, no
3296247557,  Scudierino, 1, 0, 1, no
708535368,  bubafra, 2, 0, 2, no
2563027047,  rivegauche_s, 1, 0, 1, no
409559794,  1964l, 1, 0, 1, no
472000716,  Nucci76, 1, 0, 1, no
366107110,  ELENACICCOZZI, 3, 0, 3, no
486511597,  topoteppa, 2, 0, 2, no
44651391,  MelaFerrentino, 3, 0, 3, no
2866107063,  penylouma1305, 1, 0, 1, no
2606143812,  ziamaruska, 1, 0, 1, no
397585905,  Myrti_C, 2, 0, 2, no
1611207038,  UomoPiuSemplice, 1, 0, 1, no
986768443,  regkrieger, 1, 0, 1, no
72825411,  enrico1964, 1, 0, 1, no
1163993796,  FaBenTO69, 2, 0, 2, no
1315150957,  goldenrabbit53, 1, 0, 1, no
1120123548,  Mrstoscani, 1, 0, 1, no
32166623,  Vitellozzo, 1, 0, 1, no
4403034262,  uponmyshoulders, 1, 0, 1, no
784079483301134337,  oliodipalma, 1, 0, 1, no
436855201,  LeoMangiavacchi, 1, 0, 1, no
416638388,  28gradi, 1, 0, 1, no
554634650,  Miazuiro, 2, 1, 1, neutral
805544853132165120,  Ilpapero88, 2, 0, 2, no
1219027387,  lorela70, 1, 0, 1, no
3307289301,  Giulibuww, 1, 0, 1, no
372877605,  CORRYAZ, 2, 0, 2, no
147234729,  eleverni, 1, 0, 1, no
1075073228,  IngegnerSEO, 3, 0, 3, no
2391740046,  ErBibbitaro, 1, 0, 1, no
52858066,  gr_andyx, 1, 0, 1, no
340408011,  Vipdeldivano, 4, 0, 4, no
155856263,  AntonellaRan, 2, 0, 2, no
400732379,  elenagpolidori, 1, 0, 1, no
737923249070346240,  SuicideSquiddi, 1, 0, 1, no
1229455004,  vichelaloss, 1, 0, 1, no
442214344,  claudio_spadoni, 1, 0, 1, no
385994748,  hip108092, 1, 0, 1, no
165051584,  _diana87, 1, 0, 1, no
1276107571,  ariannalucci27, 1, 0, 1, no
46355863,  Guytano__, 1, 0, 1, no
3043696354,  BrunoContiFA7, 1, 0, 1, no
332840780,  aledicicco, 1, 0, 1, no
1601206675,  non9906, 1, 0, 1, no
55053428,  Seljess, 1, 0, 1, no
239754039,  fire4wd, 1, 0, 1, no
456648155,  GioBeninato, 1, 0, 1, no
2342862611,  stefaniaes76, 1, 0, 1, no
3296663865,  Josepaddeu, 1, 0, 1, no
494383010,  Zorba4Zorba, 1, 0, 1, no
20224538,  antoporfido, 1, 0, 1, no
249321169,  InFondoAllAnima, 1, 0, 1, no
483965262,  ArmidaDebora, 2, 0, 2, no
318331245,  ilteino, 2, 0, 2, no
418689046,  vmvinicio, 1, 0, 1, no
495045767,  holly0776, 2, 0, 2, no
582126359,  roxbassblues, 1, 0, 1, no
629669385,  nadertheking, 1, 0, 1, no
147310639,  shugarplum_90, 1, 0, 1, no
3141185441,  FlorianaMissori, 1, 0, 1, no
381971890,  CinziaTwi, 3, 0, 3, no
4416532660,  ph_dimauro, 1, 0, 1, no
786470725200842752,  Pierpao09900229, 1, 0, 1, no
783020214,  GiadaFFowler, 1, 0, 1, no
2182149856,  ClaudioNonna, 1, 0, 1, no
1175684660,  scarsciotti, 1, 0, 1, no
424529280,  MrGaet, 8, 0, 8, no
337258972,  RomeoColosseo, 1, 0, 1, no
439253059,  deustronzio, 1, 0, 1, no
412605774,  RosariaDApollo, 1, 0, 1, no
179034462,  vitomaxbucci, 1, 0, 1, no
3420517433,  K365Gianni, 1, 0, 1, no
2393974623,  monnalisaselfie, 1, 0, 1, no
116408795,  NCLetterario, 1, 0, 1, no
2243027792,  chieleon, 1, 0, 1, no
50594245,  Markinux, 1, 0, 1, no
358384589,  DChiomento, 1, 0, 1, no
52023775,  TorinoClick, 1, 0, 1, no
473772424,  Cittalia, 3, 1, 2, no
599483247,  FurfaroL, 1, 0, 1, no
370377630,  barbaragraffino, 1, 0, 1, no
68648501,  ViceM25, 1, 0, 1, no
433176274,  albertobarberis, 1, 0, 1, no
468370504,  ccuitorino, 1, 0, 1, no
1345373785,  lorusso_stefano, 1, 0, 1, no
1101838909,  RegolaSrl, 2, 1, 1, neutral
512512014,  CoachMalvezzi, 2, 0, 2, no
420265631,  MarcoLavatar, 1, 0, 1, no
2451161791,  siclavoro, 1, 0, 1, no
798842956757102592,  ONGpiemonte, 1, 0, 1, no
3247867120,  stefano_manara, 1, 0, 1, no
52667653,  paolatealdi, 1, 0, 1, no
2228899537,  SistemaTorino, 1, 0, 1, no
4276681817,  ScuolaCotto, 1, 0, 1, no
3802234997,  enr_gav, 1, 0, 1, no
460996641,  GMP_WORLD, 1, 0, 1, no
1459703156,  meco_mix, 4, 0, 4, no
564370558,  massicaporale72, 1, 0, 1, no
796659204518006784,  rachelrachela80, 1, 0, 1, no
2243798055,  malasosta, 5, 0, 5, no
3307875581,  Matchagio7, 1, 0, 1, no
4544963296,  il_seccatore, 2, 0, 2, no
468780268,  federicoorta, 1, 0, 1, no
949175203,  fogliettachiara, 1, 0, 1, no
532957642,  Yes4To, 2, 0, 2, no
797369295881859072,  alessandro212m, 1, 0, 1, no
1411441638,  soantony23, 1, 0, 1, no
3320634071,  _ClaMarchisio_, 2, 0, 2, no
1196515682,  pmulassano, 1, 0, 1, no
1573345388,  marcogiuppone, 1, 0, 1, no
2506747965,  anzalotto, 1, 0, 1, no
779643582064066562,  andrea_viazzo, 1, 0, 1, no
414744686,  retronebbia, 2, 0, 2, no
484627636,  Enrzak, 2, 1, 1, neutral
4202809396,  muoversincitta, 1, 0, 1, no
2549955510,  CittaMetroTO, 8, 4, 4, neutral
801754,  suzukimaruti, 2, 0, 2, no
406323002,  pluto_03, 1, 0, 1, no
96229605,  gns2000, 1, 0, 1, no
2818840629,  GM_EuropaOvini, 1, 0, 1, no
393415845,  Lepricauno, 1, 0, 1, no
425649719,  GianmarcoFraska, 2, 0, 2, no
141936740,  SAPcagliari, 2, 0, 2, no
2931672725,  ibraMirkovic75, 1, 0, 1, no
2918245289,  DemonteMario, 1, 0, 1, no
3389000429,  Sergiosotgiase1, 3, 0, 3, no
547822404,  Adriano_Palozzi, 2, 0, 2, no
42389560,  AlexLucianoMayT, 1, 0, 1, no
784829417168207873,  Duffy_1958, 2, 0, 2, no
478305030,  loverdegianluca, 3, 0, 3, no
125975139,  Rubiyat, 1, 0, 1, no
274835694,  fineas10, 1, 0, 1, no
2207158497,  nicolalageder, 1, 0, 1, no
2472132872,  salvato14164980, 2, 0, 2, no
3081436118,  cirano148, 1, 0, 1, no
495149032,  Aledilegge, 2, 1, 1, neutral
1964814212,  enrygattoj12, 1, 0, 1, no
65371363,  lullabywoman, 1, 0, 1, no
825815605,  AndreaGavarone, 1, 0, 1, no
801332237966987267,  isskoblilina, 1, 0, 1, no
351495967,  InfoNewsNapoli, 2, 0, 2, no
972423649,  valeortuz, 1, 0, 1, no
462101728,  DioIt, 1, 0, 1, no
4020636137,  AleVerrelli, 2, 0, 2, no
450778886,  rekimko, 1, 0, 1, no
781921091510005760,  CernoIlSupremo, 2, 0, 2, no
891007872,  CircoloTurati, 2, 0, 2, no
581310185,  SottileFabrizio, 3, 0, 3, no
6521502,  alexerra, 1, 0, 1, no
1278745771,  ossetto, 1, 0, 1, no
2284024161,  MolestoIl, 3, 0, 3, no
570163803,  monicaciaburro, 1, 0, 1, no
804632834501644289,  nataraja1991, 2, 0, 2, no
471742666,  VittorioVerusio, 2, 0, 2, no
71193744,  antonellamadeo, 2, 0, 2, no
433046582,  cultnsea, 1, 0, 1, no
1719583506,  lorimarti11, 2, 0, 2, no
1097394962,  Bara__22, 1, 0, 1, no
222475722,  AletrAmp, 2, 1, 1, neutral
803386240489951232,  macn231, 1, 0, 1, no
730421706448343040,  Cris73009560, 2, 1, 1, neutral
406123480,  SergioNegroni, 1, 0, 1, no
371924509,  fabriziodist, 1, 0, 1, no
186372865,  Pescatore84, 1, 0, 1, no
570992674,  Gm15karla, 2, 0, 2, no
103232480,  enricogandolfi, 1, 0, 1, no
376145130,  assessore74, 2, 0, 2, no
514509122,  BorgMatteo, 1, 0, 1, no
96804648,  carmeloassenza, 1, 0, 1, no
391955295,  marco_gitto, 1, 0, 1, no
480438966,  LucaZaccari, 1, 0, 1, no
3855807508,  Cowboy201274, 1, 0, 1, no
878685505,  Giorgio_Assenza, 1, 0, 1, no
709503618,  MattewSchianti, 1, 0, 1, no
184348439,  entity_lm, 1, 0, 1, no
4076357332,  Nicola969703171, 1, 0, 1, no
993853790,  girmorr, 1, 0, 1, no
283507160,  GBonannodiL, 1, 0, 1, no
179871513,  italiadeidolori, 1, 0, 1, no
197355796,  vincenzomaran, 1, 0, 1, no
1427710298,  MartelliFrance, 4, 1, 3, no
113362743,  MaurizioIndaco, 2, 0, 2, no
2771777799,  CheteFregaTene, 1, 0, 1, no
603082591,  MicheleRampini, 1, 0, 1, no
2907681609,  fotoroma900, 1, 0, 1, no
3295578989,  LeneLepre, 1, 0, 1, no
731474165019119616,  thelma6317, 1, 0, 1, no
4876405329,  CbradiCristina, 1, 0, 1, no
1259891971,  MicheleBolgan, 1, 0, 1, no
190527996,  CristianoZatta, 1, 0, 1, no
425782220,  briciola00, 1, 0, 1, no
396404127,  thedriver66, 1, 0, 1, no
782340109,  gattogeremia, 1, 0, 1, no
721885819020173312,  panarinacalkig3, 1, 0, 1, no
54598696,  immagimario, 1, 0, 1, no
216643207,  Annadrx00, 2, 0, 2, no
142711432,  SimonVannini, 1, 0, 1, no
908138683,  FedericaCrepald, 1, 0, 1, no
388860597,  usai_marco, 1, 0, 1, no
483941482,  araldogiustizia, 1, 0, 1, no
354208096,  kar_el1955, 1, 0, 1, no
717323707535007744,  mimmo6666, 1, 0, 1, no
785434989576028160,  davinc242, 2, 0, 2, no
2956859205,  bacchetta55, 1, 0, 1, no
3221398883,  paolacommisso95, 1, 0, 1, no
538513540,  kartizer, 1, 0, 1, no
2211212309,  JanLaMantia, 1, 0, 1, no
793504775757238272,  Leonard15187807, 1, 0, 1, no
791001688584949764,  Vesuvio1957, 1, 0, 1, no
112769437,  Marianna2ooo, 1, 0, 1, no
407701503,  PressOfficeAREA, 2, 0, 2, no
206294638,  rezeff, 1, 0, 1, no
194223032,  seracri, 1, 0, 1, no
201761137,  iguanadan, 1, 0, 1, no
4031130172,  paolonedomenico, 1, 0, 1, no
783048133416783872,  marziaisenough1, 1, 0, 1, no
1358783606,  moira_sal, 1, 0, 1, no
1062774396,  bomberpiro, 1, 0, 1, no
1645529942,  graziano_79, 1, 0, 1, no
410601235,  FedericoLuongo1, 1, 0, 1, no
741533495227453440,  enricomancini11, 1, 0, 1, no
1271871373,  AlaskaSpines, 1, 0, 1, no
354370350,  fridrik73, 1, 0, 1, no
1189938984,  s_picen, 1, 0, 1, no
706567951428808704,  peppemasciari, 1, 0, 1, no
4764185375,  sneri1955, 1, 0, 1, no
602610308,  giu10peppe, 1, 0, 1, no
1195189627,  ahmatte_gri, 1, 0, 1, no
1289295079,  armandoperugini, 1, 0, 1, no
1301064319,  RizzoGigirz58, 7, 0, 7, no
3121689787,  LSonnj, 1, 0, 1, no
785355513152307200,  giorgio9089, 1, 0, 1, no
1545817196,  matildesjt, 1, 0, 1, no
494228967,  ciccioladelia, 1, 0, 1, no
2318406154,  carisvanghetti, 1, 0, 1, no
2817956454,  dicducfacfer18, 1, 0, 1, no
3048084708,  maddyfe, 1, 0, 1, no
2360788878,  ModoloCristina, 1, 0, 1, no
192210063,  LOSTINFICTIONUK, 10, 0, 10, no
14707379,  Carlofonda, 1, 0, 1, no
2749100742,  Nemyl1, 2, 0, 2, no
549221508,  acquaketa, 1, 0, 1, no
1090076990,  CamagheCat, 3, 0, 3, no
14650984,  marcozennaro, 1, 0, 1, no
776439709488803840,  Luigi103, 1, 0, 1, no
96192049,  flape82, 1, 0, 1, no
121691763,  leopardo14, 1, 0, 1, no
764290269361664000,  Luca42296334, 3, 0, 3, no
1867118582,  Marcoviniciodv, 5, 0, 5, no
1053575598,  Mariaro37744920, 1, 0, 1, no
60867782,  catnext, 1, 0, 1, no
2615327307,  Ferdina56463521, 1, 0, 1, no
988846506,  SilvioSaronno, 1, 0, 1, no
362202952,  AltamuraL, 1, 0, 1, no
1073514842,  liciniodimichel, 1, 0, 1, no
792758228895555584,  ansca68, 1, 0, 1, no
42671353,  ant_castaldo, 1, 0, 1, no
525770039,  unasolanima, 3, 0, 3, no
96964634,  marcoc1961, 3, 0, 3, no
2850884786,  simow1979, 7, 0, 7, no
2959921857,  mp_1972, 1, 0, 1, no
4743869176,  rollcage76, 2, 0, 2, no
272450967,  fabriGT, 2, 0, 2, no
719095505352007680,  stefano3030, 2, 0, 2, no
851310290,  LorenzoIlGiusta, 1, 0, 1, no
1183658797,  mauriliomondora, 1, 0, 1, no
458623597,  AMiracco, 1, 0, 1, no
714705252721762305,  Aldo52399586, 1, 0, 1, no
781214331748937728,  danyeydany1965, 1, 0, 1, no
2387729639,  deflamon, 1, 0, 1, no
754075999852191744,  RealVicoN, 1, 0, 1, no
803748942139760640,  stregaalyce, 4, 0, 4, no
3000836386,  David4ctl, 1, 0, 1, no
427211091,  Igor_Bermani, 1, 0, 1, no
29166185,  TheNexusV, 1, 0, 1, no
2399785188,  IrenePicarelli, 1, 0, 1, no
1171869331,  ElenaAndrea70, 1, 0, 1, no
793055656450355200,  Midwest38202040, 1, 0, 1, no
802252165595140096,  laiminsbackpri1, 1, 0, 1, no
1966745136,  waitingforthebp, 1, 0, 1, no
734962813,  ritamontanucci1, 1, 0, 1, no
618836329,  barba_emme, 1, 0, 1, no
245568963,  caliaesemenza, 1, 0, 1, no
1116457932,  DonnePolitica, 1, 0, 1, no
799549995204612096,  PaoloFreehog, 1, 0, 1, no
3311671889,  iopersempre74, 1, 0, 1, no
870556159,  salvopatane13, 1, 0, 1, no
3056430743,  AntonioSignor10, 1, 0, 1, no
4764391455,  acquarius102, 1, 0, 1, no
2430696135,  LinaVadal, 1, 0, 1, no
701748712339587072,  MichaelaAnselm1, 1, 0, 1, no
2248929082,  f_amato, 1, 0, 1, no
464857095,  GrazianoTortore, 1, 0, 1, no
603863493,  Frigo78, 1, 0, 1, no
49758744,  Soren13, 1, 0, 1, no
774973893060726785,  Salvatorecappe8, 1, 0, 1, no
4044724023,  cincischiati, 1, 0, 1, no
748630604778971136,  dellacquamarsa, 1, 0, 1, no
195455137,  MauroGiulivi, 2, 0, 2, no
850035295,  GiuffreMauro, 1, 0, 1, no
2539380734,  kira6677, 1, 0, 1, no
2852677474,  m5s_taranto, 2, 0, 2, no
3241702065,  pe_peps1987, 1, 0, 1, no
1913671255,  AdrianaCioci, 1, 0, 1, no
55251007,  saverioraimondo, 1, 0, 1, no
4858753947,  utahfoodfreedom, 1, 0, 1, no
212592062,  Dissenzo_, 1, 0, 1, no
485563568,  Toni184184, 1, 0, 1, no
1131103262,  MicheleArturo, 1, 0, 1, no
217087919,  robertoabate, 1, 0, 1, no
2887407797,  broggiglaucoj, 1, 0, 1, no
2397659735,  laricgiu, 1, 0, 1, no
2355545718,  GiuseppeABuono, 1, 0, 1, no
412637230,  LorenzPass, 1, 0, 1, no
2915966008,  MikiMinnielli, 1, 0, 1, no
706983565838385152,  giambacapitanio, 1, 0, 1, no
791439786,  DePalmaFra, 1, 0, 1, no
800412885880946688,  ConcettaMarino7, 1, 0, 1, no
554978317,  inespiludu, 1, 0, 1, no
2724223470,  WebSvelato, 2, 0, 2, no
2899382939,  Iu7Bqc, 1, 0, 1, no
50065323,  AlyLuz7, 1, 0, 1, no
448767335,  altadentro, 1, 0, 1, no
588219817,  Spaky01, 1, 0, 1, no
680173,  suafigositudine, 1, 0, 1, no
458405242,  nusspot, 1, 0, 1, no
1098895478,  thefoolishrebel, 1, 0, 1, no
1642691952,  dcentomini, 1, 0, 1, no
66792123,  Chiba87, 1, 0, 1, no
909925344,  AleMt78, 1, 0, 1, no
1479883909,  faint461, 1, 0, 1, no
712743044345364482,  kudrat_goraya, 1, 0, 1, no
192268572,  mirkoprocopio, 1, 0, 1, no
486889483,  pat_chiarello, 1, 0, 1, no
757228686777122816,  Leonardi140467, 1, 0, 1, no
3955231894,  sergiovalerioa3, 1, 0, 1, no
335888922,  simona51simona, 1, 0, 1, no
74880368,  ipsedixitennius, 1, 0, 1, no
93192980,  mirticaos, 1, 0, 1, no
1010789078,  rosapulejo, 1, 0, 1, no
359889602,  vongiap, 1, 0, 1, no
600073468,  umbertomoneta, 1, 0, 1, no
197420592,  padronadimilano, 1, 0, 1, no
892944115,  MichelePirolli, 1, 0, 1, no
379657067,  cla040681, 1, 0, 1, no
482313676,  gabrigi7, 1, 0, 1, no
1847905999,  NowakixHiro, 7, 0, 7, no
4121407583,  AvvGraziaDiBari, 1, 0, 1, no
2865919767,  tdepietto, 1, 0, 1, no
302244679,  vic2664, 1, 0, 1, no
2276998618,  PPaolomad, 2, 0, 2, no
2948537999,  MottyDi, 1, 0, 1, no
823062060,  Maximo0790, 2, 0, 2, no
1467197706,  MariaTrozzi7, 1, 0, 1, no
1218962124,  pamela1br, 1, 0, 1, no
76902417,  max_blue, 1, 0, 1, no
912548130,  migliore_il, 1, 0, 1, no
1160345166,  liviana_zanetti, 1, 1, 0, yes
246882785,  Ro_Tom, 1, 0, 1, no
1196845802,  Luca_Berretta, 3, 0, 3, no
723010411063349248,  Mimi56063872, 7, 0, 7, no
790153438491471872,  Ciresinimarghe2, 2, 0, 2, no
3428093939,  CristinaGazzin1, 1, 0, 1, no
432778390,  maripetrus, 2, 0, 2, no
7271952,  EnzoPdSUD, 1, 0, 1, no
4352795836,  ROSSANA19593, 2, 0, 2, no
259401630,  chiccarai, 1, 0, 1, no
3547880116,  carlamartamari, 1, 0, 1, no
2336702687,  rotpeter1, 1, 0, 1, no
2736537016,  ComiRomina, 1, 0, 1, no
722527613193990145,  BroggioLaura, 1, 0, 1, no
2433801274,  dinofrix, 1, 0, 1, no
1037847751,  marcomar21, 1, 0, 1, no
798283936950616072,  natalidellavita, 1, 0, 1, no
901626978,  rosolinomirabel, 1, 0, 1, no
444515250,  MTeppista, 1, 0, 1, no
464878898,  aogana, 1, 0, 1, no
2359624218,  saspav, 2, 0, 2, no
2263569021,  GrazianoPasta, 1, 0, 1, no
486053278,  laguerradiP, 4, 0, 4, no
410235395,  gf1953, 1, 0, 1, no
1158224899,  matthewgor, 1, 0, 1, no
786208274261667840,  MarziaRossi13, 2, 0, 2, no
26723126,  Fornario, 3, 0, 3, no
230749847,  aculalap, 1, 0, 1, no
2331802006,  CasaLettori, 1, 0, 1, no
2582226552,  stati_generali, 1, 0, 1, no
451487023,  paridepriamo, 1, 0, 1, no
260337748,  65mauriziobe, 2, 0, 2, no
1375679190,  MarcoVIcm, 2, 0, 2, no
213701690,  attacker_you, 1, 0, 1, no
2372229336,  GrimaldiRoccoI, 2, 0, 2, no
123078219,  uctq101, 1, 0, 1, no
3075932493,  RossLuigi58, 1, 0, 1, no
9627412,  niconarsi, 1, 0, 1, no
84932530,  O_Scarcello, 1, 0, 1, no
734452860113539072,  DarioArmandoDe1, 1, 0, 1, no
246522096,  ValeCalicchio, 3, 0, 3, no
2405213518,  antoniocoz85, 1, 0, 1, no
778540541206204416,  Alberto1332, 1, 0, 1, no
4827491773,  godofunk, 1, 0, 1, no
486682754,  PinoRenato, 2, 0, 2, no
409884335,  manni_andrea, 3, 0, 3, no
627332001,  EdizioniLindau, 1, 0, 1, no
500001834,  Antonio_Grassia, 1, 0, 1, no
430320467,  pepposrussoo, 2, 0, 2, no
311355879,  KelleddaMurgia, 1, 0, 1, no
1005025986,  MicMar77, 1, 0, 1, no
56981877,  clasurf, 1, 0, 1, no
68182390,  davidemontanaro, 12, 0, 12, no
2719691555,  eaiello73, 1, 0, 1, no
394922246,  alessiobenzi, 1, 0, 1, no
253579575,  grillimax, 1, 0, 1, no
452064464,  vanniat66, 5, 0, 5, no
304081834,  SDalleRive, 1, 0, 1, no
515681310,  al_dellacqua, 2, 0, 2, no
497256057,  MarioDanisi, 1, 0, 1, no
262745603,  ricagricolo, 1, 0, 1, no
57572869,  rafros, 1, 0, 1, no
1096629289,  _andrea_braga, 1, 0, 1, no
1067802307,  Robertam_63, 2, 0, 2, no
3882543447,  CallegaroManuel, 1, 0, 1, no
913242168,  DCoriasco, 1, 0, 1, no
752072327748345856,  Lapisandrhonos, 2, 1, 1, neutral
1042797620,  PierluigiVito, 1, 0, 1, no
2393681848,  TenaceMarilisa, 1, 0, 1, no
2647287138,  NicoHuettemann, 1, 0, 1, no
3005907202,  letterarosa, 2, 0, 2, no
244140469,  Svagaia, 2, 0, 2, no
461363018,  GiuseppeZangari, 1, 0, 1, no
2854938082,  RovigoPossibile, 2, 0, 2, no
3439821209,  l_capellini, 1, 0, 1, no
48734499,  mauroarcobaleno, 1, 0, 1, no
499862027,  emigaglia, 1, 0, 1, no
3599517983,  patriziavailat1, 1, 0, 1, no
2445913698,  quartopensiero, 1, 0, 1, no
804259262239281152,  LucaCapacci87, 2, 0, 2, no
1251955484,  M_Biccari, 3, 0, 3, no
72368174,  Mangecan, 1, 0, 1, no
88053361,  stormbraver, 1, 0, 1, no
2680148829,  kronodeuss, 2, 0, 2, no
495990520,  maurocrovace, 1, 0, 1, no
894845214,  carmeloalessan2, 1, 0, 1, no
1176909900,  RMarsalli, 1, 0, 1, no
1168367756,  giancarlo_onnis, 2, 0, 2, no
740770152044716032,  degli2811, 1, 0, 1, no
19647604,  RaffRiff, 2, 0, 2, no
2263734461,  Raffa_uff_you, 1, 0, 1, no
3007529356,  Giuliaartibani, 1, 0, 1, no
407000871,  kalufunsui, 1, 0, 1, no
526240914,  picossu, 1, 0, 1, no
444665671,  PinoVittorelli, 1, 0, 1, no
418757627,  GigiSpedicato, 1, 0, 1, no
2290561839,  chris_locci, 1, 0, 1, no
3861824717,  frocietto, 1, 0, 1, no
16511742,  palaMaxx, 1, 0, 1, no
799271957527138304,  SusannaSavini, 1, 0, 1, no
470501464,  siracusa_sandro, 2, 0, 2, no
56493633,  giovannaperduca, 2, 0, 2, no
2846735915,  ciscaleva, 1, 0, 1, no
437426255,  IvhanBurellos, 1, 0, 1, no
757861360864747521,  ellen_gambato, 1, 0, 1, no
491088290,  LorenzoMonni, 2, 0, 2, no
55419861,  barbalberoita, 1, 0, 1, no
413836005,  Clau_Dea74, 4, 0, 4, no
118058340,  TotiCamiolo, 1, 0, 1, no
252116102,  locedrola, 1, 0, 1, no
545883686,  _cristiano73, 2, 0, 2, no
407296746,  FGPo, 1, 0, 1, no
419831287,  lostragio, 1, 0, 1, no
1499415128,  nino__malo__, 1, 0, 1, no
102620569,  Panzernet, 1, 0, 1, no
528915795,  MircoSiri, 2, 0, 2, no
1064161034,  giannirus, 1, 0, 1, no
2589042406,  VitalinoGhiani, 1, 0, 1, no
458236217,  cosefra, 1, 0, 1, no
2848013902,  cristinaannam, 20, 0, 20, no
1724956302,  aglaja_amado, 1, 0, 1, no
775381846695837696,  ElvioCecchinato, 1, 0, 1, no
47758527,  remofer, 1, 0, 1, no
713403141035802624,  Passione_Civile, 1, 0, 1, no
275001458,  alliepistono, 1, 0, 1, no
3290543183,  mariaelenap88, 1, 0, 1, no
333359902,  GiuseAndre, 1, 0, 1, no
1318560558,  ByronBanguera, 1, 0, 1, no
3784148609,  madame_sin, 5, 1, 4, no
338884518,  ciaffa94, 2, 0, 2, no
422419297,  AlexAbramo, 1, 0, 1, no
379856999,  PallePerse, 1, 0, 1, no
2386873076,  Tas_89tas, 1, 0, 1, no
234432349,  n3m0scrapbook, 1, 0, 1, no
388459278,  Luisacatanese, 1, 0, 1, no
2400081577,  sattamatteo, 1, 0, 1, no
299892356,  nfl77, 1, 0, 1, no
146590259,  Salva84, 1, 0, 1, no
3063936611,  PerlaMiseriah, 3, 0, 3, no
249254321,  beppe54, 1, 0, 1, no
181302619,  _Call_Me_Liv, 1, 0, 1, no
93209808,  Gianpymalatesta, 3, 0, 3, no
418182710,  blumichelangelo, 1, 0, 1, no
703580095693385728,  fabrygrifo1974, 3, 0, 3, no
2454677914,  pabumba, 1, 0, 1, no
50456514,  iurisperitus, 1, 0, 1, no
2394639802,  micheletropi, 1, 0, 1, no
109504226,  wikipolis, 1, 0, 1, no
1234787275,  trucchia_alesmi, 1, 0, 1, no
495020368,  StefanoSSenior, 2, 0, 2, no
794168077,  danielesartore, 1, 0, 1, no
1080528002,  WSalvaterra, 1, 0, 1, no
1895168010,  martino_liva, 1, 0, 1, no
36197539,  Cippo1987, 2, 0, 2, no
376069634,  CarloRM61, 1, 0, 1, no
486569755,  lelelanzeni, 1, 0, 1, no
256660575,  alegissi, 1, 0, 1, no
2586223540,  RicciApe, 3, 1, 2, no
232296285,  giampieri_f, 4, 0, 4, no
397597107,  Oi_livio, 1, 0, 1, no
424571011,  leonardosalern2, 2, 0, 2, no
26639870,  labrumdelm, 1, 0, 1, no
943158858,  StellaFerrari80, 1, 0, 1, no
624994930,  CorriereG, 2, 0, 2, no
4924108648,  Silvia_Rose85, 1, 0, 1, no
53396756,  MatteoinivlaS, 1, 0, 1, no
283252587,  luigsab, 6, 0, 6, no
637195543,  siberiano5, 1, 0, 1, no
306686257,  croazia1, 2, 0, 2, no
1010914416,  FollettoFunky, 1, 0, 1, no
783582587608567808,  ElenaFerrante__, 4, 3, 1, yes
2491289936,  fantazita, 1, 0, 1, no
2325991760,  padanianb, 1, 0, 1, no
58009888,  Stefem, 1, 0, 1, no
1051035307,  Fr_Cannone, 1, 0, 1, no
4240753708,  GraziaCicc, 1, 0, 1, no
13479882,  manmatteo, 1, 0, 1, no
2459668985,  mirza16mir, 1, 0, 1, no
3053917222,  sagace424, 1, 0, 1, no
6743422,  caprikorn, 1, 0, 1, no
93705477,  giamartoc, 1, 0, 1, no
484005172,  GonnelliLuca, 1, 0, 1, no
4142289802,  TiaBattistini, 1, 0, 1, no
1885903771,  blkberrynights, 2, 0, 2, no
488478458,  RodyDad, 1, 0, 1, no
1370248890,  PlutoDany, 2, 0, 2, no
2233436648,  madrixlou, 1, 0, 1, no
544559226,  RobertoDepp, 1, 0, 1, no
2829406336,  giulia_gaudenzi, 1, 0, 1, no
1196898859,  nonviolento, 1, 0, 1, no
1606480278,  evpossibile, 2, 0, 2, no
28573067,  marabergomi, 1, 0, 1, no
500096388,  Giubetta, 1, 0, 1, no
1673946037,  giosal1955, 1, 0, 1, no
776474823547555840,  mariagiuliagg, 1, 0, 1, no
241350669,  PaoloProtop, 1, 0, 1, no
980154938,  mikybott2012, 2, 0, 2, no
83555860,  Davidissimo, 1, 0, 1, no
402987347,  bogontwitta, 1, 0, 1, no
1464208735,  ValoreLavoro, 3, 0, 3, no
2390000516,  TipoMoro, 3, 0, 3, no
881014213,  Paolo_Tumolo, 1, 0, 1, no
2938374375,  AndrArma1980, 1, 0, 1, no
167458005,  trisino, 1, 0, 1, no
426731073,  80sebasta, 1, 0, 1, no
400035492,  Gogodemarchis, 1, 0, 1, no
483218400,  ParvusMus, 1, 0, 1, no
2485484660,  PinelliFederica, 1, 0, 1, no
1329181153,  SusannaGaruti, 1, 0, 1, no
1267205780,  ClaBertuzzi1, 1, 0, 1, no
3145657781,  grecomarialaura, 1, 0, 1, no
1718257914,  cescachi, 1, 0, 1, no
397271314,  RobertaLisi1, 1, 0, 1, no
3099635259,  annah_anita, 2, 0, 2, no
31107308,  dav1d3, 1, 0, 1, no
622237378,  StefanoCrosara, 1, 0, 1, no
899443068,  emilnaca, 1, 0, 1, no
785391553716035584,  pro_fiore, 1, 0, 1, no
2674541642,  Meo1948Rm, 1, 0, 1, no
419630516,  GiancarloMatzeu, 2, 0, 2, no
3187818934,  arciprato, 1, 0, 1, no
3075722931,  BernardoArbusti, 1, 0, 1, no
823490869,  viamarconi8, 1, 0, 1, no
12403482,  mariopesce, 1, 0, 1, no
282206798,  mchiaragenovese, 2, 0, 2, no
400619636,  traderscomessa, 3, 0, 3, no
4877204938,  Claudio035210, 2, 0, 2, no
418142650,  CaesarSalade, 3, 0, 3, no
2814370229,  cgilrimini, 1, 0, 1, no
796124878294446080,  orsonapo1960, 1, 0, 1, no
2929361351,  FilleaEmiliaR, 1, 0, 1, no
507195444,  SpiCgilER, 1, 0, 1, no
3694828035,  gei_ste, 1, 0, 1, no
3684760575,  FinestraMonaste, 5, 4, 1, yes
731100264774651904,  _vatan_das, 6, 0, 6, no
739209725741563905,  NicolaSanna17, 1, 1, 0, yes
849549420,  bottobarbara, 1, 1, 0, yes
457023347,  FulvioVicenzo, 1, 1, 0, yes
3343884585,  Giunta6Andrea, 1, 1, 0, yes
266008962,  zeussotto, 2, 2, 0, yes
2499224871,  003Zambelli, 1, 1, 0, yes
164527808,  LuvinAndy, 1, 1, 0, yes
4631008281,  magicofralau, 1, 1, 0, yes
427389384,  IsottaRB, 1, 1, 0, yes
90376168,  cristinaobber, 1, 1, 0, yes
2246697333,  MaPa38763843, 1, 1, 0, yes
746729895997349888,  saraclumsylife, 1, 1, 0, yes
419480134,  BeppeGiulietti, 4, 4, 0, yes
43339000,  La_Nichy, 1, 1, 0, yes
777975546848407552,  occupymelzo, 2, 2, 0, yes
798605625542541313,  missforYou23, 1, 1, 0, yes
735228714070507520,  gramsci1937, 1, 1, 0, yes
769922235087872004,  XbwYkwZ0tYJuugt, 1, 1, 0, yes
1933669110,  _nicomassa, 1, 1, 0, yes
192629620,  AleDeLuca_, 1, 1, 0, yes
2733705537,  0c2327c8323f43d, 1, 1, 0, yes
117135369,  simonett_a, 1, 1, 0, yes
3492344729,  morbyda, 1, 1, 0, yes
2288778829,  LadyGLifeUK1, 1, 1, 0, yes
165686075,  _morfeus_, 1, 1, 0, yes
354305408,  OrestePollicino, 6, 6, 0, yes
46612370,  egeaonline, 1, 1, 0, yes
152725709,  ClaudiaGiuIia, 6, 6, 0, yes
2475456664,  Cheli__BB, 1, 1, 0, yes
430248545,  TeoMaggi, 1, 1, 0, yes
148699035,  GAffinito, 1, 1, 0, yes
197183571,  Gilda35, 6, 6, 0, yes
2271579289,  effeVozza, 1, 1, 0, yes
114432326,  LegambientePVDA, 1, 1, 0, yes
1913769476,  giosuemarrone, 1, 1, 0, yes
212370728,  giaroun, 1, 1, 0, yes
512493209,  giannidbpass, 1, 1, 0, yes
2318932138,  cucchia66, 1, 1, 0, yes
2172669244,  JacopoVisani, 1, 1, 0, yes
3648383904,  Harucarro, 1, 1, 0, yes
2319881557,  mitchnypd, 2, 2, 0, yes
27195745,  bavipi, 2, 1, 1, neutral
945982915,  SteBiotech, 1, 1, 0, yes
711625556509511681,  Pour_Parler, 1, 1, 0, yes
440945067,  NikoGarcia90, 1, 1, 0, yes
2346847323,  leva_massimo, 1, 1, 0, yes
3293050827,  CatchyBigData, 1, 1, 0, yes
533552599,  CamillaCavagna, 1, 1, 0, yes
329963766,  rossella_m_, 1, 1, 0, yes
365645764,  lauravolpi_it, 1, 1, 0, yes
805766874474696704,  Ass_Eunice, 1, 1, 0, yes
2173817292,  irebiotech, 1, 1, 0, yes
1947465200,  salvoruotolo, 2, 1, 1, neutral
2825238207,  emapucc, 1, 1, 0, yes
485823259,  MarzioMarzorati, 1, 1, 0, yes
787905639540555776,  Stefanatomassim, 1, 1, 0, yes
384986685,  monicaguerzoni, 1, 1, 0, yes
4796018405,  Fuhrerious1488, 2, 2, 0, yes
2427613188,  troglodigitale, 1, 1, 0, yes
72222947,  stelucky, 1, 1, 0, yes
756230745027293184,  DianaSharpton, 1, 1, 0, yes
3971698161,  Onofrio78033471, 1, 1, 0, yes
435694342,  maufaa, 1, 1, 0, yes
1085776615,  fabriziodavoli1, 1, 1, 0, yes
101442815,  SonoNataOggi, 1, 1, 0, yes
174295922,  Rosanna_Oliva, 1, 1, 0, yes
845697666,  sa_amarena, 1, 1, 0, yes
27123196,  valelongo, 1, 1, 0, yes
799522939792195584,  rubymaya59, 2, 2, 0, yes
800246297517125634,  AntonioCaselino, 1, 1, 0, yes
3293158150,  luca_perrino, 1, 1, 0, yes
198961814,  gionatanews, 1, 1, 0, yes
489553513,  tarigi2000, 1, 1, 0, yes
824859824,  DBocciolini, 1, 1, 0, yes
969014923,  MrBondiable, 1, 1, 0, yes
123194180,  enricosinatra, 1, 1, 0, yes
73153887,  iginioe, 1, 1, 0, yes
14060013,  _sweetpotatopie, 1, 1, 0, yes
1848756079,  alessandromeuc4, 1, 1, 0, yes
2441987950,  patrya53, 1, 1, 0, yes
1191558961,  RizziRes, 1, 1, 0, yes
570861587,  LorisCantarelli, 1, 1, 0, yes
782688502882324480,  DarioCalomino, 1, 1, 0, yes
591580487,  francescarocch4, 1, 1, 0, yes
771877645994848257,  Backdacycnua198, 1, 1, 0, yes
386425939,  glsiviero, 1, 1, 0, yes
3000435155,  PaoloDeAngelis1, 1, 1, 0, yes
532391937,  Chattelabadante, 1, 1, 0, yes
785058148650450944,  LiArPe78, 6, 6, 0, yes
2872098802,  apetrucci1, 1, 1, 0, yes
734721829747712001,  beavaldirana, 1, 1, 0, yes
2789453243,  mailastrappini, 1, 1, 0, yes
321318998,  giulianaganzini, 1, 1, 0, yes
769049437549232128,  39_5872, 1, 1, 0, yes
45430000,  claudialanzoni, 1, 1, 0, yes
176022966,  fabiusr, 1, 1, 0, yes
789228796008333312,  gloria_frezza, 2, 1, 1, neutral
307466367,  spada1982, 1, 1, 0, yes
722066405839998977,  Bovindino, 1, 1, 0, yes
1701456356,  UauAcademy, 1, 1, 0, yes
321664670,  skepticafro, 2, 2, 0, yes
1925644008,  3342887663, 1, 1, 0, yes
616206373,  GarethImparat0, 1, 1, 0, yes
2870709817,  germanoju59, 1, 1, 0, yes
3089846940,  FerruccioToso, 1, 1, 0, yes
261386929,  tondellolio, 1, 1, 0, yes
803417358572421120,  scorpiomatto123, 1, 1, 0, yes
3019512161,  PERDERSIaROMA, 4, 2, 2, neutral
542341771,  GCordoneLisiero, 2, 2, 0, yes
755117100805529600,  otta_bee, 2, 2, 0, yes
50637276,  Piripilla, 1, 0, 1, no
2176682146,  DanielePirozzi, 1, 0, 1, no
3353248005,  FIfrosinone, 1, 0, 1, no
3183628949,  94_giovani, 1, 0, 1, no
4714487295,  figprov, 3, 0, 3, no
776331394607898624,  comitatoNoFigRm, 1, 0, 1, no
487789216,  Nunzio_Saviano, 2, 0, 2, no
466358678,  DiegoDelPro, 1, 0, 1, no
1680602498,  carryflag, 1, 0, 1, no
1056321552,  PaoloMTweet, 1, 0, 1, no
595354243,  SacconeFranco, 2, 2, 0, yes
519519154,  VITOALO, 2, 2, 0, yes
2938237456,  adunataasti2016, 1, 1, 0, yes
780103237915516928,  Proa42, 1, 1, 0, yes
4297885697,  LelioCusimano, 3, 3, 0, yes
4150539809,  DScozziero, 3, 3, 0, yes
732748152,  gsantini1, 1, 1, 0, yes
549217197,  GiovanniZannier, 1, 1, 0, yes
792092793757990912,  ColaxRed, 1, 1, 0, yes
550787294,  raffaelemilord, 4, 3, 1, yes
1246472766,  lucablanco73, 2, 1, 1, neutral
1037946890,  frank_benedetto, 2, 2, 0, yes
874131660,  GiulioLefevre, 1, 1, 0, yes
324508308,  giovans54, 1, 1, 0, yes
328946138,  udu_sind, 1, 1, 0, yes
795237998577274880,  RdSMVerona, 1, 1, 0, yes
2949069453,  piccafra048, 2, 2, 0, yes
999067322,  bluester76, 2, 1, 1, neutral
1093314320,  LoredanaMassimi, 1, 1, 0, yes
188269982,  discolojoe, 1, 1, 0, yes
1064969216,  aldociat, 2, 2, 0, yes
1039463288,  GianmarcoPiovan, 1, 1, 0, yes
268906720,  MichelaCalculli, 1, 1, 0, yes
917018388,  EmanuelOian, 2, 1, 1, neutral
26498483,  Anseco, 1, 1, 0, yes
91080189,  erikukuzza, 2, 2, 0, yes
1213449168,  Paoloromano82, 1, 1, 0, yes
970245042,  bencivenga55, 1, 1, 0, yes
344639125,  ESpanu, 1, 1, 0, yes
2275247204,  jouissance17, 1, 1, 0, yes
258870354,  anarcofem, 1, 1, 0, yes
800433735069929472,  Mariangelaland, 1, 1, 0, yes
487913807,  MuzzuNino, 2, 1, 1, neutral
526682114,  gabrielli1969, 2, 2, 0, yes
526801476,  DAnca_C, 3, 3, 0, yes
601700840,  MarianoAmirante, 1, 1, 0, yes
327562969,  vincenzobatella, 2, 1, 1, neutral
1202155946,  pierluigi881, 2, 2, 0, yes
413203150,  MatildeAccurso, 1, 1, 0, yes
3380255259,  FuturoaSinistra, 2, 1, 1, neutral
4773966268,  LaMeglioRoma, 2, 1, 1, neutral
742471211616227328,  Barbara19956, 2, 1, 1, neutral
3002825051,  mmazzocchi56, 2, 2, 0, yes
634090141,  giorgiocasari1, 1, 1, 0, yes
715206297499615232,  is5stelle, 1, 1, 0, yes
475733636,  salpel1248, 2, 1, 1, neutral
352244786,  gianlucazoi, 2, 1, 1, neutral
12069882,  Ugugu, 1, 1, 0, yes
253032506,  leo_pipitone, 2, 1, 1, neutral
77290077,  nickreddy, 2, 1, 1, neutral
3696744435,  PD_DECOLLATURA, 2, 2, 0, yes
603010007,  Giuggirix, 1, 1, 0, yes
798655170875891712,  dario_altieri, 1, 1, 0, yes
788464901845032961,  SagristanoA, 1, 1, 0, yes
2317264650,  Thesameriver, 1, 1, 0, yes
391303643,  t_tonii, 1, 1, 0, yes
407781719,  osiride7, 1, 1, 0, yes
805627341758169088,  dumertidis1971, 1, 1, 0, yes
2545527884,  catiadeangelis2, 2, 1, 1, neutral
914705947,  alessias79, 4, 4, 0, yes
1449501241,  SimonettaRuina, 2, 1, 1, neutral
2430599152,  MirellaVattuone, 1, 1, 0, yes
2238395111,  franco11566379, 2, 1, 1, neutral
438694006,  JacopoNesti, 1, 1, 0, yes
3400288006,  EBelliardo, 1, 1, 0, yes
1099253262,  MaritaLorenz, 1, 1, 0, yes
350731504,  nio53, 1, 1, 0, yes
474018399,  JacoTrammeil, 1, 1, 0, yes
4039483637,  LuisellaLeone_, 1, 1, 0, yes
2865494778,  FolcioManuela, 1, 1, 0, yes
3047103415,  voltes48, 1, 1, 0, yes
138537677,  BarberaDOC, 1, 1, 0, yes
953331372,  RanuGiu, 2, 2, 0, yes
1238324383,  augusto_volpe, 1, 1, 0, yes
47377992,  stellabianchi, 1, 1, 0, yes
2496972727,  9532f4e3a9a6411, 2, 2, 0, yes
4845714999,  BoreaniMaria, 1, 1, 0, yes
175877595,  stefanoscartozz, 2, 1, 1, neutral
423262171,  trevisotoday, 1, 1, 0, yes
858641695,  robertozingiria, 1, 1, 0, yes
2411282335,  PDCivitavecchia, 1, 1, 0, yes
2244095766,  Davide1101989, 1, 1, 0, yes
448012101,  MParolari, 1, 1, 0, yes
140169198,  GabriPrudente, 2, 2, 0, yes
2787897519,  miskatos, 2, 1, 1, neutral
244203371,  gandinideb, 1, 1, 0, yes
3014211569,  DomaniIl, 4, 3, 1, yes
1241498544,  marcocascia, 1, 1, 0, yes
399461585,  palma_gia, 1, 1, 0, yes
630096787,  claudiapaesani, 2, 2, 0, yes
1095015379,  calogerofallett, 1, 1, 0, yes
547781607,  MariapieraF, 2, 2, 0, yes
315911398,  ClaudioLaScola, 2, 2, 0, yes
482033828,  mariagraziamase, 1, 1, 0, yes
2885629035,  Escoafareungiro, 1, 1, 0, yes
2544142104,  giorgio421, 1, 1, 0, yes
1057386960,  kappatipsilona, 1, 1, 0, yes
1405904912,  MeddixTuticum, 1, 1, 0, yes
2514356463,  BrogginiSimoma, 1, 1, 0, yes
462909893,  Julzontwit, 1, 1, 0, yes
80548769,  VincenzoMMRusso, 4, 4, 0, yes
509107564,  JamesBrook8, 4, 4, 0, yes
1429905642,  madamapezzetta, 1, 1, 0, yes
403338653,  Jammasrl, 1, 1, 0, yes
1481780942,  GasoLella, 1, 1, 0, yes
2172871278,  Sanscelerien, 1, 1, 0, yes
158136785,  SylviaGrossi, 1, 1, 0, yes
283110925,  Baldini_G, 1, 1, 0, yes
291021897,  Dani3luna, 1, 1, 0, yes
268816462,  Gaihardo, 1, 1, 0, yes
17879542,  LordKobe, 1, 1, 0, yes
496226859,  attualitaultime, 1, 1, 0, yes
418894426,  stefanoagnoli, 1, 1, 0, yes
266628056,  corsarorosso, 1, 1, 0, yes
105751279,  quattrocchigep, 1, 1, 0, yes
508128810,  blasimanagement, 1, 1, 0, yes
3019759853,  cirneaf, 1, 1, 0, yes
425752285,  AngeloBonelli1, 2, 2, 0, yes
2401247832,  PinoMDdisario, 1, 1, 0, yes
1099026602,  Ntohoope, 1, 1, 0, yes
28788328,  leoelida, 1, 1, 0, yes
1265196404,  Brancaleone72, 2, 1, 1, neutral
845726376,  MFreddy1979, 1, 1, 0, yes
105572105,  Zeitgeist51275, 1, 1, 0, yes
564443638,  DalessandroCam, 1, 1, 0, yes
82419707,  roccobove, 2, 2, 0, yes
1548421861,  Ecodem1, 1, 1, 0, yes
2203605371,  mikymirabello, 2, 2, 0, yes
19790556,  Lorenzo_Mapelli, 1, 1, 0, yes
505318962,  roccomarcel, 1, 1, 0, yes
3386138019,  GiovanniJoppas, 1, 1, 0, yes
2982793863,  RobiVivacqua, 2, 2, 0, yes
740305952046452737,  UglLatina, 1, 0, 1, no
426555682,  ninimuzzi, 1, 0, 1, no
435959517,  FIOLUI52, 4, 2, 2, neutral
912041082,  biomillarte, 1, 0, 1, no
858180829,  SantaPazienzaTW, 2, 1, 1, neutral
752828203216019456,  errecant, 2, 1, 1, neutral
1543727724,  niccolomessina, 2, 1, 1, neutral
555225636,  NatasciaTurato, 2, 1, 1, neutral
2221319601,  gigli_federica, 2, 1, 1, neutral
483005204,  mare_62, 2, 1, 1, neutral
309277206,  songase975, 2, 1, 1, neutral
1286052349,  Indexway_tw, 2, 1, 1, neutral
1510489741,  index_prod, 2, 1, 1, neutral
1582514124,  Index_Ed, 2, 1, 1, neutral
859987891,  Index_Dig, 2, 1, 1, neutral
3190304315,  Think_ita, 2, 1, 1, neutral
419914432,  HelenePacitto, 2, 1, 1, neutral
363587735,  DaniloPuddu, 2, 1, 1, neutral
391448955,  GioDeJa, 2, 0, 2, no
281709704,  iugin10, 2, 1, 1, neutral
718873030676582400,  MimmoRelax, 1, 0, 1, no
293183196,  ConilSud, 1, 0, 1, no
69209482,  gcenturelli, 1, 0, 1, no
743420210422648832,  Diaboli98522633, 4, 0, 4, no
716119452304154625,  Pietroleone80, 1, 0, 1, no
474926682,  CGILBari, 2, 0, 2, no
468670990,  cgilpuglia, 1, 0, 1, no
4182189322,  tiziana_tzn, 1, 0, 1, no
2167105112,  spicgilpuglia, 1, 0, 1, no
458400129,  Redazione_ROARS, 1, 0, 1, no
866449578,  marymariani86, 1, 0, 1, no
82849145,  andsigno, 2, 0, 2, no
2921067351,  DotaEnzo, 1, 0, 1, no
3309536651,  Giusepp11426282, 1, 0, 1, no
539277206,  LuigiCuccitto, 1, 0, 1, no
3420048107,  Manilanazzaro, 1, 0, 1, no
1449933242,  LBrogialdi, 1, 0, 1, no
330377596,  MarioDeLeo, 1, 0, 1, no
951231186,  Fiorenzochef, 1, 0, 1, no
517936381,  IlenaCaroli, 1, 0, 1, no
143423461,  DanyCifarelli, 1, 0, 1, no
4879423979,  CampolucciLuana, 1, 0, 1, no
2182154051,  MarRos824, 1, 0, 1, no
2494036502,  GrazziniMichele, 1, 0, 1, no
416644604,  ronas58, 1, 0, 1, no
713877778681171969,  Italians4Brexit, 2, 1, 1, neutral
459657997,  LuigiDeSantis84, 4, 2, 2, neutral
361788030,  DenisNesci, 1, 0, 1, no
1218018804,  sanspapier66, 1, 0, 1, no
250171655,  saturninox, 1, 0, 1, no
597192031,  FoggiaCittaAper, 1, 0, 1, no
802151489380765696,  fernandomogaver, 5, 1, 4, no
3825806842,  LaylaOHK, 1, 0, 1, no
432053287,  marinabeccuti, 1, 0, 1, no
974503058,  angelociani2, 1, 0, 1, no
2437284987,  RitaTreglia, 2, 1, 1, neutral
582553456,  GiulioSiena, 2, 1, 1, neutral
240642244,  gianpierozinzi, 2, 0, 2, no
1493349302,  OwlRunning, 1, 0, 1, no
17442496,  gloriabaldoni, 1, 0, 1, no
123291306,  Extra4four, 1, 0, 1, no
81918861,  icricelli, 2, 1, 1, neutral
397384907,  LucAnnaRomano, 2, 0, 2, no
3184242461,  BucciGigia, 1, 0, 1, no
299620549,  DanieleFinassi, 1, 0, 1, no
250249728,  popama_, 1, 0, 1, no
2966157297,  ArcheoLogica, 1, 0, 1, no
396805970,  massimodeflorio, 1, 0, 1, no
131799077,  GiovanniPa, 1, 0, 1, no
1065761461,  LaceteraFabio, 1, 0, 1, no
43657967,  felixpiemontese, 1, 0, 1, no
945543204,  Twittjamm, 1, 0, 1, no
722364988095074308,  andrea09975000, 1, 0, 1, no
3360426029,  TwocentsTweets, 1, 0, 1, no
818078472,  GiuliaFacilla, 1, 0, 1, no
1402093044,  Garganoeventi, 1, 0, 1, no
2182046839,  Roberta_M_12, 1, 0, 1, no
805315714844397568,  alfonso_terni, 2, 0, 2, no
1037333550,  CiccioTralli, 1, 0, 1, no
84611230,  finoralescani, 1, 0, 1, no
1148946800,  Cicco140, 1, 0, 1, no
527576859,  CrisDiBlasi, 1, 0, 1, no
3313144456,  magariavessi, 1, 0, 1, no
359605242,  DomenicoMicc, 1, 0, 1, no
221841366,  stepecorella, 2, 0, 2, no
1074049374,  CampagnaMarzia, 2, 0, 2, no
151142367,  AndreaLisco, 1, 0, 1, no
1640805493,  MarcoCerasino, 1, 0, 1, no
2885402735,  kedelvecchio, 1, 0, 1, no
3300924790,  cruccumanuela, 1, 0, 1, no
479571162,  GioVegliante, 1, 0, 1, no
2463260997,  lanza_84, 1, 0, 1, no
3300444479,  lovemanfredonia, 1, 0, 1, no
706567527304974336,  Amela_11, 1, 0, 1, no
238107344,  FlavioTroja, 1, 0, 1, no
383820352,  _Sblendorio, 1, 0, 1, no
1037305130,  anin09190671, 1, 0, 1, no
4706925940,  SegreteriaVisit, 1, 0, 1, no
166285112,  28_05_2003, 1, 0, 1, no
3254462871,  MignoloClamgn, 1, 0, 1, no
556357599,  RufusGio, 2, 0, 2, no
2429121827,  CorradoPrati, 1, 0, 1, no
210371655,  giulianisenior, 2, 1, 1, neutral
3105423675,  AlaimoGiusie, 3, 2, 1, yes
595901346,  PierluigiBoda, 1, 1, 0, yes
17849926,  vikingmetal, 3, 2, 1, yes
470301417,  FpCgilNazionale, 1, 0, 1, no
3099073484,  _S_T_A_N_D, 1, 0, 1, no
4878348543,  ItaliaCelere, 2, 0, 2, no
802824171755597824,  Hannibalbau, 1, 0, 1, no
802230069179666433,  GayLiberali, 1, 0, 1, no
252588117,  stelfia, 1, 0, 1, no
786904848692289541,  giuliasidd, 1, 0, 1, no
3351720815,  FIGLazio, 1, 0, 1, no
803954858000809985,  GattaTetto, 1, 0, 1, no
421120188,  SavareseVincenz, 2, 0, 2, no
1104133098,  twittatore31, 1, 0, 1, no
428476526,  JacopoCiccani, 1, 0, 1, no
4494003293,  FI_Sardegna, 1, 0, 1, no
1296671826,  assu_tavino, 1, 1, 0, yes
583915815,  laurachiodi1, 2, 2, 0, yes
2589863933,  mc_mcampo12, 1, 1, 0, yes
1676620219,  pink84x, 2, 2, 0, yes
2535296618,  decimomeridiom, 1, 1, 0, yes
422854320,  IloveuNJH, 2, 2, 0, yes
882381698,  NinoLoBurgio, 1, 1, 0, yes
758992042005368834,  lelek86, 1, 1, 0, yes
715992550029574145,  nadianuncadurmo, 2, 2, 0, yes
2568929007,  Marylan72, 2, 2, 0, yes
798583329872347137,  ariannamisa, 3, 3, 0, yes
293936852,  helionomics, 1, 1, 0, yes
803156673296732160,  LiceoPascasino, 4, 4, 0, yes
4461906317,  silvia_argiro, 2, 2, 0, yes
757200887597113345,  lookat_gab, 2, 2, 0, yes
1060414374,  Moby_Sick, 4, 2, 2, neutral
2187544810,  PietroSintesi, 1, 1, 0, yes
184007492,  mesupistravels, 1, 1, 0, yes
76596562,  FidanzaCarlo, 1, 1, 0, yes
134431419,  Ditrast, 1, 0, 1, no
1055810162,  Carmine_52, 1, 0, 1, no
2931666383,  gi_stra, 2, 0, 2, no
309575298,  andreazet, 2, 0, 2, no
1711801430,  MimmoLombezzi, 1, 1, 0, yes
951280753,  PirelliLorenzo, 7, 1, 6, no
556889420,  masdeca, 4, 4, 0, yes
1565896604,  Confronti_CNT, 1, 1, 0, yes
442197827,  cartadiroma, 1, 1, 0, yes
795355999783751680,  davideb64, 1, 1, 0, yes
417123642,  RosalbaSegatori, 1, 1, 0, yes
2170163323,  SardegnaG, 1, 1, 0, yes
3326574081,  AlwaysbusyPaolo, 2, 1, 1, neutral
308401253,  Portolano_Legal, 1, 1, 0, yes
368846123,  sergiobvc, 1, 1, 0, yes
2254901172,  MerloSimona, 1, 1, 0, yes
238349229,  albiz94, 1, 1, 0, yes
712296934703308801,  VinidiSicilia, 2, 2, 0, yes
28314890,  vincenzocali, 1, 1, 0, yes
3301496026,  GiuliaMorelli90, 1, 1, 0, yes
1198502288,  pfse_auxilium, 1, 1, 0, yes
3367934717,  FabioPinazzo, 1, 0, 1, no
714417878,  GabriGiammanco, 8, 0, 8, no
2610857110,  FeliceBrancati, 1, 0, 1, no
76863835,  Kalotipia, 1, 0, 1, no
705449054248034304,  ttentamente, 4, 0, 4, no
1287447402,  Cybrarian64, 1, 0, 1, no
2761058821,  MBensoni, 1, 0, 1, no
2299875428,  3999Alien, 1, 0, 1, no
2315855603,  E_Belluzzo, 1, 0, 1, no
2844136676,  mariapizzino94, 1, 0, 1, no
2416068015,  valeriodeb, 2, 0, 2, no
757977140491087872,  Elisabetta_ESS, 1, 0, 1, no
3331498624,  ScialpiDebora, 1, 0, 1, no
435737042,  paopalea, 1, 0, 1, no
3802794617,  PrinceKastaDOr, 3, 0, 3, no
3410200684,  robyeverfree, 1, 0, 1, no
1882562786,  FI_Veneto, 1, 0, 1, no
459430520,  michele_zuin, 1, 0, 1, no
454782176,  RBazzarello, 1, 0, 1, no
183132441,  alessandrobersi, 1, 0, 1, no
261635491,  lovisport, 1, 0, 1, no
1259206496,  BianzaleManuel, 1, 0, 1, no
3426426969,  sirottigaudenzi, 1, 0, 1, no
921162848,  Marin63Marco, 1, 0, 1, no
2460235493,  fedmontevecchi, 1, 0, 1, no
3400111648,  GGazze07, 1, 0, 1, no
3410755455,  giovit1961, 1, 0, 1, no
747427933443264512,  easylollo, 1, 0, 1, no
291985468,  GiammariaMelani, 1, 0, 1, no
706451584851566592,  Neyx_, 2, 0, 2, no
2393267188,  DanieleBenini3, 1, 0, 1, no
4661080342,  bressanuttiang1, 1, 0, 1, no
764215328528269313,  massimo_boscia, 3, 0, 3, no
284071406,  francesco96s, 1, 0, 1, no
357584516,  AndresSanto_, 2, 0, 2, no
1073360574,  Ambrogio2001, 1, 0, 1, no
3362536689,  marina_iorio26, 1, 0, 1, no
344138094,  Armando_incz, 2, 0, 2, no
733346979925905408,  diremario, 1, 0, 1, no
426886525,  diegh74, 1, 0, 1, no
263179271,  manusnella, 1, 0, 1, no
724805793594363905,  Lilianabini1, 1, 0, 1, no
722734060284604416,  Sbreighs, 1, 0, 1, no
711691056878714880,  bayon_giovanna, 1, 0, 1, no
337587506,  giummino, 1, 0, 1, no
575436900,  GiovanniTancini, 1, 0, 1, no
57066122,  Basti4n, 1, 0, 1, no
798869652415938560,  michel__vitale, 1, 0, 1, no
633232379,  GessiMenichelli, 1, 0, 1, no
791347713614946305,  siempanc, 1, 0, 1, no
529822329,  CristianoMento, 1, 0, 1, no
799657351334731776,  stanzanifilippo, 1, 0, 1, no
2361214418,  ForaniDaniele, 1, 0, 1, no
125950791,  mimmo62, 1, 0, 1, no
425828885,  FulvioAlbanese, 3, 2, 1, yes
1459430522,  ChristianGerde2, 1, 0, 1, no
2269002804,  pierovernaccini, 1, 0, 1, no
402645799,  goppaiperdu, 1, 0, 1, no
277725208,  anna2482003, 1, 0, 1, no
1013035693,  ElisaVolpetti, 1, 0, 1, no
1259410686,  monogres, 1, 0, 1, no
180834935,  leonardocarella, 1, 0, 1, no
468782303,  icemastromatteo, 1, 0, 1, no
411315576,  RTarussello, 1, 0, 1, no
436178943,  paternitig, 2, 1, 1, neutral
1223264108,  francesco_danna, 2, 0, 2, no
1640005182,  milazzo_pietro, 1, 0, 1, no
180029912,  bosonedihiggs, 1, 0, 1, no
136686643,  WriterAnnaBells, 1, 0, 1, no
482396556,  BroganMonty, 1, 0, 1, no
735880222243971072,  68_fabrizio, 2, 0, 2, no
806069030499024896,  romilodise, 1, 0, 1, no
273654471,  GRinaldini, 1, 0, 1, no
772423638544941056,  IlM5s, 1, 0, 1, no
781774392262955008,  Veruz060185, 1, 0, 1, no
2375326314,  Sydrobby, 1, 0, 1, no
1053432726,  agzshiro, 1, 0, 1, no
433223568,  sergio8111963, 3, 0, 3, no
55865413,  misswrit, 1, 0, 1, no
1015578030,  LinoDeMatteis, 1, 0, 1, no
390226814,  Oibaf_Isot, 1, 0, 1, no
399011672,  maggi_marco, 1, 0, 1, no
465658194,  222256789, 1, 0, 1, no
540816002,  cavolofiore, 1, 0, 1, no
121551906,  Cloesdays, 1, 0, 1, no
1077801097,  steffvolponius, 2, 0, 2, no
151632758,  VinzCorrado, 1, 0, 1, no
311074404,  amestratus, 1, 0, 1, no
152608093,  Fabriscalzi, 1, 0, 1, no
1028510078,  danielecane, 2, 0, 2, no
30331417,  evgenymorozov, 1, 0, 1, no
348503076,  MarcoToniolo, 1, 0, 1, no
2235916268,  Boske_DG, 1, 0, 1, no
584085438,  Nolan3802, 1, 0, 1, no
112664102,  Chycca, 2, 0, 2, no
155109665,  Giorgioven, 1, 0, 1, no
1102257895,  RVerbi, 1, 0, 1, no
221089264,  victorlaszlo88, 1, 0, 1, no
91967472,  onefitmn, 1, 0, 1, no
2685703353,  giuseppecai1, 1, 0, 1, no
1246085041,  AndreaScanzati, 1, 0, 1, no
801816274850430976,  piantaprofumata, 1, 1, 0, yes
1487833586,  allatiziana, 1, 0, 1, no
1348514569,  darcoSan, 2, 0, 2, no
727474294306033665,  silvestro_gi, 1, 0, 1, no
1298956886,  pamypou, 1, 0, 1, no
484784657,  cinziamitika, 5, 0, 5, no
3067898403,  sandrocapretti, 2, 0, 2, no
790347584120381440,  Justice3999, 1, 0, 1, no
796004787049336836,  CristianaCapor, 1, 0, 1, no
576773535,  paoloxbaroni, 1, 0, 1, no
1688088199,  ___catia, 1, 0, 1, no
4853387764,  feliziani_fabio, 1, 0, 1, no
114812293,  alessandrinigen, 1, 0, 1, no
796053127447347200,  VenturiniLSA, 1, 0, 1, no
210476331,  dvaragnolo, 1, 0, 1, no
254233000,  8oltremare, 1, 0, 1, no
795909939164315648,  CarlorfBasso, 1, 0, 1, no
311924133,  AMG_67, 1, 0, 1, no
2787877105,  __Martinello, 1, 0, 1, no
1397599338,  obelaspeza, 1, 0, 1, no
266509631,  pinoneforever, 1, 0, 1, no
756883418,  SanteTricarico, 1, 0, 1, no
768090316612243456,  Prioma2, 1, 0, 1, no
569006883,  GiselleMartino3, 1, 0, 1, no
1068434126,  monitoreromano, 1, 0, 1, no
3037470958,  Azrael899, 1, 0, 1, no
2789862845,  AngelaDPsenior, 1, 0, 1, no
422913943,  IsaTofee, 1, 0, 1, no
401970520,  stefanodina, 1, 0, 1, no
63444111,  aleendo, 1, 0, 1, no
4882825911,  NoOiL666, 3, 0, 3, no
424322762,  MiaomiaoCh, 1, 0, 1, no
431964962,  ricmeo, 1, 0, 1, no
549982210,  CambiareDavvero, 1, 0, 1, no
314712733,  Eissad64, 1, 0, 1, no
2181843523,  paolodeluca72, 3, 0, 3, no
2893477857,  biciversilia, 1, 0, 1, no
1171509590,  PietroBruno12, 1, 0, 1, no
1041831000,  sciantokescia, 2, 0, 2, no
1880756130,  easysister, 1, 0, 1, no
228121512,  tgtourism, 1, 0, 1, no
1667558509,  parcoacquedotti, 5, 0, 5, no
476844153,  FabrizioIta881, 1, 0, 1, no
546828454,  marcohilo, 1, 0, 1, no
493901532,  barbara75toud, 1, 0, 1, no
1178041686,  Aletta_rm, 3, 0, 3, no
57474419,  pietroberga, 1, 0, 1, no
2208429460,  steftak, 1, 0, 1, no
567054197,  DonnaCigno, 1, 0, 1, no
3434374247,  uniamoci_net, 3, 0, 3, no
44206038,  simisimi1972, 1, 0, 1, no
80823138,  simonecerbella, 1, 0, 1, no
2245999991,  Sofia_1_vv, 1, 0, 1, no
3103745741,  mcristinatocci, 1, 0, 1, no
351426252,  astarotte59, 1, 0, 1, no
473236373,  pietrodagostini, 1, 0, 1, no
2274799961,  dottormarcelli, 1, 0, 1, no
306205121,  redbookcarrier, 1, 0, 1, no
727142686688419841,  BoboilSemplice, 1, 0, 1, no
424054992,  SilvanaRovai, 1, 0, 1, no
440054435,  jlesel, 1, 0, 1, no
614322175,  TerraAmbr0se, 1, 0, 1, no
404663122,  gigiomous, 1, 0, 1, no
179984406,  SunnySabry, 1, 0, 1, no
260408682,  fedecentrico, 1, 0, 1, no
428243916,  piccolimaestri, 2, 0, 2, no
3371020601,  BaobabExp, 3, 0, 3, no
590726647,  simone7175, 1, 0, 1, no
2410197857,  Fedex312, 1, 0, 1, no
105218121,  urbelab, 1, 0, 1, no
768476862905479168,  salvatore_pede, 1, 0, 1, no
2163358854,  benzinazero, 1, 0, 1, no
487048219,  DanielCarax, 1, 0, 1, no
3382239311,  sicurinstrada, 1, 0, 1, no
760790168358031364,  Fiorella0003, 1, 0, 1, no
596634369,  RomanaLiuzzo, 1, 0, 1, no
2331085157,  PPANthebrief, 1, 0, 1, no
1197078822,  DisinfoATAC, 3, 0, 3, no
607424962,  amorlucis, 1, 0, 1, no
2829235384,  KlaatuN, 2, 0, 2, no
421691549,  danielesrw, 1, 0, 1, no
236739780,  PaoloIzzo, 2, 0, 2, no
162000741,  Animalistiitaly, 1, 0, 1, no
3817957395,  ViscusiElena, 1, 0, 1, no
28116095,  carlomatt, 4, 0, 4, no
451430891,  scarmat_, 1, 0, 1, no
210636450,  f_random, 1, 0, 1, no
1108371631,  Pat_Marrocco, 1, 0, 1, no
733984270499319808,  ego_sono, 20, 0, 20, no
768869991064211456,  SalrosSalvatore, 1, 0, 1, no
553600293,  rutifra, 1, 0, 1, no
2330906381,  LucianoSiri68, 9, 0, 9, no
354366770,  marcodimarco87, 1, 0, 1, no
90501152,  riko973, 1, 0, 1, no
329694687,  parcoappia, 2, 0, 2, no
2952909982,  CoppolaFrances5, 1, 0, 1, no
1142639090,  gattoboots, 1, 0, 1, no
3958590737,  francylistarm, 1, 0, 1, no
1140881040,  Ivan74C, 1, 0, 1, no
748527449932181504,  biban_guido, 1, 0, 1, no
3293491207,  SiTro82, 1, 0, 1, no
483635358,  runnerstef, 2, 0, 2, no
602706933,  StregaLorelei, 1, 0, 1, no
2280679352,  Ilpizzardone, 2, 0, 2, no
498956277,  SemplificaSas, 1, 0, 1, no
979131565,  robdimol, 1, 0, 1, no
12776392,  Yogasadhaka, 1, 0, 1, no
2482366382,  RobertoDel1955, 1, 0, 1, no
467265563,  MakxBarbi, 1, 0, 1, no
2977084942,  FLabella11, 1, 0, 1, no
3082906144,  lauraconlange, 1, 0, 1, no
1176522596,  wikipazz, 2, 0, 2, no
1037695476,  claumartino1952, 2, 0, 2, no
376070429,  Millo_82, 1, 0, 1, no
375484576,  lexsky03, 3, 0, 3, no
1462217611,  __Misantropia, 3, 0, 3, no
384757380,  SimoneSonnino, 1, 0, 1, no
306160885,  simonilla23, 1, 0, 1, no
371443272,  brandocanide, 5, 0, 5, no
2361705150,  kronos1980, 1, 0, 1, no
2530749611,  FeduzziMassi, 1, 0, 1, no
632913839,  AugustoCrespi, 1, 0, 1, no
1089769556,  infomolo55, 1, 0, 1, no
491076241,  robertocarvelli, 1, 0, 1, no
170689777,  ValeriaDesign, 1, 0, 1, no
479794355,  AWondercakes, 1, 0, 1, no
883108542,  ellabaffoni, 1, 0, 1, no
803253014878388224,  Pisce_it, 2, 0, 2, no
44340289,  ub1settantun0, 1, 0, 1, no
779420777317883904,  araitapersempre, 1, 0, 1, no
2837707258,  marinoamedeo3, 2, 0, 2, no
429422542,  twidado, 1, 0, 1, no
509309976,  FraespoEsposito, 1, 0, 1, no
578436775,  SilviaPizei, 1, 0, 1, no
14844426,  kLn69, 1, 0, 1, no
569528684,  FedericaSaraZol, 1, 0, 1, no
52003616,  LuigiFunari, 1, 0, 1, no
341048101,  Scjx, 1, 0, 1, no
1368234301,  emanuelmaddalen, 5, 0, 5, no
106542611,  zazaraziel, 1, 0, 1, no
319769760,  LivioMeacci, 1, 0, 1, no
115764177,  LorussoFabrizio, 1, 0, 1, no
1259239400,  DeniseScaramell, 2, 0, 2, no
2795074967,  lucinun, 1, 0, 1, no
3379963119,  AtacMerda, 1, 0, 1, no
1880948568,  amp0129, 1, 0, 1, no
788822353048432644,  Frances83358515, 1, 0, 1, no
3202085314,  EmanEleon, 1, 0, 1, no
1020020185,  Rosy9x, 1, 0, 1, no
3939037995,  giovanni_cerva, 1, 0, 1, no
8239432,  maus75, 4, 0, 4, no
802152857759842304,  barbarasertori, 2, 0, 2, no
1163827946,  PaoloVani, 1, 0, 1, no
2633956390,  SONIA051971, 2, 0, 2, no
499639372,  ECrosses, 2, 1, 1, neutral
632735778,  Aiyo07, 1, 0, 1, no
522616321,  GALIX77, 2, 0, 2, no
2949854579,  214c001cafda41f, 1, 0, 1, no
950216629,  old_marlet, 2, 0, 2, no
172503199,  ShioinYoruichi, 1, 0, 1, no
2964821891,  EnricoPazzi, 1, 0, 1, no
428006506,  BartoloTaormina, 1, 0, 1, no
1876630176,  supportersmagaz, 1, 0, 1, no
2743258907,  uspalletti, 1, 0, 1, no
777922906496102400,  MicAmato81, 1, 0, 1, no
2670574903,  2MunicipioRm, 2, 0, 2, no
2619826325,  Lally238, 1, 0, 1, no
310105359,  neopat2007, 1, 0, 1, no
15890886,  lucaboccianti, 1, 0, 1, no
2706096814,  colledegliabeti, 1, 0, 1, no
710806725,  tzaretta, 2, 0, 2, no
3094856279,  GanapiniMaurena, 1, 0, 1, no
420668866,  vivianabroglio, 1, 0, 1, no
266458661,  Falzarego, 3, 0, 3, no
1148764633,  durlindana69, 1, 0, 1, no
721184007,  MicRuggiero, 1, 0, 1, no
382788418,  _lo_ce, 1, 0, 1, no
2250674359,  SULPLROMA, 1, 0, 1, no
2262267598,  federtaxiroma, 1, 0, 1, no
626636550,  marconap75, 1, 0, 1, no
4736696753,  GuidoT29, 1, 0, 1, no
131544026,  DomenicoDB, 1, 0, 1, no
174802800,  ariadnestella, 1, 0, 1, no
2490233792,  lithinglife, 1, 0, 1, no
633805675,  MayoImpazzita, 1, 0, 1, no
149859582,  KavanTropia, 1, 0, 1, no
2517333900,  romandergra, 1, 0, 1, no
402974667,  stefanomarini, 1, 0, 1, no
141677910,  GianmariaPica, 1, 0, 1, no
984716708,  CosBasta, 1, 0, 1, no
323146830,  GiudyP, 1, 0, 1, no
159562066,  DonatellaLiuzzi, 1, 0, 1, no
711096762900025349,  nicopando71, 1, 0, 1, no
1011859734,  wileCoyote81, 1, 0, 1, no
2613282376,  EnricoTerrinoni, 1, 0, 1, no
161719940,  _Honeycomb_, 1, 0, 1, no
629334187,  PaoloSabbatucci, 1, 0, 1, no
2935087216,  AlexDeCinti, 1, 0, 1, no
793526411336228864,  Smartjoepress, 1, 0, 1, no
962101518,  marcostefanovit, 2, 0, 2, no
231011153,  paopape, 1, 0, 1, no
103595040,  dadadanix, 1, 0, 1, no
4004995319,  PazzoCarbonaro, 1, 0, 1, no
326157457,  MECK187, 2, 0, 2, no
2362414955,  DnlAmbrosini, 1, 0, 1, no
3051006873,  Azzurra366, 1, 0, 1, no
384818191,  FabrizioMaiozzi, 1, 0, 1, no
322728085,  Alisernio, 1, 0, 1, no
2872761441,  Davidejanoski, 1, 0, 1, no
1334303052,  moioisabella, 1, 0, 1, no
418530644,  Udaloy2, 2, 0, 2, no
3293156833,  Gelso02, 2, 0, 2, no
2331003771,  cinquantuno63, 2, 0, 2, no
797527253458554880,  Roberto08087298, 1, 0, 1, no
36636510,  lukilotom, 1, 0, 1, no
2923701220,  mrnnni, 1, 0, 1, no
31073250,  dacher70, 1, 0, 1, no
1523391000,  dedalasa, 1, 0, 1, no
91598969,  papero33, 1, 0, 1, no
279488511,  JennyTheComet, 1, 0, 1, no
2313838855,  filippo1936, 1, 0, 1, no
802208027038351360,  MariatittaRita, 1, 0, 1, no
1042958780,  ManiniLuciano, 1, 0, 1, no
1245673243,  GinnuzzuLuigi, 1, 0, 1, no
1395576606,  STEVE_241, 2, 0, 2, no
1430355200,  elaza78_mily, 2, 0, 2, no
287913024,  francescodefeo0, 1, 0, 1, no
138850923,  Leo_nardone, 2, 0, 2, no
1316738234,  CarloSeneci, 1, 0, 1, no
2365041713,  nuvoletta49, 1, 0, 1, no
460964150,  AngeloAspen, 1, 0, 1, no
21331752,  pierdonnini, 1, 0, 1, no
1172609270,  GmTafalia66, 2, 0, 2, no
278663070,  Sonya_Merenwen, 1, 0, 1, no
17465312,  elandel, 1, 0, 1, no
432314687,  gminacapelli, 1, 0, 1, no
758723224486150146,  degliesposti555, 1, 0, 1, no
345355078,  annakoj, 1, 0, 1, no
47699270,  lilloraffa, 1, 0, 1, no
774947929052291072,  Fulvio36491818, 2, 0, 2, no
770987858278674432,  anna_lucantoni, 1, 0, 1, no
3243634917,  Ercole50062492, 1, 0, 1, no
2156447281,  Lordbrady, 1, 0, 1, no
4612076177,  elisabettafabb, 2, 0, 2, no
418941097,  GabrieleMeoni, 1, 0, 1, no
1367853685,  slimnessseeker, 1, 0, 1, no
1249837879,  salvatorealotta, 8, 0, 8, no
801870748524625920,  Salvato12832415, 1, 0, 1, no
767063814235942913,  antonyconguero, 4, 0, 4, no
1269713336,  MartaGrande87, 1, 0, 1, no
264741422,  GioCheru, 9, 0, 9, no
1947326047,  Nervjc, 1, 0, 1, no
915103669,  Ale_Valenzise, 2, 0, 2, no
805559589177593856,  geremiatr, 1, 0, 1, no
2354652397,  astro_gianf, 1, 0, 1, no
777410247698841600,  giampaolo581, 2, 0, 2, no
129916269,  nonabbiatepaura, 1, 0, 1, no
496059257,  Luca_Sferrazza, 1, 0, 1, no
2276721335,  manuanto87, 2, 0, 2, no
1001206868,  Lucantarello, 2, 0, 2, no
467443952,  Philippe_FQSP, 1, 0, 1, no
712723654111588353,  cibi7299, 2, 0, 2, no
2284121413,  Rudi_trento, 1, 0, 1, no
2973475863,  MasiStefano6, 1, 0, 1, no
163822088,  refolina, 1, 0, 1, no
1285999218,  JDanloor, 1, 0, 1, no
973620294,  vincult, 1, 0, 1, no
2328757685,  AngelsMelanco, 1, 0, 1, no
20221833,  SuckMyLEFTJuan, 1, 0, 1, no
3147465341,  luigi_lucaselli, 1, 0, 1, no
60585080,  nicolafocci, 1, 0, 1, no
1320924583,  Gaetano2803, 1, 0, 1, no
549605964,  aledamato1, 1, 0, 1, no
1962640886,  Mr_Ribbo, 1, 0, 1, no
238817640,  mauri_bruzzone, 2, 0, 2, no
805849648569139200,  LuigiGrieco6, 1, 0, 1, no
227199711,  ilvecchioHolden, 1, 0, 1, no
141905030,  bigetto, 1, 0, 1, no
420277197,  Melinda_67, 1, 0, 1, no
760739499236360194,  simocoraggio, 1, 0, 1, no
1382712390,  cfbuffa, 1, 0, 1, no
464680955,  SASSOMICHELE, 1, 0, 1, no
1265473094,  Pat_Manzo, 1, 0, 1, no
75249690,  LuigiStarace, 2, 0, 2, no
829395187,  CabaTattoo, 2, 0, 2, no
590280820,  DINOPiluso, 1, 0, 1, no
2908260178,  GzZanutel, 1, 0, 1, no
1104380844,  ilarial94, 1, 0, 1, no
2255399935,  BaldassarriGiu, 1, 0, 1, no
2897894483,  AlbertoStulfa, 1, 0, 1, no
540761209,  alfo_innuendo, 1, 0, 1, no
286226119,  marcobruno999, 1, 0, 1, no
803477847117598721,  hotscritimver11, 1, 0, 1, no
517651649,  Eleluna83, 1, 0, 1, no
1059018253,  mluis1508, 2, 0, 2, no
1564993735,  rocco_rtlupin, 2, 0, 2, no
853465500,  NostroGianluca, 1, 0, 1, no
1274727440,  giovannicafori1, 1, 0, 1, no
607659598,  SarahFlorGrundy, 4, 0, 4, no
337348136,  LuisellaPasinel, 1, 0, 1, no
83886546,  roxygi, 2, 0, 2, no
727924653407260672,  SigSergio70, 1, 0, 1, no
1272189564,  ASTORPIER, 1, 0, 1, no
3065652119,  NoSiX96, 1, 0, 1, no
473121090,  VladiMurtas, 1, 0, 1, no
2821253656,  davideciurleo, 2, 0, 2, no
414225292,  claudiociancale, 1, 0, 1, no
4353254315,  Hermann_74, 2, 0, 2, no
539425700,  GabrieleCaimi, 1, 0, 1, no
230233730,  apelatti, 1, 0, 1, no
1498521200,  arkino82, 2, 0, 2, no
723554251612499968,  marionecomix, 7, 0, 7, no
2564764786,  SimoAsca, 1, 0, 1, no
588504107,  Ciemme68Claudio, 1, 0, 1, no
237879069,  TheLorenz74, 1, 0, 1, no
801504624,  MarioScfl, 1, 0, 1, no
3131557655,  raffarossi1606, 2, 0, 2, no
90935990,  JJ_OGStaff, 1, 0, 1, no
596682996,  223cotton, 1, 0, 1, no
4608476307,  marcomoschini20, 1, 0, 1, no
784661950286405632,  maryebasta63, 2, 0, 2, no
532610405,  SBazzano, 9, 0, 9, no
2333543961,  CapoferriLidia, 1, 0, 1, no
12660582,  cranius, 22, 0, 22, no
1392931717,  cristinamotta9, 1, 0, 1, no
3333003592,  pietro2015febb1, 1, 0, 1, no
53883,  miaotze, 1, 0, 1, no
858340783,  faustoaron, 1, 0, 1, no
574087401,  andreafdx, 1, 0, 1, no
145752036,  maxshore, 1, 0, 1, no
704746963091267584,  ascoltare2, 6, 0, 6, no
2224822652,  RemoRisoldiM5S, 1, 0, 1, no
1976578177,  ilrossoeilnero2, 2, 0, 2, no
795617180993912833,  Grazia66906651, 1, 0, 1, no
1213474032,  LilloMalillo, 1, 0, 1, no
564911536,  molfra66, 1, 0, 1, no
4120950795,  andrejkoimaskj, 1, 0, 1, no
333434977,  MlleSimona, 1, 0, 1, no
572802695,  angelosaer, 2, 0, 2, no
101765739,  fotoelite, 1, 0, 1, no
3230650755,  concy_manzi, 1, 0, 1, no
287818496,  fralogos32, 1, 0, 1, no
2284081610,  RinoAngeloni, 1, 0, 1, no
63562263,  cettinamellusi, 1, 0, 1, no
1965030139,  CausinPaolino, 1, 0, 1, no
799289611134570496,  Mantinetta, 1, 0, 1, no
576974264,  LCastellese, 1, 0, 1, no
2845226548,  Elybon1, 1, 0, 1, no
412877896,  AlbertSchiavone, 1, 0, 1, no
165001818,  ari1190, 1, 0, 1, no
2409138080,  EnricoBurzi, 2, 0, 2, no
799976204312973312,  c671cf893230427, 1, 0, 1, no
384575017,  alesort, 1, 0, 1, no
3147339230,  bony_rabbit, 1, 0, 1, no
519348439,  the_white_cloud, 1, 0, 1, no
434250277,  data971, 1, 0, 1, no
1124778091,  BiascoKatia, 1, 0, 1, no
592744715,  quamiuvat, 2, 0, 2, no
1261822464,  dibarolomeovinc, 1, 0, 1, no
207066712,  olcaponet, 2, 0, 2, no
707301670246600704,  harry59degroot, 1, 0, 1, no
1055093430,  EHuober, 1, 0, 1, no
449976360,  RossValsecchi, 1, 0, 1, no
2412339565,  Borghizio, 1, 0, 1, no
2189689654,  seresileoni, 1, 0, 1, no
3295324269,  Gattastraordina, 1, 0, 1, no
3039916030,  alessia_cinti, 1, 0, 1, no
803361578087251968,  skyfato, 1, 0, 1, no
2435980673,  77_russo, 1, 0, 1, no
1322053105,  laurapelosi2, 1, 0, 1, no
80838485,  andrea_piras_, 1, 0, 1, no
4603648397,  FilosofoDelCazz, 1, 0, 1, no
796720508427452416,  FLIPPER92843888, 3, 0, 3, no
712042147785080832,  ziocane66, 2, 0, 2, no
161074994,  tonytascino, 2, 0, 2, no
1017064423,  giuseppedisal14, 1, 0, 1, no
801133637911592960,  FernandoPuglie5, 2, 0, 2, no
973525898,  cosimo_adelizzi, 1, 0, 1, no
1094882970,  fontowan, 1, 0, 1, no
10468492,  albemai, 1, 0, 1, no
4575887902,  EnzaLuppino, 3, 0, 3, no
449759153,  MariaDAngelo4, 2, 0, 2, no
436226414,  fpezza, 1, 0, 1, no
14459385,  facio75, 1, 0, 1, no
384431924,  Lidia_Undiemi, 1, 0, 1, no
388891207,  ammaiFiamma, 1, 0, 1, no
2832460317,  Eziosserva, 1, 0, 1, no
751515989716660225,  Roberto94911, 1, 0, 1, no
756919771,  alastarte, 1, 0, 1, no
590943622,  RProti, 1, 0, 1, no
316375408,  DianaDalla, 1, 0, 1, no
221745046,  sailormars05, 1, 0, 1, no
741184122505289728,  EmekaSkd, 1, 0, 1, no
3028280830,  2008_lory, 2, 0, 2, no
393483438,  ilbolly, 1, 0, 1, no
49948347,  lukaduo, 1, 0, 1, no
988884571,  luisacinquestel, 1, 0, 1, no
2187882296,  Ali2_official, 1, 0, 1, no
3046854717,  DondiniLeonardo, 1, 0, 1, no
51423547,  antpa, 1, 0, 1, no
786871864752762880,  mad_maximi, 1, 0, 1, no
575059060,  FaustoBianchini, 1, 0, 1, no
451417249,  ClaudioFasani, 1, 0, 1, no
387087335,  nutella1963, 2, 0, 2, no
2225589287,  diamine71, 1, 0, 1, no
2869252114,  mircop6220, 1, 0, 1, no
1126084872,  SaiCheARoma, 1, 0, 1, no
498645635,  RRandazz, 2, 0, 2, no
1142594798,  V_Gulliver, 1, 0, 1, no
1387027693,  MircoAvanzo, 1, 0, 1, no
3424813330,  Beppe_Giuliano, 1, 0, 1, no
3227062253,  FedericoIIZ, 1, 0, 1, no
92525639,  pierovietti, 1, 0, 1, no
3866051891,  Ralfbevis, 1, 0, 1, no
215305370,  lele_74, 1, 0, 1, no
635668294,  mattegaet75, 1, 0, 1, no
748860623392505856,  PDenocratico, 1, 0, 1, no
794583917999357953,  Antonin0082291, 1, 0, 1, no
591979464,  snusiinfante, 1, 0, 1, no
338976684,  elmarkia, 2, 0, 2, no
2277800886,  emmepi_pr, 1, 0, 1, no
2498384664,  ely7389, 1, 0, 1, no
3546314488,  Mello_1988, 1, 0, 1, no
80038104,  Millazena, 1, 0, 1, no
394763740,  NMarsura, 1, 0, 1, no
52075535,  cristianodemajo, 1, 0, 1, no
1534580701,  TarantinaMente, 1, 0, 1, no
2592010609,  axelmojave, 1, 0, 1, no
125307930,  im_the_king_01, 1, 0, 1, no
2359894718,  stepitts, 1, 0, 1, no
2276619450,  zigon74, 1, 0, 1, no
256072596,  EleonoraGavio, 1, 0, 1, no
104841553,  ORTUCU, 1, 0, 1, no
709797795,  picueb, 1, 0, 1, no
172398463,  giuliodjsun, 1, 0, 1, no
4827008141,  Epesses59Tigre, 2, 0, 2, no
338376782,  EnricaSabatini, 1, 0, 1, no
2361128843,  cago_sui_gobbi, 1, 0, 1, no
174232595,  thosarmas, 2, 0, 2, no
1896572778,  Catilina89, 1, 0, 1, no
2744324373,  Luciliusenex, 1, 0, 1, no
777040765167996928,  LauraLaurablm, 1, 0, 1, no
97515974,  mai_lastessa, 1, 0, 1, no
623027480,  GabboAntoninoN1, 25, 0, 25, no
323764149,  VincenzoAlori, 1, 0, 1, no
401394767,  GENCOSILVIO, 1, 0, 1, no
395419050,  TortOrlando, 1, 0, 1, no
3397375498,  claudiogiammat2, 3, 0, 3, no
2364054668,  lucio06091996, 1, 0, 1, no
732637887263571968,  FilippoMartore2, 1, 0, 1, no
717113875620040704,  Mikythebest7, 1, 0, 1, no
387078143,  dobrevshug, 1, 0, 1, no
4872180215,  evelina_marino, 1, 0, 1, no
798072013655015424,  robcup64, 1, 0, 1, no
476791070,  MarcoLittera, 3, 0, 3, no
260404258,  titoramidara, 1, 0, 1, no
804013588105064453,  jaelz94, 2, 0, 2, no
514599314,  manliomaltempi, 1, 0, 1, no
741042600707297280,  AdaAda72197756, 1, 0, 1, no
390632691,  luca_ics, 4, 0, 4, no
2306326187,  lucyfata, 1, 0, 1, no
3290208330,  serena101178, 1, 0, 1, no
2843657991,  PatriziaCaputo3, 1, 0, 1, no
153368159,  ThFio, 1, 0, 1, no
2603193848,  FabiowFlorio, 1, 0, 1, no
3052729247,  xelecollins, 2, 0, 2, no
2956894029,  cliclirain, 1, 0, 1, no
766317983962656768,  thortellino, 1, 0, 1, no
782100039879589888,  petrelliascoli, 1, 0, 1, no
750306271165898752,  _AlbeireG_, 1, 0, 1, no
1012199538,  Giusy_Campo, 1, 0, 1, no
835547988,  Alessandrouda19, 2, 0, 2, no
408521008,  Sbobtv, 1, 0, 1, no
191592633,  L_Morassi, 1, 0, 1, no
802615953032880128,  ziatina84, 1, 0, 1, no
801109550950662145,  glamtipherta191, 1, 0, 1, no
564068843,  Tushi59058193, 2, 0, 2, no
73846193,  rodibe, 2, 0, 2, no
575127542,  ElisaMusi, 1, 0, 1, no
3930881235,  dix1979, 1, 0, 1, no
1596116120,  papillonpa, 1, 0, 1, no
1228461907,  gian_1973, 1, 0, 1, no
372413317,  aledando88, 1, 0, 1, no
2377000184,  sararicci24, 1, 0, 1, no
18578213,  tavernitimonica, 2, 0, 2, no
4732545197,  Occhiverdi_79, 1, 0, 1, no
1208707927,  salvo86442975, 1, 0, 1, no
1032807428,  Claudio_59_, 1, 0, 1, no
557994791,  fracristiano87, 1, 0, 1, no
408442694,  gryaho, 1, 0, 1, no
29926710,  ItalianSerieA, 1, 0, 1, no
2998817062,  ManfieldPeter, 1, 0, 1, no
113348709,  andreasantopiet, 1, 0, 1, no
593558753,  ClaudioDaBo, 1, 0, 1, no
506425689,  GIUSPY_, 1, 0, 1, no
167562908,  MauroZambelli, 1, 0, 1, no
605281984,  AntoMosca, 1, 0, 1, no
239950313,  zuppel63, 1, 0, 1, no
3089673065,  LinnnusPaolo, 2, 0, 2, no
4431715060,  andrearossiros1, 1, 0, 1, no
183370703,  franciritrovato, 1, 0, 1, no
2531197737,  jackiemopsy, 1, 0, 1, no
500614553,  RvRavenstijn, 1, 0, 1, no
173943002,  valemoyanomunoz, 1, 0, 1, no
3696334103,  viaggiodelmese, 1, 0, 1, no
3014221517,  maurobone54, 1, 0, 1, no
984507426,  mubblemubble, 1, 0, 1, no
2297748609,  nicoletta_lippi, 1, 0, 1, no
1219180723,  dinopuglisi, 2, 0, 2, no
4394989595,  GennaroLacatena, 1, 0, 1, no
115657951,  ldandrea08, 1, 0, 1, no
3115012150,  Claudina_Luci, 2, 0, 2, no
2572855533,  Nbeltrallo, 1, 0, 1, no
29167452,  AnnaChiara66, 1, 0, 1, no
3180067061,  IperDaBidda, 1, 0, 1, no
715564501152768003,  brixtoninnit, 1, 0, 1, no
183402202,  eguanella, 1, 0, 1, no
29963789,  davidezane, 1, 0, 1, no
429874362,  AnnaCBR600, 1, 0, 1, no
793404950353211392,  f_tutto, 1, 0, 1, no
1636428810,  SalvatoreLori, 1, 0, 1, no
141876243,  PaolaBaro, 1, 0, 1, no
487064233,  Ale74terni, 1, 0, 1, no
2413702907,  MaxpasinMap, 1, 0, 1, no
3043115600,  lucacapvt, 1, 0, 1, no
212569744,  forrunner1, 1, 0, 1, no
4896545899,  elio_cnx, 1, 0, 1, no
3102369712,  ORC_MI, 1, 0, 1, no
755398952493674496,  alisa_guida26, 1, 0, 1, no
4579284021,  trattiDistratti, 2, 1, 1, neutral
118057609,  6praia, 1, 0, 1, no
399516281,  CavallariErica, 1, 0, 1, no
714418971060076545,  simone_centra, 1, 0, 1, no
2665959495,  Esp8950, 1, 0, 1, no
518715637,  Mgv19118, 1, 0, 1, no
149972325,  bladimird, 1, 0, 1, no
2649441979,  __Fabiana___, 1, 0, 1, no
989151792,  M_C4R, 1, 0, 1, no
57598603,  LaMuseP, 1, 0, 1, no
223112072,  chesschifo, 1, 0, 1, no
131460484,  Gillocolonna, 1, 0, 1, no
536397889,  MirtillaMering1, 1, 0, 1, no
4843542401,  gabysan63, 1, 0, 1, no
1397942977,  Luca_Montezuma, 1, 0, 1, no
3350956385,  vespro4, 1, 0, 1, no
993157424,  angeluccigi, 2, 0, 2, no
1304080812,  orlandini1996, 1, 0, 1, no
3957668361,  enrigoletto, 1, 0, 1, no
3067621237,  paolainla, 1, 0, 1, no
25706997,  palloncino, 1, 0, 1, no
802859221507276800,  AlexMas74193295, 1, 0, 1, no
755342412,  AngeloBaldes, 2, 0, 2, no
99305428,  il_Gino, 1, 0, 1, no
805128308,  EmilioVia, 1, 0, 1, no
499134939,  SimonettaCarreg, 1, 0, 1, no
3906835099,  1cdfe88d3fa642d, 1, 0, 1, no
1947781513,  GIASORDI, 1, 0, 1, no
769257998,  debenedettimrco, 1, 0, 1, no
2520216374,  Nicky_210855, 1, 0, 1, no
443647219,  MadePam, 1, 0, 1, no
130491008,  brutusway, 2, 0, 2, no
465823907,  saragat0, 2, 0, 2, no
1421610379,  rossanotronto, 2, 0, 2, no
2845726755,  monicabarra29, 1, 0, 1, no
801523742413307904,  Giovann82723282, 1, 0, 1, no
1176004045,  FIngefra, 2, 0, 2, no
768524508932239360,  SIMONEJUVEPAVEL, 1, 0, 1, no
764816634963980288,  sergio_zangara, 1, 0, 1, no
1847744737,  GlucaFerrara, 2, 0, 2, no
4320259347,  58Caterina, 2, 0, 2, no
802174189822218240,  witco14, 1, 0, 1, no
2276032819,  jeannestefan, 1, 0, 1, no
284698211,  rorobelushi, 1, 0, 1, no
438799855,  AntoMelk, 1, 0, 1, no
139051050,  sociopatico87, 1, 0, 1, no
220790490,  otrebored, 1, 0, 1, no
2271870859,  MarcoMcpamposs, 1, 0, 1, no
4665546447,  famigliettiant1, 1, 0, 1, no
822911887,  fedimaro, 2, 0, 2, no
776403104526893057,  LuigiMinali, 1, 0, 1, no
803352915339595776,  dirkcarma, 1, 0, 1, no
1243910071,  5Canatt, 1, 0, 1, no
2347188528,  SergioRizzo70, 1, 0, 1, no
265941526,  StreetSmarts111, 1, 0, 1, no
174780693,  alsky68, 1, 0, 1, no
2998672889,  SiciAntonio, 1, 0, 1, no
782252594974580737,  gianmaria46, 2, 0, 2, no
4084997943,  SeraOsvaldo, 1, 0, 1, no
115359949,  ParmaLaRossa, 1, 0, 1, no
342076860,  AntoninaLeone, 1, 0, 1, no
293699524,  Orypaolo66, 1, 0, 1, no
778213728978399232,  novellifabio57, 1, 0, 1, no
702956983717068800,  f9a196fb52de4b8, 1, 0, 1, no
752179613665812480,  GiorgioVerrecc, 1, 0, 1, no
729765741814292481,  Gigi_Cata, 3, 0, 3, no
2320089569,  BabiDorso, 1, 0, 1, no
491351022,  AnlattLattanzi, 1, 0, 1, no
2300388132,  AntonioEntotar, 1, 0, 1, no
538894700,  paolopancaldi, 1, 0, 1, no
831036938,  sergio_nazzaro, 1, 0, 1, no
22035287,  carmoret, 1, 0, 1, no
528461591,  AdrianoTrop, 1, 0, 1, no
61186603,  massimods, 3, 0, 3, no
784398418949074944,  NicoSusini, 1, 0, 1, no
2678692048,  andrea_ilfalco, 1, 0, 1, no
2209268871,  thenocchius, 1, 0, 1, no
49988368,  Tat_ox, 2, 0, 2, no
287289678,  TheCarbayon, 1, 0, 1, no
52073784,  LizzyFlour, 1, 0, 1, no
4046187219,  _BPdP_, 1, 0, 1, no
145919363,  lukas1970, 1, 0, 1, no
146807161,  th3lastsamura1, 1, 0, 1, no
9619082,  yanez72, 1, 0, 1, no
576487510,  livia_67, 1, 0, 1, no
432029868,  martycly, 1, 0, 1, no
728704486080917504,  TabataRouse, 1, 0, 1, no
1144724168,  colpadelleuro, 1, 0, 1, no
782519200044679168,  MCeretti80, 1, 0, 1, no
1527250062,  vincenzogilard1, 2, 0, 2, no
696271187534598145,  PaltitoDemoclat, 1, 0, 1, no
4891182579,  RenZiTung, 1, 0, 1, no
3742104076,  Grillo_VtruVano, 1, 0, 1, no
4046411357,  Honesty_Int, 1, 0, 1, no
4144056819,  Salvisconi, 1, 0, 1, no
4687135406,  fatto5stelle, 1, 0, 1, no
454204123,  ChiaraFadda2, 1, 0, 1, no
31158194,  maxim63, 1, 0, 1, no
1627351170,  silverblade65, 1, 0, 1, no
160471953,  n_poletti, 2, 0, 2, no
708722387848720384,  mandapeppe, 1, 0, 1, no
253229564,  sartanoinmente, 2, 1, 1, neutral
799687683484172290,  mariaelena6172, 2, 1, 1, neutral
712703426468126722,  tangram_ta, 1, 0, 1, no
722341444720193536,  CARLACOSTANTIN5, 1, 0, 1, no
773146998648307712,  AmbSachs, 2, 1, 1, neutral
456976486,  SteffRomagnoli, 1, 0, 1, no
976952114,  diceNiNi, 1, 0, 1, no
873484584,  AngelaBevere, 1, 0, 1, no
374520633,  FrancoDrZap, 1, 0, 1, no
1295065447,  billi1963, 1, 0, 1, no
1009888627,  kittkarsen, 1, 0, 1, no
630249596,  annacuciniello, 1, 0, 1, no
2791515574,  AleCosta115, 1, 0, 1, no
124517180,  davidelosito, 7, 0, 7, no
1909146774,  donato_valerio, 1, 0, 1, no
562285429,  bncnln, 1, 0, 1, no
3346548844,  geomsalvatores2, 3, 0, 3, no
782862294338469888,  sinistragargano, 2, 0, 2, no
456219686,  NCampedelli, 1, 0, 1, no
50123208,  Maria_Suma, 1, 0, 1, no
72857016,  fabioturra, 1, 0, 1, no
588968100,  lucapuuu, 1, 0, 1, no
114321159,  RoBlum, 1, 0, 1, no
303175724,  windpier, 1, 0, 1, no
554555095,  Garla51, 1, 0, 1, no
2464823086,  CadoniciGiorgio, 2, 0, 2, no
1062986299,  AlbertoMacr, 2, 0, 2, no
80913303,  peppeuz, 2, 0, 2, no
737695597864595458,  myriadforms, 2, 0, 2, no
2784546021,  mgcarbotti, 1, 0, 1, no
1376631973,  Sherpa_83, 2, 0, 2, no
389436565,  Mauro_da_Pesaro, 1, 0, 1, no
477015981,  pal_lore, 1, 0, 1, no
3383047606,  articolo3savona, 4, 0, 4, no
802140278186459136,  jmaroneh, 1, 0, 1, no
52777649,  justwaitingfor, 1, 0, 1, no
4137817637,  bau_delaire76, 1, 0, 1, no
491319459,  cesko981, 1, 0, 1, no
60042349,  rolentola, 1, 0, 1, no
2315591179,  VerdiTaranto, 1, 0, 1, no
3020685586,  GianniCommodo, 2, 0, 2, no
3405837303,  PaolaBelforte, 1, 0, 1, no
712045138374213632,  giorgiosisti86, 1, 0, 1, no
394127026,  SNicoletti75, 1, 0, 1, no
444090574,  tweetarge, 3, 0, 3, no
3403818359,  bianca08463077, 1, 0, 1, no
1397692812,  Punkaldi16, 1, 0, 1, no
461446104,  risikoGE, 1, 0, 1, no
295067525,  ciro649, 1, 0, 1, no
3297668817,  forzauova, 1, 0, 1, no
3633459021,  PalazzoContessa, 3, 0, 3, no
381378184,  caronte78, 8, 0, 8, no
489721603,  CaliCla, 1, 0, 1, no
608435854,  Save0nIL, 1, 0, 1, no
1377031602,  iostoconCivati, 2, 0, 2, no
1204481552,  valgiovio, 1, 0, 1, no
3438039274,  PossibileMiEst, 1, 0, 1, no
51390659,  Fe4ericoDel, 1, 0, 1, no
707850172307472384,  Uni2grow, 1, 0, 1, no
298032144,  elofoolish, 1, 0, 1, no
1049008081,  RaffaeleRaimon2, 1, 0, 1, no
166252036,  nelpold, 1, 0, 1, no
803607670896857088,  Charles39141784, 2, 0, 2, no
398306711,  D1M9G72, 1, 0, 1, no
953258047,  bdeguglielmo, 1, 0, 1, no
2684317517,  sinivale, 1, 0, 1, no
2937794518,  Tiesfashion, 1, 0, 1, no
2872011039,  marcellocrucia1, 1, 0, 1, no
805089435738054657,  ero_chiara, 3, 0, 3, no
432842181,  FBardinella, 2, 1, 1, neutral
188425804,  dashingdesiree, 1, 0, 1, no
310524063,  LuPoten, 1, 0, 1, no
426056687,  Antonio_Decaro, 2, 1, 1, neutral
3239395349,  jackbella96, 1, 0, 1, no
3334814139,  IO_Dan_, 2, 1, 1, neutral
25746502,  herr_ludwig, 1, 0, 1, no
3384893884,  GesinoPaolo, 1, 0, 1, no
4264256531,  spacvous, 2, 1, 1, neutral
86021779,  michele_salv82, 1, 0, 1, no
3336849281,  caccia_mattia, 2, 0, 2, no
1066129710,  patty592008, 1, 0, 1, no
2785559012,  sancarloserena, 2, 2, 0, yes
452225155,  PastaStefano, 2, 2, 0, yes
798643617602695168,  Grace62826061, 2, 2, 0, yes
795640773073047552,  martuzza1992, 1, 1, 0, yes
99726049,  tannivella, 2, 2, 0, yes
845114430,  EUSocialInnov, 1, 0, 1, no
1134253987,  _Ironica_1, 1, 0, 1, no
546958874,  Labsus1, 1, 0, 1, no
3043999375,  legiones77, 2, 0, 2, no
472308628,  sabrinafiguccia, 1, 0, 1, no
795287627805130752,  felisquitieri, 1, 0, 1, no
877713914,  CarmeloCoppola, 1, 0, 1, no
772900941028884480,  ForzaGiovani, 1, 0, 1, no
402190569,  MaScano10, 1, 0, 1, no
4387739087,  Axel54193208, 2, 0, 2, no
541084493,  scuolapd, 1, 1, 0, yes
217909696,  dariogattuso, 1, 1, 0, yes
769910951143469057,  mabenveggior, 2, 2, 0, yes
406173706,  lellina9, 1, 1, 0, yes
432373469,  LorenzoVarponi, 1, 1, 0, yes
443005905,  matteopiloni, 2, 2, 0, yes
2368832677,  nandoburoni, 1, 1, 0, yes
716711752315105281,  nello_lapila, 1, 1, 0, yes
863596092,  LivioGrillo86, 1, 1, 0, yes
4084213101,  tempestine, 1, 1, 0, yes
948732571,  FeffeAtze, 1, 1, 0, yes
3309855796,  long_live_loud, 1, 1, 0, yes
1037882209,  giovannirazza63, 1, 1, 0, yes
467808427,  BrunoStrangis, 1, 1, 0, yes
854432666,  agarbo23, 1, 1, 0, yes
1474648554,  massimosabato2, 1, 1, 0, yes
733399198247194624,  Roberta02884210, 1, 1, 0, yes
56992707,  roxmtb, 1, 1, 0, yes
130114318,  fuemo_sr, 1, 1, 0, yes
2260174419,  Ghelemele, 1, 1, 0, yes
110407655,  thegianlucatv, 1, 1, 0, yes
96798994,  pierluigim, 1, 1, 0, yes
3546645802,  ultimoanarchico, 1, 1, 0, yes
3335209102,  massimopettinau, 1, 1, 0, yes
2902451260,  ang_bianchi, 1, 1, 0, yes
803782861765677056,  Christi00301449, 2, 2, 0, yes
469886629,  ivanuska79, 1, 1, 0, yes
157788976,  ciairo28, 1, 1, 0, yes
2940171280,  toremelis1951, 2, 2, 0, yes
44365850,  signor_g, 1, 1, 0, yes
792345692907905024,  alessina22, 2, 2, 0, yes
1272541094,  abuabu_it, 1, 1, 0, yes
557154074,  Giacca26, 1, 1, 0, yes
1275243168,  ICosulich, 1, 1, 0, yes
2291687349,  BeppeAmabile, 2, 2, 0, yes
1647401228,  ECaporalini, 4, 4, 0, yes
960952639,  holl_annie, 1, 1, 0, yes
66965578,  PaoloRazzano, 1, 1, 0, yes
736273601507266561,  CybermaryMaria, 1, 1, 0, yes
2682997773,  1985xxww, 1, 1, 0, yes
137097570,  beagiava, 1, 1, 0, yes
3270126810,  elle_tb15, 1, 1, 0, yes
773140845960855552,  aledili78, 1, 1, 0, yes
2793244697,  ValerioLivia, 2, 2, 0, yes
359575076,  minaccia72, 2, 2, 0, yes
2993829604,  MassZito, 1, 1, 0, yes
758057400226185216,  roseserum, 2, 2, 0, yes
665033,  jukka_re, 1, 1, 0, yes
599090564,  nivesguerra, 1, 1, 0, yes
1249499256,  francofri, 2, 1, 1, neutral
756606084413087744,  anon_Phonemix, 2, 2, 0, yes
1017057949,  Giuseppesnow, 1, 1, 0, yes
3057586576,  2b8cba70bdfd494, 2, 2, 0, yes
256027951,  monnietw, 2, 2, 0, yes
102479317,  aostasera, 2, 2, 0, yes
263764502,  RiccardiAngelo, 1, 1, 0, yes
422183991,  JuriMagrini, 2, 2, 0, yes
2517909115,  AurVinc88, 2, 2, 0, yes
1076633162,  andysimo79, 1, 1, 0, yes
1691513624,  giovyx_93, 1, 1, 0, yes
796953321911255040,  simisoundsicht1, 1, 1, 0, yes
748129984598933504,  stenbrick81, 1, 1, 0, yes
297868570,  Enrico_Lipari, 2, 2, 0, yes
390285941,  LucaBartolini77, 2, 2, 0, yes
55925583,  francescafini, 1, 1, 0, yes
489247775,  NINONipras, 1, 1, 0, yes
189612828,  terzullig, 4, 4, 0, yes
3369229600,  gianettilele, 1, 1, 0, yes
565300451,  FedericaP7, 2, 2, 0, yes
194619416,  PartSocialista, 2, 2, 0, yes
322563649,  NenciniPsi, 2, 2, 0, yes
417223754,  PierluMorelli, 1, 1, 0, yes
573089283,  MattiaSguazzini, 1, 1, 0, yes
704974666868326400,  GB_Economy, 1, 1, 0, yes
344873780,  alexthebest_7, 2, 2, 0, yes
3221064916,  libertaegualeIT, 1, 1, 0, yes
288818648,  andreatognotti, 2, 2, 0, yes
2549007144,  ITnewsBS, 1, 1, 0, yes
734695485236236288,  CivitavecchiaSI, 1, 1, 0, yes
21415789,  attivistipse, 1, 1, 0, yes
1092423506,  TRCgiornale, 1, 1, 0, yes
725633948626329600,  Mediavallenotiz, 1, 1, 0, yes
1086532536,  RiccM92, 1, 1, 0, yes
775214464476078080,  SalatinMarisa, 2, 2, 0, yes
1031243839,  LetyFranchi, 1, 1, 0, yes
1077211,  aldopinga, 1, 1, 0, yes
54988878,  DavidSassoli, 1, 1, 0, yes
90853079,  veracin, 2, 2, 0, yes
769888726579380224,  Fabiana_Fratti, 1, 1, 0, yes
127840439,  AntonioSomma, 1, 1, 0, yes
168191046,  torvat, 1, 1, 0, yes
891582636,  FeliceGiannini1, 1, 1, 0, yes
986870017,  maurojmanzo, 2, 2, 0, yes
421256635,  LorenzoBeltrame, 1, 1, 0, yes
85774828,  Domenico80, 1, 1, 0, yes
2784052049,  camaleon271, 1, 1, 0, yes
4073563527,  LibertaegualeLi, 1, 1, 0, yes
796885301918633984,  NoRad42, 1, 1, 0, yes
9106262,  remagio, 1, 1, 0, yes
1402684926,  KatzingIt, 1, 1, 0, yes
780743995383173120,  StefaniaForzan5, 1, 1, 0, yes
2448591096,  omareber1, 1, 1, 0, yes
50595914,  alconte, 2, 1, 1, neutral
2817862802,  ferrabino, 1, 1, 0, yes
307429112,  SerraRoberto, 2, 2, 0, yes
50471078,  andreadurso_73, 1, 1, 0, yes
874801201,  BettinaAnter, 2, 2, 0, yes
607353825,  ada_marra, 1, 1, 0, yes
593883870,  VerricoCasaleM, 1, 1, 0, yes
1325638555,  VincenzoRuopolo, 1, 1, 0, yes
385477663,  witterbeen, 1, 1, 0, yes
207535243,  ManueleMarcozzi, 1, 1, 0, yes
4829963293,  angygenc, 1, 1, 0, yes
4888364871,  alexciri87, 1, 1, 0, yes
775982896255565825,  RMS_FRTH, 1, 1, 0, yes
132506609,  ERNESTOAPUZZO, 1, 1, 0, yes
796990903269425152,  DMichieletti, 1, 1, 0, yes
65465146,  PeterWeb3, 1, 1, 0, yes
430160994,  Fede_Mariotti, 1, 0, 1, no
2289779280,  Massimopc1, 1, 0, 1, no
1563187658,  giuspetrosillo, 1, 0, 1, no
797794649297588224,  flavia_mataldi, 1, 0, 1, no
177645417,  fucilemario, 1, 0, 1, no
12179872,  Tecnoetica, 1, 0, 1, no
55027498,  mi_vitiello, 2, 0, 2, no
7111232,  disinformatico, 2, 2, 0, yes
799232527,  cr_bas, 2, 2, 0, yes
586429781,  CrivelliGiulia, 1, 1, 0, yes
409158913,  eleonocurreli, 1, 1, 0, yes
753701922473971713,  TerreProsecco, 2, 2, 0, yes
4566225075,  NASA71xxx, 1, 1, 0, yes
779360904475467777,  DamaMaxx, 1, 0, 1, no
359454995,  TrastevereRM, 3, 0, 3, no
1962577286,  Fajelamulta, 1, 0, 1, no
771984802807418880,  giuguih, 1, 0, 1, no
427297525,  albatortorici, 1, 0, 1, no
1019585222,  MiaSereni, 1, 0, 1, no
1334263597,  DavideConte80, 1, 0, 1, no
35739614,  acidorsa, 1, 0, 1, no
1393562082,  lamiadobermann, 1, 0, 1, no
2873807055,  WasteStrategyIT, 1, 0, 1, no
310153970,  FraSellari, 1, 0, 1, no
1006039993,  davidedionisi_, 1, 0, 1, no
552806581,  AriannaDeValeri, 1, 0, 1, no
75273087,  tonyveco, 1, 0, 1, no
408312540,  lareggio, 1, 0, 1, no
90166301,  batolino, 1, 0, 1, no
2267566928,  tutto_per_Roma, 1, 0, 1, no
4594680445,  Gabriel40844306, 1, 0, 1, no
227452853,  luka91rm, 1, 0, 1, no
400210083,  AnnaMasella1, 1, 0, 1, no
2744519609,  poterenero, 1, 0, 1, no
376218450,  AndreaScanzi, 1, 0, 1, no
782444881335713792,  avanzi_patrizia, 1, 0, 1, no
781174832130093056,  cefis77, 2, 0, 2, no
26444788,  danicat58, 3, 0, 3, no
772909927258005505,  Tower_Maria69, 1, 0, 1, no
2900945285,  BaglioniForever, 1, 0, 1, no
2872060322,  M5SWeAre99, 3, 0, 3, no
1504717525,  SmnCola, 1, 0, 1, no
421024001,  vighicarlo, 1, 0, 1, no
181318754,  IsraelinItaly, 2, 1, 1, neutral
2277828311,  g_damuri, 2, 1, 1, neutral
719848094981091328,  ippolitoetta, 1, 0, 1, no
60066745,  diego_sileo, 1, 0, 1, no
429797490,  pasquale_durso, 2, 0, 2, no
574429703,  CSVnet, 2, 2, 0, yes
245127941,  fraunipr, 1, 1, 0, yes
375333702,  luigirogolino, 1, 1, 0, yes
381810983,  roberto_tesei, 1, 1, 0, yes
2250563281,  GabrieleGiacch, 1, 1, 0, yes
2352631876,  GPovesi, 2, 2, 0, yes
430058524,  atzori_piero, 1, 1, 0, yes
118123086,  pablitox10, 1, 1, 0, yes
2447664170,  putryyy__s, 1, 0, 1, no
2598786017,  piedojole, 1, 0, 1, no
2556424255,  DirittiDem, 2, 0, 2, no
35214768,  Guanto89, 8, 0, 8, no
221538086,  Mini_Karen_, 1, 0, 1, no
1561380732,  mangeazza, 2, 0, 2, no
404051602,  lucianaelefante, 1, 0, 1, no
1251804560,  clabellumori79, 1, 0, 1, no
1572693642,  LaMomoo, 1, 0, 1, no
2712572104,  AndreaMannozzi, 1, 0, 1, no
287430226,  ILSIVA, 1, 0, 1, no
411739086,  carmenthesister, 1, 0, 1, no
496062807,  _CristinaC_, 1, 0, 1, no
987068240,  marcocalvi1973, 1, 0, 1, no
1195403832,  robyavo_, 1, 0, 1, no
596772242,  fausto_delfini, 1, 0, 1, no
1233468889,  ZangTumTumb, 1, 0, 1, no
321561841,  flaviozampa80, 1, 0, 1, no
891590768,  AttReds, 1, 0, 1, no
1978966777,  AbordAlessandro, 1, 0, 1, no
122420347,  lucaottaviano, 1, 0, 1, no
244898765,  43asarisi, 1, 0, 1, no
17948183,  oby1sky, 1, 0, 1, no
469210827,  AndreinaGallo1, 1, 0, 1, no
2325749553,  edoardoelmi, 1, 0, 1, no
751150192959823872,  BiscariLuigi, 1, 0, 1, no
306173200,  izetron, 2, 0, 2, no
1160989914,  graziel18298120, 2, 0, 2, no
457542725,  LBergianti, 2, 0, 2, no
2299501811,  ZZuccher, 1, 0, 1, no
775691826644779008,  SARAWEBO, 1, 0, 1, no
471935159,  Umb70, 1, 0, 1, no
4892086275,  raffaella6596, 2, 0, 2, no
18945486,  so_giovanni, 1, 0, 1, no
795731592950009856,  JeromeDrake69, 2, 0, 2, no
932408082,  monscer1, 2, 0, 2, no
979251522,  AndreaAntonino1, 1, 0, 1, no
2834034868,  simonetta1952c1, 1, 0, 1, no
3087427509,  MonacoGP, 1, 0, 1, no
3898304356,  El_Salbaneo, 1, 0, 1, no
968582010,  kittimanda, 1, 0, 1, no
448338914,  peppecaniglia, 1, 0, 1, no
799259554085216256,  dmzotimova, 1, 0, 1, no
472751675,  asmulevichmoked, 1, 0, 1, no
45763,  sasakifujika, 1, 0, 1, no
863334620,  ilCamisa, 1, 0, 1, no
702956804,  MatildeContino, 2, 0, 2, no
797127617774284800,  BarbaNeraSatira, 2, 0, 2, no
144973074,  weareincolour, 1, 0, 1, no
1039294760,  AntonioRenna5, 2, 0, 2, no
598563,  procionegobbo, 1, 0, 1, no
355808268,  fiorenzacipo, 2, 0, 2, no
917349780,  Gregori_9, 2, 0, 2, no
2865399789,  clementecuadu, 2, 0, 2, no
727701926544969728,  sartoris1960, 1, 0, 1, no
337113181,  LETIZIALOPEZ2, 3, 0, 3, no
941717468,  AlexTebi, 1, 0, 1, no
448083793,  etrusco72, 1, 0, 1, no
483818680,  fred_five, 1, 0, 1, no
1392593060,  bicchierevuoto, 1, 0, 1, no
1186190486,  Zerovirgolasei, 3, 1, 2, no
4301109268,  bobgrindyadown, 1, 0, 1, no
319699679,  cristiano663, 2, 0, 2, no
414369290,  linodan1, 1, 0, 1, no
2565703480,  aldomaria2014, 4, 0, 4, no
737708398125420545,  the_damn_i_give, 1, 0, 1, no
796253532936609792,  manuelaraponi, 1, 0, 1, no
618465622,  grazzi_giovanna, 1, 0, 1, no
1171615016,  GraziaIotti, 1, 0, 1, no
712607537489715200,  Carlotta9125, 1, 0, 1, no
1187920309,  IlBipolare, 1, 0, 1, no
7955602,  michelemezza, 1, 0, 1, no
2744419310,  neXtquotidiano, 1, 0, 1, no
3385762107,  Attypal, 1, 0, 1, no
2512461765,  ferro_sandro, 1, 0, 1, no
1673158423,  linofraschetti, 1, 0, 1, no
41592211,  alfiogilda, 1, 0, 1, no
712263543899480066,  RolandMitti, 2, 0, 2, no
90369822,  gnonino, 1, 0, 1, no
748833146104377344,  RaffaFaffaaa, 1, 0, 1, no
802207720908718081,  NemicaOfficial, 1, 0, 1, no
3297277417,  TonyAnbe81, 1, 0, 1, no
413978233,  ilariapedruzzi1, 1, 0, 1, no
3989830042,  FormaggIgnazio, 1, 0, 1, no
1530015979,  a_gigio, 1, 0, 1, no
462338725,  sempiAnna, 1, 0, 1, no
2534392685,  pickmefron, 1, 0, 1, no
2872133933,  frafranci62, 2, 1, 1, neutral
414686697,  AlfredoDAntonio, 2, 0, 2, no
1864429872,  AnnaGiunchedi, 1, 0, 1, no
3298832756,  LMontignani, 1, 0, 1, no
773997726,  PauTarcsio, 4, 0, 4, no
369961961,  denisfruscalzo1, 1, 0, 1, no
38495686,  giutul, 1, 0, 1, no
374510131,  raffotografo, 1, 0, 1, no
2776036158,  BiancaFrondoni, 1, 0, 1, no
1397510738,  PellegriniGio, 1, 0, 1, no
4926495803,  wildflower6422, 1, 0, 1, no
434705268,  EkaterinaVA8, 1, 0, 1, no
3192540098,  Bellajane127, 1, 0, 1, no
2933685617,  SylbermaSylvie, 2, 0, 2, no
792100041733308416,  MonicaTaveras3, 1, 0, 1, no
176238611,  altagrace121, 1, 0, 1, no
2545326607,  ArchangelMagicx, 1, 0, 1, no
326288537,  MariannBenway, 1, 0, 1, no
183263414,  BuonAndrew, 1, 0, 1, no
632940364,  biscaggina49, 1, 0, 1, no
772856434362953728,  ClaudetteDelon1, 1, 0, 1, no
4905181713,  recpnnue, 1, 0, 1, no
776110016369754114,  patatineconpan1, 1, 0, 1, no
459580953,  dyer_mods, 1, 0, 1, no
1905194282,  GianlucaSaiu, 1, 0, 1, no
3010735091,  daniele_social, 1, 0, 1, no
794640388602691585,  ElandrogeEco, 1, 0, 1, no
124020256,  MauroCasciari, 2, 0, 2, no
801425087585021952,  fpp345, 1, 0, 1, no
758782443482652672,  RcomeRinvio, 1, 0, 1, no
859915932,  mmancarell, 1, 0, 1, no
132295001,  mattilgale, 1, 0, 1, no
417957770,  RobSciarelli, 1, 0, 1, no
2366943176,  Pocahontas1913, 5, 0, 5, no
1339157467,  serpilloc, 7, 0, 7, no
2978230006,  vincenzo22964, 1, 0, 1, no
563718067,  Cmg21GRACIA, 1, 0, 1, no
3237119117,  pollybalme, 1, 0, 1, no
710745630839328768,  DavideDaffina, 1, 0, 1, no
1575572551,  l26560185, 3, 1, 2, no
326320843,  ufk37, 1, 0, 1, no
17693719,  valluan, 1, 0, 1, no
113889922,  Coco_Mars_, 1, 0, 1, no
292371234,  ffravolini, 2, 0, 2, no
3371417884,  stafanolilli, 1, 0, 1, no
260317931,  massidoo, 1, 0, 1, no
425882483,  SergCop, 1, 0, 1, no
49921379,  dandreaviola, 1, 0, 1, no
218992548,  madmaxsomm, 1, 0, 1, no
783053092753375236,  lucagiorgi0321, 1, 0, 1, no
957461155,  Retake_Roma, 1, 0, 1, no
2476947931,  LAPIS_NIGER_753, 1, 0, 1, no
3372929813,  Valentina_Sprea, 1, 0, 1, no
626284440,  stefdiste, 1, 0, 1, no
3094881555,  tutinodavide, 1, 0, 1, no
81853766,  elTioRom, 1, 0, 1, no
309933569,  marinaguarnieri, 1, 0, 1, no
3097765179,  robbo_5282, 1, 0, 1, no
478949778,  AFrisullo, 1, 1, 0, yes
449702471,  OcramFerraris, 1, 0, 1, no
715306908559806466,  OlgaMerlone, 2, 1, 1, neutral
511066939,  manu78r, 1, 0, 1, no
636535351,  SMay_76, 3, 0, 3, no
444668246,  ABertirott, 2, 0, 2, no
2350321508,  night82loord, 1, 0, 1, no
2516234993,  lulljassiagmail, 4, 0, 4, no
318371821,  facocero76, 1, 0, 1, no
2460381523,  iotwittodasolo, 1, 0, 1, no
466602032,  DeborahFrate, 1, 0, 1, no
732521189466378244,  ilvago1973, 1, 0, 1, no
781030906278604800,  i_poteri_forti, 1, 0, 1, no
1015406335,  antonellacatta3, 2, 0, 2, no
3225172937,  2f25b18ce75e4fe, 2, 0, 2, no
746789156588765184,  panicuocolo1, 2, 0, 2, no
993891668,  gian_curtis, 1, 0, 1, no
115410183,  robdefab, 1, 0, 1, no
1375557822,  robertoamato65, 1, 0, 1, no
781611241315926020,  PetrilliLidia, 1, 0, 1, no
762289531974512640,  VirgilioIndoran, 1, 0, 1, no
1852821055,  DepontiS, 1, 1, 0, yes
784447450660601857,  alterdalter, 1, 1, 0, yes
383111229,  isabellamurtas, 3, 3, 0, yes
765958811093962752,  Raffy4853, 2, 2, 0, yes
2895820156,  viaggioaoriente, 1, 1, 0, yes
500873160,  GliIntoccabili, 1, 1, 0, yes
303022623,  PinaImperato, 6, 6, 0, yes
1852086764,  2011LISA2, 1, 0, 1, no
1434986550,  RomaPulita, 1, 0, 1, no
263758608,  mapi_ipam, 1, 0, 1, no
243213767,  zio_ale, 2, 0, 2, no
4823563071,  Liukliuk25, 2, 0, 2, no
386983041,  BEPPECIPOLLA1, 1, 0, 1, no
2411294761,  JanGoodmanJ, 1, 0, 1, no
2417843232,  panicalem5s, 1, 0, 1, no
2332500221,  oliedenzo, 3, 0, 3, no
84554070,  Marfarra, 3, 0, 3, no
2671311874,  RoIaccarino, 1, 1, 0, yes
1281410628,  PaolaVitaletti, 1, 1, 0, yes
2198564562,  OmarBellicini, 1, 1, 0, yes
607106495,  Zozen75, 1, 1, 0, yes
